"Season_End_Year","Squad","Comp","Player","Nation","Pos","Age","Born","Mins_Per_90","Tkl_Tackles","TklW_Tackles","Def 3rd_Tackles","Mid 3rd_Tackles","Att 3rd_Tackles","Tkl_Challenges","Att_Challenges","Tkl_percent_Challenges","Lost_Challenges","Blocks_Blocks","Sh_Blocks","Pass_Blocks","Int","Tkl+Int","Clr","Err","Url"
2018,"Alavés","La Liga","Martin Agirregabiria","ESP","DF","21",1996,20.3,50,33,31,17,2,32,50,64,18,13,7,6,41,91,66,0,"https://fbref.com/en/players/355c883a/Martin-Agirregabiria"
2018,"Alavés","La Liga","Alexis","ESP","DF","31",1985,24.3,33,24,24,7,2,20,45,44.4,25,28,14,14,30,63,114,3,"https://fbref.com/en/players/db0cd1ae/Alexis"
2018,"Alavés","La Liga","Burgui","ESP","MF,FW","23",1993,11.5,10,5,2,4,4,2,6,33.3,4,5,0,5,7,17,1,0,"https://fbref.com/en/players/45e304c8/Burgui"
2018,"Alavés","La Liga","Ermedin Demirović","BIH","FW","19",1998,2,1,1,0,1,0,0,1,0,1,5,0,5,0,1,2,0,"https://fbref.com/en/players/ed79b7d3/Ermedin-Demirovic"
2018,"Alavés","La Liga","Adrián Diéguez","ESP","DF","21",1996,4.8,10,5,5,5,0,6,13,46.2,7,5,0,5,11,21,24,1,"https://fbref.com/en/players/70438d35/Adrian-Dieguez"
2018,"Alavés","La Liga","Rubén Duarte","ESP","DF","21",1995,23.8,76,40,42,27,7,35,59,59.3,24,40,10,30,44,120,94,0,"https://fbref.com/en/players/1fe0492d/Ruben-Duarte"
2018,"Alavés","La Liga","Rodrigo Ely","BRA","DF","23",1993,29.9,32,18,26,6,0,19,34,55.9,15,45,36,9,50,82,183,0,"https://fbref.com/en/players/fd47b4f2/Rodrigo-Ely"
2018,"Alavés","La Liga","Enzo Fernández","ESP","MF","22",1995,0.8,2,2,2,0,0,0,0,NA,0,0,0,0,0,2,1,0,"https://fbref.com/en/players/4cafb146/Enzo-Fernandez"
2018,"Alavés","La Liga","Manu García","ESP","MF","31",1986,27.1,95,65,38,51,6,24,89,27,65,34,11,23,35,130,67,0,"https://fbref.com/en/players/05a4465d/Manu-Garcia"
2018,"Alavés","La Liga","Ibai Gómez","ESP","MF,FW","27",1989,25.8,19,15,11,4,4,6,30,20,24,16,1,15,15,34,20,1,"https://fbref.com/en/players/9d2a3d5f/Ibai-Gomez"
2018,"Alavés","La Liga","John Guidetti","SWE","FW","25",1992,13.6,7,7,3,1,3,2,10,20,8,10,1,9,2,9,7,0,"https://fbref.com/en/players/99bebd12/John-Guidetti"
2018,"Alavés","La Liga","Munir El Haddadi","MAR","FW","21",1995,27.2,25,20,8,9,8,5,14,35.7,9,13,2,11,9,34,5,0,"https://fbref.com/en/players/8696bc90/Munir-El-Haddadi"
2018,"Alavés","La Liga","Héctor Hernández","ESP","DF","26",1991,0.2,1,1,0,1,0,1,1,100,0,0,0,0,0,1,1,0,"https://fbref.com/en/players/76ee80ee/Hector-Hernandez"
2018,"Alavés","La Liga","Aleksandar Katai","SRB","MF,DF","26",1991,0.6,1,1,0,1,0,0,1,0,1,0,0,0,0,1,0,0,"https://fbref.com/en/players/d5127c3f/Aleksandar-Katai"
2018,"Alavés","La Liga","Bojan Krkić","ESP","FW,MF","26",1990,4.9,2,1,1,1,0,1,2,50,1,5,0,5,3,5,0,0,"https://fbref.com/en/players/9fa0a0b8/Bojan-Krkic"
2018,"Alavés","La Liga","Víctor Laguardia","ESP","DF","27",1989,17,20,15,13,5,2,11,19,57.9,8,23,14,9,29,49,109,0,"https://fbref.com/en/players/b7c99b9b/Victor-Laguardia"
2018,"Alavés","La Liga","Víctor López","ESP","MF","20",1997,0.7,2,1,0,2,0,0,1,0,1,0,0,0,1,3,1,0,"https://fbref.com/en/players/a68856b5/Victor-Lopez"
2018,"Alavés","La Liga","Guillermo Maripán","CHI","DF","23",1994,17,28,16,24,4,0,17,32,53.1,15,19,10,9,36,64,108,0,"https://fbref.com/en/players/d9764034/Guillermo-Maripan"
2018,"Alavés","La Liga","Álvaro Medrán","ESP","MF","23",1994,10.5,20,14,5,10,5,8,21,38.1,13,7,0,7,13,33,10,0,"https://fbref.com/en/players/31223bcf/Alvaro-Medran"
2018,"Alavés","La Liga","Fernando Pacheco","ESP","GK","25",1992,37.3,0,0,0,0,0,0,0,NA,0,1,0,1,3,3,12,4,"https://fbref.com/en/players/97852360/Fernando-Pacheco"
2018,"Alavés","La Liga","Alfonso Pedraza","ESP","MF,DF","21",1996,27.1,57,40,24,21,12,19,56,33.9,37,39,5,34,32,89,26,0,"https://fbref.com/en/players/63f04c6c/Alfonso-Pedraza"
2018,"Alavés","La Liga","Hernán Pérez","PAR","MF","28",1989,4.2,11,8,6,4,1,2,19,10.5,17,5,0,5,3,14,6,0,"https://fbref.com/en/players/e1cea3f7/Hernan-Perez"
2018,"Alavés","La Liga","Tomás Pina Isla","ESP","MF","29",1987,26.5,71,49,27,38,6,20,40,50,20,28,10,18,43,114,37,0,"https://fbref.com/en/players/e54bd0a2/Tomas-Pina-Isla"
2018,"Alavés","La Liga","Óscar Romero","PAR","MF,FW","25",1992,2.8,5,2,4,1,0,0,3,0,3,3,0,3,3,8,2,0,"https://fbref.com/en/players/4bc5f2b4/Oscar-Romero"
2018,"Alavés","La Liga","Christian Santos","VEN","FW","29",1988,4.8,2,0,1,0,1,0,4,0,4,2,1,1,2,4,9,0,"https://fbref.com/en/players/4efd29bb/Christian-Santos"
2018,"Alavés","La Liga","Antonio Sivera","ESP","GK","20",1996,0.7,0,0,0,0,0,0,0,NA,0,0,0,0,0,0,0,0,"https://fbref.com/en/players/9970da54/Antonio-Sivera"
2018,"Alavés","La Liga","Rubén Sobrino","ESP","FW,MF","25",1992,16.3,33,24,12,16,5,6,27,22.2,21,19,2,17,18,51,10,0,"https://fbref.com/en/players/19b776e9/Ruben-Sobrino"
2018,"Alavés","La Liga","Daniel Torres","COL","MF","27",1989,13.5,19,11,14,5,0,7,31,22.6,24,15,7,8,19,38,32,2,"https://fbref.com/en/players/87882adc/Daniel-Torres"
2018,"Alavés","La Liga","Carlos Vigaray","ESP","DF","22",1994,9.9,27,16,16,9,2,11,16,68.8,5,5,1,4,14,41,13,0,"https://fbref.com/en/players/f69d934e/Carlos-Vigaray"
2018,"Alavés","La Liga","Wakaso","GHA","MF","27",1990,12.2,43,30,25,15,3,13,39,33.3,26,22,1,21,35,78,21,0,"https://fbref.com/en/players/999908af/Wakaso"
2018,"Amiens","Ligue 1","Khaled Adénon","BEN","DF","32",1985,32.5,38,24,26,12,0,15,32,46.9,17,42,26,16,65,103,221,1,"https://fbref.com/en/players/16714a62/Khaled-Adenon"
2018,"Amiens","Ligue 1","Danilo Avelar","BRA","DF","28",1989,19.2,41,33,27,9,5,14,45,31.1,31,16,7,9,37,78,83,1,"https://fbref.com/en/players/eacb45fd/Danilo-Avelar"
2018,"Amiens","Ligue 1","Sekou Baradji","FRA","MF","33",1984,0.1,0,0,0,0,0,0,0,NA,0,0,0,0,1,1,0,0,"https://fbref.com/en/players/5693aa98/Sekou-Baradji"
2018,"Amiens","Ligue 1","Mathieu Bodmer","FRA","DF,MF","34",1982,4.4,6,3,5,1,0,5,6,83.3,1,6,3,3,1,7,15,0,"https://fbref.com/en/players/f3642ba8/Mathieu-Bodmer"
2018,"Amiens","Ligue 1","Jean-Christophe Bouet","FRA","GK","34",1983,1,0,0,0,0,0,0,0,NA,0,0,0,0,0,0,0,0,"https://fbref.com/en/players/96908f80/Jean-Christophe-Bouet"
2018,"Amiens","Ligue 1","Emmanuel Bourgaud","FRA","FW,MF","29",1987,6,17,11,5,9,3,10,23,43.5,13,5,0,5,6,23,11,0,"https://fbref.com/en/players/7cf9f0ed/Emmanuel-Bourgaud"
2018,"Amiens","Ligue 1","Charly Charrier","FRA","MF,FW","31",1986,1.2,1,0,1,0,0,0,2,0,2,1,0,1,2,3,0,0,"https://fbref.com/en/players/346c15cc/Charly-Charrier"
2018,"Amiens","Ligue 1","Issa Cissokho","SEN","DF","32",1985,18.1,31,23,22,9,0,18,32,56.3,14,18,8,10,34,65,87,1,"https://fbref.com/en/players/a1017967/Issa-Cissokho"
2018,"Amiens","Ligue 1","Quentin Cornette","FRA","FW,MF","23",1994,5,11,8,5,3,3,3,13,23.1,10,7,0,7,3,14,5,0,"https://fbref.com/en/players/5d42d487/Quentin-Cornette"
2018,"Amiens","Ligue 1","Bakaye Dibassy","MLI","DF","27",1989,30.9,71,51,45,22,4,24,50,48,26,52,26,26,58,129,148,0,"https://fbref.com/en/players/247accfd/Bakaye-Dibassy"
2018,"Amiens","Ligue 1","Jean-Luc Dompé","FRA","FW","21",1995,0.3,0,0,0,0,0,0,0,NA,0,0,0,0,0,0,0,0,"https://fbref.com/en/players/9ffdf29a/Jean-Luc-Dompe"
2018,"Amiens","Ligue 1","Guessouma Fofana","MTN","MF","24",1992,8.3,20,13,8,12,0,6,13,46.2,7,7,1,6,12,32,11,0,"https://fbref.com/en/players/9dafff2a/Guessouma-Fofana"
2018,"Amiens","Ligue 1","Serge Gakpé","TOG","FW,MF","30",1987,20.3,16,11,9,7,0,6,27,22.2,21,18,1,17,10,26,15,0,"https://fbref.com/en/players/cf4053e2/Serge-Gakpe"
2018,"Amiens","Ligue 1","Georges Gope-Fenepej","NCL","FW","28",1988,0.5,0,0,0,0,0,0,0,NA,0,0,0,0,0,0,0,0,"https://fbref.com/en/players/8730ed6a/Georges-Gope-Fenepej"
2018,"Amiens","Ligue 1","Prince-Désir Gouano","FRA","DF","23",1993,30.5,42,29,32,8,2,22,31,71,9,58,47,11,49,91,191,6,"https://fbref.com/en/players/7c6d6c96/Prince-Desir-Gouano"
2018,"Amiens","Ligue 1","Régis Gurtner","FRA","GK","30",1986,37,1,0,1,0,0,1,1,100,0,0,0,0,4,5,15,4,"https://fbref.com/en/players/bc270726/Regis-Gurtner"
2018,"Amiens","Ligue 1","Oualid El Hajjam","MAR","DF","26",1991,24.4,64,44,37,22,5,23,49,46.9,26,25,5,20,59,123,91,1,"https://fbref.com/en/players/9f29c204/Oualid-El-Hajjam"
2018,"Amiens","Ligue 1","Julien Ielsch","FRA","MF,DF","34",1983,6.8,28,18,12,11,5,7,25,28,18,16,3,13,11,39,15,2,"https://fbref.com/en/players/20c2c0e8/Julien-Ielsch"
2018,"Amiens","Ligue 1","Gaël Kakuta","COD","MF,FW","26",1991,34.3,54,32,14,27,13,9,40,22.5,31,33,3,30,26,80,19,0,"https://fbref.com/en/players/5b1bf5e3/Gael-Kakuta"
2018,"Amiens","Ligue 1","Seybou Koita","NIG","FW","23",1994,2.4,1,1,1,0,0,1,1,100,0,0,0,0,0,1,2,0,"https://fbref.com/en/players/d3b58e33/Seybou-Koita"
2018,"Amiens","Ligue 1","Moussa Konaté","SEN","FW","24",1993,27.5,8,6,1,4,3,3,23,13,20,10,2,8,3,11,11,0,"https://fbref.com/en/players/fcbcbd94/Moussa-Konate"
2018,"Amiens","Ligue 1","Brighton Labeau","MTQ","FW","21",1996,0.3,0,0,0,0,0,0,0,NA,0,0,0,0,0,0,0,0,"https://fbref.com/en/players/f45cf4f7/Brighton-Labeau"
2018,"Amiens","Ligue 1","Harrison Manzala","COD","FW,MF","23",1994,20.7,32,23,16,9,7,8,25,32,17,22,3,19,18,50,15,0,"https://fbref.com/en/players/392d98fc/Harrison-Manzala"
2018,"Amiens","Ligue 1","Stiven Mendoza","COL","FW,MF","25",1992,11.5,18,10,7,7,4,2,11,18.2,9,11,1,10,15,33,8,0,"https://fbref.com/en/players/e68f2cb4/Stiven-Mendoza"
2018,"Amiens","Ligue 1","Thomas Monconduit","FRA","MF","26",1991,32.8,81,49,33,43,5,34,87,39.1,53,52,17,35,55,136,81,2,"https://fbref.com/en/players/84d94b91/Thomas-Monconduit"
2018,"Amiens","Ligue 1","Nathan","BRA","MF","21",1996,0.1,0,0,0,0,0,0,0,NA,0,0,0,0,0,0,0,0,"https://fbref.com/en/players/fa00f0c9/Nathan"
2018,"Amiens","Ligue 1","Tanguy Ndombele","FRA","MF","20",1996,2.6,6,5,2,4,0,1,4,25,3,4,0,4,5,11,3,0,"https://fbref.com/en/players/5cdddffa/Tanguy-Ndombele"
2018,"Amiens","Ligue 1","Guy Ngosso","CMR","MF","32",1985,6.8,8,5,4,4,0,4,20,20,16,5,3,2,9,17,19,0,"https://fbref.com/en/players/34cfec6b/Guy-Ngosso"
2018,"Amiens","Ligue 1","Lacina Traoré","CIV","FW","27",1990,8.7,9,9,2,3,4,3,7,42.9,4,6,3,3,2,11,21,0,"https://fbref.com/en/players/883f251e/Lacina-Traore"
2018,"Amiens","Ligue 1","Bongani Zungu","RSA","MF","24",1992,23.2,54,37,21,26,7,24,56,42.9,32,30,5,25,38,92,41,2,"https://fbref.com/en/players/a8797cf1/Bongani-Zungu"
2018,"Angers","Ligue 1","Yoann Andreu","FRA","DF","28",1989,23,48,30,40,6,2,16,39,41,23,23,5,18,37,85,75,1,"https://fbref.com/en/players/872cd68c/Yoann-Andreu"
2018,"Angers","Ligue 1","Abdoulaye Bamba","CIV","DF","27",1990,17,29,22,23,6,0,16,30,53.3,14,8,1,7,11,40,52,0,"https://fbref.com/en/players/7fecbcdb/Abdoulaye-Bamba"
2018,"Angers","Ligue 1","Ludovic Butelle","FRA","GK","34",1983,18.4,0,0,0,0,0,0,0,NA,0,0,0,0,1,1,10,2,"https://fbref.com/en/players/26975a92/Ludovic-Butelle"
2018,"Angers","Ligue 1","Pierrick Capelle","FRA","MF","30",1987,20.9,50,37,29,17,4,16,70,22.9,54,29,0,29,34,84,26,0,"https://fbref.com/en/players/79b2399c/Pierrick-Capelle"
2018,"Angers","Ligue 1","Saliou Ciss","SEN","DF,MF","27",1989,1.6,3,2,1,1,1,2,5,40,3,0,0,0,2,5,1,0,"https://fbref.com/en/players/2235f850/Saliou-Ciss"
2018,"Angers","Ligue 1","Lassana Coulibaly","MLI","MF","21",1996,9.3,26,17,13,10,3,10,35,28.6,25,15,1,14,8,34,10,0,"https://fbref.com/en/players/85a44ecc/Lassana-Coulibaly"
2018,"Angers","Ligue 1","Enzo Crivelli","FRA","FW","22",1995,11.4,13,9,2,6,5,1,5,20,4,4,0,4,2,15,6,0,"https://fbref.com/en/players/06f33dc8/Enzo-Crivelli"
2018,"Angers","Ligue 1","Angelo Fulgini","FRA","MF","20",1996,17,21,11,9,8,4,8,27,29.6,19,21,2,19,20,41,7,0,"https://fbref.com/en/players/4b96c347/Angelo-Fulgini"
2018,"Angers","Ligue 1","Baptiste Guillaume","BEL","FW,MF","22",1995,5.1,4,1,0,2,2,0,5,0,5,4,1,3,2,6,1,0,"https://fbref.com/en/players/9453d2f4/Baptiste-Guillaume"
2018,"Angers","Ligue 1","Wilfried Kanga","CIV","FW,MF","19",1998,1.9,2,2,0,2,0,0,2,0,2,0,0,0,0,2,1,0,"https://fbref.com/en/players/b4c816a9/Wilfried-Kanga"
2018,"Angers","Ligue 1","Billy Ketkeophomphone","LAO","MF","27",1990,4.9,14,9,4,5,5,5,15,33.3,10,9,0,9,5,19,8,0,"https://fbref.com/en/players/06f46837/Billy-Ketkeophomphone"
2018,"Angers","Ligue 1","Alexandre Letellier","FRA","GK","26",1990,13,0,0,0,0,0,0,0,NA,0,0,0,0,0,0,1,2,"https://fbref.com/en/players/96fcd380/Alexandre-Letellier"
2018,"Angers","Ligue 1","Vincent Manceau","FRA","DF","28",1989,33,84,49,56,22,6,42,76,55.3,34,34,2,32,34,118,103,0,"https://fbref.com/en/players/c26a3918/Vincent-Manceau"
2018,"Angers","Ligue 1","Thomas Mangani","FRA","MF","30",1987,33.6,92,59,35,46,11,28,120,23.3,92,40,5,35,40,132,45,1,"https://fbref.com/en/players/c801616a/Thomas-Mangani"
2018,"Angers","Ligue 1","Mathieu Michel","FRA","GK","25",1991,6.6,0,0,0,0,0,0,1,0,1,0,0,0,0,0,0,1,"https://fbref.com/en/players/e39f8724/Mathieu-Michel"
2018,"Angers","Ligue 1","Prince Oniangué","CGO","MF","28",1988,11.7,16,11,5,9,2,8,31,25.8,23,20,4,16,11,27,8,0,"https://fbref.com/en/players/9e27e5de/Prince-Oniangue"
2018,"Angers","Ligue 1","Mateo Pavlović","BIH","DF","27",1990,21.8,13,7,10,3,0,7,20,35,13,14,11,3,21,34,120,0,"https://fbref.com/en/players/450e277f/Mateo-Pavlovic"
2018,"Angers","Ligue 1","Loïc Puyo","FRA","MF","28",1988,1.9,9,5,2,5,2,3,4,75,1,7,3,4,4,13,2,0,"https://fbref.com/en/players/bcb98316/Loic-Puyo"
2018,"Angers","Ligue 1","Jeff Reine-Adélaïde","FRA","MF","19",1998,4.9,13,8,7,5,1,6,17,35.3,11,7,2,5,1,14,9,0,"https://fbref.com/en/players/d504b3e1/Jeff-Reine-Adelaide"
2018,"Angers","Ligue 1","Baptiste Santamaria","FRA","MF","22",1995,28.8,59,40,25,29,5,23,83,27.7,60,39,8,31,43,102,48,2,"https://fbref.com/en/players/5e22e2a4/Baptiste-Santamaria"
2018,"Angers","Ligue 1","Gilles Sunu","TOG","MF,FW","26",1991,7.3,4,4,1,3,0,0,4,0,4,7,0,7,3,7,3,0,"https://fbref.com/en/players/beff5d14/Gilles-Sunu"
2018,"Angers","Ligue 1","Mehdi Tahrat","ALG","MF","27",1990,4.9,7,6,4,3,0,2,5,40,3,3,1,2,9,16,15,1,"https://fbref.com/en/players/ec1aa15e/Mehdi-Tahrat"
2018,"Angers","Ligue 1","Flavien Tait","FRA","MF","24",1993,24.8,50,36,26,18,6,18,78,23.1,60,43,4,39,20,70,17,1,"https://fbref.com/en/players/a0f9b535/Flavien-Tait"
2018,"Angers","Ligue 1","Romain Thomas","FRA","DF","29",1988,27.4,31,21,16,15,0,14,29,48.3,15,32,19,13,34,65,151,1,"https://fbref.com/en/players/275e2c51/Romain-Thomas"
2018,"Angers","Ligue 1","Karl Toko Ekambi","CMR","FW,MF","24",1992,33.8,17,8,2,5,10,5,29,17.2,24,13,0,13,15,32,2,0,"https://fbref.com/en/players/5ceba7fc/Karl-Toko-Ekambi"
2018,"Angers","Ligue 1","Thomas Touré","CIV","MF","23",1993,1.4,2,1,0,1,1,0,7,0,7,5,0,5,1,3,0,0,"https://fbref.com/en/players/d72db2f5/Thomas-Toure"
2018,"Angers","Ligue 1","Ismaël Traoré","CIV","DF","30",1986,31.7,54,32,40,13,1,14,29,48.3,15,25,10,15,52,106,132,2,"https://fbref.com/en/players/b666421b/Ismael-Traore"
2018,"Arsenal","Premier League","Pierre-Emerick Aubameyang","GAB","FW","28",1989,11.7,5,4,3,2,0,1,7,14.3,6,14,1,13,3,8,7,0,"https://fbref.com/en/players/d5dd5f1f/Pierre-Emerick-Aubameyang"
2018,"Arsenal","Premier League","Héctor Bellerín","ESP","DF","22",1995,33.9,57,43,36,12,9,25,52,48.1,27,42,8,34,23,80,89,4,"https://fbref.com/en/players/f874dd44/Hector-Bellerin"
2018,"Arsenal","Premier League","Petr Čech","CZE","GK","35",1982,33.8,1,1,1,0,0,1,1,100,0,0,0,0,0,1,23,7,"https://fbref.com/en/players/71672fa0/Petr-Cech"
2018,"Arsenal","Premier League","Calum Chambers","ENG","DF","22",1995,9.6,17,10,10,6,1,5,14,35.7,9,14,11,3,18,35,47,0,"https://fbref.com/en/players/dc6f5bdd/Calum-Chambers"
2018,"Arsenal","Premier League","Francis Coquelin","FRA","MF,DF","26",1991,1.9,5,4,2,3,0,1,3,33.3,2,1,0,1,3,8,2,0,"https://fbref.com/en/players/a6951bf8/Francis-Coquelin"
2018,"Arsenal","Premier League","Mohamed Elneny","EGY","MF","25",1992,9.6,12,6,6,3,3,6,10,60,4,11,0,11,10,22,12,2,"https://fbref.com/en/players/47a34c4f/Mohamed-Elneny"
2018,"Arsenal","Premier League","Olivier Giroud","FRA","FW","30",1986,4.3,5,4,1,2,2,1,5,20,4,1,0,1,1,6,4,0,"https://fbref.com/en/players/16ceb862/Olivier-Giroud"
2018,"Arsenal","Premier League","Rob Holding","ENG","DF","21",1995,9.1,19,14,13,5,1,4,12,33.3,8,16,10,6,21,40,40,2,"https://fbref.com/en/players/d79a8c87/Rob-Holding"
2018,"Arsenal","Premier League","Alex Iwobi","NGA","MF,FW","21",1996,20.3,19,15,8,8,3,5,18,27.8,13,19,1,18,7,26,10,1,"https://fbref.com/en/players/6ca5ec4b/Alex-Iwobi"
2018,"Arsenal","Premier League","Sead Kolašinac","BIH","DF","24",1993,23.9,49,37,28,13,8,20,39,51.3,19,15,3,12,26,75,56,0,"https://fbref.com/en/players/3935e52e/Sead-Kolasinac"
2018,"Arsenal","Premier League","Laurent Koscielny","FRA","DF","31",1985,24.7,43,21,27,12,4,19,33,57.6,14,28,15,13,54,97,138,3,"https://fbref.com/en/players/f5efb153/Laurent-Koscielny"
2018,"Arsenal","Premier League","Alexandre Lacazette","FRA","FW","26",1991,24.5,24,17,6,11,7,4,27,14.8,23,19,3,16,7,31,5,0,"https://fbref.com/en/players/9dbb75ca/Alexandre-Lacazette"
2018,"Arsenal","Premier League","Ainsley Maitland-Niles","ENG","DF,MF","19",1997,10.2,25,17,12,7,6,14,31,45.2,17,15,1,14,12,37,35,2,"https://fbref.com/en/players/e3a5814e/Ainsley-Maitland-Niles"
2018,"Arsenal","Premier League","Konstantinos Mavropanos","GRE","DF","19",1997,2.2,1,1,1,0,0,1,2,50,1,4,3,1,6,7,11,1,"https://fbref.com/en/players/00963611/Konstantinos-Mavropanos"
2018,"Arsenal","Premier League","Per Mertesacker","GER","DF","32",1984,4.1,2,2,0,2,0,0,1,0,1,4,3,1,6,8,22,2,"https://fbref.com/en/players/5be28712/Per-Mertesacker"
2018,"Arsenal","Premier League","Henrikh Mkhitaryan","ARM","FW,MF","28",1989,8.8,18,13,9,7,2,5,21,23.8,16,16,2,14,8,26,7,0,"https://fbref.com/en/players/dd0daf32/Henrikh-Mkhitaryan"
2018,"Arsenal","Premier League","Nacho Monreal","ESP","DF","31",1986,24.9,54,32,19,29,6,21,48,43.8,27,26,7,19,56,110,83,2,"https://fbref.com/en/players/d4cb83cc/Nacho-Monreal"
2018,"Arsenal","Premier League","Shkodran Mustafi","GER","DF","25",1992,25.3,64,46,42,18,4,28,54,51.9,26,23,15,8,57,121,175,2,"https://fbref.com/en/players/3f2d59fe/Shkodran-Mustafi"
2018,"Arsenal","Premier League","Reiss Nelson","ENG","FW,MF","17",1999,1.6,4,3,1,1,2,0,0,NA,0,4,0,4,3,7,0,0,"https://fbref.com/en/players/c5bdb6e3/Reiss-Nelson"
2018,"Arsenal","Premier League","Eddie Nketiah","ENG","FW","18",1999,0.2,1,1,0,1,0,0,0,NA,0,0,0,0,0,1,0,0,"https://fbref.com/en/players/a53649b7/Eddie-Nketiah"
2018,"Arsenal","Premier League","David Ospina","COL","GK","28",1988,4.2,0,0,0,0,0,0,0,NA,0,0,0,0,0,0,1,0,"https://fbref.com/en/players/82b1198a/David-Ospina"
2018,"Arsenal","Premier League","Alex Oxlade-Chamberlain","ENG","DF","23",1993,2.7,5,3,2,2,1,2,3,66.7,1,5,2,3,6,11,8,0,"https://fbref.com/en/players/38c7feef/Alex-Oxlade-Chamberlain"
2018,"Arsenal","Premier League","Mesut Özil","GER","MF,FW","28",1988,24,20,13,6,10,4,5,22,22.7,17,11,1,10,12,32,9,0,"https://fbref.com/en/players/16380240/Mesut-Ozil"
2018,"Arsenal","Premier League","Aaron Ramsey","WAL","MF","26",1990,20.5,35,27,18,17,0,8,44,18.2,36,14,3,11,24,59,6,1,"https://fbref.com/en/players/ef619b0b/Aaron-Ramsey"
2018,"Arsenal","Premier League","Alexis Sánchez","CHI","MF,FW","28",1988,16.7,20,9,9,4,7,7,32,21.9,25,5,2,3,6,26,1,0,"https://fbref.com/en/players/2c0f8e9e/Alexis-Sanchez"
2018,"Arsenal","Premier League","Theo Walcott","ENG","FW,MF","28",1989,0.8,1,0,1,0,0,0,0,NA,0,0,0,0,1,2,0,0,"https://fbref.com/en/players/1ecb65be/Theo-Walcott"
2018,"Arsenal","Premier League","Danny Welbeck","ENG","FW,MF","26",1990,13.3,20,13,9,5,6,4,12,33.3,8,22,1,21,11,31,13,0,"https://fbref.com/en/players/ce5143da/Danny-Welbeck"
2018,"Arsenal","Premier League","Joe Willock","ENG","MF","17",1999,0.9,4,2,4,0,0,1,1,100,0,3,0,3,1,5,2,0,"https://fbref.com/en/players/a3b03921/Joe-Willock"
2018,"Arsenal","Premier League","Jack Wilshere","ENG","MF","25",1992,13.3,15,10,3,7,5,4,20,20,16,10,2,8,8,23,5,0,"https://fbref.com/en/players/9c318325/Jack-Wilshere"
2018,"Arsenal","Premier League","Granit Xhaka","SUI","MF","24",1992,36.2,78,57,35,40,3,26,69,37.7,43,30,9,21,37,115,68,4,"https://fbref.com/en/players/e61b8aee/Granit-Xhaka"
2018,"Atalanta","Serie A","Musa Barrow","GAM","FW","18",1998,4.9,5,2,1,3,1,2,4,50,2,2,0,2,1,6,2,0,"https://fbref.com/en/players/e5bf73f3/Musa-Barrow"
2018,"Atalanta","Serie A","Alessandro Bastoni","ITA","DF","18",1999,1,2,2,2,0,0,1,1,100,0,0,0,0,1,3,3,0,"https://fbref.com/en/players/75b86fb3/Alessandro-Bastoni"
2018,"Atalanta","Serie A","Etrit Berisha","ALB","GK","28",1989,31,1,1,1,0,0,1,1,100,0,0,0,0,1,2,5,3,"https://fbref.com/en/players/ee833569/Etrit-Berisha"
2018,"Atalanta","Serie A","Mattia Caldara","ITA","DF","23",1994,24,39,26,15,24,0,13,33,39.4,20,31,18,13,41,80,113,1,"https://fbref.com/en/players/ac7e640b/Mattia-Caldara"
2018,"Atalanta","Serie A","Timothy Castagne","BEL","DF","21",1995,16.7,54,37,32,14,8,13,27,48.1,14,25,4,21,26,80,48,0,"https://fbref.com/en/players/197640fd/Timothy-Castagne"
2018,"Atalanta","Serie A","Andreas Cornelius","DEN","FW","24",1993,10.4,9,5,3,3,3,1,7,14.3,6,7,0,7,2,11,7,0,"https://fbref.com/en/players/c693347d/Andreas-Cornelius"
2018,"Atalanta","Serie A","Bryan Cristante","ITA","MF","22",1995,31.4,66,50,21,32,13,18,59,30.5,41,43,6,37,23,89,27,0,"https://fbref.com/en/players/16657b95/Bryan-Cristante"
2018,"Atalanta","Serie A","Remo Freuler","SUI","MF","25",1992,33.4,89,62,35,41,13,27,82,32.9,55,46,13,33,28,117,37,2,"https://fbref.com/en/players/98d2c2c4/Remo-Freuler"
2018,"Atalanta","Serie A","Pierluigi Gollini","ITA","GK","22",1995,6.9,0,0,0,0,0,0,0,NA,0,0,0,0,0,0,1,0,"https://fbref.com/en/players/f0f7f62f/Pierluigi-Gollini"
2018,"Atalanta","Serie A","Papu Gómez","ARG","MF,FW","29",1988,30.6,14,9,6,5,3,5,26,19.2,21,16,1,15,22,36,7,0,"https://fbref.com/en/players/6e4df551/Papu-Gomez"
2018,"Atalanta","Serie A","Robin Gosens","GER","DF","23",1994,16.1,61,46,35,22,4,27,46,58.7,19,17,2,15,22,83,40,0,"https://fbref.com/en/players/2d970560/Robin-Gosens"
2018,"Atalanta","Serie A","Nicolas Haas","SUI","MF","21",1996,1.9,1,1,1,0,0,0,2,0,2,1,1,0,1,2,4,1,"https://fbref.com/en/players/fa449bba/Nicolas-Haas"
2018,"Atalanta","Serie A","Hans Hateboer","NED","DF","23",1994,26.6,31,25,13,13,5,15,26,57.7,11,32,5,27,30,61,46,1,"https://fbref.com/en/players/3b333ac3/Hans-Hateboer"
2018,"Atalanta","Serie A","Josip Iličić","SVN","MF,FW","29",1988,22.2,24,19,5,13,6,8,29,27.6,21,19,0,19,16,40,2,0,"https://fbref.com/en/players/68252d6d/Josip-Ilicic"
2018,"Atalanta","Serie A","Jasmin Kurtić","SVN","MF","28",1989,7.4,12,7,6,3,3,3,7,42.9,4,7,0,7,5,17,4,0,"https://fbref.com/en/players/144607cc/Jasmin-Kurtic"
2018,"Atalanta","Serie A","José Luis Palomino","ARG","DF","27",1990,22,60,39,36,19,5,24,51,47.1,27,36,21,15,39,99,111,1,"https://fbref.com/en/players/921f6058/Jose-Luis-Palomino"
2018,"Atalanta","Serie A","Gianluca Mancini","ITA","DF","21",1996,7.6,20,14,11,8,1,10,17,58.8,7,8,2,6,15,35,22,0,"https://fbref.com/en/players/5aa53281/Gianluca-Mancini"
2018,"Atalanta","Serie A","Andrea Masiello","ITA","DF","31",1986,30.1,58,38,34,20,4,30,54,55.6,24,24,6,18,72,130,137,0,"https://fbref.com/en/players/e0314d87/Andrea-Masiello"
2018,"Atalanta","Serie A","Riccardo Orsolini","ITA","MF,FW","20",1997,1.4,3,2,3,0,0,1,1,100,0,1,0,1,0,3,0,0,"https://fbref.com/en/players/e14ec482/Riccardo-Orsolini"
2018,"Atalanta","Serie A","Andrea Petagna","ITA","FW","22",1995,18,8,3,2,4,2,1,11,9.1,10,14,3,11,4,12,5,0,"https://fbref.com/en/players/03f946ed/Andrea-Petagna"
2018,"Atalanta","Serie A","Marten de Roon","NED","MF","26",1991,28.6,77,50,27,44,6,29,82,35.4,53,40,5,35,46,123,36,0,"https://fbref.com/en/players/2a1beb34/Marten-de-Roon"
2018,"Atalanta","Serie A","Francesco Rossi","ITA","GK","26",1991,0.1,0,0,0,0,0,0,0,NA,0,0,0,0,0,0,0,0,"https://fbref.com/en/players/7b5f516f/Francesco-Rossi"
2018,"Atalanta","Serie A","Leonardo Spinazzola","ITA","DF","24",1993,16.7,14,5,9,4,1,7,15,46.7,8,25,6,19,18,32,44,1,"https://fbref.com/en/players/3626daea/Leonardo-Spinazzola"
2018,"Atalanta","Serie A","Rafael Tolói","ITA","DF","26",1990,27.2,72,40,34,38,0,35,68,51.5,33,35,14,21,63,135,119,1,"https://fbref.com/en/players/c56dc39e/Rafael-Toloi"
2018,"Atalanta","Serie A","Luca Vido","ITA","FW,MF","20",1997,0.8,5,5,2,3,0,1,1,100,0,1,0,1,0,5,0,0,"https://fbref.com/en/players/eb0d77a4/Luca-Vido"
2018,"Athletic Club","La Liga","Aritz Aduriz","ESP","FW","36",1981,23.9,11,8,2,6,3,1,6,16.7,5,6,0,6,3,14,18,0,"https://fbref.com/en/players/293211e1/Aritz-Aduriz"
2018,"Athletic Club","La Liga","Ager Aketxe","ESP","MF","23",1993,0.4,1,1,1,0,0,1,2,50,1,1,0,1,1,2,0,0,"https://fbref.com/en/players/c5eaff5c/Ager-Aketxe"
2018,"Athletic Club","La Liga","Yeray Álvarez","ESP","DF","22",1995,7.5,12,7,8,4,0,6,9,66.7,3,8,2,6,11,23,18,0,"https://fbref.com/en/players/3ecc11d8/Yeray-Alvarez"
2018,"Athletic Club","La Liga","Kepa Arrizabalaga","ESP","GK","22",1994,30,0,0,0,0,0,0,2,0,2,0,0,0,2,2,6,2,"https://fbref.com/en/players/28d596a0/Kepa-Arrizabalaga"
2018,"Athletic Club","La Liga","Mikel Balenziaga","ESP","DF","29",1988,17.2,34,24,17,13,4,15,27,55.6,12,24,5,19,17,51,61,0,"https://fbref.com/en/players/1fe67e86/Mikel-Balenziaga"
2018,"Athletic Club","La Liga","Eneko Bóveda","ESP","DF","28",1988,5.8,12,11,7,4,1,5,11,45.5,6,3,0,3,14,26,14,0,"https://fbref.com/en/players/1771f2c1/Eneko-Boveda"
2018,"Athletic Club","La Liga","Iñigo Córdoba","ESP","FW","20",1997,16.2,44,30,18,21,5,16,58,27.6,42,31,0,31,21,65,9,0,"https://fbref.com/en/players/49ea92be/Inigo-Cordoba"
2018,"Athletic Club","La Liga","Beñat Etxebarria","ESP","MF","30",1987,12.4,28,20,12,13,3,13,36,36.1,23,6,1,5,28,56,12,0,"https://fbref.com/en/players/b037bd4f/Benat-Etxebarria"
2018,"Athletic Club","La Liga","Xabier Etxeita","ESP","DF","29",1987,4.2,2,2,2,0,0,1,4,25,3,3,2,1,7,9,25,1,"https://fbref.com/en/players/4a895384/Xabier-Etxeita"
2018,"Athletic Club","La Liga","Raúl García","ESP","MF,FW","31",1986,29.2,82,51,28,36,18,26,71,36.6,45,55,3,52,30,112,23,0,"https://fbref.com/en/players/b418dbd4/Raul-Garcia"
2018,"Athletic Club","La Liga","Iago Herrerín","ESP","GK","29",1988,8,2,1,2,0,0,2,2,100,0,0,0,0,0,2,7,1,"https://fbref.com/en/players/9109185e/Iago-Herrerin"
2018,"Athletic Club","La Liga","Ander Iturraspe","ESP","MF","28",1989,21.2,42,31,18,22,2,10,32,31.3,22,22,7,15,35,77,57,0,"https://fbref.com/en/players/6dce77a5/Ander-Iturraspe"
2018,"Athletic Club","La Liga","Aymeric Laporte","ESP","DF","23",1994,19,38,23,27,11,0,14,25,56,11,19,13,6,27,65,94,1,"https://fbref.com/en/players/119b9a8e/Aymeric-Laporte"
2018,"Athletic Club","La Liga","Iñigo Lekue","ESP","DF,FW","24",1993,23.5,71,42,37,26,8,34,53,64.2,19,29,3,26,16,87,46,1,"https://fbref.com/en/players/59b7d823/Inigo-Lekue"
2018,"Athletic Club","La Liga","Andoni López","ESP","DF","21",1996,1,1,0,1,0,0,1,1,100,0,1,0,1,1,2,6,0,"https://fbref.com/en/players/fc8cb238/Andoni-Lopez"
2018,"Athletic Club","La Liga","Óscar de Marcos","ESP","DF,FW","28",1989,18.4,28,21,11,15,2,13,29,44.8,16,15,2,13,19,47,36,0,"https://fbref.com/en/players/9f323c71/Oscar-de-Marcos"
2018,"Athletic Club","La Liga","Iñigo Martínez","ESP","DF","26",1991,16,28,20,20,8,0,18,29,62.1,11,17,8,9,30,58,82,0,"https://fbref.com/en/players/3fc45c73/Inigo-Martinez"
2018,"Athletic Club","La Liga","Sabin Merino","ESP","FW,MF","25",1992,4.2,7,3,2,3,2,3,8,37.5,5,6,2,4,1,8,10,0,"https://fbref.com/en/players/1d5f96d9/Sabin-Merino"
2018,"Athletic Club","La Liga","Iker Muniain","ESP","MF,FW","24",1992,8.7,10,8,2,6,2,1,7,14.3,6,4,0,4,4,14,3,0,"https://fbref.com/en/players/c05dfb74/Iker-Muniain"
2018,"Athletic Club","La Liga","Unai Núñez","ESP","DF","20",1997,32.7,73,52,54,19,0,38,56,67.9,18,52,27,25,67,140,155,2,"https://fbref.com/en/players/be170419/Unai-Nunez"
2018,"Athletic Club","La Liga","Mikel Rico","ESP","MF","32",1984,13,24,13,7,16,1,12,34,35.3,22,15,5,10,23,47,12,1,"https://fbref.com/en/players/def69cd0/Mikel-Rico"
2018,"Athletic Club","La Liga","Enric Saborit","ESP","DF","25",1992,15.9,50,27,31,17,2,19,29,65.5,10,17,5,12,24,74,55,0,"https://fbref.com/en/players/eb5bc3eb/Enric-Saborit"
2018,"Athletic Club","La Liga","Mikel San José","ESP","MF","28",1989,23.9,52,37,19,23,10,19,73,26,54,43,13,30,41,93,30,0,"https://fbref.com/en/players/003a5c72/Mikel-San-Jose"
2018,"Athletic Club","La Liga","Markel Susaeta","ESP","FW,MF","29",1987,25.2,42,29,16,15,11,16,65,24.6,49,17,0,17,18,60,13,0,"https://fbref.com/en/players/6fd1ba62/Markel-Susaeta"
2018,"Athletic Club","La Liga","Mikel Vesga","ESP","MF","24",1993,9,17,8,6,11,0,4,25,16,21,14,3,11,8,25,15,0,"https://fbref.com/en/players/b0fce72c/Mikel-Vesga"
2018,"Athletic Club","La Liga","Iñaki Williams","GHA","FW,MF","23",1994,31.7,28,17,11,15,2,8,41,19.5,33,24,2,22,17,45,13,0,"https://fbref.com/en/players/6a99e0b1/Inaki-Williams"
2018,"Atlético Madrid","La Liga","Yannick Carrasco","BEL","MF,FW","23",1993,10,17,13,7,5,5,3,8,37.5,5,9,0,9,4,21,3,0,"https://fbref.com/en/players/de39485a/Yannick-Carrasco"
2018,"Atlético Madrid","La Liga","Ángel Correa","ARG","MF,FW","22",1995,25,41,29,12,16,13,8,57,14,49,30,1,29,25,66,17,0,"https://fbref.com/en/players/01eb744d/Angel-Correa"
2018,"Atlético Madrid","La Liga","Diego Costa","ESP","FW","28",1988,11.6,17,11,2,10,5,4,15,26.7,11,14,4,10,5,22,3,0,"https://fbref.com/en/players/a190d597/Diego-Costa"
2018,"Atlético Madrid","La Liga","Augusto Fernández","ARG","MF","31",1986,1.2,3,2,1,2,0,1,3,33.3,2,3,2,1,2,5,3,0,"https://fbref.com/en/players/78c40e94/Augusto-Fernandez"
2018,"Atlético Madrid","La Liga","Gabi","ESP","MF","34",1983,26.1,80,49,39,37,4,38,104,36.5,66,28,10,18,44,124,38,0,"https://fbref.com/en/players/65d750b5/Gabi"
2018,"Atlético Madrid","La Liga","Nicolás Gaitán","ARG","MF,FW","29",1988,2.4,9,6,3,5,1,3,9,33.3,6,2,0,2,1,10,3,0,"https://fbref.com/en/players/7ebfac0f/Nicolas-Gaitan"
2018,"Atlético Madrid","La Liga","Kévin Gameiro","FRA","FW","30",1987,12.5,11,9,3,4,4,1,10,10,9,6,0,6,4,15,11,0,"https://fbref.com/en/players/42276181/Kevin-Gameiro"
2018,"Atlético Madrid","La Liga","Diego Godín","URU","DF","31",1986,28.4,50,33,37,11,2,26,47,55.3,21,33,20,13,59,109,145,1,"https://fbref.com/en/players/fc4f85b1/Diego-Godin"
2018,"Atlético Madrid","La Liga","Antoine Griezmann","FRA","FW,MF","26",1991,28,36,24,6,23,7,10,30,33.3,20,20,1,19,10,46,14,0,"https://fbref.com/en/players/df69b544/Antoine-Griezmann"
2018,"Atlético Madrid","La Liga","Lucas Hernández","FRA","DF","21",1996,23.5,93,68,51,35,7,55,74,74.3,19,35,10,25,40,133,90,0,"https://fbref.com/en/players/c3ee18ef/Lucas-Hernandez"
2018,"Atlético Madrid","La Liga","Carlos Isaac","ESP","DF","19",1998,0.7,1,0,1,0,0,1,3,33.3,2,0,0,0,2,3,1,0,"https://fbref.com/en/players/3e5a168c/Carlos-Isaac"
2018,"Atlético Madrid","La Liga","Juanfran","ESP","DF","32",1985,14.5,33,24,21,9,3,21,32,65.6,11,14,4,10,26,59,35,0,"https://fbref.com/en/players/cfd8d664/Juanfran"
2018,"Atlético Madrid","La Liga","Koke","ESP","MF","25",1992,30.6,75,45,31,32,12,27,95,28.4,68,40,3,37,24,99,38,0,"https://fbref.com/en/players/55126f3b/Koke"
2018,"Atlético Madrid","La Liga","Filipe Luís","BRA","DF","31",1985,18.4,83,52,41,33,9,36,49,73.5,13,27,7,20,35,118,34,0,"https://fbref.com/en/players/e4ed2628/Filipe-Luis"
2018,"Atlético Madrid","La Liga","José María Giménez","URU","DF","22",1995,18.8,38,27,29,6,3,23,35,65.7,12,28,15,13,30,68,101,1,"https://fbref.com/en/players/f0da930c/Jose-Maria-Gimenez"
2018,"Atlético Madrid","La Liga","Toni Moya","ESP","MF","19",1998,0,0,0,0,0,0,0,0,NA,0,0,0,0,0,0,0,0,"https://fbref.com/en/players/9e098912/Toni-Moya"
2018,"Atlético Madrid","La Liga","Saúl Ñíguez","ESP","MF","22",1994,35.1,132,90,53,69,10,40,104,38.5,64,61,12,49,55,187,77,0,"https://fbref.com/en/players/c14bc029/Saul-Niguez"
2018,"Atlético Madrid","La Liga","Jan Oblak","SVN","GK","24",1993,37,0,0,0,0,0,0,0,NA,0,0,0,0,2,2,7,0,"https://fbref.com/en/players/ee8508c0/Jan-Oblak"
2018,"Atlético Madrid","La Liga","Thomas Partey","GHA","MF,DF","24",1993,26.4,94,64,48,39,7,33,69,47.8,36,32,7,25,53,147,34,1,"https://fbref.com/en/players/529f49ab/Thomas-Partey"
2018,"Atlético Madrid","La Liga","Arona Sané","SEN","MF,FW","22",1995,0.7,1,0,1,0,0,0,0,NA,0,1,0,1,0,1,0,0,"https://fbref.com/en/players/22df75d8/Arona-Sane"
2018,"Atlético Madrid","La Liga","Stefan Savić","MNE","DF","26",1991,25.5,30,20,23,7,0,16,39,41,23,38,23,15,45,75,150,1,"https://fbref.com/en/players/f6ac68c1/Stefan-Savic"
2018,"Atlético Madrid","La Liga","Fernando Torres","ESP","FW","33",1984,10.9,11,8,3,7,1,2,6,33.3,4,4,1,3,2,13,9,0,"https://fbref.com/en/players/bdf7b97d/Fernando-Torres"
2018,"Atlético Madrid","La Liga","Luciano Vietto","ARG","FW","23",1993,3,5,4,1,2,2,0,3,0,3,3,0,3,3,8,3,0,"https://fbref.com/en/players/2513a588/Luciano-Vietto"
2018,"Atlético Madrid","La Liga","Vitolo","ESP","MF,FW","27",1989,6.9,9,6,4,3,2,3,15,20,12,10,1,9,6,15,5,0,"https://fbref.com/en/players/db750822/Vitolo"
2018,"Atlético Madrid","La Liga","Šime Vrsaljko","CRO","DF","25",1992,18.8,48,30,25,17,6,26,40,65,14,24,8,16,36,84,63,0,"https://fbref.com/en/players/46a8347f/Sime-Vrsaljko"
2018,"Atlético Madrid","La Liga","Axel Werner","ARG","GK","21",1996,1,0,0,0,0,0,0,0,NA,0,0,0,0,0,0,1,0,"https://fbref.com/en/players/c0b1a6da/Axel-Werner"
2018,"Augsburg","Bundesliga","Simon Asta","GER","MF","16",2001,0.1,2,1,2,0,0,2,2,100,0,1,0,1,0,2,0,0,"https://fbref.com/en/players/dfc85b89/Simon-Asta"
2018,"Augsburg","Bundesliga","Daniel Baier","GER","MF","33",1984,28.2,83,62,38,40,5,46,83,55.4,37,26,5,21,57,140,41,1,"https://fbref.com/en/players/f261abcb/Daniel-Baier"
2018,"Augsburg","Bundesliga","Caiuby","BRA","FW","29",1988,31.7,53,40,20,27,6,17,42,40.5,25,36,1,35,15,68,42,2,"https://fbref.com/en/players/c6637acf/Caiuby"
2018,"Augsburg","Bundesliga","Sergio Córdova","VEN","FW,MF","19",1997,6.5,5,5,0,2,3,3,4,75,1,12,2,10,0,5,6,0,"https://fbref.com/en/players/229cd98a/Sergio-Cordova"
2018,"Augsburg","Bundesliga","Kevin Danso","AUT","DF","18",1998,12.3,18,12,13,5,0,12,16,75,4,21,14,7,20,38,63,1,"https://fbref.com/en/players/6e33125f/Kevin-Danso"
2018,"Augsburg","Bundesliga","Ji Dong-won","KOR","FW,MF","26",1991,0.2,2,1,0,1,1,0,0,NA,0,1,1,0,1,3,0,0,"https://fbref.com/en/players/7d841904/Ji-Dong-won"
2018,"Augsburg","Bundesliga","Alfreð Finnbogason","ISL","FW","28",1989,20.2,18,13,7,5,6,8,15,53.3,7,15,1,14,14,32,7,0,"https://fbref.com/en/players/f9e7c4ac/Alfred-Finnbogason"
2018,"Augsburg","Bundesliga","Raphael Framberger","GER","DF","21",1995,7.7,22,18,14,6,2,15,16,93.8,1,12,3,9,14,36,15,0,"https://fbref.com/en/players/626fab5f/Raphael-Framberger"
2018,"Augsburg","Bundesliga","Jeffrey Gouweleeuw","NED","DF","26",1991,26.5,57,44,36,18,3,27,41,65.9,14,36,10,26,54,111,128,0,"https://fbref.com/en/players/1025db8e/Jeffrey-Gouweleeuw"
2018,"Augsburg","Bundesliga","Michael Gregoritsch","AUT","MF,FW","23",1994,28.1,35,27,13,15,7,11,26,42.3,15,27,1,26,10,45,56,0,"https://fbref.com/en/players/8e235926/Michael-Gregoritsch"
2018,"Augsburg","Bundesliga","Marcel Heller","GER","FW,MF","31",1986,14.4,37,24,21,14,2,12,28,42.9,16,22,1,21,10,47,7,0,"https://fbref.com/en/players/11dbba47/Marcel-Heller"
2018,"Augsburg","Bundesliga","Martin Hinteregger","AUT","DF","24",1992,29.5,79,51,55,22,2,47,61,77,14,40,27,13,49,128,135,3,"https://fbref.com/en/players/080440a4/Martin-Hinteregger"
2018,"Augsburg","Bundesliga","Marwin Hitz","SUI","GK","29",1987,32,1,1,1,0,0,1,3,33.3,2,0,0,0,0,1,12,3,"https://fbref.com/en/players/2e7ff968/Marwin-Hitz"
2018,"Augsburg","Bundesliga","Koo Ja-cheol","KOR","MF","28",1989,22.7,54,41,18,31,5,27,44,61.4,17,22,3,19,27,81,34,2,"https://fbref.com/en/players/3c05e082/Koo-Ja-cheol"
2018,"Augsburg","Bundesliga","Kilian Jakob","GER","FW","19",1998,0.6,0,0,0,0,0,0,0,NA,0,1,0,1,0,0,1,0,"https://fbref.com/en/players/99d6044d/Kilian-Jakob"
2018,"Augsburg","Bundesliga","Christoph Janker","GER","DF,MF","32",1985,0.9,4,3,3,1,0,2,3,66.7,1,0,0,0,1,5,4,1,"https://fbref.com/en/players/cf01fe3a/Christoph-Janker"
2018,"Augsburg","Bundesliga","Gojko Kačar","SRB","DF","30",1987,2.5,7,6,6,1,0,3,7,42.9,4,3,2,1,4,11,7,0,"https://fbref.com/en/players/cc58c4ea/Gojko-Kacar"
2018,"Augsburg","Bundesliga","Rani Khedira","GER","MF,DF","23",1994,25.3,62,47,25,28,9,33,47,70.2,14,41,18,23,36,98,96,0,"https://fbref.com/en/players/59e4b92e/Rani-Khedira"
2018,"Augsburg","Bundesliga","Andreas Luthe","GER","GK","30",1987,2,0,0,0,0,0,0,0,NA,0,0,0,0,0,0,2,0,"https://fbref.com/en/players/7fe12375/Andreas-Luthe"
2018,"Augsburg","Bundesliga","Philipp Max","GER","DF","23",1993,32.9,65,47,36,19,10,34,59,57.6,25,27,8,19,33,98,65,1,"https://fbref.com/en/players/826e8b63/Philipp-Max"
2018,"Augsburg","Bundesliga","Jan Morávek","CZE","MF","27",1989,7.8,41,37,17,23,1,21,36,58.3,15,19,3,16,11,52,11,0,"https://fbref.com/en/players/e7d22eae/Jan-Moravek"
2018,"Augsburg","Bundesliga","Daniel Opare","GHA","DF","26",1990,15.7,31,27,20,10,1,21,27,77.8,6,14,5,9,28,59,56,0,"https://fbref.com/en/players/49d53c68/Daniel-Opare"
2018,"Augsburg","Bundesliga","Shawn Parker","GER","FW,MF","24",1993,0.5,0,0,0,0,0,0,0,NA,0,0,0,0,0,0,0,0,"https://fbref.com/en/players/b9ebc83e/Shawn-Parker"
2018,"Augsburg","Bundesliga","Marco Richter","GER","FW","19",1997,7.2,17,14,8,8,1,8,17,47.1,9,5,1,4,1,18,10,0,"https://fbref.com/en/players/f972644c/Marco-Richter"
2018,"Augsburg","Bundesliga","Jonathan Schmid","FRA","DF,FW","27",1990,16.4,23,16,6,13,4,11,18,61.1,7,16,1,15,10,33,35,1,"https://fbref.com/en/players/088ca1bd/Jonathan-Schmid"
2018,"Augsburg","Bundesliga","Kostas Stafylidis","GRE","FW,DF","23",1993,0.4,1,1,1,0,0,0,0,NA,0,1,0,1,0,1,2,0,"https://fbref.com/en/players/861e0116/Kostas-Stafylidis"
2018,"Augsburg","Bundesliga","Erik Thommy","GER","FW","22",1994,1.9,6,5,1,3,2,3,8,37.5,5,2,0,2,5,11,0,0,"https://fbref.com/en/players/df8e7b62/Erik-Thommy"
2018,"Barcelona","La Liga","Jordi Alba","ESP","DF","28",1989,30.5,63,42,35,22,6,26,52,50,26,34,5,29,68,131,67,1,"https://fbref.com/en/players/4601e194/Jordi-Alba"
2018,"Barcelona","La Liga","Paco Alcácer","ESP","MF,FW","23",1993,7.7,4,3,0,2,2,0,6,0,6,5,0,5,11,15,3,0,"https://fbref.com/en/players/a7a9d95a/Paco-Alcacer"
2018,"Barcelona","La Liga","José Arnaiz","ESP","MF","22",1995,0.1,1,1,0,1,0,0,0,NA,0,0,0,0,0,1,0,0,"https://fbref.com/en/players/46e07328/Jose-Arnaiz"
2018,"Barcelona","La Liga","Sergio Busquets","ESP","MF","29",1988,28.8,88,48,27,46,15,39,79,49.4,40,37,10,27,51,139,15,1,"https://fbref.com/en/players/5ab0ea87/Sergio-Busquets"
2018,"Barcelona","La Liga","Jasper Cillessen","NED","GK","28",1989,1,0,0,0,0,0,0,0,NA,0,0,0,0,0,0,0,0,"https://fbref.com/en/players/04ac8285/Jasper-Cillessen"
2018,"Barcelona","La Liga","Philippe Coutinho","BRA","MF,FW","25",1992,14.4,27,14,8,14,5,9,32,28.1,23,14,0,14,6,33,4,0,"https://fbref.com/en/players/0ef89a37/Philippe-Coutinho"
2018,"Barcelona","La Liga","Ousmane Dembélé","FRA","FW,MF","20",1997,10.3,10,7,2,5,3,1,13,7.7,12,8,0,8,5,15,2,0,"https://fbref.com/en/players/b19db005/Ousmane-Dembele"
2018,"Barcelona","La Liga","Gerard Deulofeu","ESP","MF,FW","23",1994,5.6,8,5,6,1,1,3,4,75,1,2,0,2,8,16,0,0,"https://fbref.com/en/players/39583cfd/Gerard-Deulofeu"
2018,"Barcelona","La Liga","Lucas Digne","FRA","DF","24",1993,7.8,22,17,13,6,3,8,12,66.7,4,15,3,12,12,34,18,0,"https://fbref.com/en/players/1b84dbe1/Lucas-Digne"
2018,"Barcelona","La Liga","André Gomes","POR","MF","24",1993,7.1,19,12,8,10,1,5,13,38.5,8,7,1,6,4,23,6,0,"https://fbref.com/en/players/1961b2aa/Andre-Gomes"
2018,"Barcelona","La Liga","Andrés Iniesta","ESP","MF","33",1984,20.3,28,22,11,8,9,6,31,19.4,25,21,2,19,10,38,12,1,"https://fbref.com/en/players/cfd65a29/Andres-Iniesta"
2018,"Barcelona","La Liga","Javier Mascherano","ARG","DF","33",1984,6,15,13,9,6,0,8,9,88.9,1,14,8,6,8,23,20,0,"https://fbref.com/en/players/5070881b/Javier-Mascherano"
2018,"Barcelona","La Liga","Lionel Messi","ARG","FW","30",1987,33.3,17,8,0,11,6,2,18,11.1,16,11,1,10,7,24,0,0,"https://fbref.com/en/players/d70ce98e/Lionel-Messi"
2018,"Barcelona","La Liga","Yerry Mina","COL","DF","22",1994,4.1,10,8,6,4,0,4,6,66.7,2,6,3,3,6,16,16,0,"https://fbref.com/en/players/6d5701f2/Yerry-Mina"
2018,"Barcelona","La Liga","Paulinho","BRA","MF","29",1988,21.6,39,28,17,15,7,11,38,28.9,27,25,3,22,15,54,16,1,"https://fbref.com/en/players/bb7337cc/Paulinho"
2018,"Barcelona","La Liga","Gerard Piqué","ESP","DF","30",1987,29.2,31,22,22,9,0,16,36,44.4,20,40,27,13,30,61,127,0,"https://fbref.com/en/players/adfc9123/Gerard-Pique"
2018,"Barcelona","La Liga","Ivan Rakitić","CRO","MF","29",1988,31.5,52,31,16,30,6,15,45,33.3,30,42,7,35,44,96,16,0,"https://fbref.com/en/players/89f951b5/Ivan-Rakitic"
2018,"Barcelona","La Liga","Sergi Roberto","ESP","DF","25",1992,24.7,63,40,30,25,8,25,49,51,24,18,8,10,39,102,30,1,"https://fbref.com/en/players/335fa267/Sergi-Roberto"
2018,"Barcelona","La Liga","Nélson Semedo","POR","DF","23",1993,16.6,34,25,19,11,4,17,29,58.6,12,16,2,14,22,56,26,1,"https://fbref.com/en/players/d04b94db/Nelson-Semedo"
2018,"Barcelona","La Liga","Denis Suárez","ESP","MF,FW","23",1994,6.6,11,9,3,8,0,3,8,37.5,5,7,0,7,2,13,3,0,"https://fbref.com/en/players/12c50af5/Denis-Suarez"
2018,"Barcelona","La Liga","Luis Suárez","URU","FW","30",1987,32.2,17,10,4,5,8,4,19,21.1,15,4,3,1,8,25,31,0,"https://fbref.com/en/players/a6154613/Luis-Suarez"
2018,"Barcelona","La Liga","Marc-André ter Stegen","GER","GK","25",1992,37,1,0,1,0,0,1,3,33.3,2,1,0,1,4,5,12,1,"https://fbref.com/en/players/6f51e382/Marc-Andre-ter-Stegen"
2018,"Barcelona","La Liga","Samuel Umtiti","FRA","DF","23",1993,24.3,50,35,35,15,0,20,29,69,9,25,17,8,37,87,72,3,"https://fbref.com/en/players/3eed9821/Samuel-Umtiti"
2018,"Barcelona","La Liga","Thomas Vermaelen","BEL","DF","31",1985,11.3,13,9,7,5,1,5,11,45.5,6,10,3,7,18,31,28,0,"https://fbref.com/en/players/d0d79694/Thomas-Vermaelen"
2018,"Barcelona","La Liga","Aleix Vidal","ESP","MF,FW","27",1989,5.1,6,4,2,3,1,1,10,10,9,4,0,4,9,15,1,0,"https://fbref.com/en/players/04965583/Aleix-Vidal"
2018,"Bayern Munich","Bundesliga","David Alaba","AUT","DF","25",1992,17.2,23,14,11,9,3,14,20,70,6,21,6,15,10,33,23,0,"https://fbref.com/en/players/05439de2/David-Alaba"
2018,"Bayern Munich","Bundesliga","Thiago Alcántara","ESP","MF,FW","26",1991,13.9,45,35,11,25,9,15,26,57.7,11,22,3,19,27,72,6,1,"https://fbref.com/en/players/77e84962/Thiago-Alcantara"
2018,"Bayern Munich","Bundesliga","Juan Bernat","ESP","DF,FW","24",1993,9.9,25,19,13,8,4,11,18,61.1,7,11,1,10,10,35,9,1,"https://fbref.com/en/players/433dc9a2/Juan-Bernat"
2018,"Bayern Munich","Bundesliga","Jérôme Boateng","GER","DF","28",1988,18.2,26,18,18,7,1,19,32,59.4,13,20,12,8,21,47,52,1,"https://fbref.com/en/players/2db2fd7b/Jerome-Boateng"
2018,"Bayern Munich","Bundesliga","Kingsley Coman","FRA","FW,MF","21",1996,12.8,11,10,2,6,3,5,10,50,5,6,0,6,7,18,1,0,"https://fbref.com/en/players/042e8a49/Kingsley-Coman"
2018,"Bayern Munich","Bundesliga","Niklas Dorsch","GER","MF","19",1998,1,1,1,0,1,0,0,2,0,2,0,0,0,1,2,0,0,"https://fbref.com/en/players/7f73bdf4/Niklas-Dorsch"
2018,"Bayern Munich","Bundesliga","Franck Evina","CMR","FW","17",2000,1.2,2,2,2,0,0,2,2,100,0,5,0,5,0,2,0,0,"https://fbref.com/en/players/44e471ca/Franck-Evina"
2018,"Bayern Munich","Bundesliga","Marco Friedl","AUT","MF","19",1998,0.5,0,0,0,0,0,0,0,NA,0,1,0,1,1,1,0,0,"https://fbref.com/en/players/f86ad3f5/Marco-Friedl"
2018,"Bayern Munich","Bundesliga","Mats Hummels","GER","DF","28",1988,24.6,62,52,41,18,3,35,51,68.6,16,31,12,19,55,117,59,2,"https://fbref.com/en/players/05d548d8/Mats-Hummels"
2018,"Bayern Munich","Bundesliga","Joshua Kimmich","GER","DF","22",1995,25.9,32,23,14,13,5,20,38,52.6,18,26,5,21,20,52,40,0,"https://fbref.com/en/players/49296448/Joshua-Kimmich"
2018,"Bayern Munich","Bundesliga","Robert Lewandowski","POL","FW","28",1988,24.1,5,3,1,1,3,0,3,0,3,6,0,6,5,10,10,0,"https://fbref.com/en/players/8d78e732/Robert-Lewandowski"
2018,"Bayern Munich","Bundesliga","Lars Lukas Mai","GER","DF","17",2000,2,4,4,4,0,0,3,4,75,1,3,2,1,3,7,3,0,"https://fbref.com/en/players/95173427/Lars-Lukas-Mai"
2018,"Bayern Munich","Bundesliga","Javi Martínez","ESP","MF,DF","28",1988,17.9,31,22,11,15,5,9,19,47.4,10,16,5,11,33,64,40,1,"https://fbref.com/en/players/7f97771d/Javi-Martinez"
2018,"Bayern Munich","Bundesliga","Thomas Müller","GER","MF,FW","27",1989,22.3,35,30,10,15,10,13,27,48.1,14,17,1,16,7,42,14,1,"https://fbref.com/en/players/3c6089ab/Thomas-Muller"
2018,"Bayern Munich","Bundesliga","Manuel Neuer","GER","GK","31",1986,3,0,0,0,0,0,0,0,NA,0,0,0,0,0,0,1,0,"https://fbref.com/en/players/8778c910/Manuel-Neuer"
2018,"Bayern Munich","Bundesliga","Kwasi Okyere Wriedt","GHA","MF","23",1994,0.3,2,2,1,1,0,0,0,NA,0,0,0,0,0,2,0,0,"https://fbref.com/en/players/7124239e/Kwasi-Okyere-Wriedt"
2018,"Bayern Munich","Bundesliga","Rafinha","BRA","DF","31",1985,20.6,39,33,24,11,4,28,47,59.6,19,17,6,11,32,71,30,0,"https://fbref.com/en/players/d003e213/Rafinha"
2018,"Bayern Munich","Bundesliga","Franck Ribéry","FRA","FW,MF","34",1983,13.4,19,16,9,5,5,13,17,76.5,4,11,0,11,7,26,3,0,"https://fbref.com/en/players/f61c7c4e/Franck-Ribery"
2018,"Bayern Munich","Bundesliga","Arjen Robben","NED","FW,MF","33",1984,16.7,14,11,1,7,6,4,12,33.3,8,9,0,9,4,18,4,0,"https://fbref.com/en/players/09586899/Arjen-Robben"
2018,"Bayern Munich","Bundesliga","James Rodríguez","COL","MF,FW","26",1991,18,35,27,10,15,10,15,30,50,15,16,1,15,12,47,4,0,"https://fbref.com/en/players/715bf047/James-Rodriguez"
2018,"Bayern Munich","Bundesliga","Sebastian Rudy","GER","MF","27",1990,16.8,50,40,12,33,5,28,55,50.9,27,11,1,10,18,68,7,1,"https://fbref.com/en/players/80f36c88/Sebastian-Rudy"
2018,"Bayern Munich","Bundesliga","Meritan Shabani","ALB","FW","18",1999,0.6,2,1,1,0,1,1,2,50,1,1,0,1,0,2,0,1,"https://fbref.com/en/players/012c38ec/Meritan-Shabani"
2018,"Bayern Munich","Bundesliga","Tom Starke","GER","GK","36",1981,2,0,0,0,0,0,0,0,NA,0,0,0,0,0,0,0,0,"https://fbref.com/en/players/5b52d1f7/Tom-Starke"
2018,"Bayern Munich","Bundesliga","Niklas Süle","GER","DF","21",1995,21.4,34,25,25,7,2,24,31,77.4,7,24,16,8,33,67,58,0,"https://fbref.com/en/players/e33c06cf/Niklas-Sule"
2018,"Bayern Munich","Bundesliga","Corentin Tolisso","FRA","MF","22",1994,17.5,33,22,8,18,7,14,32,43.8,18,13,3,10,16,49,8,0,"https://fbref.com/en/players/652d4c37/Corentin-Tolisso"
2018,"Bayern Munich","Bundesliga","Sven Ulreich","GER","GK","28",1988,29,1,0,1,0,0,1,1,100,0,0,0,0,3,4,6,1,"https://fbref.com/en/players/7d3e7da6/Sven-Ulreich"
2018,"Bayern Munich","Bundesliga","Arturo Vidal","CHI","MF","30",1987,16.2,69,51,36,28,5,33,69,47.8,36,22,1,21,28,97,20,1,"https://fbref.com/en/players/67cdbc0e/Arturo-Vidal"
2018,"Bayern Munich","Bundesliga","Sandro Wagner","GER","FW","29",1987,8.1,9,6,3,5,1,1,1,100,0,4,0,4,2,11,1,0,"https://fbref.com/en/players/61b0b44d/Sandro-Wagner"
2018,"Benevento","Serie A","Luca Antei","ITA","DF","25",1992,6.6,19,14,12,7,0,6,11,54.5,5,10,8,2,26,45,35,0,"https://fbref.com/en/players/97c9bce3/Luca-Antei"
2018,"Benevento","Serie A","Samuel Armenteros","SWE","FW","27",1990,4.8,4,2,1,3,0,0,3,0,3,1,1,0,1,5,3,0,"https://fbref.com/en/players/9c8f641a/Samuel-Armenteros"
2018,"Benevento","Serie A","Vid Belec","SVN","GK","27",1990,12.4,0,0,0,0,0,0,0,NA,0,0,0,0,1,1,6,1,"https://fbref.com/en/players/4f8ce0e1/Vid-Belec"
2018,"Benevento","Serie A","Jean-Claude Billong","CMR","DF","23",1993,3.3,9,7,5,4,0,5,8,62.5,3,4,3,1,6,15,17,0,"https://fbref.com/en/players/a3e1d20d/Jean-Claude-Billong"
2018,"Benevento","Serie A","Enrico Brignola","ITA","MF,FW","18",1999,15,28,21,17,10,1,12,38,31.6,26,13,0,13,6,34,7,0,"https://fbref.com/en/players/d0643f8f/Enrico-Brignola"
2018,"Benevento","Serie A","Alberto Brignoli","ITA","GK","25",1991,12.5,0,0,0,0,0,0,0,NA,0,0,0,0,0,0,15,3,"https://fbref.com/en/players/6989550f/Alberto-Brignoli"
2018,"Benevento","Serie A","Danilo Cataldi","ITA","MF","22",1994,25.4,33,25,12,19,2,5,28,17.9,23,18,5,13,37,70,20,1,"https://fbref.com/en/players/ba3d3bea/Danilo-Cataldi"
2018,"Benevento","Serie A","Fabio Ceravolo","ITA","FW","30",1987,0.6,0,0,0,0,0,0,1,0,1,1,0,1,0,0,0,0,"https://fbref.com/en/players/4cc93246/Fabio-Ceravolo"
2018,"Benevento","Serie A","Raman Chibsah","GHA","MF","24",1993,11.6,20,13,10,7,3,4,14,28.6,10,13,2,11,4,24,16,0,"https://fbref.com/en/players/aa5a409a/Raman-Chibsah"
2018,"Benevento","Serie A","Amato Ciciretti","ITA","MF,FW","23",1993,9,14,8,5,6,3,2,11,18.2,9,9,0,9,6,20,4,0,"https://fbref.com/en/players/1ab0b878/Amato-Ciciretti"
2018,"Benevento","Serie A","Karamoko Cissé","GUI","FW,MF","28",1988,0.2,1,1,1,0,0,0,0,NA,0,0,0,0,0,1,0,0,"https://fbref.com/en/players/b39569c0/Karamoko-Cisse"
2018,"Benevento","Serie A","Massimo Coda","ITA","FW","28",1988,15.7,12,9,3,4,5,2,13,15.4,11,7,2,5,6,18,11,0,"https://fbref.com/en/players/4c7940d6/Massimo-Coda"
2018,"Benevento","Serie A","Andrea Costa","ITA","DF","31",1986,15.3,19,14,13,6,0,9,19,47.4,10,21,15,6,37,56,78,2,"https://fbref.com/en/players/f5e9a8bd/Andrea-Costa"
2018,"Benevento","Serie A","Marco D'Alessandro","ITA","MF,FW","26",1991,11.6,31,22,15,9,7,8,24,33.3,16,12,1,11,10,41,8,1,"https://fbref.com/en/players/060606ec/Marco-DAlessandro"
2018,"Benevento","Serie A","Lorenzo Del Pinto","ITA","MF","27",1990,8.4,23,17,10,10,3,7,25,28,18,13,4,9,16,39,7,2,"https://fbref.com/en/players/081b6080/Lorenzo-Del-Pinto"
2018,"Benevento","Serie A","Gianluca Di Chiara","ITA","DF","23",1993,11.2,26,19,18,6,2,7,21,33.3,14,10,3,7,11,37,37,1,"https://fbref.com/en/players/68852c0a/Gianluca-Di-Chiara"
2018,"Benevento","Serie A","Cheick Diabaté","MLI","FW","29",1988,7.4,1,1,0,1,0,1,3,33.3,2,2,0,2,0,1,6,0,"https://fbref.com/en/players/95cfe655/Cheick-Diabate"
2018,"Benevento","Serie A","Berat Djimsiti","ALB","DF","24",1993,30,32,17,28,4,0,12,30,40,18,37,23,14,62,94,178,1,"https://fbref.com/en/players/6eee05f1/Berat-Djimsiti"
2018,"Benevento","Serie A","Andrew Gravillon","GLP","DF","19",1998,0.9,2,1,2,0,0,0,1,0,1,1,1,0,3,5,10,0,"https://fbref.com/en/players/49136c42/Andrew-Gravillon"
2018,"Benevento","Serie A","Guilherme","BRA","MF,FW","26",1991,10.5,20,11,7,7,6,3,19,15.8,16,14,1,13,8,28,4,0,"https://fbref.com/en/players/9e61c019/Guilherme"
2018,"Benevento","Serie A","Bright Gyamfi","GHA","DF","21",1996,3.6,2,2,1,1,0,1,2,50,1,3,1,2,7,9,8,0,"https://fbref.com/en/players/251d982a/Bright-Gyamfi"
2018,"Benevento","Serie A","Pietro Iemmello","ITA","FW","25",1992,9.8,2,2,1,1,0,2,8,25,6,4,0,4,1,3,11,2,"https://fbref.com/en/players/0861b8d6/Pietro-Iemmello"
2018,"Benevento","Serie A","Mamadou Kanouté","SEN","FW,MF","23",1993,0.4,0,0,0,0,0,0,0,NA,0,0,0,0,1,1,1,0,"https://fbref.com/en/players/3d5ed93d/Mamadou-Kanoute"
2018,"Benevento","Serie A","Achraf Lazaar","MAR","MF,DF","25",1992,5.3,12,8,9,2,1,5,11,45.5,6,5,1,4,6,18,10,0,"https://fbref.com/en/players/957d41d2/Achraf-Lazaar"
2018,"Benevento","Serie A","Gaetano Letizia","ITA","DF","27",1990,23.8,36,26,21,14,1,19,49,38.8,30,24,3,21,33,69,47,3,"https://fbref.com/en/players/3dd45b70/Gaetano-Letizia"
2018,"Benevento","Serie A","Cristiano Lombardi","ITA","MF,DF","21",1995,12.4,25,19,16,7,2,6,27,22.2,21,12,2,10,13,38,22,0,"https://fbref.com/en/players/f124b4c9/Cristiano-Lombardi"
2018,"Benevento","Serie A","Fabio Lucioni","ITA","DF","29",1987,8,11,9,7,4,0,7,11,63.6,4,14,11,3,7,18,61,0,"https://fbref.com/en/players/8efa621b/Fabio-Lucioni"
2018,"Benevento","Serie A","Ledian Memushaj","ALB","MF","30",1986,14,28,18,11,13,4,7,30,23.3,23,24,5,19,10,38,10,1,"https://fbref.com/en/players/8011fcf6/Ledian-Memushaj"
2018,"Benevento","Serie A","Vittorio Parigini","ITA","MF,FW","21",1996,9.5,18,11,11,6,1,6,17,35.3,11,8,1,7,5,23,1,0,"https://fbref.com/en/players/75efed2e/Vittorio-Parigini"
2018,"Benevento","Serie A","Christian Puggioni","ITA","GK","36",1981,13.1,0,0,0,0,0,0,0,NA,0,0,0,0,0,0,5,1,"https://fbref.com/en/players/b39dfab0/Christian-Puggioni"
2018,"Benevento","Serie A","George Pușcaș","ROU","FW,MF","21",1996,7.8,0,0,0,0,0,0,3,0,3,0,0,0,1,1,13,0,"https://fbref.com/en/players/c23c8e0d/George-Puscas"
2018,"Benevento","Serie A","Bacary Sagna","FRA","DF","34",1983,10.6,9,7,5,3,1,1,7,14.3,6,9,2,7,20,29,28,0,"https://fbref.com/en/players/6ef56efd/Bacary-Sagna"
2018,"Benevento","Serie A","Sandro","BRA","MF","28",1989,12.8,29,21,15,13,1,12,18,66.7,6,23,16,7,18,47,43,1,"https://fbref.com/en/players/c1c2c925/Sandro"
2018,"Benevento","Serie A","Siriki Sanogo","CIV","MF","15",2001,0.4,1,1,0,1,0,0,0,NA,0,0,0,0,1,2,1,0,"https://fbref.com/en/players/ff120e44/Siriki-Sanogo"
2018,"Benevento","Serie A","Luca Sparandeo","ITA","DF","17",1999,0.4,0,0,0,0,0,0,1,0,1,1,0,1,0,0,0,0,"https://fbref.com/en/players/dfbb3234/Luca-Sparandeo"
2018,"Benevento","Serie A","Alin Toșca","ROU","DF","25",1992,13,11,8,7,4,0,6,12,50,6,9,4,5,13,24,69,0,"https://fbref.com/en/players/322ba2df/Alin-Tosca"
2018,"Benevento","Serie A","Lorenzo Venuti","ITA","DF","22",1995,26.6,44,34,26,12,6,16,37,43.2,21,40,16,24,40,84,105,3,"https://fbref.com/en/players/983ff2c7/Lorenzo-Venuti"
2018,"Benevento","Serie A","Nicolas Viola","ITA","MF","27",1989,20.6,37,27,20,14,3,15,39,38.5,24,29,8,21,24,61,23,2,"https://fbref.com/en/players/45392b06/Nicolas-Viola"
2018,"Benevento","Serie A","Giovanni Volpicelli","ITA","MF","17",1999,0,0,0,0,0,0,0,1,0,1,0,0,0,0,0,0,0,"https://fbref.com/en/players/844a87c2/Giovanni-Volpicelli"
2018,"Benevento","Serie A","Filip Đuričić","SRB","MF,FW","25",1992,10.8,22,14,11,8,3,5,9,55.6,4,7,1,6,9,31,5,0,"https://fbref.com/en/players/eccbe56a/Filip-Djuricic"
2018,"Benevento","Serie A","Christian Rutjens","","","",NA,0,NA,NA,NA,NA,NA,NA,NA,NA,NA,NA,NA,NA,NA,NA,NA,NA,"https://fbref.com/en/players//Christian-Rutjens"
2018,"Betis","La Liga","Antonio Adán","ESP","GK","30",1987,30,1,0,1,0,0,1,1,100,0,1,0,1,0,1,11,2,"https://fbref.com/en/players/65d62814/Antonio-Adan"
2018,"Betis","La Liga","Jordi Amat","IDN","DF,MF","25",1992,22.7,32,23,15,16,1,11,24,45.8,13,14,4,10,38,70,77,2,"https://fbref.com/en/players/d70a2141/Jordi-Amat"
2018,"Betis","La Liga","Antonio Barragán","ESP","DF","30",1987,26.4,59,42,40,11,8,24,36,66.7,12,22,5,17,24,83,66,0,"https://fbref.com/en/players/487d9b09/Antonio-Barragan"
2018,"Betis","La Liga","Marc Bartra","ESP","DF","26",1991,15.8,38,28,30,8,0,21,39,53.8,18,19,10,9,32,70,97,1,"https://fbref.com/en/players/b742cc0d/Marc-Bartra"
2018,"Betis","La Liga","Ryad Boudebouz","ALG","MF,FW","27",1990,15.1,32,18,6,21,5,6,26,23.1,20,18,1,17,7,39,8,0,"https://fbref.com/en/players/1001ae82/Ryad-Boudebouz"
2018,"Betis","La Liga","Víctor Camarasa","ESP","MF","23",1994,13.9,20,15,8,10,2,3,13,23.1,10,8,0,8,15,35,13,0,"https://fbref.com/en/players/b2d03887/Victor-Camarasa"
2018,"Betis","La Liga","Joel Campbell","CRC","MF,FW","25",1992,2.4,6,2,3,3,0,3,6,50,3,2,0,2,0,6,0,0,"https://fbref.com/en/players/895ff3ca/Joel-Campbell"
2018,"Betis","La Liga","Rubén Castro","ESP","FW","36",1981,4,1,1,0,0,1,0,0,NA,0,0,0,0,0,1,2,0,"https://fbref.com/en/players/d109f62b/Ruben-Castro"
2018,"Betis","La Liga","Riza Durmisi","DEN","DF","23",1994,23.1,39,21,24,14,1,10,18,55.6,8,18,7,11,15,54,65,1,"https://fbref.com/en/players/e5cd9da6/Riza-Durmisi"
2018,"Betis","La Liga","Zouhair Feddal","MAR","DF","28",1989,14,22,14,14,6,2,7,12,58.3,5,17,13,4,36,58,95,2,"https://fbref.com/en/players/89151b16/Zouhair-Feddal"
2018,"Betis","La Liga","Junior Firpo","ESP","DF","20",1996,13.2,26,17,15,8,3,10,18,55.6,8,21,2,19,20,46,37,1,"https://fbref.com/en/players/24f59bb2/Junior-Firpo"
2018,"Betis","La Liga","Javi García","ESP","MF,DF","30",1987,26.8,34,22,18,16,0,13,40,32.5,27,19,12,7,25,59,78,1,"https://fbref.com/en/players/167c1bb0/Javi-Garcia"
2018,"Betis","La Liga","Dani Giménez","ESP","GK","34",1983,3.4,0,0,0,0,0,0,0,NA,0,0,0,0,0,0,0,0,"https://fbref.com/en/players/7c218bf9/Dani-Gimenez"
2018,"Betis","La Liga","Julio Gracia","ESP","DF,FW","19",1998,0.3,0,0,0,0,0,0,0,NA,0,0,0,0,1,1,0,0,"https://fbref.com/en/players/314eeab1/Julio-Gracia"
2018,"Betis","La Liga","Andrés Guardado","MEX","MF","30",1986,25.2,41,27,17,18,6,15,55,27.3,40,27,5,22,22,63,29,1,"https://fbref.com/en/players/ef322658/Andres-Guardado"
2018,"Betis","La Liga","Francis Guerrero","ESP","DF,MF","21",1996,11,31,19,22,7,2,16,34,47.1,18,16,4,12,21,52,26,0,"https://fbref.com/en/players/59d53e8a/Francis-Guerrero"
2018,"Betis","La Liga","Joaquín","ESP","MF,FW","36",1981,27.5,22,19,11,10,1,4,16,25,12,17,2,15,15,37,38,0,"https://fbref.com/en/players/4c5b14d2/Joaquin"
2018,"Betis","La Liga","Sergio León","ESP","FW","28",1989,22,13,7,3,6,4,3,11,27.3,8,12,1,11,6,19,5,0,"https://fbref.com/en/players/0a0cc13c/Sergio-Leon"
2018,"Betis","La Liga","Pedro López","ESP","GK","22",1995,4.6,0,0,0,0,0,0,0,NA,0,1,0,1,0,0,3,0,"https://fbref.com/en/players/bfa29677/Pedro-Lopez"
2018,"Betis","La Liga","Aïssa Mandi","ALG","DF","25",1991,33.6,54,35,27,25,2,19,34,55.9,15,39,24,15,71,125,133,3,"https://fbref.com/en/players/fbd6378b/Aissa-Mandi"
2018,"Betis","La Liga","Loren Morón","ESP","FW","23",1993,11.8,14,8,4,5,5,4,17,23.5,13,14,1,13,1,15,12,0,"https://fbref.com/en/players/3aa4a3be/Loren-Moron"
2018,"Betis","La Liga","Matías Nahuel","ESP","MF,FW","20",1996,2.8,4,4,1,1,2,2,5,40,3,2,0,2,2,6,1,0,"https://fbref.com/en/players/48e4c485/Matias-Nahuel"
2018,"Betis","La Liga","Juanjo Narváez","COL","MF","22",1995,3.4,8,6,4,4,0,3,6,50,3,3,0,3,8,16,4,0,"https://fbref.com/en/players/485e4939/Juanjo-Narvaez"
2018,"Betis","La Liga","Rafa Navarro","ESP","DF","23",1994,1.5,3,2,3,0,0,0,4,0,4,0,0,0,1,4,6,0,"https://fbref.com/en/players/83627094/Rafa-Navarro"
2018,"Betis","La Liga","Aitor Ruibal","ESP","MF","21",1996,0.1,0,0,0,0,0,0,0,NA,0,0,0,0,0,0,0,0,"https://fbref.com/en/players/a55d8df5/Aitor-Ruibal"
2018,"Betis","La Liga","Fabián Ruiz Peña","ESP","MF","21",1996,29.5,83,53,34,40,9,26,73,35.6,47,35,3,32,42,125,36,1,"https://fbref.com/en/players/c0c7ff58/Fabian-Ruiz-Pena"
2018,"Betis","La Liga","Antonio Sanabria","PAR","FW","21",1996,9.5,8,8,0,4,4,0,3,0,3,5,0,5,4,12,6,0,"https://fbref.com/en/players/0a447501/Antonio-Sanabria"
2018,"Betis","La Liga","Cristian Tello","ESP","FW,MF","25",1991,18.8,32,24,12,14,6,7,37,18.9,30,19,0,19,16,48,4,1,"https://fbref.com/en/players/72a99e38/Cristian-Tello"
2018,"Betis","La Liga","Alin Toșca","ROU","DF","25",1992,4.7,12,9,7,5,0,5,9,55.6,4,7,1,6,5,17,17,1,"https://fbref.com/en/players/322ba2df/Alin-Tosca"
2018,"Bologna","Serie A","Felipe Avenatti","URU","FW","24",1993,5.2,6,4,1,5,0,1,2,50,1,7,1,6,1,7,6,0,"https://fbref.com/en/players/23f9e9d3/Felipe-Avenatti"
2018,"Bologna","Serie A","Angelo da Costa Júnior","BRA","GK","33",1983,4,0,0,0,0,0,0,0,NA,0,0,0,0,0,0,2,0,"https://fbref.com/en/players/18736214/Angelo-da-Costa-Junior"
2018,"Bologna","Serie A","Lorenzo Crisetig","ITA","MF","24",1993,6.2,18,14,8,9,1,7,24,29.2,17,8,2,6,13,31,16,1,"https://fbref.com/en/players/f54dfca8/Lorenzo-Crisetig"
2018,"Bologna","Serie A","Sebastien De Maio","FRA","DF","30",1987,22.8,26,17,15,11,0,10,25,40,15,35,18,17,36,62,147,0,"https://fbref.com/en/players/952a03fe/Sebastien-De-Maio"
2018,"Bologna","Serie A","Mattia Destro","ITA","FW","26",1991,18,15,13,4,9,2,3,11,27.3,8,10,1,9,5,20,26,0,"https://fbref.com/en/players/d7d32194/Mattia-Destro"
2018,"Bologna","Serie A","Federico Di Francesco","ITA","FW,DF","23",1994,17.7,26,13,14,8,4,5,20,25,15,24,2,22,16,42,25,0,"https://fbref.com/en/players/1fca9171/Federico-Di-Francesco"
2018,"Bologna","Serie A","Godfred Donsah","GHA","MF","21",1996,19.9,29,20,11,14,4,10,17,58.8,7,25,0,25,22,51,43,0,"https://fbref.com/en/players/384dd218/Godfred-Donsah"
2018,"Bologna","Serie A","Blerim Džemaili","SUI","MF,FW","31",1986,13.3,27,19,11,15,1,9,27,33.3,18,15,4,11,18,45,11,0,"https://fbref.com/en/players/756959aa/Blerim-Dzemaili"
2018,"Bologna","Serie A","Cesar Falletti","URU","MF,FW","24",1992,3.6,11,7,4,6,1,4,8,50,4,10,0,10,0,11,5,0,"https://fbref.com/en/players/00823e9a/Cesar-Falletti"
2018,"Bologna","Serie A","Giancarlo González","CRC","DF","29",1988,20.6,20,15,14,5,1,9,13,69.2,4,26,18,8,33,53,152,1,"https://fbref.com/en/players/117beb8f/Giancarlo-Gonzalez"
2018,"Bologna","Serie A","Filip Helander","SWE","DF","24",1993,27.8,48,32,33,15,0,15,29,51.7,14,47,25,22,37,85,160,2,"https://fbref.com/en/players/27f0ddef/Filip-Helander"
2018,"Bologna","Serie A","Cheick Keita","MLI","DF","21",1996,1.4,2,2,1,1,0,1,3,33.3,2,5,0,5,2,4,1,0,"https://fbref.com/en/players/82f32d55/Cheick-Keita"
2018,"Bologna","Serie A","Emil Krafth","SWE","DF","22",1994,10.5,23,16,14,8,1,10,19,52.6,9,12,4,8,16,39,39,1,"https://fbref.com/en/players/77cf6852/Emil-Krafth"
2018,"Bologna","Serie A","Ladislav Krejčí","CZE","MF,FW","25",1992,4.4,7,5,1,3,3,1,5,20,4,3,0,3,2,9,3,0,"https://fbref.com/en/players/58027adc/Ladislav-Krejci"
2018,"Bologna","Serie A","Domenico Maietta","ITA","DF","34",1982,5.2,5,4,4,1,0,3,9,33.3,6,8,6,2,7,12,13,1,"https://fbref.com/en/players/3d936ba9/Domenico-Maietta"
2018,"Bologna","Serie A","Adam Masina","MAR","DF","23",1994,31.4,82,57,49,26,7,36,84,42.9,48,46,7,39,51,133,127,0,"https://fbref.com/en/players/de0f152c/Adam-Masina"
2018,"Bologna","Serie A","Ibrahima Mbaye","SEN","DF","22",1994,19.6,59,34,40,17,2,25,36,69.4,11,25,6,19,28,87,95,0,"https://fbref.com/en/players/cfbf9881/Ibrahima-Mbaye"
2018,"Bologna","Serie A","Antonio Mirante","ITA","GK","34",1983,33,0,0,0,0,0,0,3,0,3,1,0,1,0,0,11,5,"https://fbref.com/en/players/30223b33/Antonio-Mirante"
2018,"Bologna","Serie A","Ádám Nagy","HUN","MF","22",1995,7.9,16,9,6,8,2,7,13,53.8,6,11,0,11,7,23,5,0,"https://fbref.com/en/players/788b31e2/Adam-Nagy"
2018,"Bologna","Serie A","Orji Okwonkwo","NGA","FW,MF","19",1998,2.9,9,3,6,3,0,1,4,25,3,2,0,2,1,10,1,0,"https://fbref.com/en/players/905a4f61/Orji-Okwonkwo"
2018,"Bologna","Serie A","Riccardo Orsolini","ITA","FW,DF","20",1997,3.8,5,5,4,1,0,1,5,20,4,2,1,1,3,8,4,0,"https://fbref.com/en/players/e14ec482/Riccardo-Orsolini"
2018,"Bologna","Serie A","Rodrigo Palacio","ARG","FW,MF","35",1982,22.9,25,18,6,12,7,10,28,35.7,18,16,2,14,12,37,14,0,"https://fbref.com/en/players/8d8178ac/Rodrigo-Palacio"
2018,"Bologna","Serie A","Bruno Petković","CRO","FW,MF","22",1994,3.7,7,6,0,5,2,1,1,100,0,3,0,3,4,11,5,0,"https://fbref.com/en/players/24228180/Bruno-Petkovic"
2018,"Bologna","Serie A","Andrea Poli","ITA","MF","27",1989,28.3,66,53,33,27,6,18,64,28.1,46,55,3,52,43,109,27,0,"https://fbref.com/en/players/b3fd7075/Andrea-Poli"
2018,"Bologna","Serie A","Erick Pulgar","CHI","MF","23",1994,30.8,70,48,41,29,0,24,75,32,51,49,13,36,46,116,83,1,"https://fbref.com/en/players/4611e028/Erick-Pulgar"
2018,"Bologna","Serie A","Simone Romagnoli","ITA","DF","27",1990,6.2,12,9,10,2,0,4,9,44.4,5,12,8,4,7,19,41,2,"https://fbref.com/en/players/09899de8/Simone-Romagnoli"
2018,"Bologna","Serie A","Antonio Santurro","DOM","GK","25",1992,1,0,0,0,0,0,0,0,NA,0,0,0,0,0,0,1,0,"https://fbref.com/en/players/61228681/Antonio-Santurro"
2018,"Bologna","Serie A","Saphir Taïder","ALG","MF","25",1992,4.3,6,2,4,2,0,1,2,50,1,3,2,1,1,7,4,0,"https://fbref.com/en/players/a12d0c05/Saphir-Taider"
2018,"Bologna","Serie A","Vasilis Torosidis","GRE","DF","32",1985,9.1,8,7,5,2,1,4,9,44.4,5,8,3,5,15,23,42,0,"https://fbref.com/en/players/8ea2c099/Vasilis-Torosidis"
2018,"Bologna","Serie A","Simone Verdi","ITA","FW,MF","25",1992,31.4,33,24,17,13,3,11,43,25.6,32,20,1,19,36,69,12,0,"https://fbref.com/en/players/0375723e/Simone-Verdi"
2018,"Bordeaux","Ligue 1","Paul Baysse","FRA","DF","29",1988,6.3,4,2,3,1,0,1,5,20,4,4,3,1,7,11,38,1,"https://fbref.com/en/players/2515040a/Paul-Baysse"
2018,"Bordeaux","Ligue 1","Martin Braithwaite","DEN","FW","26",1991,10.2,6,4,0,4,2,1,6,16.7,5,6,2,4,0,6,3,0,"https://fbref.com/en/players/fd771f95/Martin-Braithwaite"
2018,"Bordeaux","Ligue 1","Jonathan Cafu","BRA","FW,MF","26",1991,7,16,9,7,6,3,5,13,38.5,8,6,1,5,10,26,1,0,"https://fbref.com/en/players/8d043f1d/Jonathan-Cafu"
2018,"Bordeaux","Ligue 1","Thomas Carrique","FRA","DF","18",1999,1,1,0,0,1,0,1,3,33.3,2,0,0,0,2,3,3,0,"https://fbref.com/en/players/23b6ab66/Thomas-Carrique"
2018,"Bordeaux","Ligue 1","Diego Contento","GER","DF,MF","27",1990,1.2,3,0,1,2,0,1,1,100,0,2,1,1,1,4,9,0,"https://fbref.com/en/players/15a21c79/Diego-Contento"
2018,"Bordeaux","Ligue 1","Benoît Costil","FRA","GK","30",1987,36,0,0,0,0,0,0,2,0,2,0,0,0,3,3,13,4,"https://fbref.com/en/players/2434f24a/Benoit-Costil"
2018,"Bordeaux","Ligue 1","Milan Gajić","SRB","DF","21",1996,4,6,3,4,2,0,2,4,50,2,7,0,7,4,10,14,0,"https://fbref.com/en/players/9f6325f9/Milan-Gajic"
2018,"Bordeaux","Ligue 1","Vukašin Jovanović","SRB","DF","21",1996,16,18,14,11,7,0,6,14,42.9,8,18,10,8,27,45,67,0,"https://fbref.com/en/players/0eb03d5b/Vukasin-Jovanovic"
2018,"Bordeaux","Ligue 1","François Kamano","GUI","FW","21",1996,22.4,32,24,11,14,7,10,35,28.6,25,18,2,16,15,47,8,0,"https://fbref.com/en/players/81d3318f/Francois-Kamano"
2018,"Bordeaux","Ligue 1","Jules Koundé","FRA","DF","18",1998,17.7,26,19,19,7,0,13,17,76.5,4,14,11,3,14,40,97,0,"https://fbref.com/en/players/4d1666ff/Jules-Kounde"
2018,"Bordeaux","Ligue 1","Gaëtan Laborde","FRA","FW","23",1994,10.6,9,7,1,6,2,2,7,28.6,5,8,2,6,1,10,7,1,"https://fbref.com/en/players/7cdda3bf/Gaetan-Laborde"
2018,"Bordeaux","Ligue 1","Lukas Lerager","DEN","MF","24",1993,36.5,107,74,33,61,13,33,107,30.8,74,44,8,36,67,174,66,1,"https://fbref.com/en/players/1b82f8df/Lukas-Lerager"
2018,"Bordeaux","Ligue 1","Igor Lewczuk","POL","DF","32",1985,4.9,9,7,5,3,1,3,6,50,3,2,2,0,7,16,11,0,"https://fbref.com/en/players/6b9f2f3e/Igor-Lewczuk"
2018,"Bordeaux","Ligue 1","Malcom","BRA","FW","20",1997,31.7,15,10,3,7,5,1,28,3.6,27,13,1,12,14,29,6,0,"https://fbref.com/en/players/6853490f/Malcom"
2018,"Bordeaux","Ligue 1","Soualiho Meïté","FRA","MF","23",1994,14.8,25,13,4,19,2,9,32,28.1,23,22,6,16,23,48,13,1,"https://fbref.com/en/players/5cec2c74/Soualiho-Meite"
2018,"Bordeaux","Ligue 1","Alexandre Mendy","GNB","FW","23",1994,8.8,4,4,1,2,1,1,6,16.7,5,5,1,4,1,5,4,0,"https://fbref.com/en/players/e067808c/Alexandre-Mendy"
2018,"Bordeaux","Ligue 1","Otávio","BRA","MF","23",1994,16.5,64,42,25,37,2,20,61,32.8,41,26,4,22,32,96,35,0,"https://fbref.com/en/players/243f4a0b/Otavio"
2018,"Bordeaux","Ligue 1","Pablo","BRA","DF","26",1991,14.3,16,15,13,3,0,10,16,62.5,6,13,7,6,16,32,96,1,"https://fbref.com/en/players/29d8ad3f/Pablo"
2018,"Bordeaux","Ligue 1","Théo Pellenard","FRA","DF","23",1994,15.9,32,20,13,15,4,10,28,35.7,18,15,6,9,32,64,31,0,"https://fbref.com/en/players/97fb4608/Theo-Pellenard"
2018,"Bordeaux","Ligue 1","Jaroslav Plašil","CZE","MF","35",1982,11.6,24,14,7,17,0,7,31,22.6,24,18,6,12,21,45,15,0,"https://fbref.com/en/players/516dc25b/Jaroslav-Plasil"
2018,"Bordeaux","Ligue 1","Maxime Poundjé","FRA","DF","24",1992,18.9,53,29,32,16,5,28,51,54.9,23,14,6,8,35,88,63,1,"https://fbref.com/en/players/b92edde2/Maxime-Poundje"
2018,"Bordeaux","Ligue 1","Nicolas de Préville","FRA","FW","26",1991,21.5,34,27,10,15,9,9,33,27.3,24,25,4,21,21,55,12,0,"https://fbref.com/en/players/b0547a87/Nicolas-de-Preville"
2018,"Bordeaux","Ligue 1","Jérôme Prior","FRA","GK","21",1995,2,0,0,0,0,0,0,0,NA,0,0,0,0,0,0,2,2,"https://fbref.com/en/players/1061c207/Jerome-Prior"
2018,"Bordeaux","Ligue 1","Youssouf Sabaly","SEN","DF","24",1993,34.4,93,61,54,34,5,43,68,63.2,25,26,6,20,54,147,104,0,"https://fbref.com/en/players/fbbb9269/Youssouf-Sabaly"
2018,"Bordeaux","Ligue 1","Younousse Sankharé","SEN","MF","27",1989,20.9,33,23,10,20,3,4,34,11.8,30,15,4,11,21,54,7,0,"https://fbref.com/en/players/c650629d/Younousse-Sankhare"
2018,"Bordeaux","Ligue 1","Ervin Taha","FRA","FW","18",1999,0.4,1,1,0,1,0,0,1,0,1,0,0,0,0,1,0,0,"https://fbref.com/en/players/942c6dc3/Ervin-Taha"
2018,"Bordeaux","Ligue 1","Jérémy Toulalan","FRA","DF","33",1983,21,43,25,35,7,1,17,39,43.6,22,25,16,9,28,71,121,0,"https://fbref.com/en/players/7adea561/Jeremy-Toulalan"
2018,"Bordeaux","Ligue 1","Thomas Touré","CIV","FW","23",1993,0.1,0,0,0,0,0,0,0,NA,0,0,0,0,1,1,0,0,"https://fbref.com/en/players/d72db2f5/Thomas-Toure"
2018,"Bordeaux","Ligue 1","Valentín Vada","ARG","MF","21",1996,9.6,22,11,7,14,1,8,32,25,24,8,1,7,6,28,5,1,"https://fbref.com/en/players/dcf7cf44/Valentin-Vada"
2018,"Bordeaux","Ligue 1","Olivier Verdon","BEN","DF","21",1995,0.1,0,0,0,0,0,0,0,NA,0,0,0,0,0,0,3,0,"https://fbref.com/en/players/7cb9de24/Olivier-Verdon"
2018,"Bordeaux","Ligue 1","Zaydou Youssouf","FRA","FW","18",1999,1.5,3,1,2,1,0,1,2,50,1,1,0,1,1,4,1,0,"https://fbref.com/en/players/e2f9bb5f/Zaydou-Youssouf"
2018,"Bournemouth","Premier League","Benik Afobe","COD","FW","24",1993,6.8,4,3,1,2,1,1,6,16.7,5,4,0,4,0,4,6,0,"https://fbref.com/en/players/b63f4077/Benik-Afobe"
2018,"Bournemouth","Premier League","Nathan Aké","NED","DF","22",1995,37.3,53,32,34,16,3,22,40,55,18,47,24,23,48,101,246,2,"https://fbref.com/en/players/eaeca114/Nathan-Ake"
2018,"Bournemouth","Premier League","Harry Arter","IRL","MF","27",1989,10.7,19,16,10,7,2,6,23,26.1,17,18,5,13,9,28,6,0,"https://fbref.com/en/players/2f4c5a52/Harry-Arter"
2018,"Bournemouth","Premier League","Asmir Begović","BIH","GK","30",1987,38,0,0,0,0,0,0,2,0,2,0,0,0,2,2,16,7,"https://fbref.com/en/players/7b4de647/Asmir-Begovic"
2018,"Bournemouth","Premier League","Lewis Cook","ENG","MF","20",1997,24.9,67,35,37,30,0,26,69,37.7,43,33,12,21,35,102,25,2,"https://fbref.com/en/players/2afc7272/Lewis-Cook"
2018,"Bournemouth","Premier League","Steve Cook","ENG","DF","26",1991,30.7,37,19,28,7,2,19,29,65.5,10,63,45,18,54,91,232,4,"https://fbref.com/en/players/3e5e4e63/Steve-Cook"
2018,"Bournemouth","Premier League","Charlie Daniels","ENG","DF,MF","30",1986,33.4,48,34,32,12,4,22,41,53.7,19,34,7,27,31,79,114,0,"https://fbref.com/en/players/9d107085/Charlie-Daniels"
2018,"Bournemouth","Premier League","Jermain Defoe","ENG","FW","34",1982,12.1,12,9,2,6,4,2,10,20,8,10,0,10,4,16,1,0,"https://fbref.com/en/players/f1e8372d/Jermain-Defoe"
2018,"Bournemouth","Premier League","Simon Francis","ENG","DF","32",1985,30.1,49,34,26,16,7,24,43,55.8,19,29,18,11,49,98,194,4,"https://fbref.com/en/players/1e0b6a73/Simon-Francis"
2018,"Bournemouth","Premier League","Ryan Fraser","SCO","MF,DF","23",1994,22.3,11,8,7,2,2,7,20,35,13,20,4,16,17,28,34,0,"https://fbref.com/en/players/d56543a0/Ryan-Fraser"
2018,"Bournemouth","Premier League","Dan Gosling","ENG","MF","27",1990,21.6,50,25,19,26,5,19,68,27.9,49,36,8,28,25,75,35,0,"https://fbref.com/en/players/7fec31a0/Dan-Gosling"
2018,"Bournemouth","Premier League","Emerson Hyndman","USA","MF","21",1996,0.6,0,0,0,0,0,0,1,0,1,2,0,2,1,1,1,0,"https://fbref.com/en/players/3be1a627/Emerson-Hyndman"
2018,"Bournemouth","Premier League","Jordon Ibe","ENG","MF,FW","21",1995,22.2,14,12,7,5,2,6,22,27.3,16,5,0,5,10,24,11,0,"https://fbref.com/en/players/9f736ed2/Jordon-Ibe"
2018,"Bournemouth","Premier League","Joshua King","NOR","FW,MF","25",1992,27.3,36,26,11,17,8,4,27,14.8,23,23,3,20,4,40,14,1,"https://fbref.com/en/players/43458538/Joshua-King"
2018,"Bournemouth","Premier League","Tyrone Mings","ENG","DF","24",1993,2.2,1,1,1,0,0,0,0,NA,0,2,2,0,6,7,13,1,"https://fbref.com/en/players/8397a50c/Tyrone-Mings"
2018,"Bournemouth","Premier League","Lys Mousset","FRA","FW,MF","21",1996,6.6,9,5,6,3,0,0,8,0,8,5,2,3,3,12,9,0,"https://fbref.com/en/players/d9cfca3d/Lys-Mousset"
2018,"Bournemouth","Premier League","Marc Pugh","ENG","MF,FW","30",1987,10.9,7,3,2,4,1,2,10,20,8,6,1,5,13,20,13,2,"https://fbref.com/en/players/9aacb284/Marc-Pugh"
2018,"Bournemouth","Premier League","Jack Simpson","ENG","DF","20",1996,0.8,1,1,1,0,0,0,1,0,1,1,0,1,0,1,4,0,"https://fbref.com/en/players/76fa5f80/Jack-Simpson"
2018,"Bournemouth","Premier League","Adam Smith","ENG","DF,MF","26",1991,23,50,36,33,16,1,24,53,45.3,29,46,8,38,31,81,73,0,"https://fbref.com/en/players/20b104bc/Adam-Smith"
2018,"Bournemouth","Premier League","Junior Stanislas","ENG","MF,FW","27",1989,14.3,16,8,8,4,4,7,15,46.7,8,21,6,15,6,22,15,0,"https://fbref.com/en/players/6992791d/Junior-Stanislas"
2018,"Bournemouth","Premier League","Andrew Surman","ENG","MF","30",1986,20.6,16,12,5,8,3,6,23,26.1,17,33,12,21,16,32,52,2,"https://fbref.com/en/players/7d41b619/Andrew-Surman"
2018,"Bournemouth","Premier League","Callum Wilson","ENG","FW","25",1992,22,9,5,2,6,1,1,14,7.1,13,15,3,12,3,12,15,0,"https://fbref.com/en/players/c596fcb0/Callum-Wilson"
2018,"Brighton","Premier League","Sam Baldock","ENG","FW","28",1989,0.4,0,0,0,0,0,0,0,NA,0,0,0,0,0,0,0,0,"https://fbref.com/en/players/9d597f08/Sam-Baldock"
2018,"Brighton","Premier League","Gaëtan Bong","CMR","DF","29",1988,24.8,39,32,25,11,3,15,26,57.7,11,24,6,18,40,79,81,1,"https://fbref.com/en/players/cfd5e123/Gaetan-Bong"
2018,"Brighton","Premier League","Izzy Brown","ENG","MF,FW","20",1997,3.5,3,3,2,1,0,1,7,14.3,6,3,0,3,1,4,3,0,"https://fbref.com/en/players/bf54c8cc/Izzy-Brown"
2018,"Brighton","Premier League","Bruno","ESP","DF","36",1980,22.4,30,17,21,6,3,14,22,63.6,8,17,11,6,38,68,76,0,"https://fbref.com/en/players/78803d03/Bruno"
2018,"Brighton","Premier League","Shane Duffy","IRL","DF","25",1992,36.6,31,19,22,9,0,7,20,35,13,66,59,7,50,81,332,5,"https://fbref.com/en/players/7314bba4/Shane-Duffy"
2018,"Brighton","Premier League","Lewis Dunk","ENG","DF","25",1991,38,67,33,49,18,0,25,48,52.1,23,73,58,15,71,138,230,2,"https://fbref.com/en/players/282f75f3/Lewis-Dunk"
2018,"Brighton","Premier League","Connor Goldson","ENG","DF","24",1992,2.2,2,2,1,1,0,1,4,25,3,3,3,0,1,3,9,0,"https://fbref.com/en/players/56f6f826/Connor-Goldson"
2018,"Brighton","Premier League","Pascal Groß","GER","FW,MF","26",1991,32.5,36,24,18,16,2,10,67,14.9,57,31,5,26,14,50,20,0,"https://fbref.com/en/players/8aec0537/Pascal-Gross"
2018,"Brighton","Premier League","Tomer Hemed","ISR","FW","30",1987,9.4,7,5,3,4,0,2,10,20,8,10,1,9,2,9,12,0,"https://fbref.com/en/players/27d7453c/Tomer-Hemed"
2018,"Brighton","Premier League","Uwe Hünemeier","GER","DF","31",1986,0.2,0,0,0,0,0,0,0,NA,0,0,0,0,0,0,4,0,"https://fbref.com/en/players/f42456eb/Uwe-Hunemeier"
2018,"Brighton","Premier League","José Izquierdo","COL","MF,FW","25",1992,22,23,15,12,9,2,7,19,36.8,12,6,0,6,16,39,34,0,"https://fbref.com/en/players/ca2bc3df/Jose-Izquierdo"
2018,"Brighton","Premier League","Beram Kayal","ISR","MF","29",1988,8.3,18,11,10,7,1,6,26,23.1,20,11,4,7,12,30,9,0,"https://fbref.com/en/players/26679cdf/Beram-Kayal"
2018,"Brighton","Premier League","Anthony Knockaert","FRA","MF,FW","25",1991,26.9,39,26,25,11,3,16,55,29.1,39,29,3,26,23,62,16,0,"https://fbref.com/en/players/6c679c6d/Anthony-Knockaert"
2018,"Brighton","Premier League","Jürgen Locadia","NED","FW,MF","23",1993,2.5,1,0,0,1,0,0,1,0,1,0,0,0,1,2,1,1,"https://fbref.com/en/players/6cc47ae1/Jurgen-Locadia"
2018,"Brighton","Premier League","Solly March","ENG","MF,FW","23",1994,20.6,54,41,34,14,6,22,54,40.7,32,27,3,24,13,67,49,0,"https://fbref.com/en/players/bb5fbd2b/Solly-March"
2018,"Brighton","Premier League","Jamie Murphy","SCO","MF","27",1989,1.9,2,2,2,0,0,2,4,50,2,0,0,0,1,3,3,0,"https://fbref.com/en/players/6c96b263/Jamie-Murphy"
2018,"Brighton","Premier League","Glenn Murray","ENG","FW","33",1983,24.4,18,12,4,11,3,2,18,11.1,16,16,4,12,5,23,27,0,"https://fbref.com/en/players/f2f29dda/Glenn-Murray"
2018,"Brighton","Premier League","Davy Pröpper","NED","MF","25",1991,34.7,73,44,35,35,3,18,83,21.7,65,35,11,24,60,133,80,2,"https://fbref.com/en/players/fdd85f94/Davy-Propper"
2018,"Brighton","Premier League","Liam Rosenior","ENG","DF","33",1984,1.8,4,3,2,1,1,2,5,40,3,2,1,1,4,8,7,0,"https://fbref.com/en/players/8b0d6fe9/Liam-Rosenior"
2018,"Brighton","Premier League","Mathew Ryan","AUS","GK","25",1992,38,0,0,0,0,0,0,3,0,3,0,0,0,3,3,10,3,"https://fbref.com/en/players/4535e4bb/Mathew-Ryan"
2018,"Brighton","Premier League","Ezequiel Schelotto","ITA","DF","28",1989,14.6,20,13,14,6,0,12,27,44.4,15,7,3,4,19,39,58,2,"https://fbref.com/en/players/a6e316c1/Ezequiel-Schelotto"
2018,"Brighton","Premier League","Dale Stephens","ENG","MF","28",1989,36,104,62,63,39,2,32,114,28.1,82,53,16,37,63,167,69,1,"https://fbref.com/en/players/653ee42d/Dale-Stephens"
2018,"Brighton","Premier League","Markus Suttner","AUT","DF","30",1987,13.1,25,15,18,4,3,10,22,45.5,12,16,2,14,12,37,49,1,"https://fbref.com/en/players/7391c2d9/Markus-Suttner"
2018,"Brighton","Premier League","Leonardo Ulloa","ARG","FW","31",1986,3,3,1,0,1,2,1,7,14.3,6,1,0,1,0,3,3,0,"https://fbref.com/en/players/eed56f6c/Leonardo-Ulloa"
2018,"Burnley","Premier League","Scott Arfield","CAN","MF,FW","28",1988,14.8,36,26,20,13,3,19,44,43.2,25,22,1,21,11,47,24,0,"https://fbref.com/en/players/b1313ec4/Scott-Arfield"
2018,"Burnley","Premier League","Phil Bardsley","SCO","DF","32",1985,12.5,17,16,9,7,1,4,11,36.4,7,22,6,16,22,39,77,0,"https://fbref.com/en/players/1ae30132/Phil-Bardsley"
2018,"Burnley","Premier League","Ashley Barnes","ENG","FW","27",1989,24.1,21,14,1,14,6,5,29,17.2,24,26,5,21,2,23,19,0,"https://fbref.com/en/players/2691c772/Ashley-Barnes"
2018,"Burnley","Premier League","Jóhann Berg Guðmundsson","ISL","MF","26",1990,31.5,43,27,16,19,8,20,47,42.6,27,21,1,20,34,77,43,0,"https://fbref.com/en/players/f72293fc/Johann-Berg-Gudmundsson"
2018,"Burnley","Premier League","Robbie Brady","IRL","MF","25",1992,14.2,32,21,14,17,1,8,28,28.6,20,17,3,14,7,39,29,0,"https://fbref.com/en/players/96bb8cc2/Robbie-Brady"
2018,"Burnley","Premier League","Jack Cork","ENG","MF","28",1989,38,60,44,25,27,8,20,62,32.3,42,36,15,21,41,101,86,1,"https://fbref.com/en/players/74e12f1e/Jack-Cork"
2018,"Burnley","Premier League","Steven Defour","BEL","MF","29",1988,22.2,33,22,12,18,3,10,46,21.7,36,35,7,28,46,79,25,0,"https://fbref.com/en/players/73489527/Steven-Defour"
2018,"Burnley","Premier League","Tom Heaton","ENG","GK","31",1986,3.4,0,0,0,0,0,0,0,NA,0,0,0,0,0,0,0,0,"https://fbref.com/en/players/a6de6361/Tom-Heaton"
2018,"Burnley","Premier League","Jeff Hendrick","IRL","FW,MF","25",1992,25.9,16,10,4,10,2,3,17,17.6,14,11,2,9,8,24,21,1,"https://fbref.com/en/players/989d5705/Jeff-Hendrick"
2018,"Burnley","Premier League","Aaron Lennon","ENG","MF","30",1987,12.4,20,14,5,14,1,2,20,10,18,20,5,15,8,28,18,0,"https://fbref.com/en/players/2ff964a0/Aaron-Lennon"
2018,"Burnley","Premier League","Kevin Long","IRL","DF","26",1990,16,32,23,28,4,0,16,26,61.5,10,25,14,11,19,51,129,1,"https://fbref.com/en/players/5a4280b1/Kevin-Long"
2018,"Burnley","Premier League","Matthew Lowton","ENG","DF","28",1989,25.5,55,34,26,27,2,28,60,46.7,32,35,15,20,39,94,141,2,"https://fbref.com/en/players/9a9c05db/Matthew-Lowton"
2018,"Burnley","Premier League","Ben Mee","ENG","DF","27",1989,29,33,20,22,11,0,16,29,55.2,13,51,42,9,33,66,217,1,"https://fbref.com/en/players/8df7a2fb/Ben-Mee"
2018,"Burnley","Premier League","Georges-Kévin N'Koudou","CMR","MF,FW","22",1995,2.5,7,6,5,1,1,3,8,37.5,5,4,0,4,1,8,1,0,"https://fbref.com/en/players/76c131da/Georges-Kevin-NKoudou"
2018,"Burnley","Premier League","Aiden O'Neill","AUS","MF","19",1998,0,NA,NA,NA,NA,NA,NA,NA,NA,NA,NA,NA,NA,NA,NA,NA,NA,"https://fbref.com/en/players/c7aee75b/Aiden-ONeill"
2018,"Burnley","Premier League","Nick Pope","ENG","GK","25",1992,34.6,0,0,0,0,0,0,1,0,1,0,0,0,0,0,21,0,"https://fbref.com/en/players/4b40d9ca/Nick-Pope"
2018,"Burnley","Premier League","James Tarkowski","ENG","DF","24",1992,31,46,26,36,10,0,17,38,44.7,21,55,43,12,50,96,223,2,"https://fbref.com/en/players/15ea812b/James-Tarkowski"
2018,"Burnley","Premier League","Charlie Taylor","ENG","DF","23",1993,10.6,16,4,9,6,1,7,12,58.3,5,13,5,8,15,31,52,0,"https://fbref.com/en/players/cc2d7ad5/Charlie-Taylor"
2018,"Burnley","Premier League","Sam Vokes","WAL","FW","27",1989,11.1,3,1,1,2,0,0,3,0,3,6,2,4,3,6,15,0,"https://fbref.com/en/players/1d6ac165/Sam-Vokes"
2018,"Burnley","Premier League","Jonathan Walters","IRL","FW","33",1983,0.4,0,0,0,0,0,0,0,NA,0,0,0,0,0,0,1,0,"https://fbref.com/en/players/0356cf4f/Jonathan-Walters"
2018,"Burnley","Premier League","Stephen Ward","IRL","DF","31",1985,27.3,39,31,27,8,4,20,42,47.6,22,27,12,15,42,81,126,0,"https://fbref.com/en/players/3831b9fe/Stephen-Ward"
2018,"Burnley","Premier League","Nahki Wells","BER","FW,MF","27",1990,0.6,4,3,0,3,1,1,1,100,0,2,0,2,0,4,0,0,"https://fbref.com/en/players/b070482d/Nahki-Wells"
2018,"Burnley","Premier League","Ashley Westwood","ENG","MF","27",1990,12.3,13,10,10,3,0,2,16,12.5,14,17,9,8,19,32,16,0,"https://fbref.com/en/players/495945ef/Ashley-Westwood"
2018,"Burnley","Premier League","Chris Wood","NZL","FW","25",1991,18,7,3,2,3,2,3,13,23.1,10,12,4,8,0,7,16,0,"https://fbref.com/en/players/4e9a0555/Chris-Wood"
2018,"Caen","Ligue 1","Youssef Aït Bennasser","MAR","MF","21",1996,22.7,47,28,17,27,3,15,64,23.4,49,35,2,33,32,79,30,0,"https://fbref.com/en/players/c46fa34c/Youssef-Ait-Bennasser"
2018,"Caen","Ligue 1","Yoël Armougom","FRA","DF,MF","19",1998,1.5,2,1,0,1,1,1,1,100,0,1,1,0,1,3,2,1,"https://fbref.com/en/players/9dd5da03/Yoel-Armougom"
2018,"Caen","Ligue 1","Durel Avounou","CGO","DF,MF","19",1997,7.2,16,11,6,9,1,5,17,29.4,12,12,1,11,10,26,25,0,"https://fbref.com/en/players/833a91a1/Durel-Avounou"
2018,"Caen","Ligue 1","Hervé Bazile","HAI","MF,FW","27",1990,9.7,21,15,9,7,5,5,15,33.3,10,22,0,22,15,36,8,0,"https://fbref.com/en/players/7abfcbff/Herve-Bazile"
2018,"Caen","Ligue 1","Vincent Bessat","FRA","DF,MF","31",1985,17.4,41,27,23,16,2,22,48,45.8,26,19,1,18,18,59,18,0,"https://fbref.com/en/players/5e6342d4/Vincent-Bessat"
2018,"Caen","Ligue 1","Enzo Crivelli","FRA","FW","22",1995,8.1,4,2,2,1,1,1,5,20,4,1,0,1,2,6,2,0,"https://fbref.com/en/players/06f33dc8/Enzo-Crivelli"
2018,"Caen","Ligue 1","Damien Da Silva","FRA","DF","29",1988,31.5,52,35,40,12,0,20,33,60.6,13,45,25,20,36,88,184,2,"https://fbref.com/en/players/1ec7e1c5/Damien-Da-Silva"
2018,"Caen","Ligue 1","Jonathan Delaplace","FRA","MF","31",1986,6.5,10,8,1,8,1,3,10,30,7,13,5,8,8,18,8,0,"https://fbref.com/en/players/79685569/Jonathan-Delaplace"
2018,"Caen","Ligue 1","Jessy Deminguet","FRA","MF,FW","19",1998,5.9,12,9,4,6,2,4,14,28.6,10,5,0,5,10,22,13,0,"https://fbref.com/en/players/a6138e4a/Jessy-Deminguet"
2018,"Caen","Ligue 1","Ismaël Diomandé","CIV","DF,MF","24",1992,7.9,14,8,7,6,1,10,15,66.7,5,11,5,6,5,19,20,0,"https://fbref.com/en/players/10650926/Ismael-Diomande"
2018,"Caen","Ligue 1","Alexander Djiku","GHA","DF","22",1994,28,65,43,52,11,2,25,52,48.1,27,34,5,29,57,122,155,2,"https://fbref.com/en/players/43e7a164/Alexander-Djiku"
2018,"Caen","Ligue 1","Julien Féret","FRA","MF","35",1982,34,40,27,10,25,5,14,75,18.7,61,52,7,45,49,89,58,2,"https://fbref.com/en/players/ac62861c/Julien-Feret"
2018,"Caen","Ligue 1","Romain Genevois","HAI","DF","29",1987,20.1,48,28,27,13,8,21,39,53.8,18,25,11,14,31,79,76,0,"https://fbref.com/en/players/1040e783/Romain-Genevois"
2018,"Caen","Ligue 1","Frederic Guilbert","FRA","DF","22",1994,36,136,89,71,58,7,50,105,47.6,55,43,13,30,88,224,136,0,"https://fbref.com/en/players/5d8d7454/Frederic-Guilbert"
2018,"Caen","Ligue 1","Emmanuel Imorou","BEN","DF","28",1988,0.4,0,0,0,0,0,0,0,NA,0,0,0,0,1,1,1,0,"https://fbref.com/en/players/3e87d087/Emmanuel-Imorou"
2018,"Caen","Ligue 1","Christian Kouakou","CIV","MF,FW","26",1991,9.4,24,13,14,8,2,5,19,26.3,14,16,1,15,8,32,6,1,"https://fbref.com/en/players/ce316f8c/Christian-Kouakou"
2018,"Caen","Ligue 1","Adama Mbengue","SEN","DF","23",1993,17.7,71,48,48,18,5,41,65,63.1,24,21,1,20,28,99,50,0,"https://fbref.com/en/players/b931d9d1/Adama-Mbengue"
2018,"Caen","Ligue 1","Jordan Nkololo","COD","MF,FW","24",1992,4.7,9,6,4,5,0,1,4,25,3,7,1,6,1,10,0,0,"https://fbref.com/en/players/bf354e77/Jordan-Nkololo"
2018,"Caen","Ligue 1","Stef Peeters","BEL","MF","25",1992,12.3,22,11,6,14,2,6,31,19.4,25,17,3,14,7,29,11,0,"https://fbref.com/en/players/2f8f43f3/Stef-Peeters"
2018,"Caen","Ligue 1","Jan Repas","SVN","MF,FW","20",1997,10,14,11,5,5,4,4,18,22.2,14,10,0,10,7,21,3,0,"https://fbref.com/en/players/e0d725fe/Jan-Repas"
2018,"Caen","Ligue 1","Ronny Rodelin","FRA","FW,MF","27",1989,35.1,33,22,7,18,8,8,42,19,34,21,2,19,28,61,41,1,"https://fbref.com/en/players/1f8c7aa9/Ronny-Rodelin"
2018,"Caen","Ligue 1","Brice Samba","CGO","GK","23",1994,3.5,0,0,0,0,0,0,0,NA,0,0,0,0,0,0,2,0,"https://fbref.com/en/players/60d90c55/Brice-Samba"
2018,"Caen","Ligue 1","Baissama Sankoh","GUI","MF,DF","25",1992,17.1,27,19,8,18,1,8,28,28.6,20,20,8,12,25,52,64,1,"https://fbref.com/en/players/a8b4a643/Baissama-Sankoh"
2018,"Caen","Ligue 1","Ivan Santini","CRO","FW","28",1989,30.9,19,12,5,8,6,4,29,13.8,25,13,5,8,4,23,33,0,"https://fbref.com/en/players/086d7db3/Ivan-Santini"
2018,"Caen","Ligue 1","Timo Stavitski","FIN","MF,FW","18",1999,4.5,4,3,1,1,2,1,16,6.3,15,7,0,7,3,7,1,0,"https://fbref.com/en/players/6fb7edd3/Timo-Stavitski"
2018,"Caen","Ligue 1","Rémy Vercoutre","FRA","GK","37",1980,34.5,2,2,2,0,0,2,2,100,0,0,0,0,2,4,14,2,"https://fbref.com/en/players/1d0900d4/Remy-Vercoutre"
2018,"Cagliari","Serie A","Marco Andreolli","ITA","DF","31",1986,20.3,25,17,20,4,1,12,20,60,8,24,17,7,30,55,139,0,"https://fbref.com/en/players/13d820de/Marco-Andreolli"
2018,"Cagliari","Serie A","Nicolò Barella","ITA","MF","20",1997,32.8,92,69,37,43,12,25,78,32.1,53,48,6,42,45,137,53,0,"https://fbref.com/en/players/6928979a/Nicolo-Barella"
2018,"Cagliari","Serie A","Fabrizio Caligara","ITA","MF","17",2000,0.2,0,0,0,0,0,0,0,NA,0,1,1,0,1,1,1,0,"https://fbref.com/en/players/22ca11f1/Fabrizio-Caligara"
2018,"Cagliari","Serie A","Marco Capuano","ITA","DF","25",1991,7.7,13,9,6,7,0,4,8,50,4,7,2,5,6,19,23,1,"https://fbref.com/en/players/616aea37/Marco-Capuano"
2018,"Cagliari","Serie A","Leandro Castán","BRA","DF","30",1986,12.7,24,15,16,8,0,15,20,75,5,16,10,6,23,47,48,1,"https://fbref.com/en/players/019f4d0d/Leandro-Castan"
2018,"Cagliari","Serie A","Luca Ceppitelli","ITA","DF","27",1989,24.7,45,33,31,12,2,16,34,47.1,18,33,21,12,50,95,156,0,"https://fbref.com/en/players/7d50454d/Luca-Ceppitelli"
2018,"Cagliari","Serie A","Damir Ceter","COL","FW","19",1997,2.2,2,1,0,2,0,0,0,NA,0,3,0,3,0,2,1,0,"https://fbref.com/en/players/eade5337/Damir-Ceter"
2018,"Cagliari","Serie A","Luca Cigarini","ITA","MF","31",1986,22.5,42,30,16,25,1,18,64,28.1,46,32,5,27,42,84,27,1,"https://fbref.com/en/players/ae64d449/Luca-Cigarini"
2018,"Cagliari","Serie A","Duje Čop","CRO","FW,MF","27",1990,1.1,1,1,0,0,1,0,1,0,1,1,0,1,0,1,0,0,"https://fbref.com/en/players/8b0b02c9/Duje-Cop"
2018,"Cagliari","Serie A","Andrea Cossu","ITA","MF,FW","37",1980,2.7,1,0,0,0,1,0,2,0,2,2,0,2,3,4,2,0,"https://fbref.com/en/players/70fd593e/Andrea-Cossu"
2018,"Cagliari","Serie A","Alessio Cragno","ITA","GK","23",1994,28.2,0,0,0,0,0,0,0,NA,0,1,0,1,0,0,12,0,"https://fbref.com/en/players/f554e29b/Alessio-Cragno"
2018,"Cagliari","Serie A","Luca Crosta","ITA","GK","19",1998,1,0,0,0,0,0,0,0,NA,0,0,0,0,0,0,1,0,"https://fbref.com/en/players/a4ec7d09/Luca-Crosta"
2018,"Cagliari","Serie A","Alessandro Deiola","ITA","MF","21",1995,5,9,7,5,3,1,6,13,46.2,7,8,0,8,4,13,12,0,"https://fbref.com/en/players/7f267d66/Alessandro-Deiola"
2018,"Cagliari","Serie A","Gregory van der Wiel","NED","DF","29",1988,3.2,5,3,4,1,0,3,5,60,2,1,0,1,10,15,12,0,"https://fbref.com/en/players/2fb3ad46/Gregory-van-der-Wiel"
2018,"Cagliari","Serie A","Daniele Dessena","ITA","MF,DF","30",1987,6.4,18,10,12,5,1,6,12,50,6,7,1,6,6,24,17,0,"https://fbref.com/en/players/02b2937c/Daniele-Dessena"
2018,"Cagliari","Serie A","Paolo Faragò","ITA","DF","24",1993,27.3,92,67,53,24,15,24,60,40,36,41,5,36,23,115,76,0,"https://fbref.com/en/players/9085dd7c/Paolo-Farago"
2018,"Cagliari","Serie A","Diego Farias","BRA","FW,MF","27",1990,17.9,21,15,3,9,9,6,24,25,18,17,0,17,8,29,6,0,"https://fbref.com/en/players/157d29b6/Diego-Farias"
2018,"Cagliari","Serie A","Niccolò Giannetti","ITA","FW,DF","26",1991,3.3,5,4,2,3,0,2,6,33.3,4,1,0,1,1,6,3,0,"https://fbref.com/en/players/d9e750e5/Niccolo-Giannetti"
2018,"Cagliari","Serie A","Artur Ioniță","MDA","MF","26",1990,29.7,63,45,30,24,9,17,38,44.7,21,39,7,32,28,91,29,0,"https://fbref.com/en/players/cedb3e36/Artur-Ionita"
2018,"Cagliari","Serie A","Han Kwang-song","PRK","FW","18",1998,3.1,1,1,0,0,1,0,4,0,4,4,0,4,0,1,0,0,"https://fbref.com/en/players/87243064/Han-Kwang-song"
2018,"Cagliari","Serie A","Charalambos Lykogiannis","GRE","DF","23",1993,7.6,16,12,9,5,2,11,18,61.1,7,12,3,9,15,31,28,0,"https://fbref.com/en/players/5efc5389/Charalambos-Lykogiannis"
2018,"Cagliari","Serie A","Senna Miangue","BEL","DF,FW","20",1997,8.9,7,5,4,2,1,3,7,42.9,4,8,1,7,7,14,35,0,"https://fbref.com/en/players/42591ed0/Senna-Miangue"
2018,"Cagliari","Serie A","Simone Padoin","ITA","DF,MF","33",1984,34.5,22,18,8,10,4,12,28,42.9,16,38,14,24,24,46,74,0,"https://fbref.com/en/players/5eb72339/Simone-Padoin"
2018,"Cagliari","Serie A","Leonardo Pavoletti","ITA","FW","28",1988,30.2,27,13,5,14,8,2,21,9.5,19,13,5,8,13,40,28,0,"https://fbref.com/en/players/d37b0350/Leonardo-Pavoletti"
2018,"Cagliari","Serie A","João Pedro","ITA","MF,FW","25",1992,18.4,15,9,4,9,2,0,12,0,12,9,1,8,11,26,24,0,"https://fbref.com/en/players/81255c03/Joao-Pedro"
2018,"Cagliari","Serie A","Fabio Pisacane","ITA","DF","31",1986,21.4,52,39,36,13,3,15,41,36.6,26,29,16,13,38,90,105,1,"https://fbref.com/en/players/56400c01/Fabio-Pisacane"
2018,"Cagliari","Serie A","Rafael","BRA","GK","35",1982,8.8,0,0,0,0,0,0,0,NA,0,0,0,0,1,1,9,0,"https://fbref.com/en/players/dd06d56c/Rafael"
2018,"Cagliari","Serie A","Filippo Romagna","ITA","DF","20",1997,21,33,18,20,12,1,16,26,61.5,10,20,11,9,33,66,96,0,"https://fbref.com/en/players/84594618/Filippo-Romagna"
2018,"Cagliari","Serie A","Marco Sau","ITA","FW,MF","29",1987,14.6,9,6,2,4,3,1,17,5.9,16,10,0,10,9,18,1,0,"https://fbref.com/en/players/1ad1f50d/Marco-Sau"
2018,"Celta Vigo","La Liga","Sergio Álvarez","ESP","GK","30",1986,16.4,0,0,0,0,0,0,1,0,1,1,0,1,0,0,11,1,"https://fbref.com/en/players/8875b8c9/Sergio-Alvarez"
2018,"Celta Vigo","La Liga","Iago Aspas","ESP","FW","29",1987,32.6,26,22,10,10,6,5,34,14.7,29,15,1,14,23,49,11,1,"https://fbref.com/en/players/7dcf86f6/Iago-Aspas"
2018,"Celta Vigo","La Liga","Rubén Blanco","ESP","GK","22",1995,21.6,0,0,0,0,0,0,2,0,2,1,0,1,3,3,16,1,"https://fbref.com/en/players/967f34d3/Ruben-Blanco"
2018,"Celta Vigo","La Liga","Lucas Boyé","ARG","FW,MF","21",1996,3.1,12,8,3,7,2,3,10,30,7,5,0,5,6,18,4,0,"https://fbref.com/en/players/d49f3e6b/Lucas-Boye"
2018,"Celta Vigo","La Liga","Gustavo Cabral","ARG","DF","31",1985,21,29,21,14,15,0,14,38,36.8,24,22,11,11,43,72,106,2,"https://fbref.com/en/players/92b4a127/Gustavo-Cabral"
2018,"Celta Vigo","La Liga","Jonny Castro","ESP","DF","23",1994,35.6,102,78,60,31,11,43,91,47.3,48,48,8,40,93,195,92,1,"https://fbref.com/en/players/e28868f3/Jonny-Castro"
2018,"Celta Vigo","La Liga","Andreu Fontàs","ESP","DF","27",1989,9.8,13,9,8,5,0,3,13,23.1,10,9,5,4,14,27,30,0,"https://fbref.com/en/players/0f138d5a/Andreu-Fontas"
2018,"Celta Vigo","La Liga","Maxi Gómez","URU","FW","20",1996,34.1,7,4,1,4,2,0,18,0,18,9,4,5,3,10,34,0,"https://fbref.com/en/players/4c2e9442/Maxi-Gomez"
2018,"Celta Vigo","La Liga","Sergi Gómez","ESP","DF","25",1992,29.8,52,37,38,13,1,20,34,58.8,14,32,22,10,56,108,118,1,"https://fbref.com/en/players/bc6f5f06/Sergi-Gomez"
2018,"Celta Vigo","La Liga","John Guidetti","SWE","FW,MF","25",1992,1.3,0,0,0,0,0,0,0,NA,0,0,0,0,0,0,0,0,"https://fbref.com/en/players/99bebd12/John-Guidetti"
2018,"Celta Vigo","La Liga","Pablo Hernández","CHI","MF","30",1986,20.2,48,33,17,27,4,14,46,30.4,32,29,11,18,40,88,72,0,"https://fbref.com/en/players/6c2f5996/Pablo-Hernandez"
2018,"Celta Vigo","La Liga","Andrew Hjulsager","DEN","DF,MF","22",1995,0.2,0,0,0,0,0,0,2,0,2,1,0,1,0,0,0,0,"https://fbref.com/en/players/2ef16f06/Andrew-Hjulsager"
2018,"Celta Vigo","La Liga","Jozabed","ESP","MF","26",1991,16.4,18,12,7,9,2,3,18,16.7,15,18,2,16,16,34,19,0,"https://fbref.com/en/players/9b337c7c/Jozabed"
2018,"Celta Vigo","La Liga","Stanislav Lobotka","SVK","MF","22",1994,34,64,45,24,35,5,23,65,35.4,42,25,9,16,39,103,22,0,"https://fbref.com/en/players/e1cbb531/Stanislav-Lobotka"
2018,"Celta Vigo","La Liga","Hugo Mallo","ESP","DF","26",1991,33.3,84,55,55,26,3,35,53,66,18,30,15,15,68,152,111,1,"https://fbref.com/en/players/cb574619/Hugo-Mallo"
2018,"Celta Vigo","La Liga","Róbert Mazáň","SVK","DF","23",1994,0.9,0,0,0,0,0,0,1,0,1,1,0,1,2,2,0,0,"https://fbref.com/en/players/30672832/Robert-Mazan"
2018,"Celta Vigo","La Liga","Brais Méndez","ESP","MF,FW","20",1997,10.5,19,15,9,6,4,7,17,41.2,10,13,0,13,4,23,12,0,"https://fbref.com/en/players/c9e39d91/Brais-Mendez"
2018,"Celta Vigo","La Liga","Daniel Molina Orta","ESP","MF","21",1996,0.1,0,0,0,0,0,0,0,NA,0,0,0,0,0,0,0,0,"https://fbref.com/en/players/102fda08/Daniel-Molina-Orta"
2018,"Celta Vigo","La Liga","Emre Mor","TUR","FW,MF","20",1997,7.4,14,7,6,7,1,6,11,54.5,5,7,1,6,4,18,7,0,"https://fbref.com/en/players/0c3f7197/Emre-Mor"
2018,"Celta Vigo","La Liga","Nemanja Radoja","SRB","MF","24",1993,12.3,18,16,6,8,4,3,8,37.5,5,8,2,6,10,28,11,0,"https://fbref.com/en/players/b5dd3469/Nemanja-Radoja"
2018,"Celta Vigo","La Liga","Facundo Roncaglia","ARG","DF","30",1987,16.6,35,25,30,5,0,22,36,61.1,14,18,6,12,31,66,50,1,"https://fbref.com/en/players/51e3954c/Facundo-Roncaglia"
2018,"Celta Vigo","La Liga","Pione Sisto","DEN","FW,MF","22",1995,28,18,12,8,6,4,9,33,27.3,24,12,1,11,12,30,7,1,"https://fbref.com/en/players/fd9c4805/Pione-Sisto"
2018,"Celta Vigo","La Liga","Daniel Wass","DEN","MF,DF","28",1989,32.6,30,21,8,18,4,8,25,32,17,23,3,20,30,60,47,0,"https://fbref.com/en/players/d83bbc54/Daniel-Wass"
2018,"Chelsea","Premier League","Marcos Alonso","ESP","DF,MF","26",1990,31.7,51,33,30,18,3,23,44,52.3,21,36,5,31,47,98,76,1,"https://fbref.com/en/players/f4290206/Marcos-Alonso"
2018,"Chelsea","Premier League","Ethan Ampadu","WAL","DF","16",2000,0.1,1,1,0,1,0,0,0,NA,0,0,0,0,0,1,2,0,"https://fbref.com/en/players/10b9fa99/Ethan-Ampadu"
2018,"Chelsea","Premier League","César Azpilicueta","ESP","DF","27",1989,37,80,59,47,26,7,27,54,50,27,48,22,26,54,134,135,1,"https://fbref.com/en/players/53cad200/Cesar-Azpilicueta"
2018,"Chelsea","Premier League","Tiemoué Bakayoko","FRA","MF","22",1994,23.6,64,41,25,32,7,16,48,33.3,32,23,6,17,37,101,38,4,"https://fbref.com/en/players/59bf127b/Tiemoue-Bakayoko"
2018,"Chelsea","Premier League","Ross Barkley","ENG","MF","23",1993,1.4,0,0,0,0,0,0,1,0,1,3,1,2,0,0,2,0,"https://fbref.com/en/players/3a24769f/Ross-Barkley"
2018,"Chelsea","Premier League","Michy Batshuayi","BEL","FW","23",1993,4,5,4,2,3,0,1,3,33.3,2,0,0,0,1,6,3,0,"https://fbref.com/en/players/2973d8ff/Michy-Batshuayi"
2018,"Chelsea","Premier League","Jeremie Boga","CIV","MF","20",1997,0.2,0,0,0,0,0,0,0,NA,0,0,0,0,0,0,0,0,"https://fbref.com/en/players/fe012aca/Jeremie-Boga"
2018,"Chelsea","Premier League","Willy Caballero","ARG","GK","35",1981,3,0,0,0,0,0,0,0,NA,0,0,0,0,0,0,3,0,"https://fbref.com/en/players/a179d516/Willy-Caballero"
2018,"Chelsea","Premier League","Gary Cahill","ENG","DF","31",1985,23.2,29,21,15,9,5,10,21,47.6,11,21,14,7,27,56,127,1,"https://fbref.com/en/players/7914b9fe/Gary-Cahill"
2018,"Chelsea","Premier League","Andreas Christensen","DEN","DF","21",1996,23.2,26,13,23,3,0,10,15,66.7,5,25,17,8,39,65,109,5,"https://fbref.com/en/players/1cb49278/Andreas-Christensen"
2018,"Chelsea","Premier League","Thibaut Courtois","BEL","GK","25",1992,35,0,0,0,0,0,0,0,NA,0,0,0,0,0,0,8,1,"https://fbref.com/en/players/1840e36d/Thibaut-Courtois"
2018,"Chelsea","Premier League","Danny Drinkwater","ENG","MF","27",1990,5.9,15,10,6,8,1,3,17,17.6,14,10,2,8,8,23,7,0,"https://fbref.com/en/players/2649ff32/Danny-Drinkwater"
2018,"Chelsea","Premier League","Cesc Fàbregas","ESP","MF","30",1987,25.6,68,49,30,29,9,18,69,26.1,51,25,4,21,22,90,26,2,"https://fbref.com/en/players/33508c78/Cesc-Fabregas"
2018,"Chelsea","Premier League","Olivier Giroud","FRA","FW","30",1986,6.8,4,3,1,2,1,1,3,33.3,2,0,0,0,1,5,5,0,"https://fbref.com/en/players/16ceb862/Olivier-Giroud"
2018,"Chelsea","Premier League","Eden Hazard","BEL","FW,MF","26",1991,26.9,6,3,2,3,1,3,21,14.3,18,11,0,11,3,9,0,0,"https://fbref.com/en/players/a39bb753/Eden-Hazard"
2018,"Chelsea","Premier League","Callum Hudson-Odoi","ENG","FW,DF","16",2000,0.3,0,0,0,0,0,0,0,NA,0,0,0,0,0,0,0,0,"https://fbref.com/en/players/15f3ec41/Callum-Hudson-Odoi"
2018,"Chelsea","Premier League","N'Golo Kanté","FRA","MF","26",1991,33.3,113,77,55,52,6,33,92,35.9,59,40,4,36,85,198,29,3,"https://fbref.com/en/players/b9fbae28/NGolo-Kante"
2018,"Chelsea","Premier League","David Luiz","BRA","DF,MF","30",1987,9.3,18,11,13,4,1,11,21,52.4,10,9,5,4,24,42,45,2,"https://fbref.com/en/players/c0e27d1a/David-Luiz"
2018,"Chelsea","Premier League","Álvaro Morata","ESP","FW","24",1992,22.9,13,8,0,7,6,1,21,4.8,20,17,4,13,6,19,20,0,"https://fbref.com/en/players/129af0db/Alvaro-Morata"
2018,"Chelsea","Premier League","Victor Moses","NGA","DF,MF","26",1990,23.4,37,29,21,13,3,14,24,58.3,10,29,4,25,15,52,39,2,"https://fbref.com/en/players/e726e11e/Victor-Moses"
2018,"Chelsea","Premier League","Charly Musonda Jr.","BEL","FW","20",1996,0.4,1,0,0,0,1,1,1,100,0,0,0,0,0,1,0,0,"https://fbref.com/en/players/62a0089e/Charly-Musonda-Jr"
2018,"Chelsea","Premier League","Emerson Palmieri","ITA","DF","22",1994,3.1,6,4,4,2,0,5,5,100,0,2,0,2,2,8,10,0,"https://fbref.com/en/players/e0bc6fdc/Emerson-Palmieri"
2018,"Chelsea","Premier League","Pedro","ESP","MF,FW","30",1987,16.9,20,11,6,8,6,5,18,27.8,13,13,1,12,13,33,7,1,"https://fbref.com/en/players/3ca7254a/Pedro"
2018,"Chelsea","Premier League","Antonio Rüdiger","GER","DF","24",1993,26,31,21,20,10,1,15,31,48.4,16,29,15,14,24,55,115,1,"https://fbref.com/en/players/18b896d6/Antonio-Rudiger"
2018,"Chelsea","Premier League","Willian","BRA","MF,FW","28",1988,21,22,17,7,12,3,0,16,0,16,13,1,12,10,32,10,0,"https://fbref.com/en/players/8b9ebd03/Willian"
2018,"Chelsea","Premier League","Davide Zappacosta","ITA","DF,MF","25",1992,12.2,26,11,14,9,3,11,25,44,14,11,2,9,6,32,26,0,"https://fbref.com/en/players/7fe90ccd/Davide-Zappacosta"
2018,"Chievo","Serie A","Mattia Bani","ITA","DF","23",1993,14.6,28,20,22,6,0,11,26,42.3,15,19,10,9,27,55,111,0,"https://fbref.com/en/players/0821331c/Mattia-Bani"
2018,"Chievo","Serie A","Samuel Bastien","COD","MF","20",1996,15.1,17,13,7,8,2,7,23,30.4,16,23,2,21,18,35,25,0,"https://fbref.com/en/players/ec30b9c8/Samuel-Bastien"
2018,"Chievo","Serie A","Valter Birsa","SVN","MF,FW","30",1986,27.8,28,14,7,18,3,7,54,13,47,22,2,20,24,52,20,1,"https://fbref.com/en/players/455a2b79/Valter-Birsa"
2018,"Chievo","Serie A","Fabrizio Cacciatore","ITA","DF","30",1986,31.9,34,27,20,9,5,15,30,50,15,33,11,22,38,72,99,3,"https://fbref.com/en/players/00b0bb87/Fabrizio-Cacciatore"
2018,"Chievo","Serie A","Lucas Castro","ARG","MF","28",1989,22.1,54,40,14,29,11,16,43,37.2,27,39,7,32,38,92,35,0,"https://fbref.com/en/players/56b2957b/Lucas-Castro"
2018,"Chievo","Serie A","Boštjan Cesar","SVN","DF","35",1982,6.1,4,3,3,1,0,3,4,75,1,6,4,2,3,7,40,0,"https://fbref.com/en/players/c1d18f10/Bostjan-Cesar"
2018,"Chievo","Serie A","Dario Dainelli","ITA","DF","38",1979,16.7,19,14,14,4,1,10,21,47.6,11,27,22,5,46,65,126,0,"https://fbref.com/en/players/3858e611/Dario-Dainelli"
2018,"Chievo","Serie A","Fabio Depaoli","ITA","DF,MF","20",1997,13.2,31,22,21,7,3,21,40,52.5,19,27,10,17,15,46,42,0,"https://fbref.com/en/players/d97f2e8d/Fabio-Depaoli"
2018,"Chievo","Serie A","Alessandro Gamberini","ITA","DF","35",1981,20.2,13,8,11,2,0,8,12,66.7,4,32,25,7,16,29,117,1,"https://fbref.com/en/players/8ec95452/Alessandro-Gamberini"
2018,"Chievo","Serie A","Luca Garritano","ITA","MF,FW","23",1994,2.1,4,3,2,1,1,0,4,0,4,3,1,2,1,5,6,0,"https://fbref.com/en/players/1ceeae3e/Luca-Garritano"
2018,"Chievo","Serie A","Gianluca Gaudino","GER","MF","20",1996,0.2,0,0,0,0,0,0,0,NA,0,1,0,1,0,0,1,0,"https://fbref.com/en/players/0d72fbca/Gianluca-Gaudino"
2018,"Chievo","Serie A","Emanuele Giaccherini","ITA","MF,FW","32",1985,10,7,4,4,2,1,5,25,20,20,9,3,6,5,12,6,0,"https://fbref.com/en/players/1c50f354/Emanuele-Giaccherini"
2018,"Chievo","Serie A","Massimo Gobbi","ITA","DF","36",1980,22.8,24,18,13,9,2,11,26,42.3,15,20,5,15,22,46,90,1,"https://fbref.com/en/players/635b0bae/Massimo-Gobbi"
2018,"Chievo","Serie A","Përparim Hetemaj","FIN","MF","30",1986,26.8,74,48,34,25,15,29,78,37.2,49,39,6,33,39,113,47,1,"https://fbref.com/en/players/90b70194/Perparim-Hetemaj"
2018,"Chievo","Serie A","Roberto Inglese","ITA","FW","25",1991,30.9,31,21,13,9,9,7,30,23.3,23,21,2,19,8,39,17,1,"https://fbref.com/en/players/6c1f7328/Roberto-Inglese"
2018,"Chievo","Serie A","Paweł Jaroszyński","POL","DF","22",1994,9,20,12,14,5,1,9,18,50,9,11,4,7,21,41,40,1,"https://fbref.com/en/players/958a601f/Pawel-Jaroszynski"
2018,"Chievo","Serie A","Mehdi Léris","ALG","MF,FW","19",1998,0.5,1,1,1,0,0,0,1,0,1,0,0,0,1,2,0,0,"https://fbref.com/en/players/7d3cbc67/Mehdi-Leris"
2018,"Chievo","Serie A","Riccardo Meggiorini","ITA","FW","31",1985,8.7,9,6,3,6,0,1,6,16.7,5,12,3,9,2,11,9,0,"https://fbref.com/en/players/2ec0f902/Riccardo-Meggiorini"
2018,"Chievo","Serie A","Sergio Pellissier","ITA","FW","38",1979,6.2,6,2,1,3,2,1,3,33.3,2,3,0,3,1,7,2,0,"https://fbref.com/en/players/878ee034/Sergio-Pellissier"
2018,"Chievo","Serie A","Manuel Pucciarelli","ITA","FW,MF","26",1991,15.3,23,14,3,11,9,8,21,38.1,13,15,0,15,7,30,4,0,"https://fbref.com/en/players/a1c7b425/Manuel-Pucciarelli"
2018,"Chievo","Serie A","Ivan Radovanović","SRB","MF","28",1988,34.9,55,35,30,22,3,18,48,37.5,30,39,16,23,47,102,107,1,"https://fbref.com/en/players/023937a9/Ivan-Radovanovic"
2018,"Chievo","Serie A","Nicola Rigoni","ITA","MF","26",1990,10.4,29,20,15,12,2,9,26,34.6,17,8,3,5,11,40,22,1,"https://fbref.com/en/players/e327bd76/Nicola-Rigoni"
2018,"Chievo","Serie A","Stefano Sorrentino","ITA","GK","38",1979,38,0,0,0,0,0,0,0,NA,0,0,0,0,0,0,23,3,"https://fbref.com/en/players/048877f5/Stefano-Sorrentino"
2018,"Chievo","Serie A","Mariusz Stępiński","POL","FW","22",1995,7.9,9,5,4,4,1,2,10,20,8,5,1,4,4,13,5,0,"https://fbref.com/en/players/7b536033/Mariusz-Stepinski"
2018,"Chievo","Serie A","Nenad Tomović","SRB","DF","29",1987,25.6,23,17,17,6,0,10,17,58.8,7,29,21,8,50,73,146,0,"https://fbref.com/en/players/6aafdc27/Nenad-Tomovic"
2018,"Crotone","Serie A","Arlind Ajeti","ALB","DF","23",1993,14.1,42,23,25,14,3,18,30,60,12,27,15,12,34,76,82,0,"https://fbref.com/en/players/f9714604/Arlind-Ajeti"
2018,"Crotone","Serie A","Andrea Barberis","ITA","MF","23",1993,33.7,80,44,33,42,5,16,68,23.5,52,52,5,47,58,138,67,1,"https://fbref.com/en/players/32ebfe1e/Andrea-Barberis"
2018,"Crotone","Serie A","Ahmad Benali","LBY","MF","25",1992,9,19,10,8,10,1,5,27,18.5,22,14,1,13,8,27,15,0,"https://fbref.com/en/players/a128b07e/Ahmad-Benali"
2018,"Crotone","Serie A","Ante Budimir","CRO","FW","26",1991,17.6,28,20,4,16,8,2,20,10,18,20,3,17,7,35,27,0,"https://fbref.com/en/players/8f3565b3/Ante-Budimir"
2018,"Crotone","Serie A","Leandro Cabrera","URU","DF","26",1991,4.1,8,5,8,0,0,0,3,0,3,5,2,3,6,14,33,0,"https://fbref.com/en/players/69cbc8b6/Leandro-Cabrera"
2018,"Crotone","Serie A","Marco Capuano","ITA","DF","25",1991,15.6,20,10,14,6,0,5,15,33.3,10,19,13,6,28,48,93,0,"https://fbref.com/en/players/616aea37/Marco-Capuano"
2018,"Crotone","Serie A","Federico Ceccherini","ITA","DF","25",1992,35.9,35,21,28,4,3,13,25,52,12,39,21,18,83,118,276,1,"https://fbref.com/en/players/d9624b51/Federico-Ceccherini"
2018,"Crotone","Serie A","Alex Cordaz","ITA","GK","34",1983,38,0,0,0,0,0,0,0,NA,0,0,0,0,2,2,16,4,"https://fbref.com/en/players/e66ebabb/Alex-Cordaz"
2018,"Crotone","Serie A","Giovanni Crociata","ITA","MF,FW","19",1997,3.2,9,6,3,4,2,1,4,25,3,7,0,7,4,13,3,0,"https://fbref.com/en/players/8c964914/Giovanni-Crociata"
2018,"Crotone","Serie A","Moussa Diaby","FRA","MF","18",1999,0.8,1,0,1,0,0,1,4,25,3,1,0,1,1,2,0,0,"https://fbref.com/en/players/aeed5c06/Moussa-Diaby"
2018,"Crotone","Serie A","Noë Dussenne","BEL","FW","25",1992,0.9,2,0,2,0,0,0,0,NA,0,0,0,0,1,3,8,0,"https://fbref.com/en/players/8b9b8e43/Noe-Dussenne"
2018,"Crotone","Serie A","Davide Faraoni","ITA","DF,MF","25",1991,19.5,62,39,36,20,6,28,47,59.6,19,30,8,22,58,120,76,0,"https://fbref.com/en/players/aae9d04a/Davide-Faraoni"
2018,"Crotone","Serie A","Mariano Julio Izco","ARG","MF","34",1983,2,6,4,2,4,0,2,4,50,2,2,0,2,4,10,1,0,"https://fbref.com/en/players/0d2bdb4b/Mariano-Julio-Izco"
2018,"Crotone","Serie A","Oliver Kragl","GER","MF","27",1990,1.1,1,0,0,1,0,0,0,NA,0,1,0,1,2,3,2,0,"https://fbref.com/en/players/1c17dfe0/Oliver-Kragl"
2018,"Crotone","Serie A","Rolando Mandragora","ITA","MF","20",1997,36,91,60,48,34,9,26,69,37.7,43,41,13,28,86,177,75,0,"https://fbref.com/en/players/c7259b83/Rolando-Mandragora"
2018,"Crotone","Serie A","Bruno Martella","ITA","DF","24",1992,29.1,30,21,19,7,4,12,30,40,18,22,9,13,48,78,151,1,"https://fbref.com/en/players/1e12c53b/Bruno-Martella"
2018,"Crotone","Serie A","Andrea Nalini","ITA","FW,MF","27",1990,18.2,43,32,22,16,5,16,25,64,9,25,2,23,15,58,19,1,"https://fbref.com/en/players/65c75ea8/Andrea-Nalini"
2018,"Crotone","Serie A","Simeon Nwankwo","NGA","FW","25",1992,13.5,12,9,1,5,6,1,12,8.3,11,16,3,13,1,13,20,0,"https://fbref.com/en/players/80dbbd10/Simeon-Nwankwo"
2018,"Crotone","Serie A","Daniel Pavlović","BIH","DF","29",1988,8.4,10,5,9,0,1,5,10,50,5,4,3,1,5,15,22,0,"https://fbref.com/en/players/47146acb/Daniel-Pavlovic"
2018,"Crotone","Serie A","Federico Ricci","ITA","FW","23",1994,10.2,25,18,9,10,6,9,28,32.1,19,14,0,14,11,36,5,0,"https://fbref.com/en/players/524eb8c5/Federico-Ricci"
2018,"Crotone","Serie A","Marcus Rohdén","SWE","MF","26",1991,18.1,33,19,21,10,2,14,50,28,36,14,1,13,18,51,30,0,"https://fbref.com/en/players/b5b27493/Marcus-Rohden"
2018,"Crotone","Serie A","Aristóteles Romero","VEN","MF,FW","21",1995,1,11,7,7,4,0,3,5,60,2,3,0,3,5,16,0,0,"https://fbref.com/en/players/9f069180/Aristoteles-Romero"
2018,"Crotone","Serie A","Mario Sampirisi","ITA","DF","24",1992,24.4,44,32,29,12,3,13,22,59.1,9,27,14,13,43,87,116,2,"https://fbref.com/en/players/cda2ec29/Mario-Sampirisi"
2018,"Crotone","Serie A","Stefan Simić","CZE","DF","22",1995,6.2,13,8,11,2,0,10,11,90.9,1,6,3,3,10,23,44,0,"https://fbref.com/en/players/b5365398/Stefan-Simic"
2018,"Crotone","Serie A","Adrian Stoian","ROU","MF,FW","26",1991,23.7,23,19,12,10,1,11,44,25,33,29,0,29,25,48,26,0,"https://fbref.com/en/players/4468b31a/Adrian-Stoian"
2018,"Crotone","Serie A","Aleksandar Tonev","BUL","FW,MF","27",1990,4.5,5,3,1,2,2,0,1,0,1,4,1,3,1,6,6,0,"https://fbref.com/en/players/c15d1af9/Aleksandar-Tonev"
2018,"Crotone","Serie A","Marcello Trotta","ITA","FW","24",1992,25.1,39,21,12,18,9,10,55,18.2,45,22,2,20,14,53,20,0,"https://fbref.com/en/players/acdad0aa/Marcello-Trotta"
2018,"Crotone","Serie A","Marco Tumminello","ITA","FW","18",1998,2.3,2,2,0,1,1,0,2,0,2,2,0,2,0,2,0,0,"https://fbref.com/en/players/5bdd44d8/Marco-Tumminello"
2018,"Crotone","Serie A","Niccolò Zanellato","ITA","MF","19",1998,0.8,3,2,0,3,0,1,2,50,1,3,0,3,0,3,0,0,"https://fbref.com/en/players/741e058f/Niccolo-Zanellato"
2018,"Crystal Palace","Premier League","Patrick van Aanholt","NED","DF","26",1990,24.3,47,32,29,15,3,16,34,47.1,18,24,5,19,47,94,64,2,"https://fbref.com/en/players/5f09991f/Patrick-van-Aanholt"
2018,"Crystal Palace","Premier League","Christian Benteke","BEL","FW","26",1990,24.9,11,4,3,7,1,2,17,11.8,15,15,3,12,3,14,44,0,"https://fbref.com/en/players/ab070c55/Christian-Benteke"
2018,"Crystal Palace","Premier League","Yohan Cabaye","FRA","MF","31",1986,26.4,70,44,39,28,3,24,97,24.7,73,47,4,43,79,149,29,4,"https://fbref.com/en/players/ad7b19ef/Yohan-Cabaye"
2018,"Crystal Palace","Premier League","Lee Chung-yong","KOR","FW,MF","29",1988,1.5,2,0,0,1,1,0,0,NA,0,3,0,3,2,4,0,1,"https://fbref.com/en/players/49b05a83/Lee-Chung-yong"
2018,"Crystal Palace","Premier League","Scott Dann","ENG","DF","30",1987,15.9,10,5,8,2,0,7,17,41.2,10,17,14,3,23,33,98,1,"https://fbref.com/en/players/52105203/Scott-Dann"
2018,"Crystal Palace","Premier League","Damien Delaney","IRL","DF","36",1981,1.1,2,1,2,0,0,1,1,100,0,5,4,1,3,5,7,0,"https://fbref.com/en/players/210d9ecb/Damien-Delaney"
2018,"Crystal Palace","Premier League","Timothy Fosu-Mensah","NED","DF","19",1998,17.7,42,33,33,8,1,21,34,61.8,13,17,9,8,31,73,74,1,"https://fbref.com/en/players/a9142dc3/Timothy-Fosu-Mensah"
2018,"Crystal Palace","Premier League","Wayne Hennessey","WAL","GK","30",1987,27,0,0,0,0,0,0,0,NA,0,1,0,1,2,2,5,1,"https://fbref.com/en/players/76eca7e2/Wayne-Hennessey"
2018,"Crystal Palace","Premier League","Sullay Kaikai","SLE","MF","21",1995,0.2,1,0,0,1,0,0,0,NA,0,1,0,1,0,1,1,0,"https://fbref.com/en/players/fc166e49/Sullay-Kaikai"
2018,"Crystal Palace","Premier League","Martin Kelly","ENG","DF","27",1990,13.3,19,13,15,4,0,14,26,53.8,12,16,11,5,9,28,67,3,"https://fbref.com/en/players/d7492450/Martin-Kelly"
2018,"Crystal Palace","Premier League","Freddie Ladapo","ENG","FW","24",1993,0.2,0,0,0,0,0,0,0,NA,0,0,0,0,0,0,0,0,"https://fbref.com/en/players/da2b8db3/Freddie-Ladapo"
2018,"Crystal Palace","Premier League","Ruben Loftus-Cheek","ENG","MF","21",1996,20.8,21,15,7,13,1,7,30,23.3,23,19,2,17,22,43,31,0,"https://fbref.com/en/players/e97fd090/Ruben-Loftus-Cheek"
2018,"Crystal Palace","Premier League","Levi Lumeka","ENG","FW","18",1998,0.3,1,1,1,0,0,0,0,NA,0,0,0,0,1,2,0,0,"https://fbref.com/en/players/199ff86e/Levi-Lumeka"
2018,"Crystal Palace","Premier League","James McArthur","SCO","MF","29",1987,27,58,44,28,27,3,23,61,37.7,38,39,2,37,36,94,44,2,"https://fbref.com/en/players/cee31595/James-McArthur"
2018,"Crystal Palace","Premier League","Luka Milivojević","SRB","MF","26",1991,34.2,85,52,40,37,8,31,86,36,55,50,12,38,71,156,81,3,"https://fbref.com/en/players/2ce2508a/Luka-Milivojevic"
2018,"Crystal Palace","Premier League","Jason Puncheon","ENG","MF","31",1986,7.2,13,4,3,7,3,1,5,20,4,3,0,3,5,18,4,0,"https://fbref.com/en/players/fd3f57ce/Jason-Puncheon"
2018,"Crystal Palace","Premier League","Jaïro Riedewald","NED","MF,DF","20",1996,4.9,11,8,6,4,1,0,2,0,2,7,1,6,12,23,13,0,"https://fbref.com/en/players/7a1f2c08/Jairo-Riedewald"
2018,"Crystal Palace","Premier League","Mamadou Sakho","FRA","DF","27",1990,17.8,21,14,15,5,1,9,16,56.3,7,19,11,8,30,51,101,3,"https://fbref.com/en/players/87935cf3/Mamadou-Sakho"
2018,"Crystal Palace","Premier League","Bakary Sako","MLI","FW,MF","29",1988,5.3,7,6,5,0,2,2,9,22.2,7,2,0,2,1,8,2,0,"https://fbref.com/en/players/381d7d54/Bakary-Sako"
2018,"Crystal Palace","Premier League","Jeffrey Schlupp","GHA","DF,MF","24",1992,19.4,57,36,35,20,2,23,43,53.5,20,34,8,26,24,81,67,0,"https://fbref.com/en/players/3312f911/Jeffrey-Schlupp"
2018,"Crystal Palace","Premier League","Pape Souaré","SEN","DF","27",1990,0.1,0,0,0,0,0,0,0,NA,0,0,0,0,0,0,0,0,"https://fbref.com/en/players/46b5375e/Pape-Souare"
2018,"Crystal Palace","Premier League","Julián Speroni","ARG","GK","38",1979,11,0,0,0,0,0,0,0,NA,0,0,0,0,1,1,4,0,"https://fbref.com/en/players/8e65a5e5/Julian-Speroni"
2018,"Crystal Palace","Premier League","Alexander Sørloth","NOR","FW","21",1995,4,6,3,1,4,1,4,12,33.3,8,5,0,5,2,8,5,0,"https://fbref.com/en/players/e92cd3f7/Alexander-Sorloth"
2018,"Crystal Palace","Premier League","James Tomkins","ENG","DF","28",1989,26.5,47,26,36,10,1,16,31,51.6,15,24,12,12,63,110,216,1,"https://fbref.com/en/players/e7ca0439/James-Tomkins"
2018,"Crystal Palace","Premier League","Andros Townsend","ENG","FW,MF","26",1991,34.7,60,34,35,12,13,24,75,32,51,49,1,48,35,95,28,0,"https://fbref.com/en/players/b28bbd58/Andros-Townsend"
2018,"Crystal Palace","Premier League","Aaron Wan-Bissaka","ENG","DF","19",1997,7,30,19,20,7,3,15,19,78.9,4,18,7,11,15,45,45,0,"https://fbref.com/en/players/9e525177/Aaron-Wan-Bissaka"
2018,"Crystal Palace","Premier League","Joel Ward","ENG","DF","27",1989,17.9,35,30,23,12,0,16,28,57.1,12,27,11,16,28,63,76,0,"https://fbref.com/en/players/8a7ff278/Joel-Ward"
2018,"Crystal Palace","Premier League","Wilfried Zaha","CIV","FW,MF","24",1992,28.3,30,23,9,13,8,4,23,17.4,19,24,0,24,7,37,4,0,"https://fbref.com/en/players/b2bc3b1f/Wilfried-Zaha"
2018,"Dijon","Ligue 1","Mehdi Abeid","ALG","MF","24",1992,13.1,23,15,8,14,1,8,32,25,24,11,6,5,18,41,25,2,"https://fbref.com/en/players/a4c3f7af/Mehdi-Abeid"
2018,"Dijon","Ligue 1","Romain Amalfitano","FRA","MF","27",1989,30,59,37,18,38,3,25,69,36.2,44,29,7,22,85,144,35,2,"https://fbref.com/en/players/d7bf3d19/Romain-Amalfitano"
2018,"Dijon","Ligue 1","Dylan Bahamboula","CGO","FW,MF","22",1995,0.3,0,0,0,0,0,0,0,NA,0,0,0,0,0,0,0,0,"https://fbref.com/en/players/7844c810/Dylan-Bahamboula"
2018,"Dijon","Ligue 1","Florent Balmont","FRA","MF","37",1980,9.6,14,9,4,9,1,4,25,16,21,15,1,14,8,22,5,0,"https://fbref.com/en/players/4e7bfc23/Florent-Balmont"
2018,"Dijon","Ligue 1","Arnold Bouka Moutou","CGO","DF","28",1988,3.7,8,5,6,0,2,6,8,75,2,4,1,3,4,12,5,0,"https://fbref.com/en/players/f3085377/Arnold-Bouka-Moutou"
2018,"Dijon","Ligue 1","Fouad Chafik","MAR","DF","30",1986,17.9,58,49,31,19,8,20,35,57.1,15,17,1,16,33,91,46,1,"https://fbref.com/en/players/edd1466a/Fouad-Chafik"
2018,"Dijon","Ligue 1","Kwon Chang-hoon","KOR","FW,MF","23",1994,23.7,37,22,10,18,9,11,35,31.4,24,32,1,31,24,61,30,0,"https://fbref.com/en/players/7961f7aa/Kwon-Chang-hoon"
2018,"Dijon","Ligue 1","Papy Djilobodji","SEN","DF","28",1988,30,45,29,34,11,0,21,43,48.8,22,38,25,13,71,116,211,5,"https://fbref.com/en/players/083525e5/Papy-Djilobodji"
2018,"Dijon","Ligue 1","Oussama Haddadi","TUN","DF","25",1992,27.8,44,29,33,9,2,14,47,29.8,33,29,12,17,43,87,79,1,"https://fbref.com/en/players/ec400194/Oussama-Haddadi"
2018,"Dijon","Ligue 1","Benjamin Jeannot","FRA","FW","25",1992,15.6,12,7,5,6,1,1,13,7.7,12,9,3,6,6,18,26,0,"https://fbref.com/en/players/2e52206e/Benjamin-Jeannot"
2018,"Dijon","Ligue 1","Ádám Lang","HUN","DF","24",1993,2.6,3,1,3,0,0,3,5,60,2,2,1,1,3,6,12,0,"https://fbref.com/en/players/8614496d/Adam-Lang"
2018,"Dijon","Ligue 1","Wesley Lautoa","NCL","DF,MF","29",1987,6.9,17,13,11,6,0,6,12,50,6,10,4,6,19,36,24,1,"https://fbref.com/en/players/6e5b5a45/Wesley-Lautoa"
2018,"Dijon","Ligue 1","Enzo Loiodice","FRA","MF","16",2000,1.9,9,5,4,5,0,4,7,57.1,3,0,0,0,2,11,0,0,"https://fbref.com/en/players/6bca20fe/Enzo-Loiodice"
2018,"Dijon","Ligue 1","Jordan Marié","FRA","MF","25",1991,20.9,63,38,22,36,5,18,66,27.3,48,26,9,17,40,103,25,2,"https://fbref.com/en/players/0d2158d5/Jordan-Marie"
2018,"Dijon","Ligue 1","Eden Massouema","CGO","MF,FW","20",1997,2.1,2,1,2,0,0,2,2,100,0,3,0,3,5,7,2,0,"https://fbref.com/en/players/639b42f5/Eden-Massouema"
2018,"Dijon","Ligue 1","Baptiste Reynet","FRA","GK","26",1990,38,6,4,5,1,0,5,7,71.4,2,2,0,2,2,8,35,1,"https://fbref.com/en/players/bcf1b2e9/Baptiste-Reynet"
2018,"Dijon","Ligue 1","Valentin Rosier","FRA","DF","20",1996,30.9,73,54,47,23,3,26,68,38.2,42,43,9,34,58,131,124,0,"https://fbref.com/en/players/9b6d9b53/Valentin-Rosier"
2018,"Dijon","Ligue 1","Vincent Rüfli","SUI","DF,FW","29",1988,0.3,4,1,3,1,0,3,3,100,0,1,0,1,1,5,0,0,"https://fbref.com/en/players/a87e9eb6/Vincent-Rufli"
2018,"Dijon","Ligue 1","Adrián Sahibeddine","FRA","FW,MF","22",1994,0.4,0,0,0,0,0,0,1,0,1,1,0,1,0,0,0,0,"https://fbref.com/en/players/22c77851/Adrian-Sahibeddine"
2018,"Dijon","Ligue 1","Wesley Saïd","FRA","FW,MF","22",1995,20.4,33,22,17,11,5,7,26,26.9,19,15,1,14,15,48,4,0,"https://fbref.com/en/players/90fcf472/Wesley-Said"
2018,"Dijon","Ligue 1","Frédéric Sammaritano","FRA","FW,MF","31",1986,15.9,29,25,17,9,3,10,36,27.8,26,14,0,14,5,34,15,0,"https://fbref.com/en/players/8802c1d5/Frederic-Sammaritano"
2018,"Dijon","Ligue 1","Naïm Sliti","TUN","FW,MF","25",1992,25.4,47,32,20,17,10,20,52,38.5,32,22,2,20,13,60,7,0,"https://fbref.com/en/players/2e0367a6/Naim-Sliti"
2018,"Dijon","Ligue 1","Júlio Tavares","CPV","FW","28",1988,22.8,3,1,1,1,1,1,11,9.1,10,11,6,5,3,6,36,0,"https://fbref.com/en/players/d520120b/Julio-Tavares"
2018,"Dijon","Ligue 1","Cédric Varrault","FRA","DF","37",1980,9.8,13,7,6,7,0,9,12,75,3,14,11,3,16,29,72,0,"https://fbref.com/en/players/8cb8dc58/Cedric-Varrault"
2018,"Dijon","Ligue 1","Xeka","POR","MF","22",1994,15.5,25,14,10,11,4,10,38,26.3,28,13,2,11,16,41,21,0,"https://fbref.com/en/players/f3600c02/Xeka"
2018,"Dijon","Ligue 1","Cédric Yamberé","CTA","DF","26",1990,31.4,58,42,46,12,0,16,34,47.1,18,24,16,8,54,112,138,5,"https://fbref.com/en/players/1c344204/Cedric-Yambere"
2018,"Dortmund","Bundesliga","Manuel Akanji","SUI","DF","22",1995,10,22,15,14,8,0,15,17,88.2,2,11,4,7,7,29,43,2,"https://fbref.com/en/players/89ac64a6/Manuel-Akanji"
2018,"Dortmund","Bundesliga","Pierre-Emerick Aubameyang","GAB","FW","28",1989,15.7,5,5,1,1,3,2,8,25,6,16,1,15,3,8,1,0,"https://fbref.com/en/players/d5dd5f1f/Pierre-Emerick-Aubameyang"
2018,"Dortmund","Bundesliga","Marc Bartra","ESP","DF","26",1991,9,28,19,16,12,0,15,24,62.5,9,14,2,12,28,56,43,1,"https://fbref.com/en/players/b742cc0d/Marc-Bartra"
2018,"Dortmund","Bundesliga","Michy Batshuayi","BEL","FW","23",1993,9.3,8,6,1,4,3,2,4,50,2,4,0,4,0,8,5,0,"https://fbref.com/en/players/2973d8ff/Michy-Batshuayi"
2018,"Dortmund","Bundesliga","Jacob Bruun Larsen","DEN","DF","18",1998,0.1,1,1,1,0,0,1,2,50,1,0,0,0,0,1,0,0,"https://fbref.com/en/players/4e204552/Jacob-Bruun-Larsen"
2018,"Dortmund","Bundesliga","Roman Bürki","SUI","GK","26",1990,33,1,1,1,0,0,1,3,33.3,2,1,0,1,0,1,10,4,"https://fbref.com/en/players/9d12e142/Roman-Burki"
2018,"Dortmund","Bundesliga","Gonzalo Castro","GER","MF","30",1987,13.4,26,18,7,18,1,5,22,22.7,17,23,3,20,10,36,13,1,"https://fbref.com/en/players/68829001/Gonzalo-Castro"
2018,"Dortmund","Bundesliga","Mahmoud Dahoud","GER","MF","21",1996,12.7,38,23,11,21,6,13,30,43.3,17,18,2,16,12,50,7,0,"https://fbref.com/en/players/db4ed67b/Mahmoud-Dahoud"
2018,"Dortmund","Bundesliga","Sergio Gómez","ESP","MF","16",2000,0.1,0,0,0,0,0,0,0,NA,0,0,0,0,0,0,0,0,"https://fbref.com/en/players/01e5f06e/Sergio-Gomez"
2018,"Dortmund","Bundesliga","Mario Götze","GER","MF","25",1992,17.8,50,43,19,24,7,14,34,41.2,20,17,1,16,8,58,9,0,"https://fbref.com/en/players/9efa1d25/Mario-Gotze"
2018,"Dortmund","Bundesliga","Raphaël Guerreiro","POR","DF,MF","23",1993,6.1,10,8,5,4,1,2,5,40,3,3,0,3,11,21,8,0,"https://fbref.com/en/players/048a1cbc/Raphael-Guerreiro"
2018,"Dortmund","Bundesliga","Alexander Isak","SWE","FW,MF","17",1999,1.3,1,0,0,1,0,0,1,0,1,1,0,1,0,1,0,0,"https://fbref.com/en/players/8e92be30/Alexander-Isak"
2018,"Dortmund","Bundesliga","Shinji Kagawa","JPN","MF","28",1989,13,32,22,11,14,7,18,27,66.7,9,6,0,6,6,38,2,0,"https://fbref.com/en/players/5afafbfe/Shinji-Kagawa"
2018,"Dortmund","Bundesliga","Sokratis Papastathopoulos","GRE","DF","29",1988,26.4,65,47,50,13,2,39,47,83,8,36,11,25,30,95,112,0,"https://fbref.com/en/players/b682dcf6/Sokratis-Papastathopoulos"
2018,"Dortmund","Bundesliga","Felix Passlack","GER","DF","19",1998,0.1,0,0,0,0,0,0,0,NA,0,0,0,0,1,1,0,0,"https://fbref.com/en/players/5c899683/Felix-Passlack"
2018,"Dortmund","Bundesliga","Maximilian Philipp","GER","FW","23",1994,13.4,24,19,9,12,3,6,19,31.6,13,12,0,12,6,30,7,0,"https://fbref.com/en/players/061e8e23/Maximilian-Philipp"
2018,"Dortmund","Bundesliga","Łukasz Piszczek","POL","DF","32",1985,23.8,51,37,23,23,5,30,52,57.7,22,39,11,28,42,93,64,1,"https://fbref.com/en/players/fe2db476/Lukasz-Piszczek"
2018,"Dortmund","Bundesliga","Christian Pulisic","USA","FW,DF","18",1998,25.6,46,30,12,20,14,26,44,59.1,18,24,2,22,16,62,11,0,"https://fbref.com/en/players/1bf33a9a/Christian-Pulisic"
2018,"Dortmund","Bundesliga","Marco Reus","GER","MF,FW","28",1989,10.3,16,8,2,12,2,5,12,41.7,7,16,3,13,4,20,9,0,"https://fbref.com/en/players/36a3ff67/Marco-Reus"
2018,"Dortmund","Bundesliga","Nuri Şahin","TUR","MF","28",1988,13.6,40,34,9,28,3,15,39,38.5,24,12,0,12,20,60,29,1,"https://fbref.com/en/players/f4081572/Nuri-Sahin"
2018,"Dortmund","Bundesliga","Jadon Sancho","ENG","FW","17",2000,7.7,5,5,2,2,1,2,7,28.6,5,8,0,8,5,10,2,0,"https://fbref.com/en/players/dbf053da/Jadon-Sancho"
2018,"Dortmund","Bundesliga","Marcel Schmelzer","GER","DF","29",1988,16.6,35,27,21,12,2,20,30,66.7,10,27,6,21,30,65,57,1,"https://fbref.com/en/players/89565ac5/Marcel-Schmelzer"
2018,"Dortmund","Bundesliga","André Schürrle","GER","FW","26",1990,13.7,22,19,8,7,7,9,18,50,9,13,1,12,7,29,7,1,"https://fbref.com/en/players/ecbb3fdf/Andre-Schurrle"
2018,"Dortmund","Bundesliga","Neven Subotić","SRB","DF","28",1988,3,9,9,5,3,1,6,7,85.7,1,6,2,4,5,14,16,0,"https://fbref.com/en/players/821233cc/Neven-Subotic"
2018,"Dortmund","Bundesliga","Jeremy Toljan","GER","DF","22",1994,13.5,29,20,17,11,1,19,32,59.4,13,17,2,15,12,41,45,0,"https://fbref.com/en/players/a96e5dc0/Jeremy-Toljan"
2018,"Dortmund","Bundesliga","Ömer Toprak","TUR","DF","28",1989,22.4,36,25,29,6,1,26,29,89.7,3,27,16,11,21,57,104,1,"https://fbref.com/en/players/c5fd13e9/Omer-Toprak"
2018,"Dortmund","Bundesliga","Roman Weidenfeller","GER","GK","36",1980,1,0,0,0,0,0,0,0,NA,0,0,0,0,0,0,0,1,"https://fbref.com/en/players/16b8fabd/Roman-Weidenfeller"
2018,"Dortmund","Bundesliga","Julian Weigl","GER","MF","21",1995,21.6,69,49,20,42,7,42,66,63.6,24,26,6,20,34,103,29,2,"https://fbref.com/en/players/346d51d9/Julian-Weigl"
2018,"Dortmund","Bundesliga","Andriy Yarmolenko","UKR","FW,MF","27",1989,11.5,17,12,6,6,5,7,16,43.8,9,4,0,4,7,24,4,0,"https://fbref.com/en/players/849c826a/Andriy-Yarmolenko"
2018,"Dortmund","Bundesliga","Dan-Axel Zagadou","FRA","DF","18",1999,7.3,9,8,5,3,1,6,7,85.7,1,9,0,9,11,20,20,1,"https://fbref.com/en/players/a4effc55/Dan-Axel-Zagadou"
2018,"Eibar","La Liga","Iván Alejo","ESP","MF,FW","22",1995,12.2,20,16,4,9,7,1,10,10,9,9,0,9,5,25,1,0,"https://fbref.com/en/players/3d7e48ce/Ivan-Alejo"
2018,"Eibar","La Liga","José Ángel","ESP","DF","27",1989,27,61,44,36,19,6,38,58,65.5,20,31,1,30,38,99,76,0,"https://fbref.com/en/players/3024e383/Jose-Angel"
2018,"Eibar","La Liga","Anaitz Arbilla","ESP","DF","30",1987,26.8,38,30,24,12,2,21,40,52.5,19,21,10,11,78,116,108,2,"https://fbref.com/en/players/850c0a0d/Anaitz-Arbilla"
2018,"Eibar","La Liga","Bebé","CPV","MF,FW","27",1990,4.1,9,7,1,4,4,3,8,37.5,5,5,0,5,3,12,1,0,"https://fbref.com/en/players/d8712bf9/Bebe"
2018,"Eibar","La Liga","Ander Capa","ESP","DF","25",1992,25,57,38,34,14,9,25,38,65.8,13,21,2,19,52,109,50,1,"https://fbref.com/en/players/37f1cf47/Ander-Capa"
2018,"Eibar","La Liga","Charles","BRA","FW","33",1984,17.6,11,8,2,5,4,1,8,12.5,7,7,0,7,7,18,10,0,"https://fbref.com/en/players/c4b8bcf4/Charles"
2018,"Eibar","La Liga","Papakouli Diop","SEN","MF","31",1986,10.4,26,20,6,16,4,11,26,42.3,15,3,0,3,13,39,10,0,"https://fbref.com/en/players/7329018e/Papakouli-Diop"
2018,"Eibar","La Liga","Marko Dmitrović","SRB","GK","25",1992,36,4,4,4,0,0,4,11,36.4,7,1,0,1,2,6,26,2,"https://fbref.com/en/players/ac295d9e/Marko-Dmitrovic"
2018,"Eibar","La Liga","Sergi Enrich","ESP","FW","27",1990,14.8,11,8,3,3,5,2,8,25,6,13,1,12,6,17,8,0,"https://fbref.com/en/players/bb4b1242/Sergi-Enrich"
2018,"Eibar","La Liga","Gonzalo Escalante","ARG","MF","24",1993,17.4,59,35,21,32,6,17,39,43.6,22,26,3,23,32,91,19,0,"https://fbref.com/en/players/3f79a1c8/Gonzalo-Escalante"
2018,"Eibar","La Liga","Álex Gálvez","ESP","DF","28",1989,4,11,4,5,6,0,7,12,58.3,5,5,1,4,13,24,17,0,"https://fbref.com/en/players/960fb42d/Alex-Galvez"
2018,"Eibar","La Liga","Dani García","ESP","MF","27",1990,30.8,80,59,23,47,10,31,80,38.8,49,28,4,24,70,150,25,0,"https://fbref.com/en/players/240d3a0b/Dani-Garcia"
2018,"Eibar","La Liga","Takashi Inui","JPN","MF,FW","29",1988,29.2,39,21,12,19,8,13,42,31,29,36,0,36,18,57,10,0,"https://fbref.com/en/players/61bd33d0/Takashi-Inui"
2018,"Eibar","La Liga","Joan Jordán","ESP","MF","23",1994,27,31,24,8,19,4,10,68,14.7,58,24,0,24,30,61,12,0,"https://fbref.com/en/players/2a0c8ba4/Joan-Jordan"
2018,"Eibar","La Liga","David Juncà","ESP","DF","23",1993,10,15,13,9,6,0,7,19,36.8,12,7,1,6,11,26,25,0,"https://fbref.com/en/players/de7d40d6/David-Junca"
2018,"Eibar","La Liga","Kike","ESP","FW","27",1989,27.3,14,8,1,7,6,2,11,18.2,9,15,1,14,10,24,14,0,"https://fbref.com/en/players/e897d8ba/Kike"
2018,"Eibar","La Liga","Pedro León","ESP","FW,MF","30",1986,10.3,9,4,0,2,7,0,4,0,4,18,2,16,9,18,5,0,"https://fbref.com/en/players/d66b9872/Pedro-Leon"
2018,"Eibar","La Liga","David Lombán","ESP","DF","30",1987,11,16,8,12,3,1,10,15,66.7,5,6,4,2,29,45,66,2,"https://fbref.com/en/players/b43b81f1/David-Lomban"
2018,"Eibar","La Liga","Paulo Oliveira","POR","DF","25",1992,24.6,41,22,28,13,0,16,22,72.7,6,23,9,14,62,103,140,0,"https://fbref.com/en/players/a8fbae1d/Paulo-Oliveira"
2018,"Eibar","La Liga","Fabián Orellana","CHI","MF,FW","31",1986,13.1,14,8,5,8,1,4,23,17.4,19,10,1,9,7,21,3,0,"https://fbref.com/en/players/c90977db/Fabian-Orellana"
2018,"Eibar","La Liga","Rubén Peña","ESP","DF,MF","26",1991,19.2,41,28,20,17,4,20,42,47.6,22,24,6,18,30,71,31,0,"https://fbref.com/en/players/1f079188/Ruben-Pena"
2018,"Eibar","La Liga","Iván Ramis","ESP","DF","32",1984,14.5,20,14,8,12,0,8,19,42.1,11,12,5,7,25,45,51,2,"https://fbref.com/en/players/d2be40f2/Ivan-Ramis"
2018,"Eibar","La Liga","Xesc Regis","ESP","FW","20",1996,0,1,1,0,1,0,0,0,NA,0,0,0,0,0,1,0,0,"https://fbref.com/en/players/4b32b2be/Xesc-Regis"
2018,"Eibar","La Liga","Asier Riesgo","ESP","GK","33",1983,1,0,0,0,0,0,0,0,NA,0,0,0,0,0,0,0,0,"https://fbref.com/en/players/581c5276/Asier-Riesgo"
2018,"Eibar","La Liga","Cristian Rivera","ESP","MF","20",1997,2.7,13,10,4,8,1,5,7,71.4,2,2,2,0,3,16,2,0,"https://fbref.com/en/players/8ef81d2d/Cristian-Rivera"
2018,"Eibar","La Liga","Imanol Sarriegi","ESP","MF,FW","22",1995,0.5,2,2,1,0,1,2,3,66.7,1,2,0,2,1,3,0,0,"https://fbref.com/en/players/b32b7d1b/Imanol-Sarriegi"
2018,"Eibar","La Liga","Yoel","ESP","GK","28",1988,1,0,0,0,0,0,0,0,NA,0,0,0,0,0,0,2,0,"https://fbref.com/en/players/61bb7498/Yoel"
2018,"Eint Frankfurt","Bundesliga","David Abraham","ARG","DF","31",1986,25.6,40,32,29,10,1,27,36,75,9,29,15,14,40,80,141,1,"https://fbref.com/en/players/565bf0da/David-Abraham"
2018,"Eint Frankfurt","Bundesliga","Aymen Barkok","MAR","FW,MF","19",1998,3.5,11,11,6,4,1,5,7,71.4,2,8,2,6,2,13,3,0,"https://fbref.com/en/players/a2a85828/Aymen-Barkok"
2018,"Eint Frankfurt","Bundesliga","Danny Blum","GER","MF,DF","26",1991,0.3,0,0,0,0,0,0,0,NA,0,0,0,0,1,1,0,0,"https://fbref.com/en/players/eb61713c/Danny-Blum"
2018,"Eint Frankfurt","Bundesliga","Kevin-Prince Boateng","GHA","MF,FW","30",1987,26.2,34,22,10,22,2,11,36,30.6,25,29,6,23,23,57,43,1,"https://fbref.com/en/players/f4ec4fd0/Kevin-Prince-Boateng"
2018,"Eint Frankfurt","Bundesliga","Marijan Ćavar","BIH","MF","19",1998,0.4,0,0,0,0,0,0,3,0,3,0,0,0,0,0,0,0,"https://fbref.com/en/players/33ec696b/Marijan-Cavar"
2018,"Eint Frankfurt","Bundesliga","Timothy Chandler","USA","DF,FW","27",1990,21,27,21,11,13,3,11,17,64.7,6,15,0,15,33,60,52,0,"https://fbref.com/en/players/b3b7f5a6/Timothy-Chandler"
2018,"Eint Frankfurt","Bundesliga","Danny da Costa","GER","DF,FW","24",1993,13.4,41,34,17,14,10,24,28,85.7,4,21,4,17,13,54,47,0,"https://fbref.com/en/players/5ddb8f9f/Danny-da-Costa"
2018,"Eint Frankfurt","Bundesliga","Marco Fabián","MEX","MF,FW","28",1989,4.7,5,3,2,3,0,3,4,75,1,2,0,2,3,8,1,0,"https://fbref.com/en/players/e665a2db/Marco-Fabian"
2018,"Eint Frankfurt","Bundesliga","Simon Falette","GUI","DF","25",1992,24.6,34,30,23,10,1,19,31,61.3,12,37,15,22,58,92,134,1,"https://fbref.com/en/players/b82880c6/Simon-Falette"
2018,"Eint Frankfurt","Bundesliga","Gelson Fernandes","SUI","MF","30",1986,11.5,58,46,25,29,4,23,45,51.1,22,23,3,20,16,74,21,0,"https://fbref.com/en/players/8e58987d/Gelson-Fernandes"
2018,"Eint Frankfurt","Bundesliga","Mijat Gaćinović","SRB","MF,FW","22",1995,20.2,56,44,21,27,8,20,52,38.5,32,38,1,37,39,95,22,1,"https://fbref.com/en/players/16daec92/Mijat-Gacinovic"
2018,"Eint Frankfurt","Bundesliga","Jonathan de Guzmán","NED","MF","29",1987,12.1,16,16,8,8,0,6,16,37.5,10,13,0,13,13,29,12,0,"https://fbref.com/en/players/1bcca8b8/Jonathan-de-Guzman"
2018,"Eint Frankfurt","Bundesliga","Sébastien Haller","CIV","FW","23",1994,26.1,25,16,4,16,5,7,14,50,7,17,4,13,8,33,39,0,"https://fbref.com/en/players/ba115a40/Sebastien-Haller"
2018,"Eint Frankfurt","Bundesliga","Makoto Hasebe","JPN","DF,MF","33",1984,23.2,38,23,19,19,0,21,33,63.6,12,40,19,21,25,63,74,0,"https://fbref.com/en/players/9ab16552/Makoto-Hasebe"
2018,"Eint Frankfurt","Bundesliga","Lukáš Hrádecký","FIN","GK","27",1989,34,0,0,0,0,0,0,2,0,2,0,0,0,0,0,23,3,"https://fbref.com/en/players/ad3389d5/Lukas-Hradecky"
2018,"Eint Frankfurt","Bundesliga","Branimir Hrgota","SWE","MF,FW","24",1993,2.2,5,4,0,3,2,4,7,57.1,3,2,0,2,0,5,1,0,"https://fbref.com/en/players/710fbdd1/Branimir-Hrgota"
2018,"Eint Frankfurt","Bundesliga","Luka Jović","SRB","FW","19",1997,10.4,5,5,0,5,0,1,3,33.3,2,6,2,4,1,6,2,0,"https://fbref.com/en/players/4d8cd038/Luka-Jovic"
2018,"Eint Frankfurt","Bundesliga","Daichi Kamada","JPN","MF,FW","20",1996,1.6,1,1,0,1,0,0,0,NA,0,0,0,0,1,2,0,0,"https://fbref.com/en/players/15b287da/Daichi-Kamada"
2018,"Eint Frankfurt","Bundesliga","Omar Mascarell","ESP","MF","24",1993,8.6,20,16,8,12,0,10,18,55.6,8,14,1,13,21,41,10,0,"https://fbref.com/en/players/11fd2b75/Omar-Mascarell"
2018,"Eint Frankfurt","Bundesliga","Slobodan Medojević","SRB","MF","26",1990,0.3,0,0,0,0,0,0,0,NA,0,0,0,0,0,0,1,0,"https://fbref.com/en/players/2e64bb49/Slobodan-Medojevic"
2018,"Eint Frankfurt","Bundesliga","Alexander Meier","GER","FW","34",1983,0,0,0,0,0,0,0,0,NA,0,0,0,0,0,0,0,0,"https://fbref.com/en/players/362aa29d/Alexander-Meier"
2018,"Eint Frankfurt","Bundesliga","Ante Rebić","CRO","FW","23",1993,19.5,37,29,7,21,9,7,24,29.2,17,27,2,25,6,43,13,0,"https://fbref.com/en/players/536cebe5/Ante-Rebic"
2018,"Eint Frankfurt","Bundesliga","Marco Russ","GER","DF","31",1985,12.7,17,11,9,8,0,13,19,68.4,6,23,11,12,24,41,66,0,"https://fbref.com/en/players/e26c4233/Marco-Russ"
2018,"Eint Frankfurt","Bundesliga","Carlos Salcedo","MEX","DF","23",1993,17.9,26,22,16,9,1,19,29,65.5,10,28,12,16,21,47,94,1,"https://fbref.com/en/players/64c07ae1/Carlos-Salcedo"
2018,"Eint Frankfurt","Bundesliga","Marc Stendera","GER","MF","21",1995,4.1,23,20,6,15,2,8,20,40,12,10,1,9,8,31,2,0,"https://fbref.com/en/players/500cd987/Marc-Stendera"
2018,"Eint Frankfurt","Bundesliga","Taleb Tawatha","ISR","DF,MF","25",1992,4.9,12,7,7,5,0,5,9,55.6,4,7,1,6,6,18,18,0,"https://fbref.com/en/players/bbb496b5/Taleb-Tawatha"
2018,"Eint Frankfurt","Bundesliga","Jetro Willems","NED","FW,DF","23",1994,18.5,55,42,28,23,4,27,42,64.3,15,31,1,30,20,75,53,0,"https://fbref.com/en/players/9050ddc4/Jetro-Willems"
2018,"Eint Frankfurt","Bundesliga","Marius Wolf","GER","MF,FW","22",1995,26.3,37,28,15,18,4,18,46,39.1,28,45,1,44,27,64,46,0,"https://fbref.com/en/players/fa661778/Marius-Wolf"
2018,"Espanyol","La Liga","Léo Baptistão","BRA","FW,MF","24",1992,29.7,54,34,12,28,14,13,52,25,39,22,1,21,23,77,25,0,"https://fbref.com/en/players/35f6db55/Leo-Baptistao"
2018,"Espanyol","La Liga","Sergi Darder","ESP","MF","23",1993,30.9,64,43,29,28,7,19,62,30.6,43,31,5,26,52,116,48,1,"https://fbref.com/en/players/070a3904/Sergi-Darder"
2018,"Espanyol","La Liga","Papakouli Diop","SEN","MF","31",1986,2.9,5,3,1,3,1,0,3,0,3,5,2,3,6,11,6,0,"https://fbref.com/en/players/7329018e/Papakouli-Diop"
2018,"Espanyol","La Liga","Óscar Duarte","CRC","DF","28",1989,11,12,9,8,4,0,4,11,36.4,7,8,8,0,9,21,60,2,"https://fbref.com/en/players/aa0ac32d/Oscar-Duarte"
2018,"Espanyol","La Liga","Javi Fuego","ESP","MF","33",1984,14.9,34,25,19,12,3,11,28,39.3,17,15,6,9,19,53,23,0,"https://fbref.com/en/players/2e8fc160/Javi-Fuego"
2018,"Espanyol","La Liga","Sergio García","ESP","FW,MF","34",1983,18.2,15,12,1,10,4,3,22,13.6,19,6,3,3,10,25,12,0,"https://fbref.com/en/players/2bee98fd/Sergio-Garcia"
2018,"Espanyol","La Liga","Esteban Granero","ESP","MF","30",1987,13.7,32,22,15,13,4,9,27,33.3,18,19,0,19,19,51,21,0,"https://fbref.com/en/players/1b17ed86/Esteban-Granero"
2018,"Espanyol","La Liga","Mario Hermoso","ESP","DF","22",1995,21.4,14,12,13,1,0,8,21,38.1,13,15,8,7,25,39,122,0,"https://fbref.com/en/players/555f3a0b/Mario-Hermoso"
2018,"Espanyol","La Liga","David López","ESP","DF,MF","27",1989,37,67,49,47,19,1,27,54,50,27,43,26,17,67,134,161,0,"https://fbref.com/en/players/f03f284b/David-Lopez"
2018,"Espanyol","La Liga","Diego López","ESP","GK","35",1981,9.5,0,0,0,0,0,0,1,0,1,0,0,0,0,0,1,0,"https://fbref.com/en/players/73683fa9/Diego-Lopez"
2018,"Espanyol","La Liga","Javi López","ESP","DF","31",1986,10.7,47,35,31,12,4,18,35,51.4,17,7,2,5,18,65,48,0,"https://fbref.com/en/players/ffad706e/Javi-Lopez"
2018,"Espanyol","La Liga","Pau López","ESP","GK","22",1994,28.5,0,0,0,0,0,0,0,NA,0,0,0,0,1,1,15,2,"https://fbref.com/en/players/20b9f052/Pau-Lopez"
2018,"Espanyol","La Liga","José Manuel Jurado","ESP","MF,FW","31",1986,16.7,18,14,8,8,2,5,14,35.7,9,13,1,12,16,34,5,0,"https://fbref.com/en/players/71d4e271/Jose-Manuel-Jurado"
2018,"Espanyol","La Liga","Aarón Martín","ESP","DF","20",1997,31.3,56,36,41,12,3,31,59,52.5,28,26,5,21,49,105,78,0,"https://fbref.com/en/players/2f3e911a/Aaron-Martin"
2018,"Espanyol","La Liga","Óscar Melendo","ESP","MF,FW","19",1997,7.6,2,2,2,0,0,0,5,0,5,2,0,2,3,5,3,0,"https://fbref.com/en/players/379652be/Oscar-Melendo"
2018,"Espanyol","La Liga","Gerard Moreno","ESP","FW","25",1992,37.9,41,28,7,22,12,12,53,22.6,41,27,6,21,19,60,46,0,"https://fbref.com/en/players/81f0781e/Gerard-Moreno"
2018,"Espanyol","La Liga","Naldo","BRA","DF","28",1988,10.2,14,8,12,1,1,5,10,50,5,13,10,3,16,30,57,1,"https://fbref.com/en/players/a2609621/Naldo"
2018,"Espanyol","La Liga","Marc Navarro","ESP","DF","22",1995,12.3,20,13,12,8,0,10,20,50,10,11,6,5,22,42,17,0,"https://fbref.com/en/players/c2846353/Marc-Navarro"
2018,"Espanyol","La Liga","Hernán Pérez","PAR","MF,DF","28",1989,1.6,4,3,1,1,2,2,3,66.7,1,1,0,1,1,5,1,0,"https://fbref.com/en/players/e1cea3f7/Hernan-Perez"
2018,"Espanyol","La Liga","Pablo Piatti","ARG","MF,FW","28",1989,19.3,45,32,14,21,10,17,57,29.8,40,28,3,25,22,67,16,0,"https://fbref.com/en/players/48e89655/Pablo-Piatti"
2018,"Espanyol","La Liga","Marc Roca","ESP","MF","20",1996,2.9,8,7,3,5,0,3,4,75,1,4,2,2,4,12,10,0,"https://fbref.com/en/players/da27e268/Marc-Roca"
2018,"Espanyol","La Liga","Carlos Sánchez","COL","MF","31",1986,12.5,25,12,6,16,3,9,24,37.5,15,13,5,8,18,43,24,2,"https://fbref.com/en/players/50b51fac/Carlos-Sanchez"
2018,"Espanyol","La Liga","Sergio Sánchez","ESP","DF","31",1986,1.1,4,3,4,0,0,3,4,75,1,1,0,1,3,7,3,0,"https://fbref.com/en/players/83a83b0a/Sergio-Sanchez"
2018,"Espanyol","La Liga","Víctor Sánchez","ESP","MF,DF","29",1987,27.3,106,72,56,45,5,49,113,43.4,64,38,14,24,79,185,73,1,"https://fbref.com/en/players/ad4d0985/Victor-Sanchez"
2018,"Espanyol","La Liga","Dídac Vilà","ESP","DF,MF","28",1989,8.1,29,26,15,9,5,13,18,72.2,5,14,3,11,14,43,27,0,"https://fbref.com/en/players/bad38a94/Didac-Vila"
2018,"Everton","Premier League","Leighton Baines","ENG","DF","32",1984,21.2,25,13,18,3,4,9,14,64.3,5,18,6,12,25,50,56,0,"https://fbref.com/en/players/b18095b6/Leighton-Baines"
2018,"Everton","Premier League","Beni Baningime","COD","MF","18",1998,2.2,6,2,1,2,3,0,4,0,4,5,1,4,2,8,2,0,"https://fbref.com/en/players/ca9178af/Beni-Baningime"
2018,"Everton","Premier League","Muhamed Bešić","BIH","MF","24",1992,0.5,1,1,1,0,0,1,3,33.3,2,2,2,0,0,1,1,0,"https://fbref.com/en/players/7ca9f0f0/Muhamed-Besic"
2018,"Everton","Premier League","Yannick Bolasie","COD","FW","28",1989,9.5,8,7,4,1,3,2,7,28.6,5,5,0,5,4,12,8,0,"https://fbref.com/en/players/715fc0fe/Yannick-Bolasie"
2018,"Everton","Premier League","Dominic Calvert-Lewin","ENG","FW","20",1997,20.9,15,8,5,3,7,2,15,13.3,13,13,1,12,10,25,23,1,"https://fbref.com/en/players/59e6e5bf/Dominic-Calvert-Lewin"
2018,"Everton","Premier League","Séamus Coleman","IRL","DF","28",1988,11.5,14,14,9,3,2,6,11,54.5,5,16,12,4,10,24,29,2,"https://fbref.com/en/players/0420d84f/Seamus-Coleman"
2018,"Everton","Premier League","Tom Davies","ENG","MF","19",1998,21.1,30,20,14,11,5,12,54,22.2,42,19,5,14,24,54,21,0,"https://fbref.com/en/players/9228b07c/Tom-Davies"
2018,"Everton","Premier League","Ramiro Funes Mori","ARG","DF","26",1991,1.3,0,0,0,0,0,0,0,NA,0,1,1,0,3,3,14,0,"https://fbref.com/en/players/89cbc961/Ramiro-Funes-Mori"
2018,"Everton","Premier League","Idrissa Gana Gueye","SEN","MF","27",1989,30.6,117,93,65,41,11,35,86,40.7,51,59,9,50,62,179,48,1,"https://fbref.com/en/players/72c812f3/Idrissa-Gana-Gueye"
2018,"Everton","Premier League","Mason Holgate","ENG","DF","20",1996,13.2,23,16,15,7,1,10,21,47.6,11,12,9,3,23,46,86,2,"https://fbref.com/en/players/d0042ab9/Mason-Holgate"
2018,"Everton","Premier League","Phil Jagielka","ENG","DF","34",1982,22.9,33,23,24,9,0,8,21,38.1,13,30,20,10,39,72,179,1,"https://fbref.com/en/players/3233eefd/Phil-Jagielka"
2018,"Everton","Premier League","Michael Keane","ENG","DF","24",1993,28.4,33,25,26,5,2,19,43,44.2,24,39,28,11,53,86,214,0,"https://fbref.com/en/players/c5b7c315/Michael-Keane"
2018,"Everton","Premier League","Jonjoe Kenny","ENG","DF","20",1997,17.7,41,33,28,10,3,20,32,62.5,12,17,7,10,28,69,95,0,"https://fbref.com/en/players/099e666f/Jonjoe-Kenny"
2018,"Everton","Premier League","Davy Klaassen","NED","MF,FW","24",1993,2.8,3,1,1,2,0,2,6,33.3,4,2,1,1,1,4,2,0,"https://fbref.com/en/players/15fd5593/Davy-Klaassen"
2018,"Everton","Premier League","Aaron Lennon","ENG","FW,MF","30",1987,8.8,17,10,10,5,2,5,21,23.8,16,13,1,12,11,28,9,0,"https://fbref.com/en/players/2ff964a0/Aaron-Lennon"
2018,"Everton","Premier League","Ademola Lookman","NGA","FW,MF","19",1997,1.8,1,1,0,1,0,0,2,0,2,2,0,2,1,2,3,0,"https://fbref.com/en/players/7c104bb7/Ademola-Lookman"
2018,"Everton","Premier League","Eliaquim Mangala","FRA","DF","26",1991,1.5,2,1,1,1,0,0,0,NA,0,0,0,0,1,3,4,1,"https://fbref.com/en/players/f520049f/Eliaquim-Mangala"
2018,"Everton","Premier League","Cuco Martina","CUW","DF","27",1989,20.3,61,35,38,15,8,27,46,58.7,19,17,4,13,42,103,130,2,"https://fbref.com/en/players/22551915/Cuco-Martina"
2018,"Everton","Premier League","James McCarthy","IRL","MF","26",1990,2.3,9,9,3,4,2,1,5,20,4,9,2,7,5,14,3,1,"https://fbref.com/en/players/64b08de7/James-McCarthy"
2018,"Everton","Premier League","Kevin Mirallas","BEL","FW,MF","29",1987,1.5,4,3,1,2,1,0,1,0,1,0,0,0,0,4,3,0,"https://fbref.com/en/players/aa51343f/Kevin-Mirallas"
2018,"Everton","Premier League","Oumar Niasse","SEN","FW","27",1990,12.1,10,6,2,5,3,4,19,21.1,15,3,2,1,2,12,6,0,"https://fbref.com/en/players/af721f98/Oumar-Niasse"
2018,"Everton","Premier League","Jordan Pickford","ENG","GK","23",1994,38,0,0,0,0,0,0,2,0,2,0,0,0,2,2,26,5,"https://fbref.com/en/players/4806ec67/Jordan-Pickford"
2018,"Everton","Premier League","Sandro Ramírez","ESP","FW,MF","22",1995,3.1,2,1,0,1,1,0,3,0,3,1,0,1,1,3,0,0,"https://fbref.com/en/players/833fb62e/Sandro-Ramirez"
2018,"Everton","Premier League","Wayne Rooney","ENG","MF,FW","31",1985,25.2,28,19,11,13,4,10,42,23.8,32,25,6,19,16,44,43,2,"https://fbref.com/en/players/f07be45a/Wayne-Rooney"
2018,"Everton","Premier League","Morgan Schneiderlin","FRA","MF","27",1989,23.7,58,40,34,21,3,15,44,34.1,29,18,7,11,61,119,59,1,"https://fbref.com/en/players/51b41c5c/Morgan-Schneiderlin"
2018,"Everton","Premier League","Gylfi Sigurðsson","ISL","MF,FW","27",1989,25.1,38,26,15,14,9,16,57,28.1,41,37,7,30,34,72,36,0,"https://fbref.com/en/players/76dd1480/Gylfi-Sigurdsson"
2018,"Everton","Premier League","Cenk Tosun","TUR","FW","26",1991,11,6,3,2,2,2,1,11,9.1,10,9,4,5,1,7,13,0,"https://fbref.com/en/players/9a104dee/Cenk-Tosun"
2018,"Everton","Premier League","Nikola Vlašić","CRO","MF,FW","19",1997,6.4,9,5,3,6,0,2,9,22.2,7,14,2,12,9,18,10,0,"https://fbref.com/en/players/aa8e289e/Nikola-Vlasic"
2018,"Everton","Premier League","Theo Walcott","ENG","FW","28",1989,12.8,27,19,12,13,2,7,15,46.7,8,9,0,9,8,35,12,0,"https://fbref.com/en/players/1ecb65be/Theo-Walcott"
2018,"Everton","Premier League","Ashley Williams","WAL","DF","32",1984,20.4,23,13,17,6,0,9,18,50,9,31,23,8,36,59,173,3,"https://fbref.com/en/players/a498e276/Ashley-Williams"
2018,"Fiorentina","Serie A","Davide Astori","ITA","DF","30",1987,25,47,31,33,13,1,18,29,62.1,11,29,17,12,51,98,131,2,"https://fbref.com/en/players/1522dab2/Davide-Astori"
2018,"Fiorentina","Serie A","Khouma Babacar","SEN","FW","24",1993,5,4,4,3,0,1,2,4,50,2,0,0,0,2,6,5,0,"https://fbref.com/en/players/422ec08a/Khouma-Babacar"
2018,"Fiorentina","Serie A","Milan Badelj","CRO","MF","28",1989,26.1,71,41,26,38,7,28,71,39.4,43,48,2,46,71,142,52,3,"https://fbref.com/en/players/e8c930bb/Milan-Badelj"
2018,"Fiorentina","Serie A","Gil Bastião Dias","POR","FW,MF","20",1996,13.2,49,31,28,15,6,19,48,39.6,29,23,0,23,19,68,12,1,"https://fbref.com/en/players/e61bdd69/Gil-Bastiao-Dias"
2018,"Fiorentina","Serie A","Marco Benassi","ITA","MF,FW","22",1994,30.9,54,38,18,22,14,17,52,32.7,35,52,2,50,28,82,36,0,"https://fbref.com/en/players/0000acda/Marco-Benassi"
2018,"Fiorentina","Serie A","Cristiano Biraghi","ITA","DF","24",1992,33.1,74,48,33,32,9,36,58,62.1,22,42,5,37,43,117,103,2,"https://fbref.com/en/players/9e1577aa/Cristiano-Biraghi"
2018,"Fiorentina","Serie A","Federico Chiesa","ITA","FW,MF","19",1997,33.5,62,41,22,22,18,16,54,29.6,38,34,1,33,18,80,16,0,"https://fbref.com/en/players/b0f7e36c/Federico-Chiesa"
2018,"Fiorentina","Serie A","Sebastián Cristóforo","URU","MF","23",1993,3,16,12,6,8,2,9,19,47.4,10,4,0,4,4,20,6,0,"https://fbref.com/en/players/3c05c659/Sebastian-Cristoforo"
2018,"Fiorentina","Serie A","Bryan Dabo","BFA","MF","25",1992,6.6,17,11,6,10,1,6,15,40,9,13,1,12,15,32,24,1,"https://fbref.com/en/players/c53083ad/Bryan-Dabo"
2018,"Fiorentina","Serie A","Bartłomiej Drągowski","POL","GK","19",1997,2.4,0,0,0,0,0,0,0,NA,0,0,0,0,0,0,0,1,"https://fbref.com/en/players/085e71a7/Bartlomiej-Dragowski"
2018,"Fiorentina","Serie A","Valentin Eysseric","FRA","FW,MF","25",1992,7.8,17,13,7,4,6,6,20,30,14,10,2,8,6,23,6,0,"https://fbref.com/en/players/ae82fa48/Valentin-Eysseric"
2018,"Fiorentina","Serie A","Diego Falcinelli","ITA","FW","26",1991,4.9,1,1,1,0,0,0,5,0,5,5,1,4,1,2,4,0,"https://fbref.com/en/players/a39b9ef6/Diego-Falcinelli"
2018,"Fiorentina","Serie A","Bruno Gaspar","ANG","DF","24",1993,8.7,20,11,13,6,1,9,15,60,6,8,1,7,9,29,25,0,"https://fbref.com/en/players/55ae91f0/Bruno-Gaspar"
2018,"Fiorentina","Serie A","Vitor Hugo","BRA","DF","26",1991,13.4,32,21,26,6,0,10,17,58.8,7,10,6,4,43,75,92,0,"https://fbref.com/en/players/f2c1300a/Vitor-Hugo"
2018,"Fiorentina","Serie A","Vincent Laurini","FRA","DF","28",1989,17.9,34,23,21,9,4,12,22,54.5,10,20,5,15,11,45,72,1,"https://fbref.com/en/players/3535098b/Vincent-Laurini"
2018,"Fiorentina","Serie A","Simone Lo Faso","ITA","FW","19",1998,0.4,1,1,1,0,0,0,1,0,1,0,0,0,1,2,0,0,"https://fbref.com/en/players/51c614fd/Simone-Lo-Faso"
2018,"Fiorentina","Serie A","Nikola Milenković","SRB","DF","19",1997,13.9,39,25,20,16,3,16,29,55.2,13,18,8,10,23,62,70,0,"https://fbref.com/en/players/bee704fc/Nikola-Milenkovic"
2018,"Fiorentina","Serie A","Maximiliano Olivera","URU","DF","25",1992,4.6,12,9,5,4,3,3,8,37.5,5,4,1,3,11,23,11,0,"https://fbref.com/en/players/32a33c68/Maximiliano-Olivera"
2018,"Fiorentina","Serie A","Germán Pezzella","ARG","DF","26",1991,33.1,63,47,42,19,2,19,41,46.3,22,33,16,17,63,126,185,1,"https://fbref.com/en/players/8c725b43/German-Pezzella"
2018,"Fiorentina","Serie A","Carlos Sánchez","COL","MF,DF","31",1986,4.1,7,6,2,5,0,4,6,66.7,2,3,1,2,8,15,10,0,"https://fbref.com/en/players/50b51fac/Carlos-Sanchez"
2018,"Fiorentina","Serie A","Riccardo Saponara","ITA","MF,FW","25",1991,10,12,8,2,8,2,2,11,18.2,9,3,1,2,1,13,5,0,"https://fbref.com/en/players/3bb7af3b/Riccardo-Saponara"
2018,"Fiorentina","Serie A","Giovanni Simeone","ARG","FW","22",1995,33.3,32,23,9,17,6,8,40,20,32,27,1,26,12,44,32,0,"https://fbref.com/en/players/343c0d52/Giovanni-Simeone"
2018,"Fiorentina","Serie A","Marco Sportiello","ITA","GK","25",1992,35.6,0,0,0,0,0,0,1,0,1,0,0,0,1,1,13,4,"https://fbref.com/en/players/ac4003af/Marco-Sportiello"
2018,"Fiorentina","Serie A","Cyril Théréau","FRA","FW,MF","34",1983,12.4,11,6,3,6,2,7,19,36.8,12,13,0,13,8,19,9,0,"https://fbref.com/en/players/4d3ab428/Cyril-Thereau"
2018,"Fiorentina","Serie A","Nenad Tomović","SRB","DF","29",1987,1.5,2,1,1,1,0,0,2,0,2,0,0,0,3,5,5,1,"https://fbref.com/en/players/6aafdc27/Nenad-Tomovic"
2018,"Fiorentina","Serie A","Jordan Veretout","FRA","MF","24",1993,35.7,65,45,34,23,8,20,69,29,49,39,4,35,37,102,59,0,"https://fbref.com/en/players/4a56052c/Jordan-Veretout"
2018,"Fiorentina","Serie A","Rafik Zekhnini","NOR","FW","19",1998,0.1,0,0,0,0,0,0,0,NA,0,0,0,0,0,0,0,0,"https://fbref.com/en/players/1b62a7df/Rafik-Zekhnini"
2018,"Freiburg","Bundesliga","Amir Abrashi","ALB","MF","27",1990,9.4,35,32,15,18,2,16,23,69.6,7,22,5,17,19,54,20,0,"https://fbref.com/en/players/1c08a3c8/Amir-Abrashi"
2018,"Freiburg","Bundesliga","Onur Bulut","TUR","FW","23",1994,0.4,0,0,0,0,0,0,1,0,1,0,0,0,0,0,0,0,"https://fbref.com/en/players/32e96d52/Onur-Bulut"
2018,"Freiburg","Bundesliga","Mohamed Dräger","TUN","MF,FW","21",1996,0.6,0,0,0,0,0,0,1,0,1,1,0,1,0,0,0,0,"https://fbref.com/en/players/8954fddc/Mohamed-Drager"
2018,"Freiburg","Bundesliga","Mike Frantz","GER","MF","30",1986,11.6,23,16,9,11,3,6,16,37.5,10,13,3,10,13,36,15,0,"https://fbref.com/en/players/482b70ad/Mike-Frantz"
2018,"Freiburg","Bundesliga","Rafał Gikiewicz","POL","GK","29",1987,1.7,0,0,0,0,0,0,0,NA,0,0,0,0,0,0,0,0,"https://fbref.com/en/players/17376543/Rafal-Gikiewicz"
2018,"Freiburg","Bundesliga","Karim Guédé","SVK","FW","32",1985,0.7,2,2,2,0,0,2,2,100,0,1,1,0,1,3,0,0,"https://fbref.com/en/players/79fa1799/Karim-Guede"
2018,"Freiburg","Bundesliga","Manuel Gulde","GER","DF","26",1991,17,16,10,14,2,0,10,19,52.6,9,24,17,7,14,30,71,0,"https://fbref.com/en/players/25ab9c9c/Manuel-Gulde"
2018,"Freiburg","Bundesliga","Christian Günter","GER","DF,MF","24",1993,34,73,54,45,21,7,38,63,60.3,25,38,7,31,20,93,68,0,"https://fbref.com/en/players/8593f88c/Christian-Gunter"
2018,"Freiburg","Bundesliga","Janik Haberer","GER","MF,FW","23",1994,30.5,62,49,20,34,8,23,57,40.4,34,43,1,42,30,92,42,0,"https://fbref.com/en/players/70dcf94d/Janik-Haberer"
2018,"Freiburg","Bundesliga","Nicolas Höfler","GER","MF","27",1990,25.1,57,36,23,30,4,31,50,62,19,42,10,32,44,101,51,2,"https://fbref.com/en/players/5d8e331f/Nicolas-Hofler"
2018,"Freiburg","Bundesliga","Lucas Höler","GER","FW,MF","23",1994,10.1,24,20,8,13,3,9,24,37.5,15,10,0,10,7,31,13,0,"https://fbref.com/en/players/ca618d23/Lucas-Holer"
2018,"Freiburg","Bundesliga","Bartosz Kapustka","POL","FW,MF","20",1996,2.6,9,5,2,6,1,4,6,66.7,2,4,0,4,3,12,0,0,"https://fbref.com/en/players/7364c4d1/Bartosz-Kapustka"
2018,"Freiburg","Bundesliga","Florian Kath","GER","FW,MF","22",1994,7.5,15,10,3,9,3,9,17,52.9,8,9,0,9,8,23,1,0,"https://fbref.com/en/players/6a81a181/Florian-Kath"
2018,"Freiburg","Bundesliga","Marc-Oliver Kempf","GER","DF","22",1995,10,13,12,9,4,0,5,8,62.5,3,7,7,0,17,30,52,0,"https://fbref.com/en/players/815c314f/Marc-Oliver-Kempf"
2018,"Freiburg","Bundesliga","Ryan Kent","ENG","FW,MF","20",1996,2.7,4,3,2,1,1,2,5,40,3,6,0,6,1,5,1,0,"https://fbref.com/en/players/316de854/Ryan-Kent"
2018,"Freiburg","Bundesliga","Tim Kleindienst","GER","FW,DF","21",1995,12.6,22,15,6,12,4,4,17,23.5,13,17,3,14,6,28,21,0,"https://fbref.com/en/players/258a6f4d/Tim-Kleindienst"
2018,"Freiburg","Bundesliga","Robin Koch","GER","MF,DF","21",1996,21.3,34,24,21,13,0,10,18,55.6,8,27,11,16,35,69,67,0,"https://fbref.com/en/players/ea6bc03a/Robin-Koch"
2018,"Freiburg","Bundesliga","Lukas Kübler","GER","DF,MF","24",1992,12.8,31,19,16,15,0,13,23,56.5,10,15,6,9,18,49,41,0,"https://fbref.com/en/players/2a29eb9b/Lukas-Kubler"
2018,"Freiburg","Bundesliga","Philipp Lienhart","AUT","DF","21",1996,9.6,16,14,12,4,0,6,17,35.3,11,14,9,5,11,27,60,0,"https://fbref.com/en/players/302527b2/Philipp-Lienhart"
2018,"Freiburg","Bundesliga","Florian Niederlechner","GER","FW,MF","26",1990,7.7,8,6,1,5,2,2,5,40,3,5,1,4,3,11,6,0,"https://fbref.com/en/players/d6862409/Florian-Niederlechner"
2018,"Freiburg","Bundesliga","Nils Petersen","GER","FW","28",1988,24.9,27,18,7,18,2,10,27,37,17,28,2,26,17,44,33,0,"https://fbref.com/en/players/f93e6e94/Nils-Petersen"
2018,"Freiburg","Bundesliga","Yoric Ravet","FRA","FW,MF","27",1989,5.5,9,7,3,6,0,3,7,42.9,4,7,0,7,3,12,6,0,"https://fbref.com/en/players/4d74201d/Yoric-Ravet"
2018,"Freiburg","Bundesliga","Julian Schuster","GER","DF,MF","32",1985,14.5,14,10,6,7,1,6,11,54.5,5,17,10,7,19,33,56,0,"https://fbref.com/en/players/d0421d25/Julian-Schuster"
2018,"Freiburg","Bundesliga","Alexander Schwolow","GER","GK","25",1992,32.3,0,0,0,0,0,0,1,0,1,0,0,0,0,0,9,1,"https://fbref.com/en/players/0d55d942/Alexander-Schwolow"
2018,"Freiburg","Bundesliga","Vincent Sierro","SUI","MF,FW","21",1995,2.4,8,6,2,6,0,4,9,44.4,5,2,1,1,4,12,0,0,"https://fbref.com/en/players/92ffb8f9/Vincent-Sierro"
2018,"Freiburg","Bundesliga","Çağlar Söyüncü","TUR","DF","21",1996,23.9,42,26,26,15,1,15,26,57.7,11,30,20,10,54,96,91,2,"https://fbref.com/en/players/21166ff4/Caglar-Soyuncu"
2018,"Freiburg","Bundesliga","Caleb Stanko","USA","DF","24",1993,2.1,2,2,1,1,0,1,2,50,1,3,0,3,1,3,8,0,"https://fbref.com/en/players/381e52af/Caleb-Stanko"
2018,"Freiburg","Bundesliga","Pascal Stenzel","GER","MF,DF","21",1996,21.6,62,45,35,25,2,34,57,59.6,23,20,3,17,35,97,51,1,"https://fbref.com/en/players/99f7e9aa/Pascal-Stenzel"
2018,"Freiburg","Bundesliga","Marco Terrazzino","GER","MF,FW","26",1991,16.5,31,24,12,13,6,21,39,53.8,18,16,0,16,9,40,19,0,"https://fbref.com/en/players/7e689867/Marco-Terrazzino"
2018,"Genoa","Serie A","Andrea Bertolacci","ITA","MF","26",1991,32.2,85,53,40,38,7,21,63,33.3,42,46,12,34,46,131,37,1,"https://fbref.com/en/players/c75b6a02/Andrea-Bertolacci"
2018,"Genoa","Serie A","Daniel Bessa","ITA","MF","24",1993,4.9,6,6,2,2,2,0,1,0,1,7,0,7,3,9,6,0,"https://fbref.com/en/players/88895312/Daniel-Bessa"
2018,"Genoa","Serie A","Davide Biraschi","ITA","DF","23",1994,20,33,25,13,19,1,18,25,72,7,19,10,9,38,71,78,0,"https://fbref.com/en/players/64cd167d/Davide-Biraschi"
2018,"Genoa","Serie A","Petar Brlek","CRO","MF","23",1994,2.6,9,7,4,5,0,3,7,42.9,4,0,0,0,1,10,3,0,"https://fbref.com/en/players/4590c6e7/Petar-Brlek"
2018,"Genoa","Serie A","Ricardo Centurión","ARG","MF,FW","24",1993,0.6,0,0,0,0,0,0,0,NA,0,0,0,0,0,0,0,0,"https://fbref.com/en/players/fac896b0/Ricardo-Centurion"
2018,"Genoa","Serie A","Isaac Cofie","GHA","MF","25",1991,6.6,13,10,3,9,1,7,15,46.7,8,9,3,6,10,23,7,0,"https://fbref.com/en/players/c6dda86e/Isaac-Cofie"
2018,"Genoa","Serie A","Andrey Galabinov","BUL","FW","28",1988,12.5,7,5,0,5,2,0,5,0,5,17,1,16,2,9,11,0,"https://fbref.com/en/players/0a1efd3c/Andrey-Galabinov"
2018,"Genoa","Serie A","Santiago Gentiletti","ARG","DF","32",1985,3.2,4,3,4,0,0,1,6,16.7,5,1,0,1,3,7,11,1,"https://fbref.com/en/players/4ac07e1b/Santiago-Gentiletti"
2018,"Genoa","Serie A","Oscar Hiljemark","SWE","MF","25",1992,14.2,12,8,2,8,2,3,24,12.5,21,14,4,10,9,21,12,0,"https://fbref.com/en/players/98e958af/Oscar-Hiljemark"
2018,"Genoa","Serie A","Armando Izzo","ITA","DF","25",1992,15.4,30,23,14,10,6,12,18,66.7,6,15,6,9,34,64,70,0,"https://fbref.com/en/players/89976232/Armando-Izzo"
2018,"Genoa","Serie A","Eugenio Lamanna","ITA","GK","27",1989,1,0,0,0,0,0,0,0,NA,0,0,0,0,0,0,1,0,"https://fbref.com/en/players/349601c3/Eugenio-Lamanna"
2018,"Genoa","Serie A","Gianluca Lapadula","PER","FW","27",1990,16.6,8,5,4,4,0,1,11,9.1,10,7,1,6,3,11,8,0,"https://fbref.com/en/players/2ead2809/Gianluca-Lapadula"
2018,"Genoa","Serie A","Diego Laxalt","URU","DF","24",1993,31.2,54,43,31,17,6,22,59,37.3,37,38,3,35,25,79,55,1,"https://fbref.com/en/players/f26e3c59/Diego-Laxalt"
2018,"Genoa","Serie A","Darko Lazović","SRB","DF,MF","26",1990,13.8,19,12,16,2,1,9,18,50,9,8,0,8,13,32,12,0,"https://fbref.com/en/players/5128bde4/Darko-Lazovic"
2018,"Genoa","Serie A","Iuri Medeiros","POR","FW,MF","23",1994,7.1,6,4,3,2,1,4,8,50,4,3,1,2,2,8,3,0,"https://fbref.com/en/players/97e2aa67/Iuri-Medeiros"
2018,"Genoa","Serie A","Francesco Migliore","ITA","DF","29",1988,3.7,5,5,4,1,0,2,6,33.3,4,1,0,1,3,8,9,1,"https://fbref.com/en/players/1a584cb2/Francesco-Migliore"
2018,"Genoa","Serie A","Stephane Omeonga","BEL","MF,DF","21",1996,8.9,25,15,16,8,1,7,18,38.9,11,20,1,19,5,30,6,0,"https://fbref.com/en/players/72c803a0/Stephane-Omeonga"
2018,"Genoa","Serie A","Raffaele Palladino","ITA","MF,FW","33",1984,2.6,1,1,1,0,0,0,1,0,1,0,0,0,1,2,0,0,"https://fbref.com/en/players/961a4174/Raffaele-Palladino"
2018,"Genoa","Serie A","Goran Pandev","MKD","FW,MF","34",1983,20,10,9,3,6,1,2,13,15.4,11,8,0,8,4,14,5,0,"https://fbref.com/en/players/d711d04f/Goran-Pandev"
2018,"Genoa","Serie A","Pietro Pellegri","ITA","FW","16",2001,3.1,1,0,0,0,1,0,5,0,5,3,0,3,2,3,1,0,"https://fbref.com/en/players/a44d3a3c/Pietro-Pellegri"
2018,"Genoa","Serie A","Pedro Pereira","POR","DF","19",1998,4.2,5,4,2,1,2,3,5,60,2,5,2,3,5,10,15,0,"https://fbref.com/en/players/c77be0cf/Pedro-Pereira"
2018,"Genoa","Serie A","Mattia Perin","ITA","GK","24",1992,37,0,0,0,0,0,0,1,0,1,0,0,0,1,1,14,2,"https://fbref.com/en/players/4c62d0c8/Mattia-Perin"
2018,"Genoa","Serie A","Federico Ricci","ITA","MF","23",1994,2.4,2,2,2,0,0,1,3,33.3,2,2,0,2,1,3,1,0,"https://fbref.com/en/players/524eb8c5/Federico-Ricci"
2018,"Genoa","Serie A","Luca Rigoni","ITA","MF","32",1984,17.5,32,22,11,20,1,7,35,20,28,24,2,22,19,51,13,0,"https://fbref.com/en/players/4dba2a97/Luca-Rigoni"
2018,"Genoa","Serie A","Aleandro Rosi","ITA","DF","30",1987,18.9,24,17,7,13,4,5,19,26.3,14,24,5,19,20,44,61,1,"https://fbref.com/en/players/1b729ba2/Aleandro-Rosi"
2018,"Genoa","Serie A","Luca Rossettini","ITA","DF","32",1985,22.5,16,8,12,3,1,6,17,35.3,11,31,21,10,29,45,151,1,"https://fbref.com/en/players/47a500ae/Luca-Rossettini"
2018,"Genoa","Serie A","Giuseppe Rossi","ITA","FW,MF","30",1987,2.9,1,1,0,1,0,0,3,0,3,2,0,2,1,2,1,0,"https://fbref.com/en/players/fe48a073/Giuseppe-Rossi"
2018,"Genoa","Serie A","Eddie Salcedo","ITA","FW","15",2001,0.4,0,0,0,0,0,0,0,NA,0,0,0,0,0,0,0,0,"https://fbref.com/en/players/0489bb30/Eddie-Salcedo"
2018,"Genoa","Serie A","Nicolás Spolli","ARG","DF","34",1983,20,27,21,24,2,1,13,22,59.1,9,26,17,9,36,63,120,2,"https://fbref.com/en/players/9a560ebe/Nicolas-Spolli"
2018,"Genoa","Serie A","Adel Taarabt","MAR","FW,MF","28",1989,17.9,18,11,5,11,2,7,16,43.8,9,13,3,10,12,30,7,0,"https://fbref.com/en/players/47dc80f5/Adel-Taarabt"
2018,"Genoa","Serie A","Miguel Veloso","POR","MF","31",1986,19.3,40,29,18,19,3,11,41,26.8,30,26,3,23,13,53,35,0,"https://fbref.com/en/players/ab1ca213/Miguel-Veloso"
2018,"Genoa","Serie A","Jawad El Yamiq","MAR","DF","25",1992,4,8,5,7,1,0,6,8,75,2,11,5,6,5,13,22,1,"https://fbref.com/en/players/f6f6b6e8/Jawad-El-Yamiq"
2018,"Genoa","Serie A","Ervin Zukanović","BIH","DF","30",1987,31.9,50,41,33,16,1,20,51,39.2,31,32,19,13,48,98,175,0,"https://fbref.com/en/players/1253a12e/Ervin-Zukanovic"
2018,"Getafe","La Liga","David Alba","ESP","DF","18",1999,0.7,1,1,1,0,0,1,1,100,0,0,0,0,0,1,7,1,"https://fbref.com/en/players/7a4cd784/David-Alba"
2018,"Getafe","La Liga","Amath","SEN","MF,FW","21",1996,31.8,78,53,32,28,18,24,89,27,65,36,3,33,33,111,20,0,"https://fbref.com/en/players/f3b1d9a2/Amath"
2018,"Getafe","La Liga","Miguel Ángel Rubio","ESP","DF","19",1998,0.3,0,0,0,0,0,0,0,NA,0,0,0,0,0,0,1,0,"https://fbref.com/en/players/56cafd0a/Miguel-Angel-Rubio"
2018,"Getafe","La Liga","Vitorino Antunes","POR","DF","30",1987,31.1,58,44,42,14,2,38,74,51.4,36,31,3,28,58,116,89,1,"https://fbref.com/en/players/3e4f735d/Vitorino-Antunes"
2018,"Getafe","La Liga","Mauro Arambarri","URU","MF","21",1995,23.6,56,41,19,30,7,14,47,29.8,33,26,3,23,25,81,36,0,"https://fbref.com/en/players/58afe001/Mauro-Arambarri"
2018,"Getafe","La Liga","Barri","ESP","MF,FW","21",1995,1.3,1,0,0,1,0,0,4,0,4,1,1,0,1,2,3,0,"https://fbref.com/en/players/9704b62b/Barri"
2018,"Getafe","La Liga","Markel Bergara","ESP","MF","31",1986,16.3,35,22,17,17,1,7,25,28,18,10,3,7,23,58,20,0,"https://fbref.com/en/players/04a65a8f/Markel-Bergara"
2018,"Getafe","La Liga","Leandro Cabrera","URU","DF","26",1991,8,19,10,12,7,0,7,17,41.2,10,9,5,4,22,41,37,0,"https://fbref.com/en/players/69cbc8b6/Leandro-Cabrera"
2018,"Getafe","La Liga","Cala","ESP","DF","27",1989,20,21,14,16,5,0,13,27,48.1,14,21,10,11,39,60,124,0,"https://fbref.com/en/players/fe05804b/Cala"
2018,"Getafe","La Liga","Carlos Calderón","ESP","MF","22",1995,0,1,1,0,0,1,0,0,NA,0,0,0,0,0,1,0,0,"https://fbref.com/en/players/4e2c27bb/Carlos-Calderon"
2018,"Getafe","La Liga","Djené","TOG","DF","25",1991,36,87,65,71,15,1,34,52,65.4,18,33,14,19,78,165,190,1,"https://fbref.com/en/players/a4971d84/Djene"
2018,"Getafe","La Liga","Hugo Duro","ESP","FW","17",1999,0.2,0,0,0,0,0,0,1,0,1,0,0,0,0,0,0,0,"https://fbref.com/en/players/37e103f8/Hugo-Duro"
2018,"Getafe","La Liga","Fayçal Fajr","MAR","MF,FW","28",1988,26.5,62,45,22,34,6,17,66,25.8,49,26,4,22,30,92,42,0,"https://fbref.com/en/players/79135368/Faycal-Fajr"
2018,"Getafe","La Liga","Mathieu Flamini","FRA","MF","33",1984,5.3,11,5,3,7,1,4,9,44.4,5,2,0,2,8,19,8,0,"https://fbref.com/en/players/148d4105/Mathieu-Flamini"
2018,"Getafe","La Liga","Bruno González","ESP","DF","27",1990,17.1,25,18,18,7,0,13,26,50,13,11,3,8,31,56,107,0,"https://fbref.com/en/players/f11fe861/Bruno-Gonzalez"
2018,"Getafe","La Liga","Vicente Guaita","ESP","GK","30",1987,33,0,0,0,0,0,0,0,NA,0,0,0,0,3,3,12,1,"https://fbref.com/en/players/ab13a5aa/Vicente-Guaita"
2018,"Getafe","La Liga","Álvaro Jiménez","ESP","MF,FW","22",1995,5.9,15,8,5,6,4,8,21,38.1,13,6,0,6,1,16,6,0,"https://fbref.com/en/players/5f5501ed/Alvaro-Jimenez"
2018,"Getafe","La Liga","Mehdi Lacen","ALG","MF","33",1984,0.7,3,1,2,1,0,0,0,NA,0,1,0,1,0,3,1,0,"https://fbref.com/en/players/a3a306f6/Mehdi-Lacen"
2018,"Getafe","La Liga","Emiliano Martínez","ARG","GK","24",1992,5,0,0,0,0,0,0,0,NA,0,0,0,0,0,0,3,0,"https://fbref.com/en/players/7956236f/Emiliano-Martinez"
2018,"Getafe","La Liga","Jorge Molina","ESP","FW","35",1982,31,18,10,3,6,9,4,27,14.8,23,25,4,21,7,25,27,0,"https://fbref.com/en/players/43f71e77/Jorge-Molina"
2018,"Getafe","La Liga","Francisco Molinero","ESP","DF","32",1985,6.4,13,10,10,3,0,7,16,43.8,9,6,0,6,14,27,27,0,"https://fbref.com/en/players/2cea96ce/Francisco-Molinero"
2018,"Getafe","La Liga","Jefferson Montero","ECU","MF,FW","27",1989,0.6,1,1,1,0,0,1,1,100,0,0,0,0,0,1,2,0,"https://fbref.com/en/players/fa6561bf/Jefferson-Montero"
2018,"Getafe","La Liga","Sergio Mora","ESP","MF","37",1979,9,21,15,8,12,1,14,31,45.2,17,10,2,8,15,36,11,0,"https://fbref.com/en/players/f0a31c00/Sergio-Mora"
2018,"Getafe","La Liga","Merveille Ndockyt","CGO","MF,FW","19",1998,0.8,1,1,0,1,0,0,1,0,1,2,0,2,2,3,0,0,"https://fbref.com/en/players/32b84cec/Merveille-Ndockyt"
2018,"Getafe","La Liga","Mathías Olivera","URU","MF","19",1997,1.1,3,1,1,0,2,3,5,60,2,3,0,3,1,4,2,0,"https://fbref.com/en/players/41c12f75/Mathias-Olivera"
2018,"Getafe","La Liga","Daniel Pacheco","ESP","MF,FW","26",1991,1.9,4,4,1,2,1,0,1,0,1,2,0,2,2,6,1,0,"https://fbref.com/en/players/5b2a4b8d/Daniel-Pacheco"
2018,"Getafe","La Liga","Francisco Portillo","ESP","MF,FW","27",1990,27.3,38,23,15,18,5,11,45,24.4,34,25,1,24,22,60,21,0,"https://fbref.com/en/players/8e010ff4/Francisco-Portillo"
2018,"Getafe","La Liga","Alberto Redondo","ESP","DF","20",1997,1,4,3,4,0,0,2,4,50,2,2,1,1,0,4,1,0,"https://fbref.com/en/players/1214f0a6/Alberto-Redondo"
2018,"Getafe","La Liga","Loïc Rémy","FRA","FW,MF","30",1987,5.1,4,2,1,3,0,1,5,20,4,4,0,4,1,5,2,0,"https://fbref.com/en/players/5c2da10f/Loic-Remy"
2018,"Getafe","La Liga","Ángel Rodríguez","ESP","FW","30",1987,25.5,28,19,3,19,6,3,26,11.5,23,18,3,15,6,34,14,0,"https://fbref.com/en/players/8cfc2f69/Angel-Rodriguez"
2018,"Getafe","La Liga","Gaku Shibasaki","JPN","MF,FW","25",1992,11.1,21,10,8,10,3,6,21,28.6,15,6,1,5,19,40,9,0,"https://fbref.com/en/players/d2ac648c/Gaku-Shibasaki"
2018,"Getafe","La Liga","Damián Suárez","URU","DF","29",1988,32,86,64,54,21,11,44,90,48.9,46,34,8,26,46,132,76,1,"https://fbref.com/en/players/ba5004e1/Damian-Suarez"
2018,"Girona","La Liga","Aday","ESP","DF","29",1987,20.4,17,15,11,4,2,6,17,35.3,11,19,3,16,25,42,52,1,"https://fbref.com/en/players/5890cef1/Aday"
2018,"Girona","La Liga","Pedro Alcalá","ESP","DF","28",1989,7.7,9,5,5,4,0,1,3,33.3,2,7,3,4,14,23,41,0,"https://fbref.com/en/players/ba71d071/Pedro-Alcala"
2018,"Girona","La Liga","Eloi Amagat","ESP","MF","32",1985,0.2,0,0,0,0,0,0,1,0,1,0,0,0,0,0,0,0,"https://fbref.com/en/players/12a875ce/Eloi-Amagat"
2018,"Girona","La Liga","Yassine Bounou","MAR","GK","26",1991,29.5,1,1,1,0,0,0,2,0,2,0,0,0,4,5,14,0,"https://fbref.com/en/players/f6798fc3/Yassine-Bounou"
2018,"Girona","La Liga","Bernardo Espinosa","COL","DF","28",1989,31.9,36,22,29,6,1,18,33,54.5,15,27,19,8,66,102,169,0,"https://fbref.com/en/players/4242011c/Bernardo-Espinosa"
2018,"Girona","La Liga","Aleix García","ESP","MF","20",1997,9.5,24,14,13,9,2,12,22,54.5,10,9,1,8,17,41,12,0,"https://fbref.com/en/players/a10361d2/Aleix-Garcia"
2018,"Girona","La Liga","Borja García","ESP","MF","26",1990,31.1,39,18,15,18,6,13,39,33.3,26,31,2,29,30,69,15,0,"https://fbref.com/en/players/e7f4603c/Borja-Garcia"
2018,"Girona","La Liga","Álex Granell","ESP","MF","28",1988,31.6,78,53,31,39,8,38,114,33.3,76,46,3,43,47,125,29,0,"https://fbref.com/en/players/a25250f8/Alex-Granell"
2018,"Girona","La Liga","Gorka Iraizoz","ESP","GK","36",1981,8.5,1,1,1,0,0,1,2,50,1,0,0,0,1,2,9,2,"https://fbref.com/en/players/26f2473f/Gorka-Iraizoz"
2018,"Girona","La Liga","Juanpe","ESP","DF","26",1991,34.1,48,30,28,20,0,30,43,69.8,13,27,19,8,53,101,137,0,"https://fbref.com/en/players/1633fc8a/Juanpe"
2018,"Girona","La Liga","Olarenwaju Kayode","NGA","FW,MF","24",1993,4.3,3,3,1,2,0,0,4,0,4,1,0,1,1,4,0,0,"https://fbref.com/en/players/d3272fba/Olarenwaju-Kayode"
2018,"Girona","La Liga","Anthony Lozano","HON","FW,MF","24",1993,5.2,9,5,2,7,0,1,5,20,4,3,0,3,3,12,2,0,"https://fbref.com/en/players/38699c72/Anthony-Lozano"
2018,"Girona","La Liga","Douglas Luiz","BRA","MF,FW","19",1998,3.4,10,9,4,6,0,3,11,27.3,8,1,0,1,4,14,0,0,"https://fbref.com/en/players/6f7d826d/Douglas-Luiz"
2018,"Girona","La Liga","Pablo Maffeo","ESP","DF","20",1997,29.4,74,55,39,23,12,25,49,51,24,28,7,21,50,124,82,0,"https://fbref.com/en/players/5db04597/Pablo-Maffeo"
2018,"Girona","La Liga","Johan Mojica","COL","DF","24",1992,23.7,42,27,31,8,3,21,37,56.8,16,24,3,21,32,74,42,2,"https://fbref.com/en/players/608f2092/Johan-Mojica"
2018,"Girona","La Liga","Marlos Moreno","COL","MF,DF","20",1996,0.3,1,1,0,0,1,0,1,0,1,1,0,1,0,1,0,0,"https://fbref.com/en/players/8499c713/Marlos-Moreno"
2018,"Girona","La Liga","Marc Muniesa","ESP","DF","25",1992,12.5,33,18,17,15,1,11,23,47.8,12,12,5,7,33,66,40,0,"https://fbref.com/en/players/4db76f57/Marc-Muniesa"
2018,"Girona","La Liga","Michael Olunga","KEN","FW,MF","23",1994,4.8,6,5,1,3,2,1,3,33.3,2,5,0,5,3,9,5,0,"https://fbref.com/en/players/48593154/Michael-Olunga"
2018,"Girona","La Liga","Carles Planas","ESP","DF","26",1991,2.1,5,2,4,1,0,3,6,50,3,1,0,1,5,10,6,0,"https://fbref.com/en/players/72b92c4e/Carles-Planas"
2018,"Girona","La Liga","Pere Pons","ESP","MF","24",1993,28.4,80,54,28,48,4,23,87,26.4,64,28,3,25,30,110,25,0,"https://fbref.com/en/players/29b61deb/Pere-Pons"
2018,"Girona","La Liga","Portu","ESP","MF","25",1992,33.3,30,24,9,11,10,8,33,24.2,25,14,0,14,12,42,1,0,"https://fbref.com/en/players/1bda5842/Portu"
2018,"Girona","La Liga","Jonás Ramalho","ESP","DF","24",1993,25.5,25,16,20,5,0,15,24,62.5,9,25,11,14,35,60,115,0,"https://fbref.com/en/players/be3a0121/Jonas-Ramalho"
2018,"Girona","La Liga","Kévin Soni","CMR","MF","19",1998,0.2,1,1,0,1,0,0,0,NA,0,0,0,0,0,1,0,0,"https://fbref.com/en/players/6435143e/Kevin-Soni"
2018,"Girona","La Liga","Cristhian Stuani","URU","FW","30",1986,30.1,22,14,2,17,3,3,29,10.3,26,10,0,10,5,27,32,0,"https://fbref.com/en/players/220c11f1/Cristhian-Stuani"
2018,"Girona","La Liga","David Timor","ESP","MF,DF","27",1989,10.3,17,10,7,7,3,7,18,38.9,11,10,5,5,20,37,30,1,"https://fbref.com/en/players/174651c8/David-Timor"
2018,"Guingamp","Ligue 1","Nicolas Benezet","FRA","FW,MF","26",1991,18.3,38,30,18,16,4,11,37,29.7,26,8,2,6,12,50,7,0,"https://fbref.com/en/players/30395d3b/Nicolas-Benezet"
2018,"Guingamp","Ligue 1","Ludovic Blas","FRA","MF","19",1997,19.9,23,14,10,12,1,7,36,19.4,29,15,3,12,19,42,9,1,"https://fbref.com/en/players/6191093d/Ludovic-Blas"
2018,"Guingamp","Ligue 1","Jimmy Briand","FRA","FW","31",1985,35.7,33,21,13,15,5,4,42,9.5,38,17,2,15,12,45,51,0,"https://fbref.com/en/players/f83c8d6c/Jimmy-Briand"
2018,"Guingamp","Ligue 1","Abdoul Camara","GUI","FW,MF","27",1990,9.9,6,4,2,3,1,3,11,27.3,8,7,1,6,7,13,4,0,"https://fbref.com/en/players/07296190/Abdoul-Camara"
2018,"Guingamp","Ligue 1","Marcus Coco","FRA","FW,MF","21",1996,17.6,40,28,17,13,10,7,35,20,28,22,3,19,15,55,9,0,"https://fbref.com/en/players/3010aefb/Marcus-Coco"
2018,"Guingamp","Ligue 1","Lucas Deaux","FRA","MF","28",1988,21.6,62,45,21,37,4,20,67,29.9,47,41,6,35,32,94,19,0,"https://fbref.com/en/players/44f8c299/Lucas-Deaux"
2018,"Guingamp","Ligue 1","Mustapha Diallo","SEN","MF","31",1986,15.4,48,36,15,29,4,15,33,45.5,18,20,4,16,20,68,29,0,"https://fbref.com/en/players/6c6ecdd4/Mustapha-Diallo"
2018,"Guingamp","Ligue 1","Étienne Didot","FRA","MF","34",1983,18,54,33,20,33,1,20,43,46.5,23,21,7,14,19,73,29,0,"https://fbref.com/en/players/d2aa8ac0/Etienne-Didot"
2018,"Guingamp","Ligue 1","Félix Eboa Eboa","CMR","DF","20",1997,16.9,19,11,12,7,0,8,16,50,8,21,11,10,39,58,119,2,"https://fbref.com/en/players/167d5018/Felix-Eboa-Eboa"
2018,"Guingamp","Ligue 1","Thibault Giresse","FRA","FW,MF","36",1981,0.3,0,0,0,0,0,0,0,NA,0,0,0,0,1,1,0,0,"https://fbref.com/en/players/81d9a76b/Thibault-Giresse"
2018,"Guingamp","Ligue 1","Clément Grenier","FRA","MF","26",1991,13.4,23,14,3,13,7,12,42,28.6,30,16,1,15,14,37,15,1,"https://fbref.com/en/players/8b298f56/Clement-Grenier"
2018,"Guingamp","Ligue 1","Jordan Ikoko","COD","DF","23",1994,26.9,44,29,24,15,5,22,42,52.4,20,20,2,18,48,92,74,0,"https://fbref.com/en/players/8ff4872e/Jordan-Ikoko"
2018,"Guingamp","Ligue 1","Karl-Johan Johnsson","SWE","GK","27",1990,38,0,0,0,0,0,0,1,0,1,0,0,0,0,0,14,4,"https://fbref.com/en/players/a56bd2ee/Karl-Johan-Johnsson"
2018,"Guingamp","Ligue 1","Christophe Kerbrat","FRA","DF","30",1986,36.9,62,45,47,14,1,35,65,53.8,30,49,40,9,62,124,249,2,"https://fbref.com/en/players/0515a4cb/Christophe-Kerbrat"
2018,"Guingamp","Ligue 1","Jonathan Martins Pereira","FRA","DF","31",1986,12.6,34,18,21,10,3,8,23,34.8,15,9,3,6,37,71,39,1,"https://fbref.com/en/players/b51242ef/Jonathan-Martins-Pereira"
2018,"Guingamp","Ligue 1","Yeni Ngbakoto","COD","FW,MF","25",1992,6.4,11,10,4,6,1,3,10,30,7,10,0,10,9,20,6,0,"https://fbref.com/en/players/813aae2f/Yeni-Ngbakoto"
2018,"Guingamp","Ligue 1","Lebogang Phiri","RSA","MF","22",1994,11.5,28,17,14,12,2,11,43,25.6,32,9,2,7,19,47,13,0,"https://fbref.com/en/players/b6dac747/Lebogang-Phiri"
2018,"Guingamp","Ligue 1","Sloan Privat","FRA","FW","28",1989,0,0,0,0,0,0,0,0,NA,0,0,0,0,0,0,0,0,"https://fbref.com/en/players/4df04a86/Sloan-Privat"
2018,"Guingamp","Ligue 1","Pedro Rebocho","POR","DF","22",1995,19.1,29,22,18,8,3,12,28,42.9,16,20,6,14,19,48,76,0,"https://fbref.com/en/players/276cce2e/Pedro-Rebocho"
2018,"Guingamp","Ligue 1","Yannis Salibur","FRA","FW,MF","26",1991,16.9,11,9,4,6,1,4,15,26.7,11,7,1,6,7,18,2,0,"https://fbref.com/en/players/bb4a42be/Yannis-Salibur"
2018,"Guingamp","Ligue 1","Jérémy Sorbon","FRA","DF","33",1983,29,32,19,24,7,1,10,32,31.3,22,37,24,13,53,85,152,4,"https://fbref.com/en/players/7768df30/Jeremy-Sorbon"
2018,"Guingamp","Ligue 1","Franck Tabanou","FRA","DF","28",1989,11.6,23,17,17,5,1,10,26,38.5,16,5,3,2,26,49,48,0,"https://fbref.com/en/players/15e1afd5/Franck-Tabanou"
2018,"Guingamp","Ligue 1","Marcus Thuram","FRA","FW","19",1997,21.4,20,15,6,10,4,6,25,24,19,14,0,14,5,25,12,0,"https://fbref.com/en/players/6f8cd6d0/Marcus-Thuram"
2018,"Hamburger SV","Bundesliga","Stephan Ambrosius","GHA","DF","18",1998,0.5,0,0,0,0,0,0,0,NA,0,2,1,1,1,1,4,0,"https://fbref.com/en/players/2930c9d8/Stephan-Ambrosius"
2018,"Hamburger SV","Bundesliga","Jann-Fiete Arp","GER","FW,MF","17",2000,9.4,7,5,0,3,4,1,7,14.3,6,6,0,6,2,9,7,0,"https://fbref.com/en/players/c21fb312/Jann-Fiete-Arp"
2018,"Hamburger SV","Bundesliga","Dennis Diekmeier","GER","DF","27",1989,20.8,47,43,31,10,6,25,36,69.4,11,22,11,11,16,63,50,0,"https://fbref.com/en/players/6873f3bc/Dennis-Diekmeier"
2018,"Hamburger SV","Bundesliga","Rick van Drongelen","NED","DF","18",1998,16,30,25,23,7,0,21,28,75,7,20,11,9,19,49,58,1,"https://fbref.com/en/players/f0797d57/Rick-van-Drongelen"
2018,"Hamburger SV","Bundesliga","Albin Ekdal","SWE","MF","28",1989,12.3,39,28,19,19,1,18,29,62.1,11,20,3,17,21,60,19,0,"https://fbref.com/en/players/f503ea63/Albin-Ekdal"
2018,"Hamburger SV","Bundesliga","Mohamed Gouaida","TUN","MF","24",1993,0.6,3,3,1,1,1,0,0,NA,0,0,0,0,0,3,3,0,"https://fbref.com/en/players/d45472b2/Mohamed-Gouaida"
2018,"Hamburger SV","Bundesliga","André Hahn","GER","FW","26",1990,15.1,33,24,15,13,5,10,32,31.3,22,30,2,28,10,43,26,0,"https://fbref.com/en/players/cd82452e/Andre-Hahn"
2018,"Hamburger SV","Bundesliga","Lewis Holtby","GER","MF,FW","26",1990,13.3,44,29,14,26,4,17,32,53.1,15,23,2,21,10,54,9,0,"https://fbref.com/en/players/410ab123/Lewis-Holtby"
2018,"Hamburger SV","Bundesliga","Aaron Hunt","GER","MF,FW","30",1986,23.1,36,24,12,20,4,11,37,29.7,26,20,2,18,14,50,18,2,"https://fbref.com/en/players/5f9f0531/Aaron-Hunt"
2018,"Hamburger SV","Bundesliga","Tatsuya Ito","JPN","MF,FW","20",1997,11.2,16,13,4,8,4,11,22,50,11,28,0,28,6,22,1,0,"https://fbref.com/en/players/6743cef5/Tatsuya-Ito"
2018,"Hamburger SV","Bundesliga","Vasilije Janjicic","SUI","MF","18",1998,3.6,14,11,5,9,0,2,4,50,2,6,1,5,3,17,5,0,"https://fbref.com/en/players/8279c033/Vasilije-Janjicic"
2018,"Hamburger SV","Bundesliga","Bakery Jatta","GAM","MF,FW","19",1998,3.3,14,12,2,12,0,4,6,66.7,2,6,1,5,3,17,5,0,"https://fbref.com/en/players/34c313d5/Bakery-Jatta"
2018,"Hamburger SV","Bundesliga","Gideon Jung","GER","MF,DF","22",1994,28.6,59,41,32,24,3,22,38,57.9,16,29,12,17,38,97,71,1,"https://fbref.com/en/players/a2e7de6f/Gideon-Jung"
2018,"Hamburger SV","Bundesliga","Törles Knöll","GER","MF,FW","19",1997,0.2,0,0,0,0,0,0,0,NA,0,1,0,1,0,0,0,0,"https://fbref.com/en/players/b883006f/Torles-Knoll"
2018,"Hamburger SV","Bundesliga","Filip Kostić","SRB","FW,MF","24",1992,27.1,48,38,16,21,11,20,41,48.8,21,42,1,41,10,58,12,0,"https://fbref.com/en/players/b1cd37e6/Filip-Kostic"
2018,"Hamburger SV","Bundesliga","Christian Mathenia","GER","GK","25",1992,24,0,0,0,0,0,0,3,0,3,0,0,0,0,0,11,3,"https://fbref.com/en/players/4a15e95b/Christian-Mathenia"
2018,"Hamburger SV","Bundesliga","Ville Matti Steinmann","GER","MF","22",1995,6.6,16,10,6,8,2,8,17,47.1,9,6,1,5,18,34,9,1,"https://fbref.com/en/players/ee57792b/Ville-Matti-Steinmann"
2018,"Hamburger SV","Bundesliga","Mërgim Mavraj","ALB","DF","31",1986,16.1,45,32,32,11,2,22,37,59.5,15,28,12,16,21,66,91,3,"https://fbref.com/en/players/0eb5720b/Mergim-Mavraj"
2018,"Hamburger SV","Bundesliga","Nicolai Müller","GER","DF,MF","29",1987,1.1,2,0,0,1,1,0,0,NA,0,1,0,1,0,2,0,0,"https://fbref.com/en/players/5e1df051/Nicolai-Muller"
2018,"Hamburger SV","Bundesliga","Kyriakos Papadopoulos","GRE","DF","25",1992,29,60,54,36,24,0,41,69,59.4,28,54,35,19,43,103,181,2,"https://fbref.com/en/players/931b7c30/Kyriakos-Papadopoulos"
2018,"Hamburger SV","Bundesliga","Julian Pollersbeck","GER","GK","22",1994,10,0,0,0,0,0,0,1,0,1,0,0,0,0,0,4,1,"https://fbref.com/en/players/d6f6ce93/Julian-Pollersbeck"
2018,"Hamburger SV","Bundesliga","Gōtoku Sakai","JPN","DF,MF","26",1991,25.4,50,40,25,18,7,22,47,46.8,25,40,12,28,44,94,55,0,"https://fbref.com/en/players/c8e25f78/Gotoku-Sakai"
2018,"Hamburger SV","Bundesliga","Sejad Salihović","BIH","MF","32",1984,4.1,7,5,3,3,1,0,3,0,3,5,0,5,5,12,1,0,"https://fbref.com/en/players/a4e14205/Sejad-Salihovic"
2018,"Hamburger SV","Bundesliga","Douglas Santos","BRA","DF","23",1994,26.4,90,60,53,34,3,50,87,57.5,37,63,2,61,56,146,96,1,"https://fbref.com/en/players/c50e5bba/Douglas-Santos"
2018,"Hamburger SV","Bundesliga","Sven Schipplock","GER","FW,MF","28",1988,3.8,7,6,1,5,1,0,1,0,1,4,0,4,1,8,3,0,"https://fbref.com/en/players/53eeaf6a/Sven-Schipplock"
2018,"Hamburger SV","Bundesliga","Josha Vagnoman","GER","MF","16",2000,0.2,1,1,0,1,0,1,1,100,0,0,0,0,0,1,0,0,"https://fbref.com/en/players/fb377d11/Josha-Vagnoman"
2018,"Hamburger SV","Bundesliga","Walace","BRA","MF","22",1995,14.6,38,25,13,23,2,19,44,43.2,25,25,3,22,21,59,14,1,"https://fbref.com/en/players/26db8853/Walace"
2018,"Hamburger SV","Bundesliga","Luca Waldschmidt","GER","MF,FW","21",1996,8.8,10,6,1,8,1,3,10,30,7,11,0,11,3,13,2,0,"https://fbref.com/en/players/e5a35ae9/Luca-Waldschmidt"
2018,"Hamburger SV","Bundesliga","Bobby Wood","USA","FW,MF","24",1992,17.9,13,8,2,4,7,3,9,33.3,6,4,0,4,2,15,13,0,"https://fbref.com/en/players/9853983f/Bobby-Wood"
2018,"Hannover 96","Bundesliga","Miiko Albornoz","CHI","DF,MF","26",1990,7.8,24,20,17,4,3,11,16,68.8,5,15,2,13,5,29,23,0,"https://fbref.com/en/players/d459281d/Miiko-Albornoz"
2018,"Hannover 96","Bundesliga","Waldemar Anton","GER","DF,MF","21",1996,25.3,65,49,39,21,5,41,65,63.1,24,56,27,29,39,104,112,3,"https://fbref.com/en/players/5e66fa06/Waldemar-Anton"
2018,"Hannover 96","Bundesliga","Marvin Bakalorz","GER","MF","27",1989,22.8,44,25,19,23,2,22,37,59.5,15,38,7,31,20,64,46,1,"https://fbref.com/en/players/04c11885/Marvin-Bakalorz"
2018,"Hannover 96","Bundesliga","Noah Joel Sarenren Bazee","NGA","FW,MF","20",1996,1.3,0,0,0,0,0,0,0,NA,0,3,0,3,0,0,3,0,"https://fbref.com/en/players/fbbc8e15/Noah-Joel-Sarenren-Bazee"
2018,"Hannover 96","Bundesliga","Ihlas Bebou","TOG","MF,FW","23",1994,23.8,37,29,15,17,5,14,27,51.9,13,34,3,31,24,61,27,0,"https://fbref.com/en/players/a53b661f/Ihlas-Bebou"
2018,"Hannover 96","Bundesliga","Charlison Benschop","CUW","MF,DF","27",1989,2,4,4,1,3,0,3,8,37.5,5,1,0,1,2,6,2,0,"https://fbref.com/en/players/fc93fdf1/Charlison-Benschop"
2018,"Hannover 96","Bundesliga","Josip Elez","CRO","DF","23",1994,8.6,12,8,9,2,1,5,9,55.6,4,9,7,2,16,28,39,1,"https://fbref.com/en/players/eafac393/Josip-Elez"
2018,"Hannover 96","Bundesliga","Michael Esser","GER","GK","29",1987,3,0,0,0,0,0,0,1,0,1,0,0,0,0,0,0,0,"https://fbref.com/en/players/83e0eeb4/Michael-Esser"
2018,"Hannover 96","Bundesliga","Felipe","BRA","DF","30",1987,5.1,8,8,4,4,0,2,4,50,2,4,3,1,11,19,29,0,"https://fbref.com/en/players/de164de6/Felipe"
2018,"Hannover 96","Bundesliga","Iver Fossum","NOR","MF","21",1996,14.5,27,19,8,13,6,10,31,32.3,21,28,3,25,15,42,14,0,"https://fbref.com/en/players/ce218223/Iver-Fossum"
2018,"Hannover 96","Bundesliga","Niclas Füllkrug","GER","FW","24",1993,26.5,16,11,4,8,4,10,20,50,10,22,3,19,8,24,30,0,"https://fbref.com/en/players/4f16405e/Niclas-Fullkrug"
2018,"Hannover 96","Bundesliga","Martin Harnik","AUT","FW,MF","30",1987,21,17,10,4,10,3,4,25,16,21,21,2,19,8,25,26,0,"https://fbref.com/en/players/99b7584f/Martin-Harnik"
2018,"Hannover 96","Bundesliga","Timo Hübers","GER","DF","21",1996,5,11,10,9,2,0,9,15,60,6,13,8,5,9,20,31,0,"https://fbref.com/en/players/94302c52/Timo-Hubers"
2018,"Hannover 96","Bundesliga","Florian Hübner","GER","DF","26",1991,3.6,10,9,8,2,0,5,9,55.6,4,3,2,1,6,16,21,0,"https://fbref.com/en/players/e87ad81a/Florian-Hubner"
2018,"Hannover 96","Bundesliga","Jonathas","BRA","FW","28",1989,7,7,3,2,4,1,1,2,50,1,3,1,2,0,7,9,0,"https://fbref.com/en/players/531807b3/Jonathas"
2018,"Hannover 96","Bundesliga","Kenan Karaman","TUR","MF,FW","23",1994,9.5,16,13,9,6,1,6,7,85.7,1,10,4,6,1,17,17,0,"https://fbref.com/en/players/8f0f2230/Kenan-Karaman"
2018,"Hannover 96","Bundesliga","Felix Klaus","GER","MF,FW","24",1992,22,48,38,20,21,7,23,50,46,27,29,4,25,8,56,28,0,"https://fbref.com/en/players/aeda1f69/Felix-Klaus"
2018,"Hannover 96","Bundesliga","Julian Korb","GER","DF,MF","25",1992,26,52,41,27,19,6,37,68,54.4,31,30,2,28,22,74,77,0,"https://fbref.com/en/players/3dffff26/Julian-Korb"
2018,"Hannover 96","Bundesliga","Sebastian Maier","GER","MF","23",1993,2.9,11,6,4,7,0,2,12,16.7,10,6,1,5,4,15,1,1,"https://fbref.com/en/players/e8385ec4/Sebastian-Maier"
2018,"Hannover 96","Bundesliga","Linton Maina","GER","MF","18",1999,0.1,1,1,0,0,1,0,0,NA,0,0,0,0,1,2,0,0,"https://fbref.com/en/players/e5d85da8/Linton-Maina"
2018,"Hannover 96","Bundesliga","Matthias Ostrzolek","GER","DF,MF","27",1990,26.4,68,53,43,20,5,38,57,66.7,19,39,10,29,30,98,58,1,"https://fbref.com/en/players/1cd87320/Matthias-Ostrzolek"
2018,"Hannover 96","Bundesliga","Salif Sané","SEN","DF","26",1990,32,57,43,46,10,1,40,64,62.5,24,49,29,20,57,114,238,6,"https://fbref.com/en/players/791abba1/Salif-Sane"
2018,"Hannover 96","Bundesliga","Manuel Schmiedebach","GER","MF","28",1988,1.8,5,5,5,0,0,4,9,44.4,5,2,0,2,5,10,6,0,"https://fbref.com/en/players/d8f5dc3d/Manuel-Schmiedebach"
2018,"Hannover 96","Bundesliga","Pirmin Schwegler","SUI","MF","30",1987,25.8,81,57,25,55,1,42,70,60,28,33,9,24,49,130,46,1,"https://fbref.com/en/players/5528407e/Pirmin-Schwegler"
2018,"Hannover 96","Bundesliga","Oliver Sorg","GER","DF,MF","27",1990,18.7,46,28,27,18,1,23,53,43.4,30,24,7,17,42,88,71,0,"https://fbref.com/en/players/541cdd20/Oliver-Sorg"
2018,"Hannover 96","Bundesliga","Philipp Tschauner","GER","GK","31",1985,31,1,0,1,0,0,1,2,50,1,2,0,2,0,1,8,5,"https://fbref.com/en/players/73e2f6eb/Philipp-Tschauner"
2018,"Hellas Verona","Serie A","Rolando Aarons","ENG","MF,FW","21",1995,5.7,13,8,4,4,5,1,7,14.3,6,3,1,2,2,15,0,0,"https://fbref.com/en/players/c5942695/Rolando-Aarons"
2018,"Hellas Verona","Serie A","Nícolas Andrade","BRA","GK","29",1988,36,2,1,2,0,0,1,4,25,3,2,0,2,2,4,16,7,"https://fbref.com/en/players/326d09ef/Nicolas-Andrade"
2018,"Hellas Verona","Serie A","Enrico Bearzotti","ITA","DF,FW","20",1996,4.6,3,2,2,0,1,1,4,25,3,3,1,2,4,7,18,0,"https://fbref.com/en/players/c67836b8/Enrico-Bearzotti"
2018,"Hellas Verona","Serie A","Daniel Bessa","ITA","MF,FW","24",1993,15.4,26,19,9,15,2,8,29,27.6,21,12,2,10,14,40,8,1,"https://fbref.com/en/players/88895312/Daniel-Bessa"
2018,"Hellas Verona","Serie A","Matteo Bianchetti","ITA","DF","24",1993,1.4,3,1,3,0,0,1,3,33.3,2,3,2,1,2,5,8,0,"https://fbref.com/en/players/b3a20f18/Matteo-Bianchetti"
2018,"Hellas Verona","Serie A","Deian Boldor","ROU","DF","22",1995,1,3,2,3,0,0,2,3,66.7,1,5,2,3,3,6,11,0,"https://fbref.com/en/players/9b7533de/Deian-Boldor"
2018,"Hellas Verona","Serie A","Marcel Büchel","LIE","MF","26",1991,18.8,37,21,15,21,1,13,48,27.1,35,35,6,29,45,82,46,1,"https://fbref.com/en/players/2edeb221/Marcel-Buchel"
2018,"Hellas Verona","Serie A","Martín Cáceres","URU","DF","30",1987,12.9,16,11,14,1,1,7,18,38.9,11,9,5,4,19,35,41,1,"https://fbref.com/en/players/e94d79e3/Martin-Caceres"
2018,"Hellas Verona","Serie A","Simone Calvano","ITA","MF","24",1993,7.2,13,12,4,9,0,3,16,18.8,13,10,4,6,15,28,14,1,"https://fbref.com/en/players/9dabfcf5/Simone-Calvano"
2018,"Hellas Verona","Serie A","Antonio Caracciolo","ITA","DF","27",1990,31.7,52,34,41,8,3,17,30,56.7,13,64,44,20,39,91,203,0,"https://fbref.com/en/players/99d8fc35/Antonio-Caracciolo"
2018,"Hellas Verona","Serie A","Alessio Cerci","ITA","FW","30",1987,18.2,15,10,7,3,5,4,16,25,12,4,0,4,4,19,8,0,"https://fbref.com/en/players/5370cba7/Alessio-Cerci"
2018,"Hellas Verona","Serie A","Andrea Danzi","ITA","MF","18",1999,4.4,11,6,7,4,0,5,13,38.5,8,3,0,3,5,16,5,1,"https://fbref.com/en/players/263b855a/Andrea-Danzi"
2018,"Hellas Verona","Serie A","Mohamed Fares","ALG","DF,MF","21",1996,28.9,50,33,29,17,4,16,42,38.1,26,24,5,19,50,100,132,2,"https://fbref.com/en/players/b7a5bc86/Mohamed-Fares"
2018,"Hellas Verona","Serie A","Alex Ferrari","ITA","DF","23",1994,23.7,73,54,42,23,8,36,67,53.7,31,41,15,26,47,120,117,4,"https://fbref.com/en/players/d0dbca9f/Alex-Ferrari"
2018,"Hellas Verona","Serie A","Gian Filippo Felicioli","ITA","MF,DF","19",1997,3.1,13,8,5,5,3,0,4,0,4,0,0,0,5,18,6,0,"https://fbref.com/en/players/ff219f73/Gian-Filippo-Felicioli"
2018,"Hellas Verona","Serie A","Marco Fossati","ITA","MF","24",1992,12.2,27,13,11,14,2,11,33,33.3,22,19,6,13,23,50,31,1,"https://fbref.com/en/players/39bec070/Marco-Fossati"
2018,"Hellas Verona","Serie A","Thomas Heurtaux","FRA","DF","29",1988,15.5,14,11,12,2,0,4,8,50,4,25,16,9,37,51,97,1,"https://fbref.com/en/players/32d1c24f/Thomas-Heurtaux"
2018,"Hellas Verona","Serie A","Moise Kean","ITA","FW","17",2000,12.6,8,5,1,3,4,1,6,16.7,5,6,0,6,7,15,4,0,"https://fbref.com/en/players/3d50bcdb/Moise-Kean"
2018,"Hellas Verona","Serie A","Ryder Matos","BRA","FW,MF","24",1993,10.9,18,15,11,5,2,4,9,44.4,5,5,0,5,3,21,9,1,"https://fbref.com/en/players/7280b54f/Ryder-Matos"
2018,"Hellas Verona","Serie A","Giampaolo Pazzini","ITA","FW","32",1984,11,0,0,0,0,0,0,4,0,4,2,0,2,1,1,13,0,"https://fbref.com/en/players/6ca663b4/Giampaolo-Pazzini"
2018,"Hellas Verona","Serie A","Bruno Petković","CRO","FW","22",1994,10.2,14,12,3,8,3,6,13,46.2,7,11,1,10,7,21,12,0,"https://fbref.com/en/players/24228180/Bruno-Petkovic"
2018,"Hellas Verona","Serie A","Rômulo","ITA","MF,DF","30",1987,35.2,58,44,23,29,6,13,54,24.1,41,29,2,27,43,101,41,0,"https://fbref.com/en/players/07abb358/Romulo"
2018,"Hellas Verona","Serie A","Lee Seung-woo","KOR","MF,FW","19",1998,4,3,2,0,1,2,0,6,0,6,1,0,1,2,5,0,0,"https://fbref.com/en/players/0f22b650/Lee-Seung-woo"
2018,"Hellas Verona","Serie A","Marco Silvestri","ITA","GK","26",1991,2,0,0,0,0,0,0,0,NA,0,0,0,0,1,1,0,0,"https://fbref.com/en/players/0d422df7/Marco-Silvestri"
2018,"Hellas Verona","Serie A","Samuel Souprayen","FRA","DF","28",1989,17.6,29,19,25,3,1,12,19,63.2,7,18,9,9,22,51,67,1,"https://fbref.com/en/players/f7c9fcd6/Samuel-Souprayen"
2018,"Hellas Verona","Serie A","Ľubomír Tupta","SVK","MF,FW","19",1998,0.4,0,0,0,0,0,0,3,0,3,0,0,0,0,0,0,0,"https://fbref.com/en/players/b02af64f/Lubomir-Tupta"
2018,"Hellas Verona","Serie A","Mattia Valoti","ITA","MF,FW","23",1993,17.5,62,41,21,35,6,11,53,20.8,42,25,3,22,41,103,37,1,"https://fbref.com/en/players/c414df9d/Mattia-Valoti"
2018,"Hellas Verona","Serie A","Daniele Verde","ITA","FW,MF","21",1996,21.7,10,9,8,1,1,6,20,30,14,8,0,8,30,40,19,0,"https://fbref.com/en/players/d3298c99/Daniele-Verde"
2018,"Hellas Verona","Serie A","Jagoš Vuković","SRB","DF","29",1988,14.8,5,4,3,1,1,3,6,50,3,19,14,5,20,25,113,0,"https://fbref.com/en/players/ba06950a/Jagos-Vukovic"
2018,"Hellas Verona","Serie A","Mattia Zaccagni","ITA","MF,FW","22",1995,1.7,7,5,4,0,3,2,3,66.7,1,0,0,0,5,12,0,0,"https://fbref.com/en/players/d85c238b/Mattia-Zaccagni"
2018,"Hellas Verona","Serie A","Bruno Zuculini","ARG","MF","24",1993,13.5,68,49,37,28,3,20,48,41.7,28,35,8,27,38,106,31,0,"https://fbref.com/en/players/17cddb4d/Bruno-Zuculini"
2018,"Hellas Verona","Serie A","Franco Zuculini","ARG","MF,FW","26",1990,3.7,11,8,5,5,1,5,14,35.7,9,4,0,4,5,16,6,1,"https://fbref.com/en/players/9c31bb89/Franco-Zuculini"
2018,"Hertha BSC","Bundesliga","Per Ciljan Skjelbred","NOR","MF","30",1987,24.3,89,66,33,54,2,42,64,65.6,22,31,6,25,45,134,23,0,"https://fbref.com/en/players/ecab64a0/Per-Ciljan-Skjelbred"
2018,"Hertha BSC","Bundesliga","Palkó Dárdai","HUN","FW,MF","18",1999,0.3,0,0,0,0,0,0,0,NA,0,0,0,0,0,0,1,0,"https://fbref.com/en/players/db7161ed/Palko-Dardai"
2018,"Hertha BSC","Bundesliga","Vladimír Darida","CZE","MF","26",1990,18.2,38,28,11,18,9,11,26,42.3,15,22,4,18,24,62,23,0,"https://fbref.com/en/players/3eb0f2df/Vladimir-Darida"
2018,"Hertha BSC","Bundesliga","Ondrej Duda","SVK","MF","22",1994,8.3,16,12,7,6,3,6,14,42.9,8,15,0,15,4,20,8,0,"https://fbref.com/en/players/79ca3e23/Ondrej-Duda"
2018,"Hertha BSC","Bundesliga","Alexander Esswein","GER","FW,MF","27",1990,6.9,25,16,13,10,2,12,25,48,13,4,0,4,9,34,11,0,"https://fbref.com/en/players/b48215cd/Alexander-Esswein"
2018,"Hertha BSC","Bundesliga","Genki Haraguchi","JPN","FW","26",1991,2.3,6,6,2,3,1,2,6,33.3,4,4,0,4,2,8,3,0,"https://fbref.com/en/players/f24ea523/Genki-Haraguchi"
2018,"Hertha BSC","Bundesliga","Vedad Ibišević","BIH","FW","32",1984,16.1,10,8,1,5,4,4,7,57.1,3,8,1,7,4,14,23,0,"https://fbref.com/en/players/c3fd9887/Vedad-Ibisevic"
2018,"Hertha BSC","Bundesliga","Rune Jarstein","NOR","GK","32",1984,31,1,1,1,0,0,1,2,50,1,0,0,0,0,1,8,5,"https://fbref.com/en/players/27d2618c/Rune-Jarstein"
2018,"Hertha BSC","Bundesliga","Salomon Kalou","CIV","FW,MF","31",1985,24.5,19,11,12,5,2,9,17,52.9,8,37,1,36,10,29,29,0,"https://fbref.com/en/players/2042d931/Salomon-Kalou"
2018,"Hertha BSC","Bundesliga","Thomas Kraft","GER","GK","29",1988,3,0,0,0,0,0,0,0,NA,0,0,0,0,0,0,1,0,"https://fbref.com/en/players/bb25c778/Thomas-Kraft"
2018,"Hertha BSC","Bundesliga","Sebastian Langkamp","GER","DF","29",1988,10.6,15,12,9,6,0,11,18,61.1,7,7,4,3,21,36,58,1,"https://fbref.com/en/players/74d70fb5/Sebastian-Langkamp"
2018,"Hertha BSC","Bundesliga","Valentino Lazaro","AUT","MF,FW","21",1996,20.7,33,28,11,12,10,15,31,48.4,16,35,2,33,15,48,32,0,"https://fbref.com/en/players/016ff750/Valentino-Lazaro"
2018,"Hertha BSC","Bundesliga","Mathew Leckie","AUS","FW,MF","26",1991,20.6,35,30,16,15,4,20,35,57.1,15,26,3,23,19,54,32,1,"https://fbref.com/en/players/b93b7882/Mathew-Leckie"
2018,"Hertha BSC","Bundesliga","Fabian Lustenberger","SUI","MF,DF","29",1988,17.6,47,34,26,20,1,21,31,67.7,10,31,12,19,24,71,74,1,"https://fbref.com/en/players/a63a995f/Fabian-Lustenberger"
2018,"Hertha BSC","Bundesliga","Arne Maier","GER","MF","18",1999,13.6,29,23,12,16,1,18,24,75,6,19,3,16,24,53,20,0,"https://fbref.com/en/players/ab700320/Arne-Maier"
2018,"Hertha BSC","Bundesliga","Maximilian Mittelstädt","GER","MF,DF","20",1997,4.7,19,11,14,4,1,10,19,52.6,9,8,1,7,9,28,11,0,"https://fbref.com/en/players/88d4144a/Maximilian-Mittelstadt"
2018,"Hertha BSC","Bundesliga","Peter Pekarík","SVK","DF","30",1986,15.3,42,33,17,21,4,21,29,72.4,8,23,3,20,18,60,44,0,"https://fbref.com/en/players/c18d22f5/Peter-Pekarik"
2018,"Hertha BSC","Bundesliga","Marvin Plattenhardt","GER","DF","25",1992,33,57,43,39,15,3,35,50,70,15,24,7,17,27,84,92,0,"https://fbref.com/en/players/f7aa75bd/Marvin-Plattenhardt"
2018,"Hertha BSC","Bundesliga","Karim Rekik","NED","DF","22",1994,25.6,38,29,32,6,0,24,26,92.3,2,27,11,16,28,66,116,2,"https://fbref.com/en/players/3376a776/Karim-Rekik"
2018,"Hertha BSC","Bundesliga","Julian Schieber","GER","MF,FW","28",1989,0.6,1,1,0,0,1,1,1,100,0,1,0,1,0,1,2,0,"https://fbref.com/en/players/37c213cf/Julian-Schieber"
2018,"Hertha BSC","Bundesliga","Davie Selke","GER","FW","22",1995,21,13,10,1,5,7,4,9,44.4,5,26,5,21,2,15,20,1,"https://fbref.com/en/players/1238a3f9/Davie-Selke"
2018,"Hertha BSC","Bundesliga","Niklas Stark","GER","DF,MF","22",1995,24.6,49,31,32,17,0,22,30,73.3,8,39,14,25,34,83,165,0,"https://fbref.com/en/players/aad48be9/Niklas-Stark"
2018,"Hertha BSC","Bundesliga","Valentin Stocker","SUI","MF","28",1989,0.6,1,0,0,1,0,0,0,NA,0,1,0,1,0,1,0,0,"https://fbref.com/en/players/6b85f966/Valentin-Stocker"
2018,"Hertha BSC","Bundesliga","Jordan Torunarigha","GER","DF","19",1997,7.4,18,12,16,2,0,7,13,53.8,6,20,13,7,23,41,43,1,"https://fbref.com/en/players/f86cabbd/Jordan-Torunarigha"
2018,"Hertha BSC","Bundesliga","Mitchell Weiser","GER","DF,FW","23",1994,22,54,43,20,27,7,17,38,44.7,21,28,1,27,44,98,37,1,"https://fbref.com/en/players/30c220c3/Mitchell-Weiser"
2018,"Hoffenheim","Bundesliga","Kevin Akpoguma","NGA","DF","22",1995,18.8,47,39,29,16,2,24,35,68.6,11,18,4,14,22,69,60,1,"https://fbref.com/en/players/6ec6fde0/Kevin-Akpoguma"
2018,"Hoffenheim","Bundesliga","Nadiem Amiri","GER","MF","20",1996,19.4,39,26,13,21,5,19,42,45.2,23,33,4,29,17,56,7,0,"https://fbref.com/en/players/555d5edd/Nadiem-Amiri"
2018,"Hoffenheim","Bundesliga","Oliver Baumann","GER","GK","27",1990,34,0,0,0,0,0,0,2,0,2,0,0,0,1,1,15,6,"https://fbref.com/en/players/47064058/Oliver-Baumann"
2018,"Hoffenheim","Bundesliga","Ermin Bičakčić","BIH","DF","27",1990,6.1,17,15,8,8,1,8,12,66.7,4,4,2,2,9,26,26,0,"https://fbref.com/en/players/7aac47fe/Ermin-Bicakcic"
2018,"Hoffenheim","Bundesliga","Kerem Demirbay","GER","MF","24",1993,13.5,38,30,15,17,6,12,28,42.9,16,21,3,18,14,52,21,0,"https://fbref.com/en/players/54b4dc4e/Kerem-Demirbay"
2018,"Hoffenheim","Bundesliga","Dennis Geiger","GER","MF","19",1998,17.6,52,36,19,31,2,16,40,40,24,38,2,36,15,67,7,0,"https://fbref.com/en/players/37f606f0/Dennis-Geiger"
2018,"Hoffenheim","Bundesliga","Serge Gnabry","GER","FW","22",1995,16.7,32,22,10,18,4,13,24,54.2,11,15,1,14,8,40,9,2,"https://fbref.com/en/players/88e357ef/Serge-Gnabry"
2018,"Hoffenheim","Bundesliga","Florian Grillitsch","AUT","MF","21",1995,21,68,46,30,36,2,35,58,60.3,23,26,3,23,39,107,25,1,"https://fbref.com/en/players/ffbbc83b/Florian-Grillitsch"
2018,"Hoffenheim","Bundesliga","Robin Hack","GER","FW,MF","18",1998,0.8,2,2,1,0,1,0,1,0,1,1,1,0,0,2,1,0,"https://fbref.com/en/players/0174ba21/Robin-Hack"
2018,"Hoffenheim","Bundesliga","Benjamin Hübner","GER","DF","28",1989,25.7,71,56,43,27,1,31,46,67.4,15,40,18,22,51,122,114,0,"https://fbref.com/en/players/99de6b6f/Benjamin-Hubner"
2018,"Hoffenheim","Bundesliga","Pavel Kadeřábek","CZE","FW,DF","25",1992,24.4,44,30,22,18,4,20,44,45.5,24,27,8,19,34,78,45,1,"https://fbref.com/en/players/79c90e45/Pavel-Kaderabek"
2018,"Hoffenheim","Bundesliga","Andrej Kramarić","CRO","FW,MF","26",1991,24.8,8,6,4,3,1,3,8,37.5,5,15,0,15,6,14,7,0,"https://fbref.com/en/players/603cb947/Andrej-Kramaric"
2018,"Hoffenheim","Bundesliga","Håvard Nordtveit","NOR","DF","27",1990,10.8,19,16,10,9,0,13,18,72.2,5,19,8,11,10,29,50,0,"https://fbref.com/en/players/6cafd68d/Havard-Nordtveit"
2018,"Hoffenheim","Bundesliga","Philipp Ochs","GER","FW,DF","20",1997,0.8,5,4,1,3,1,1,2,50,1,0,0,0,1,6,0,0,"https://fbref.com/en/players/78952998/Philipp-Ochs"
2018,"Hoffenheim","Bundesliga","Felix Passlack","GER","FW,DF","19",1998,0.7,2,2,2,0,0,2,3,66.7,1,0,0,0,0,2,2,0,"https://fbref.com/en/players/5c899683/Felix-Passlack"
2018,"Hoffenheim","Bundesliga","Eugen Polanski","POL","MF","31",1986,2.9,8,7,3,4,1,5,6,83.3,1,6,1,5,4,12,4,0,"https://fbref.com/en/players/fb2a63bb/Eugen-Polanski"
2018,"Hoffenheim","Bundesliga","Stefan Posch","AUT","DF","20",1997,8.4,28,21,18,7,3,15,27,55.6,12,15,4,11,24,52,30,0,"https://fbref.com/en/players/7f609bfc/Stefan-Posch"
2018,"Hoffenheim","Bundesliga","Lukas Rupp","GER","MF,FW","26",1991,12.9,36,32,18,14,4,19,36,52.8,17,18,0,18,13,49,13,2,"https://fbref.com/en/players/3faa1780/Lukas-Rupp"
2018,"Hoffenheim","Bundesliga","Nico Schulz","GER","FW,MF","24",1993,19.8,40,29,17,14,9,20,27,74.1,7,33,5,28,23,63,24,0,"https://fbref.com/en/players/fa274d97/Nico-Schulz"
2018,"Hoffenheim","Bundesliga","Ádám Szalai","HUN","FW","29",1987,10,8,7,1,4,3,2,5,40,3,9,2,7,0,8,10,0,"https://fbref.com/en/players/53e07d0b/Adam-Szalai"
2018,"Hoffenheim","Bundesliga","Jeremy Toljan","GER","DF,FW","22",1994,2,3,1,1,2,0,2,3,66.7,1,3,0,3,0,3,3,0,"https://fbref.com/en/players/a96e5dc0/Jeremy-Toljan"
2018,"Hoffenheim","Bundesliga","Mark Uth","GER","FW","25",1991,24.2,32,23,4,21,7,5,22,22.7,17,30,3,27,9,41,19,0,"https://fbref.com/en/players/a3ddb1b9/Mark-Uth"
2018,"Hoffenheim","Bundesliga","Kevin Vogt","GER","DF","25",1991,31,38,28,30,7,1,23,34,67.6,11,37,23,14,25,63,114,2,"https://fbref.com/en/players/1d8e9add/Kevin-Vogt"
2018,"Hoffenheim","Bundesliga","Sandro Wagner","GER","FW","29",1987,9.7,8,5,3,5,0,5,6,83.3,1,11,3,8,3,11,13,0,"https://fbref.com/en/players/61b0b44d/Sandro-Wagner"
2018,"Hoffenheim","Bundesliga","Steven Zuber","SUI","FW,DF","25",1991,15.9,40,30,22,13,5,26,41,63.4,15,18,3,15,17,57,27,0,"https://fbref.com/en/players/b6a6e0a7/Steven-Zuber"
2018,"Hoffenheim","Bundesliga","Robert Žulj","AUT","MF,FW","25",1992,2.3,3,3,1,2,0,1,1,100,0,3,0,3,0,3,2,0,"https://fbref.com/en/players/f2e3b81c/Robert-Zulj"
2018,"Huddersfield","Premier League","Philip Billing","DEN","MF","21",1996,8.5,25,16,11,11,3,8,22,36.4,14,17,1,16,18,43,19,0,"https://fbref.com/en/players/d328a254/Philip-Billing"
2018,"Huddersfield","Premier League","Martin Cranie","ENG","DF","30",1986,2,3,2,2,1,0,0,1,0,1,3,3,0,1,4,10,0,"https://fbref.com/en/players/9e53837d/Martin-Cranie"
2018,"Huddersfield","Premier League","Laurent Depoitre","BEL","FW","28",1988,20.2,14,8,4,8,2,3,21,14.3,18,15,3,12,11,25,36,0,"https://fbref.com/en/players/aa5859cb/Laurent-Depoitre"
2018,"Huddersfield","Premier League","Florent Hadergjonaj","KVX","DF,MF","23",1994,18.6,21,16,7,10,4,12,30,40,18,22,10,12,17,38,45,0,"https://fbref.com/en/players/9aa186b2/Florent-Hadergjonaj"
2018,"Huddersfield","Premier League","Michael Hefele","GER","DF","26",1990,0.4,0,0,0,0,0,0,0,NA,0,0,0,0,1,1,5,0,"https://fbref.com/en/players/91bdc54a/Michael-Hefele"
2018,"Huddersfield","Premier League","Jonathan Hogg","ENG","MF","28",1988,26.6,93,64,29,59,5,26,89,29.2,63,51,12,39,69,162,48,0,"https://fbref.com/en/players/9306d5ea/Jonathan-Hogg"
2018,"Huddersfield","Premier League","Tom Ince","ENG","MF,FW","25",1992,27.2,35,27,14,16,5,10,29,34.5,19,20,0,20,12,47,12,0,"https://fbref.com/en/players/67d23ab0/Tom-Ince"
2018,"Huddersfield","Premier League","Mathias Jørgensen","DEN","DF","27",1990,38,55,36,40,13,2,19,45,42.2,26,49,20,29,76,131,249,5,"https://fbref.com/en/players/0db5d2c8/Mathias-Jorgensen"
2018,"Huddersfield","Premier League","Elias Kachunga","COD","FW,MF","25",1992,14.8,30,26,13,12,5,8,19,42.1,11,14,1,13,2,32,9,0,"https://fbref.com/en/players/5bddccc9/Elias-Kachunga"
2018,"Huddersfield","Premier League","Terence Kongolo","NED","DF","23",1994,11.7,33,20,19,13,1,14,22,63.6,8,12,6,6,32,65,71,0,"https://fbref.com/en/players/1f9a3a04/Terence-Kongolo"
2018,"Huddersfield","Premier League","Rajiv van La Parra","NED","FW,MF","26",1991,23.7,41,29,18,15,8,12,41,29.3,29,27,1,26,21,62,8,1,"https://fbref.com/en/players/1931bde9/Rajiv-van-La-Parra"
2018,"Huddersfield","Premier League","Joe Lolley","ENG","FW,MF","24",1992,2.5,2,0,1,1,0,0,2,0,2,0,0,0,3,5,2,1,"https://fbref.com/en/players/c5f13182/Joe-Lolley"
2018,"Huddersfield","Premier League","Jonas Lössl","DEN","GK","28",1989,38,1,0,1,0,0,1,5,20,4,0,0,0,4,5,13,6,"https://fbref.com/en/players/939bc634/Jonas-Lossl"
2018,"Huddersfield","Premier League","Chris Löwe","GER","DF","28",1989,17.6,43,29,26,15,2,20,44,45.5,24,21,8,13,34,77,65,3,"https://fbref.com/en/players/c6896eab/Chris-Lowe"
2018,"Huddersfield","Premier League","Scott Malone","ENG","DF","26",1991,12.4,39,29,27,10,2,17,24,70.8,7,12,2,10,26,65,43,2,"https://fbref.com/en/players/f15a50e8/Scott-Malone"
2018,"Huddersfield","Premier League","Aaron Mooy","AUS","MF","26",1990,34.1,102,60,39,51,12,23,55,41.8,32,39,5,34,38,140,52,0,"https://fbref.com/en/players/47b7e3af/Aaron-Mooy"
2018,"Huddersfield","Premier League","Steve Mounié","BEN","FW","22",1994,20.6,11,8,2,4,5,0,19,0,19,23,3,20,7,18,30,0,"https://fbref.com/en/players/19ba6c6d/Steve-Mounie"
2018,"Huddersfield","Premier League","Kasey Palmer","JAM","MF,FW","20",1996,1.9,6,3,2,3,1,2,8,25,6,5,0,5,0,6,2,0,"https://fbref.com/en/players/453f566a/Kasey-Palmer"
2018,"Huddersfield","Premier League","Alex Pritchard","ENG","MF,FW","24",1993,11.1,18,8,2,6,10,10,21,47.6,11,6,1,5,5,23,11,0,"https://fbref.com/en/players/ff9fcd4d/Alex-Pritchard"
2018,"Huddersfield","Premier League","Collin Quaner","GER","FW,MF","26",1991,14.2,22,15,8,8,6,9,26,34.6,17,24,4,20,11,33,15,0,"https://fbref.com/en/players/19b8b0b9/Collin-Quaner"
2018,"Huddersfield","Premier League","Abdelhamid Sabiri","MAR","MF","20",1996,2.4,5,4,2,0,3,1,7,14.3,6,4,0,4,1,6,2,0,"https://fbref.com/en/players/4830e0af/Abdelhamid-Sabiri"
2018,"Huddersfield","Premier League","Christopher Schindler","GER","DF","27",1990,36.3,83,61,56,27,0,24,41,58.5,17,54,30,24,75,158,275,1,"https://fbref.com/en/players/8ae9869d/Christopher-Schindler"
2018,"Huddersfield","Premier League","Tommy Smith","ENG","DF","25",1992,21.2,38,27,18,14,6,23,36,63.9,13,22,6,16,26,64,80,3,"https://fbref.com/en/players/e9208654/Tommy-Smith"
2018,"Huddersfield","Premier League","Dean Whitehead","ENG","MF","35",1982,0.8,0,0,0,0,0,0,1,0,1,1,0,1,2,2,0,0,"https://fbref.com/en/players/a32204c9/Dean-Whitehead"
2018,"Huddersfield","Premier League","Danny Williams","USA","MF","28",1989,12.5,23,14,13,9,1,7,22,31.8,15,12,2,10,26,49,27,0,"https://fbref.com/en/players/ec9a28ce/Danny-Williams"
2018,"Inter","Serie A","Marcelo Brozović","CRO","MF","24",1992,21.4,60,43,21,31,8,19,63,30.2,44,30,7,23,18,78,18,0,"https://fbref.com/en/players/33b8d077/Marcelo-Brozovic"
2018,"Inter","Serie A","João Cancelo","POR","DF","23",1994,20.6,42,29,27,11,4,17,42,40.5,25,15,2,13,35,77,51,0,"https://fbref.com/en/players/bd6351cd/Joao-Cancelo"
2018,"Inter","Serie A","Antonio Candreva","ITA","FW","30",1987,28.2,12,7,7,5,0,8,39,20.5,31,20,2,18,22,34,24,0,"https://fbref.com/en/players/356c9002/Antonio-Candreva"
2018,"Inter","Serie A","Danilo D'Ambrosio","ITA","DF","28",1988,33.1,82,64,38,35,9,30,59,50.8,29,31,7,24,45,127,68,1,"https://fbref.com/en/players/44eb9093/Danilo-DAmbrosio"
2018,"Inter","Serie A","Éder","ITA","FW,MF","30",1986,8.9,10,7,2,4,4,0,10,0,10,6,1,5,5,15,4,0,"https://fbref.com/en/players/5a325298/Eder"
2018,"Inter","Serie A","Roberto Gagliardini","ITA","MF","23",1994,22.1,63,45,28,29,6,20,54,37,34,18,3,15,45,108,32,2,"https://fbref.com/en/players/ce30bfc8/Roberto-Gagliardini"
2018,"Inter","Serie A","Samir Handanović","SVN","GK","33",1984,38,0,0,0,0,0,0,0,NA,0,1,0,1,0,0,7,1,"https://fbref.com/en/players/74419746/Samir-Handanovic"
2018,"Inter","Serie A","Dalbert Henrique","BRA","DF","23",1993,5.9,15,10,11,3,1,7,13,53.8,6,7,4,3,13,28,19,0,"https://fbref.com/en/players/f45f9427/Dalbert-Henrique"
2018,"Inter","Serie A","Mauro Icardi","ARG","FW","24",1993,32.9,3,2,1,2,0,1,8,12.5,7,14,6,8,5,8,23,1,"https://fbref.com/en/players/43b78598/Mauro-Icardi"
2018,"Inter","Serie A","Yann Karamoh","FRA","FW,MF","19",1998,5.4,3,1,1,1,1,0,3,0,3,4,0,4,4,7,1,1,"https://fbref.com/en/players/8b66d9cc/Yann-Karamoh"
2018,"Inter","Serie A","Lisandro López","ARG","DF","27",1989,0.5,2,2,1,1,0,0,2,0,2,0,0,0,1,3,3,0,"https://fbref.com/en/players/8320fe65/Lisandro-Lopez"
2018,"Inter","Serie A","João Mário","POR","MF,FW","24",1993,6.2,8,4,3,3,2,2,8,25,6,6,1,5,4,12,5,0,"https://fbref.com/en/players/f0021247/Joao-Mario"
2018,"Inter","Serie A","Miranda","BRA","DF","32",1984,30.3,48,37,38,10,0,22,25,88,3,30,23,7,38,86,131,2,"https://fbref.com/en/players/314f2124/Miranda"
2018,"Inter","Serie A","Yuto Nagatomo","JPN","DF","30",1986,8.8,10,6,4,5,1,5,14,35.7,9,8,3,5,10,20,28,0,"https://fbref.com/en/players/4b6960d2/Yuto-Nagatomo"
2018,"Inter","Serie A","Ivan Perišić","CRO","FW","28",1989,36.8,47,31,15,23,9,8,56,14.3,48,47,6,41,45,92,62,0,"https://fbref.com/en/players/6fe90922/Ivan-Perisic"
2018,"Inter","Serie A","Andrea Pinamonti","ITA","FW","18",1999,0.2,0,0,0,0,0,0,0,NA,0,0,0,0,0,0,0,0,"https://fbref.com/en/players/08aa9cd1/Andrea-Pinamonti"
2018,"Inter","Serie A","Rafinha","BRA","MF","24",1993,11.6,14,9,1,10,3,3,16,18.8,13,15,0,15,7,21,9,0,"https://fbref.com/en/players/0c2ac3cb/Rafinha"
2018,"Inter","Serie A","Andrea Ranocchia","ITA","DF","29",1988,7,8,4,6,2,0,3,6,50,3,6,5,1,12,20,35,0,"https://fbref.com/en/players/539230cf/Andrea-Ranocchia"
2018,"Inter","Serie A","Davide Santon","ITA","DF","26",1991,9.3,19,14,13,6,0,9,17,52.9,8,10,3,7,20,39,32,2,"https://fbref.com/en/players/88c89891/Davide-Santon"
2018,"Inter","Serie A","Milan Škriniar","SVK","DF","22",1995,38,86,55,69,16,1,44,70,62.9,26,38,26,12,35,121,180,0,"https://fbref.com/en/players/30f5ffa9/Milan-Skriniar"
2018,"Inter","Serie A","Borja Valero","ESP","MF","32",1985,28.5,46,31,17,25,4,20,58,34.5,38,15,4,11,18,64,41,1,"https://fbref.com/en/players/0e21fc3c/Borja-Valero"
2018,"Inter","Serie A","Matías Vecino","URU","MF","25",1991,23.7,54,34,15,30,9,19,49,38.8,30,28,6,22,20,74,31,0,"https://fbref.com/en/players/44ac04e9/Matias-Vecino"
2018,"Juventus","Serie A","Kwadwo Asamoah","GHA","DF","28",1988,17.4,28,21,12,14,2,15,23,65.2,8,11,0,11,18,46,30,0,"https://fbref.com/en/players/089550f5/Kwadwo-Asamoah"
2018,"Juventus","Serie A","Andrea Barzagli","ITA","DF","36",1981,16.1,26,15,14,11,1,9,16,56.3,7,14,7,7,17,43,46,0,"https://fbref.com/en/players/7c0000fd/Andrea-Barzagli"
2018,"Juventus","Serie A","Medhi Benatia","MAR","DF","30",1987,19.5,28,21,20,6,2,8,15,53.3,7,18,13,5,43,71,89,1,"https://fbref.com/en/players/3b15ef2d/Medhi-Benatia"
2018,"Juventus","Serie A","Rodrigo Bentancur","URU","MF","20",1997,6.5,18,11,10,7,1,2,16,12.5,14,5,1,4,3,21,14,0,"https://fbref.com/en/players/3b8674e6/Rodrigo-Bentancur"
2018,"Juventus","Serie A","Federico Bernardeschi","ITA","FW,MF","23",1994,9.4,8,5,4,3,1,1,7,14.3,6,9,0,9,11,19,18,1,"https://fbref.com/en/players/ee93c1a9/Federico-Bernardeschi"
2018,"Juventus","Serie A","Gianluigi Buffon","ITA","GK","39",1978,20.7,0,0,0,0,0,0,0,NA,0,0,0,0,0,0,11,2,"https://fbref.com/en/players/e40d028b/Gianluigi-Buffon"
2018,"Juventus","Serie A","Giorgio Chiellini","ITA","DF","32",1984,24,28,19,17,10,1,7,15,46.7,8,21,14,7,47,75,142,3,"https://fbref.com/en/players/e85fb9b8/Giorgio-Chiellini"
2018,"Juventus","Serie A","Douglas Costa","BRA","FW,MF","26",1990,19.9,17,14,10,5,2,8,25,32,17,15,0,15,7,24,7,0,"https://fbref.com/en/players/4fa7cb9b/Douglas-Costa"
2018,"Juventus","Serie A","Juan Cuadrado","COL","FW,MF","29",1988,15,28,19,17,9,2,11,27,40.7,16,14,0,14,19,47,14,1,"https://fbref.com/en/players/0ab1f153/Juan-Cuadrado"
2018,"Juventus","Serie A","Mattia De Sciglio","ITA","DF","24",1992,10.8,22,17,7,13,2,9,13,69.2,4,12,2,10,14,36,32,0,"https://fbref.com/en/players/ae4e2852/Mattia-De-Sciglio"
2018,"Juventus","Serie A","Paulo Dybala","ARG","MF,FW","23",1993,26.1,19,11,4,10,5,4,32,12.5,28,22,0,22,12,31,4,0,"https://fbref.com/en/players/e0921a4f/Paulo-Dybala"
2018,"Juventus","Serie A","Gonzalo Higuaín","ARG","FW","29",1987,31.3,19,17,3,7,9,2,19,10.5,17,19,4,15,7,26,20,0,"https://fbref.com/en/players/8a08491a/Gonzalo-Higuain"
2018,"Juventus","Serie A","Benedikt Höwedes","GER","DF","29",1988,2.7,1,1,1,0,0,0,0,NA,0,0,0,0,8,9,10,1,"https://fbref.com/en/players/d5c04323/Benedikt-Howedes"
2018,"Juventus","Serie A","Sami Khedira","GER","MF","30",1987,21.2,14,9,1,9,4,2,23,8.7,21,13,3,10,20,34,20,0,"https://fbref.com/en/players/38ac43d3/Sami-Khedira"
2018,"Juventus","Serie A","Stephan Lichtsteiner","SUI","DF","33",1984,18.9,31,27,16,10,5,9,17,52.9,8,11,2,9,15,46,38,1,"https://fbref.com/en/players/99b1d0e6/Stephan-Lichtsteiner"
2018,"Juventus","Serie A","Mario Mandžukić","CRO","FW","31",1986,25.8,36,23,13,11,12,8,29,27.6,21,20,3,17,25,61,42,2,"https://fbref.com/en/players/afa0d4e0/Mario-Mandzukic"
2018,"Juventus","Serie A","Claudio Marchisio","ITA","MF","31",1986,9.1,17,10,9,5,3,6,21,28.6,15,7,2,5,4,21,7,0,"https://fbref.com/en/players/e304acd5/Claudio-Marchisio"
2018,"Juventus","Serie A","Blaise Matuidi","FRA","MF","30",1987,26.2,49,35,14,25,10,10,35,28.6,25,28,4,24,32,81,22,1,"https://fbref.com/en/players/c0cddebe/Blaise-Matuidi"
2018,"Juventus","Serie A","Carlo Pinsoglio","ITA","GK","27",1990,0.3,0,0,0,0,0,0,0,NA,0,0,0,0,0,0,0,0,"https://fbref.com/en/players/f6a06749/Carlo-Pinsoglio"
2018,"Juventus","Serie A","Miralem Pjanić","BIH","MF","27",1990,27.6,36,30,13,18,5,13,51,25.5,38,25,5,20,64,100,27,2,"https://fbref.com/en/players/ad6df2d5/Miralem-Pjanic"
2018,"Juventus","Serie A","Daniele Rugani","ITA","DF","23",1994,21.5,18,12,11,5,2,7,13,53.8,6,18,14,4,20,38,87,1,"https://fbref.com/en/players/14b8fcdf/Daniele-Rugani"
2018,"Juventus","Serie A","Alex Sandro","BRA","DF","26",1991,23.5,57,31,33,17,7,20,39,51.3,19,21,1,20,30,87,45,0,"https://fbref.com/en/players/0d82903c/Alex-Sandro"
2018,"Juventus","Serie A","Stefano Sturaro","ITA","MF,DF","24",1993,6.8,17,11,5,9,3,4,11,36.4,7,9,2,7,5,22,18,1,"https://fbref.com/en/players/2334478a/Stefano-Sturaro"
2018,"Juventus","Serie A","Wojciech Szczęsny","POL","GK","27",1990,17,0,0,0,0,0,0,0,NA,0,0,0,0,0,0,4,0,"https://fbref.com/en/players/01b8a2b2/Wojciech-Szczesny"
2018,"Köln","Bundesliga","Yann Aurel Bisseck","GER","DF,MF","16",2000,1.7,2,2,2,0,0,1,1,100,0,1,1,0,3,5,8,0,"https://fbref.com/en/players/3963c25b/Yann-Aurel-Bisseck"
2018,"Köln","Bundesliga","Leonardo Bittencourt","GER","MF,FW","23",1993,17.9,49,42,17,21,11,19,43,44.2,24,26,0,26,17,66,11,1,"https://fbref.com/en/players/dc62fbee/Leonardo-Bittencourt"
2018,"Köln","Bundesliga","Christian Clemens","GER","MF,FW","25",1991,7.2,12,11,6,5,1,4,13,30.8,9,8,0,8,4,16,7,0,"https://fbref.com/en/players/612cb8d3/Christian-Clemens"
2018,"Köln","Bundesliga","Jhon Córdoba","COL","FW","24",1993,10.6,13,10,0,11,2,1,5,20,4,6,2,4,1,14,9,0,"https://fbref.com/en/players/9f381d8b/Jhon-Cordoba"
2018,"Köln","Bundesliga","Chris Führich","GER","MF","19",1998,1.1,4,3,1,2,1,2,5,40,3,3,0,3,0,4,1,0,"https://fbref.com/en/players/0cf778df/Chris-Fuhrich"
2018,"Köln","Bundesliga","Sehrou Guirassy","GUI","FW","21",1996,9.5,3,3,0,2,1,1,5,20,4,9,1,8,1,4,11,0,"https://fbref.com/en/players/923f4dda/Sehrou-Guirassy"
2018,"Köln","Bundesliga","Tim Handwerker","GER","MF,DF","19",1998,4.4,12,7,9,2,1,5,7,71.4,2,3,0,3,6,18,10,0,"https://fbref.com/en/players/33a81b3d/Tim-Handwerker"
2018,"Köln","Bundesliga","Jonas Hector","GER","DF,MF","27",1990,19.5,47,35,23,18,6,18,40,45,22,39,6,33,28,75,65,2,"https://fbref.com/en/players/c2009df3/Jonas-Hector"
2018,"Köln","Bundesliga","Dominique Heintz","GER","DF","23",1993,31,60,42,47,13,0,38,64,59.4,26,35,17,18,53,113,140,0,"https://fbref.com/en/players/699fb8db/Dominique-Heintz"
2018,"Köln","Bundesliga","Marco Höger","GER","MF","27",1989,18.6,60,40,31,28,1,30,64,46.9,34,35,5,30,25,85,27,1,"https://fbref.com/en/players/4114f306/Marco-Hoger"
2018,"Köln","Bundesliga","Jannes Horn","GER","DF","20",1997,9.2,16,11,11,4,1,11,14,78.6,3,12,3,9,17,33,26,0,"https://fbref.com/en/players/2b83fa49/Jannes-Horn"
2018,"Köln","Bundesliga","Timo Horn","GER","GK","24",1993,34,3,2,3,0,0,3,6,50,3,0,0,0,0,3,18,2,"https://fbref.com/en/players/3cd9e95a/Timo-Horn"
2018,"Köln","Bundesliga","Miloš Jojić","SRB","MF","25",1992,16.2,36,26,18,15,3,16,40,40,24,31,4,27,15,51,16,0,"https://fbref.com/en/players/fb59286d/Milos-Jojic"
2018,"Köln","Bundesliga","Lukas Klünter","GER","DF,FW","21",1996,14.8,25,20,16,8,1,16,24,66.7,8,11,2,9,13,38,28,1,"https://fbref.com/en/players/92948149/Lukas-Klunter"
2018,"Köln","Bundesliga","Vincent Koziello","FRA","MF","21",1995,8.8,28,21,6,21,1,10,21,47.6,11,9,0,9,10,38,5,1,"https://fbref.com/en/players/9a493fb7/Vincent-Koziello"
2018,"Köln","Bundesliga","Filip Kusić","SRB","DF,MF","21",1996,0.2,0,0,0,0,0,0,0,NA,0,0,0,0,0,0,1,0,"https://fbref.com/en/players/de1a2530/Filip-Kusic"
2018,"Köln","Bundesliga","Matthias Lehmann","GER","MF","34",1983,16.8,33,23,14,18,1,17,29,58.6,12,15,7,8,26,59,24,1,"https://fbref.com/en/players/abb42ce6/Matthias-Lehmann"
2018,"Köln","Bundesliga","Dominic Maroh","SVN","DF","30",1987,10.2,22,15,18,4,0,15,18,83.3,3,17,9,8,21,43,68,1,"https://fbref.com/en/players/3f30b506/Dominic-Maroh"
2018,"Köln","Bundesliga","Jorge Meré","ESP","DF","20",1997,21,34,23,25,9,0,23,35,65.7,12,25,13,12,34,68,110,1,"https://fbref.com/en/players/9f979eb2/Jorge-Mere"
2018,"Köln","Bundesliga","Nikolas Nartey","DEN","MF","17",2000,0.1,0,0,0,0,0,0,0,NA,0,0,0,0,0,0,0,0,"https://fbref.com/en/players/30261ba1/Nikolas-Nartey"
2018,"Köln","Bundesliga","Paweł Olkowski","POL","DF","27",1990,5,17,12,9,8,0,5,9,55.6,4,11,2,9,3,20,17,0,"https://fbref.com/en/players/896c126c/Pawel-Olkowski"
2018,"Köln","Bundesliga","Yuya Osako","JPN","FW,MF","27",1990,21.1,13,10,4,9,0,4,18,22.2,14,13,2,11,8,21,22,0,"https://fbref.com/en/players/f69fba57/Yuya-Osako"
2018,"Köln","Bundesliga","Anas Ouahim","GER","MF","19",1997,0.2,1,1,0,1,0,1,1,100,0,0,0,0,0,1,0,0,"https://fbref.com/en/players/f04f45a2/Anas-Ouahim"
2018,"Köln","Bundesliga","Salih Özcan","TUR","MF","19",1998,18.6,56,42,24,29,3,28,54,51.9,26,27,5,22,29,85,22,1,"https://fbref.com/en/players/15413fa5/Salih-Ozcan"
2018,"Köln","Bundesliga","Claudio Pizarro","PER","FW,MF","38",1978,6.4,11,9,3,6,2,6,9,66.7,3,10,2,8,3,14,5,0,"https://fbref.com/en/players/54b6ee79/Claudio-Pizarro"
2018,"Köln","Bundesliga","Konstantin Rausch","RUS","DF","27",1990,10.3,21,16,13,7,1,11,26,42.3,15,9,2,7,17,38,25,0,"https://fbref.com/en/players/6435e737/Konstantin-Rausch"
2018,"Köln","Bundesliga","Birk Risa","NOR","FW","19",1998,0.9,1,1,0,1,0,0,3,0,3,2,1,1,0,1,0,0,"https://fbref.com/en/players/c70b221c/Birk-Risa"
2018,"Köln","Bundesliga","Marcel Risse","GER","DF,MF","27",1989,13,21,14,17,4,0,11,19,57.9,8,21,3,18,6,27,10,2,"https://fbref.com/en/players/140afefb/Marcel-Risse"
2018,"Köln","Bundesliga","Frederik Sørensen","DEN","DF","25",1992,22.2,56,45,40,14,2,30,41,73.2,11,35,17,18,37,93,130,3,"https://fbref.com/en/players/68635c10/Frederik-Sorensen"
2018,"Köln","Bundesliga","Simon Terodde","GER","FW","29",1988,12.9,11,9,3,8,0,4,11,36.4,7,3,0,3,4,15,7,0,"https://fbref.com/en/players/863ff1ee/Simon-Terodde"
2018,"Köln","Bundesliga","Simon Zoller","GER","MF,FW","26",1991,10.7,11,7,3,6,2,7,10,70,3,5,2,3,8,19,9,0,"https://fbref.com/en/players/29f7cfd9/Simon-Zoller"
2018,"La Coruña","La Liga","Raúl Albentosa","ESP","DF","28",1988,19.4,13,6,9,4,0,7,20,35,13,26,19,7,26,39,92,1,"https://fbref.com/en/players/348e4809/Raul-Albentosa"
2018,"La Coruña","La Liga","Steve Aldo One","CMR","DF","22",1995,1,1,0,0,1,0,0,0,NA,0,0,0,0,0,1,7,0,"https://fbref.com/en/players/a8599c17/Steve-Aldo-One"
2018,"La Coruña","La Liga","Florin Andone","ROU","FW","24",1993,18.2,9,7,4,4,1,4,17,23.5,13,9,2,7,3,12,12,0,"https://fbref.com/en/players/dc008610/Florin-Andone"
2018,"La Coruña","La Liga","Alejandro Arribas","ESP","DF","28",1989,3,2,2,1,1,0,1,5,20,4,5,3,2,6,8,8,0,"https://fbref.com/en/players/cc29324e/Alejandro-Arribas"
2018,"La Coruña","La Liga","Zakaria Bakkali","BEL","FW,MF","21",1996,10.1,12,10,7,4,1,4,14,28.6,10,5,0,5,4,16,6,0,"https://fbref.com/en/players/ec3efd7f/Zakaria-Bakkali"
2018,"La Coruña","La Liga","Celso Borges","CRC","MF","29",1988,25.6,61,39,34,22,5,15,47,31.9,32,39,7,32,34,95,36,0,"https://fbref.com/en/players/b8836910/Celso-Borges"
2018,"La Coruña","La Liga","Eneko Bóveda","ESP","DF","28",1988,7.4,24,16,13,10,1,8,13,61.5,5,18,7,11,16,40,36,2,"https://fbref.com/en/players/1771f2c1/Eneko-Boveda"
2018,"La Coruña","La Liga","Federico Cartabia","ARG","FW,MF","24",1993,14.7,37,23,15,15,7,11,30,36.7,19,15,0,15,18,55,10,0,"https://fbref.com/en/players/a8e6bebf/Federico-Cartabia"
2018,"La Coruña","La Liga","Emre Çolak","TUR","MF","26",1991,16.1,24,19,4,14,6,7,28,25,21,7,1,6,7,31,5,1,"https://fbref.com/en/players/643b39a6/Emre-Colak"
2018,"La Coruña","La Liga","Edu Expósito","ESP","MF,FW","20",1996,1.1,1,0,0,0,1,0,1,0,1,1,0,1,2,3,2,0,"https://fbref.com/en/players/283c7121/Edu-Exposito"
2018,"La Coruña","La Liga","Bruno Gama","POR","FW,MF","29",1987,1.3,1,1,1,0,0,1,3,33.3,2,0,0,0,0,1,2,0,"https://fbref.com/en/players/6cffc9df/Bruno-Gama"
2018,"La Coruña","La Liga","Carles Gil","ESP","FW,MF","24",1992,5.3,6,4,1,4,1,1,5,20,4,5,0,5,4,10,0,0,"https://fbref.com/en/players/11c30a46/Carles-Gil"
2018,"La Coruña","La Liga","Guilherme","BRA","MF","26",1991,29.3,79,56,35,37,7,28,77,36.4,49,36,9,27,46,125,62,0,"https://fbref.com/en/players/8754c7ca/Guilherme"
2018,"La Coruña","La Liga","Juanfran","ESP","DF","28",1988,34,64,44,38,22,4,35,65,53.8,30,29,11,18,63,127,121,0,"https://fbref.com/en/players/9ba48d64/Juanfran"
2018,"La Coruña","La Liga","Maksym Koval","UKR","GK","24",1992,1.3,0,0,0,0,0,0,0,NA,0,0,0,0,0,0,0,2,"https://fbref.com/en/players/60713cb3/Maksym-Koval"
2018,"La Coruña","La Liga","Michael Krohn-Dehli","DEN","MF","34",1983,8.1,12,9,6,5,1,4,17,23.5,13,2,0,2,13,25,7,0,"https://fbref.com/en/players/1c8dc17d/Michael-Krohn-Dehli"
2018,"La Coruña","La Liga","Adrián López","ESP","FW,MF","29",1988,26.1,24,14,11,8,5,7,25,28,18,22,4,18,10,34,49,0,"https://fbref.com/en/players/88a359d4/Adrian-Lopez"
2018,"La Coruña","La Liga","Luisinho","POR","DF","32",1985,29.1,111,77,64,40,7,65,96,67.7,31,24,4,20,55,166,113,0,"https://fbref.com/en/players/a7f00c8c/Luisinho"
2018,"La Coruña","La Liga","Pedro Mosquera","ESP","MF","29",1988,15.5,48,31,15,29,4,13,38,34.2,25,26,6,20,23,71,38,0,"https://fbref.com/en/players/c5fa58ea/Pedro-Mosquera"
2018,"La Coruña","La Liga","Sulley Muntari","GHA","MF","32",1984,4.5,9,7,2,7,0,1,7,14.3,6,10,4,6,11,20,10,0,"https://fbref.com/en/players/e185aa52/Sulley-Muntari"
2018,"La Coruña","La Liga","Fernando Navarro","ESP","DF","35",1982,11.6,32,22,24,7,1,16,25,64,9,13,3,10,29,61,49,0,"https://fbref.com/en/players/5a3f6fae/Fernando-Navarro"
2018,"La Coruña","La Liga","Costel Pantilimon","ROU","GK","30",1987,6,0,0,0,0,0,0,1,0,1,0,0,0,0,0,0,1,"https://fbref.com/en/players/d24e154c/Costel-Pantilimon"
2018,"La Coruña","La Liga","Lucas Pérez","ESP","FW","28",1988,31.1,17,12,5,8,4,1,32,3.1,31,19,1,18,9,26,1,0,"https://fbref.com/en/players/a300ac7e/Lucas-Perez"
2018,"La Coruña","La Liga","Rubén","ESP","GK","33",1984,27.5,1,0,1,0,0,1,3,33.3,2,0,0,0,1,2,5,4,"https://fbref.com/en/players/24279b8b/Ruben"
2018,"La Coruña","La Liga","Mujaid Sadick","ESP","DF","17",2000,1.2,4,2,2,2,0,2,3,66.7,1,3,2,1,1,5,4,0,"https://fbref.com/en/players/21164a21/Mujaid-Sadick"
2018,"La Coruña","La Liga","Fabian Schär","SUI","DF","25",1991,24.7,59,45,45,14,0,32,61,52.5,29,36,20,16,45,104,141,1,"https://fbref.com/en/players/c8aa95da/Fabian-Schar"
2018,"La Coruña","La Liga","Sidnei","BRA","DF","27",1989,19.8,41,28,30,11,0,18,25,72,7,26,9,17,31,72,101,1,"https://fbref.com/en/players/b14d0c5d/Sidnei"
2018,"La Coruña","La Liga","Przemysław Tytoń","POL","GK","30",1987,1.1,0,0,0,0,0,0,0,NA,0,0,0,0,0,0,0,0,"https://fbref.com/en/players/1fa85681/Przemyslaw-Tyton"
2018,"La Coruña","La Liga","Francis Uzoho","NGA","GK","18",1998,2,0,0,0,0,0,0,0,NA,0,0,0,0,0,0,1,0,"https://fbref.com/en/players/cfd68aa7/Francis-Uzoho"
2018,"La Coruña","La Liga","Gerard Valentín","ESP","DF,FW","24",1993,1.8,5,4,4,0,1,1,2,50,1,1,0,1,3,8,3,0,"https://fbref.com/en/players/9d4c3227/Gerard-Valentin"
2018,"La Coruña","La Liga","Borja Valle","ESP","FW,MF","25",1992,5.4,6,6,3,3,0,1,4,25,3,2,0,2,3,9,4,0,"https://fbref.com/en/players/3a6a49f7/Borja-Valle"
2018,"La Coruña","La Liga","Federico Valverde","URU","MF,FW","19",1998,13.7,25,16,12,10,3,8,15,53.3,7,12,1,11,21,46,17,0,"https://fbref.com/en/players/0959c2a2/Federico-Valverde"
2018,"Las Palmas","La Liga","Matías Aguirregaray","URU","DF","28",1989,12.8,26,20,12,12,2,12,32,37.5,20,13,1,12,24,50,25,0,"https://fbref.com/en/players/8617e3d9/Matias-Aguirregaray"
2018,"Las Palmas","La Liga","Alberto Aquilani","ITA","MF","33",1984,14.4,33,19,13,17,3,11,31,35.5,20,20,4,16,23,56,23,0,"https://fbref.com/en/players/ad340e17/Alberto-Aquilani"
2018,"Las Palmas","La Liga","Sergio Araujo","ARG","MF,FW","25",1992,0.4,3,2,0,0,3,1,1,100,0,0,0,0,0,3,0,0,"https://fbref.com/en/players/080ac8d8/Sergio-Araujo"
2018,"Las Palmas","La Liga","Aythami Artiles","ESP","DF","31",1986,2,2,2,2,0,0,0,1,0,1,2,1,1,2,4,19,0,"https://fbref.com/en/players/01ae64cd/Aythami-Artiles"
2018,"Las Palmas","La Liga","Pedro Bigas","ESP","DF","26",1990,9.9,14,9,10,4,0,7,13,53.8,6,18,11,7,16,30,41,2,"https://fbref.com/en/players/697295b1/Pedro-Bigas"
2018,"Las Palmas","La Liga","Jonathan Calleri","ARG","FW","23",1993,34.5,24,16,5,10,9,4,23,17.4,19,15,2,13,7,31,35,0,"https://fbref.com/en/players/6922f806/Jonathan-Calleri"
2018,"Las Palmas","La Liga","Dani Castellano","ESP","DF","29",1987,22.5,46,29,29,16,1,25,48,52.1,23,28,7,21,42,88,64,1,"https://fbref.com/en/players/21d4e122/Dani-Castellano"
2018,"Las Palmas","La Liga","Javi Castellano","ESP","MF","29",1987,17.4,47,27,20,25,2,20,37,54.1,17,23,6,17,38,85,16,1,"https://fbref.com/en/players/dac68523/Javi-Castellano"
2018,"Las Palmas","La Liga","Leandro Chichizola","ARG","GK","27",1990,27,2,0,2,0,0,2,6,33.3,4,0,0,0,4,6,29,3,"https://fbref.com/en/players/8d957256/Leandro-Chichizola"
2018,"Las Palmas","La Liga","Oghenekaro Etebo","NGA","MF","21",1995,13.5,24,17,9,12,3,12,26,46.2,14,17,3,14,27,51,10,0,"https://fbref.com/en/players/b579e83d/Oghenekaro-Etebo"
2018,"Las Palmas","La Liga","Erik Expósito","ESP","FW","21",1996,5.2,1,1,0,1,0,0,6,0,6,6,0,6,1,2,5,0,"https://fbref.com/en/players/07d67579/Erik-Exposito"
2018,"Las Palmas","La Liga","Imoh Ezekiel","NGA","MF,FW","23",1993,5.2,8,6,3,2,3,3,4,75,1,4,0,4,2,10,3,0,"https://fbref.com/en/players/9243fea6/Imoh-Ezekiel"
2018,"Las Palmas","La Liga","Álex Gálvez","ESP","DF","28",1989,18,50,36,26,24,0,22,41,53.7,19,20,11,9,43,93,74,2,"https://fbref.com/en/players/960fb42d/Alex-Galvez"
2018,"Las Palmas","La Liga","David García","ESP","DF","35",1982,9.6,16,10,10,4,2,8,12,66.7,4,15,8,7,19,35,33,1,"https://fbref.com/en/players/1250086e/David-Garcia"
2018,"Las Palmas","La Liga","Nacho Gil","ESP","FW,MF","21",1995,8.1,10,6,6,2,2,5,21,23.8,16,9,0,9,6,16,2,0,"https://fbref.com/en/players/87ec1a2a/Nacho-Gil"
2018,"Las Palmas","La Liga","Vicente Gómez","ESP","MF","28",1988,16.9,21,13,6,11,4,10,29,34.5,19,18,4,14,17,38,14,1,"https://fbref.com/en/players/cefb32b1/Vicente-Gomez"
2018,"Las Palmas","La Liga","Fabio González","ESP","MF","20",1997,0.7,2,1,2,0,0,1,4,25,3,1,0,1,1,3,1,0,"https://fbref.com/en/players/5418d47c/Fabio-Gonzalez"
2018,"Las Palmas","La Liga","Alen Halilović","CRO","FW,MF","21",1996,14.5,11,7,5,6,0,4,17,23.5,13,10,1,9,5,16,4,0,"https://fbref.com/en/players/a6b9bd00/Alen-Halilovic"
2018,"Las Palmas","La Liga","Hernán","ESP","MF","26",1990,3.9,18,9,8,7,3,10,17,58.8,7,2,0,2,8,26,5,0,"https://fbref.com/en/players/8c83efb6/Hernan"
2018,"Las Palmas","La Liga","Borja Herrera","ESP","DF","24",1993,2.7,2,1,2,0,0,2,7,28.6,5,6,1,5,3,5,4,0,"https://fbref.com/en/players/4f6d9bcd/Borja-Herrera"
2018,"Las Palmas","La Liga","Mauricio Lemos","URU","DF,MF","21",1995,14,22,10,17,5,0,15,27,55.6,12,16,13,3,25,47,51,1,"https://fbref.com/en/players/dbe5a587/Mauricio-Lemos"
2018,"Las Palmas","La Liga","Raúl Lizoain","ESP","GK","26",1991,11,1,0,1,0,0,1,3,33.3,2,0,0,0,1,2,2,3,"https://fbref.com/en/players/f69e9eee/Raul-Lizoain"
2018,"Las Palmas","La Liga","Michel","BRA","DF","27",1990,23.7,33,24,21,8,4,14,25,56,11,21,11,10,39,72,64,1,"https://fbref.com/en/players/05384ea1/Michel"
2018,"Las Palmas","La Liga","Momo","ESP","FW,MF","35",1982,7.5,14,8,8,3,3,4,13,30.8,9,5,0,5,5,19,1,0,"https://fbref.com/en/players/9857e65d/Momo"
2018,"Las Palmas","La Liga","Ximo Navarro","ESP","DF","27",1990,29,63,43,44,19,0,28,50,56,22,27,16,11,66,129,131,4,"https://fbref.com/en/players/8db394aa/Ximo-Navarro"
2018,"Las Palmas","La Liga","Gabriel Peñalba","ARG","MF","32",1984,6.3,6,5,4,2,0,5,11,45.5,6,7,4,3,8,14,15,0,"https://fbref.com/en/players/e7375367/Gabriel-Penalba"
2018,"Las Palmas","La Liga","Benito Ramírez","ESP","FW,DF","22",1995,1.8,6,3,2,3,1,1,5,20,4,0,0,0,2,8,3,0,"https://fbref.com/en/players/db714daf/Benito-Ramirez"
2018,"Las Palmas","La Liga","Loïc Rémy","FRA","FW","30",1987,8.5,4,3,1,3,0,0,1,0,1,0,0,0,1,5,2,0,"https://fbref.com/en/players/5c2da10f/Loic-Remy"
2018,"Las Palmas","La Liga","Sergi Samper","ESP","MF","22",1995,1.6,10,4,4,6,0,2,3,66.7,1,0,0,0,0,10,0,0,"https://fbref.com/en/players/6a7586f4/Sergi-Samper"
2018,"Las Palmas","La Liga","Jairo Samperio","ESP","FW,MF","24",1993,6.2,9,6,2,6,1,3,13,23.1,10,5,1,4,1,10,5,0,"https://fbref.com/en/players/c0a0c18f/Jairo-Samperio"
2018,"Las Palmas","La Liga","David Simón","ESP","DF","28",1988,8,24,17,11,10,3,9,16,56.3,7,13,4,9,22,46,11,1,"https://fbref.com/en/players/251336da/David-Simon"
2018,"Las Palmas","La Liga","Tana","ESP","MF,FW","26",1990,17.2,31,24,13,14,4,12,36,33.3,24,8,0,8,23,54,5,0,"https://fbref.com/en/players/ef345601/Tana"
2018,"Las Palmas","La Liga","Oussama Tannane","MAR","FW","23",1994,6.4,15,13,6,8,1,7,12,58.3,5,5,0,5,5,20,0,0,"https://fbref.com/en/players/730bd100/Oussama-Tannane"
2018,"Las Palmas","La Liga","Hernán Toledo","ARG","FW,MF","21",1996,6.9,5,5,2,2,1,1,11,9.1,10,2,0,2,5,10,5,0,"https://fbref.com/en/players/93568a16/Hernan-Toledo"
2018,"Las Palmas","La Liga","Jonathan Viera","ESP","MF","27",1989,22.1,36,25,10,22,4,3,28,10.7,25,21,0,21,11,47,2,0,"https://fbref.com/en/players/efa708aa/Jonathan-Viera"
2018,"Las Palmas","La Liga","Vitolo","ESP","FW,MF","27",1989,7.7,15,12,9,5,1,4,17,23.5,13,10,3,7,6,21,9,0,"https://fbref.com/en/players/db750822/Vitolo"
2018,"Lazio","Serie A","Luis Alberto","ESP","FW,MF","24",1992,29.7,39,28,8,23,8,10,44,22.7,34,30,2,28,16,55,7,0,"https://fbref.com/en/players/5294a83f/Luis-Alberto"
2018,"Lazio","Serie A","Felipe Anderson","BRA","FW,MF","24",1993,12.9,34,21,7,11,16,6,35,17.1,29,17,0,17,11,45,8,1,"https://fbref.com/en/players/9f1893b9/Felipe-Anderson"
2018,"Lazio","Serie A","Dušan Basta","SRB","DF","32",1984,8.6,9,7,4,3,2,6,14,42.9,8,10,3,7,13,22,15,0,"https://fbref.com/en/players/3b57f7f8/Dusan-Basta"
2018,"Lazio","Serie A","Bastos","ANG","DF","26",1991,15.6,33,24,19,13,1,19,30,63.3,11,13,8,5,24,57,67,0,"https://fbref.com/en/players/c01c66d9/Bastos"
2018,"Lazio","Serie A","Martín Cáceres","URU","DF","30",1987,4.9,12,7,9,2,1,10,14,71.4,4,4,4,0,4,16,13,0,"https://fbref.com/en/players/e94d79e3/Martin-Caceres"
2018,"Lazio","Serie A","Felipe Caicedo","ECU","FW,MF","28",1988,8,11,10,3,5,3,2,7,28.6,5,6,0,6,1,12,4,0,"https://fbref.com/en/players/93b891d1/Felipe-Caicedo"
2018,"Lazio","Serie A","Davide Di Gennaro","ITA","MF","29",1988,0.1,1,0,1,0,0,1,1,100,0,0,0,0,0,1,0,0,"https://fbref.com/en/players/951a4ee4/Davide-Di-Gennaro"
2018,"Lazio","Serie A","Luiz Felipe","ITA","DF","20",1997,13,40,28,24,16,0,15,25,60,10,26,14,12,18,58,50,1,"https://fbref.com/en/players/15d0c248/Luiz-Felipe"
2018,"Lazio","Serie A","Ciro Immobile","ITA","FW","27",1990,29.8,4,2,0,3,1,0,17,0,17,14,1,13,0,4,9,0,"https://fbref.com/en/players/4431aed2/Ciro-Immobile"
2018,"Lazio","Serie A","Lucas Leiva","BRA","MF","30",1987,32,107,80,43,59,5,29,100,29,71,33,7,26,70,177,59,0,"https://fbref.com/en/players/4c78b5ed/Lucas-Leiva"
2018,"Lazio","Serie A","Jordan Lukaku","BEL","DF","23",1994,15.1,28,15,14,11,3,10,16,62.5,6,14,2,12,15,43,23,0,"https://fbref.com/en/players/0cd0e21b/Jordan-Lukaku"
2018,"Lazio","Serie A","Senad Lulić","BIH","DF,MF","31",1986,27,66,40,32,22,12,21,80,26.3,59,32,4,28,36,102,39,0,"https://fbref.com/en/players/7fd58fe3/Senad-Lulic"
2018,"Lazio","Serie A","Adam Marušić","MNE","DF","24",1992,28,28,21,17,8,3,12,28,42.9,16,22,2,20,31,59,33,0,"https://fbref.com/en/players/d4535821/Adam-Marusic"
2018,"Lazio","Serie A","Maurício","BRA","DF","28",1988,0.1,0,0,0,0,0,0,0,NA,0,0,0,0,0,0,0,0,"https://fbref.com/en/players/d5bd1abc/Mauricio"
2018,"Lazio","Serie A","Sergej Milinković-Savić","SRB","MF","22",1995,31.6,55,39,11,34,10,13,52,25,39,29,6,23,33,88,36,1,"https://fbref.com/en/players/4e6dbac4/Sergej-Milinkovic-Savic"
2018,"Lazio","Serie A","Alessandro Murgia","ITA","MF","20",1996,8.6,19,12,9,9,1,5,19,26.3,14,14,3,11,17,36,13,0,"https://fbref.com/en/players/fb2c533b/Alessandro-Murgia"
2018,"Lazio","Serie A","Nani","POR","FW,MF","30",1986,4.3,9,6,2,2,5,3,9,33.3,6,8,0,8,2,11,0,0,"https://fbref.com/en/players/15e9c7e6/Nani"
2018,"Lazio","Serie A","Simone Palombi","ITA","FW","21",1996,0.7,0,0,0,0,0,0,0,NA,0,0,0,0,0,0,0,0,"https://fbref.com/en/players/d0e6399c/Simone-Palombi"
2018,"Lazio","Serie A","Marco Parolo","ITA","MF","32",1985,29,70,37,27,36,7,14,58,24.1,44,49,8,41,43,113,64,0,"https://fbref.com/en/players/ed5886d2/Marco-Parolo"
2018,"Lazio","Serie A","Patric","ESP","DF","24",1993,6.6,11,6,8,2,1,4,6,66.7,2,3,0,3,3,14,32,0,"https://fbref.com/en/players/f7223718/Patric"
2018,"Lazio","Serie A","Ștefan Radu","ROU","DF","30",1986,28.8,53,38,36,16,1,25,41,61,16,30,14,16,55,108,105,1,"https://fbref.com/en/players/53de807a/Stefan-Radu"
2018,"Lazio","Serie A","Thomas Strakosha","ALB","GK","22",1995,38,0,0,0,0,0,0,0,NA,0,0,0,0,2,2,13,4,"https://fbref.com/en/players/339fe0e8/Thomas-Strakosha"
2018,"Lazio","Serie A","Stefan de Vrij","NED","DF","25",1992,33.7,31,22,14,17,0,14,23,60.9,9,43,24,19,71,102,156,1,"https://fbref.com/en/players/d0d8dd44/Stefan-de-Vrij"
2018,"Lazio","Serie A","Wallace","BRA","DF","22",1994,11.1,17,7,11,6,0,4,13,30.8,9,13,5,8,29,46,43,3,"https://fbref.com/en/players/d61b3354/Wallace"
2018,"Leganés","La Liga","Alexander","ARG","MF,FW","28",1988,11.8,14,11,2,11,1,2,12,16.7,10,11,0,11,22,36,4,0,"https://fbref.com/en/players/3e1858af/Alexander"
2018,"Leganés","La Liga","Nordin Amrabat","MAR","FW,MF","30",1987,18,19,10,5,10,4,5,17,29.4,12,13,0,13,5,24,2,0,"https://fbref.com/en/players/7c2a398c/Nordin-Amrabat"
2018,"Leganés","La Liga","Jon Ander Serantes","ESP","GK","27",1989,1,0,0,0,0,0,0,0,NA,0,0,0,0,0,0,0,1,"https://fbref.com/en/players/983ccabe/Jon-Ander-Serantes"
2018,"Leganés","La Liga","Miguel Ángel Guerrero","ESP","FW","27",1990,16,7,5,0,2,5,1,11,9.1,10,11,0,11,9,16,16,0,"https://fbref.com/en/players/b35db3f6/Miguel-Angel-Guerrero"
2018,"Leganés","La Liga","Claudio Beauvue","GLP","FW","29",1988,18.6,5,3,2,2,1,1,12,8.3,11,7,0,7,2,7,16,0,"https://fbref.com/en/players/8ca253a3/Claudio-Beauvue"
2018,"Leganés","La Liga","Darko Brašanac","SRB","MF,FW","25",1992,13.4,32,17,11,17,4,13,33,39.4,20,14,3,11,14,46,12,0,"https://fbref.com/en/players/4accb7e0/Darko-Brasanac"
2018,"Leganés","La Liga","Unai Bustinza","ESP","DF","25",1992,18.2,36,21,25,8,3,21,38,55.3,17,17,9,8,47,83,64,0,"https://fbref.com/en/players/f3112790/Unai-Bustinza"
2018,"Leganés","La Liga","Nereo Champagne","ARG","GK","32",1985,2,0,0,0,0,0,0,0,NA,0,0,0,0,0,0,3,0,"https://fbref.com/en/players/7a9fae62/Nereo-Champagne"
2018,"Leganés","La Liga","Iván Cuéllar","ESP","GK","33",1984,35,4,3,4,0,0,3,4,75,1,0,0,0,3,7,22,6,"https://fbref.com/en/players/75751c99/Ivan-Cuellar"
2018,"Leganés","La Liga","Mauro dos Santos","ARG","DF","28",1989,10.9,16,14,11,5,0,10,15,66.7,5,7,5,2,12,28,53,1,"https://fbref.com/en/players/ec699fdd/Mauro-dos-Santos"
2018,"Leganés","La Liga","Javier Eraso","ESP","MF,FW","27",1990,28.1,32,15,10,18,4,13,42,31,29,16,5,11,23,55,17,0,"https://fbref.com/en/players/aec0fb6f/Javier-Eraso"
2018,"Leganés","La Liga","Gabriel","BRA","MF","23",1993,26.4,90,69,28,54,8,29,74,39.2,45,38,4,34,38,128,27,0,"https://fbref.com/en/players/0d10333c/Gabriel"
2018,"Leganés","La Liga","Raúl García","ESP","DF","28",1989,15.5,34,25,24,9,1,18,30,60,12,18,3,15,19,53,50,1,"https://fbref.com/en/players/1a317a1b/Raul-Garcia"
2018,"Leganés","La Liga","Gerard Gumbau","ESP","MF","22",1994,15.9,35,26,13,21,1,12,37,32.4,25,12,4,8,14,49,27,0,"https://fbref.com/en/players/ac454a4f/Gerard-Gumbau"
2018,"Leganés","La Liga","Alejandro Gutiérrez Mozo","ESP","MF","22",1995,0.5,3,2,1,2,0,1,4,25,3,0,0,0,0,3,0,0,"https://fbref.com/en/players/4410f0b0/Alejandro-Gutierrez-Mozo"
2018,"Leganés","La Liga","Martín Mantovani","ARG","DF","33",1984,11.4,12,5,10,2,0,7,10,70,3,10,6,4,22,34,67,0,"https://fbref.com/en/players/4ffb647d/Martin-Mantovani"
2018,"Leganés","La Liga","Erik Morán","ESP","MF","26",1991,2.5,2,2,1,0,1,0,3,0,3,1,1,0,4,6,0,0,"https://fbref.com/en/players/6941883f/Erik-Moran"
2018,"Leganés","La Liga","Ezequiel Muñoz","ARG","DF","26",1990,15.6,36,28,24,12,0,11,20,55,9,18,11,7,24,60,84,0,"https://fbref.com/en/players/e4b8c5b6/Ezequiel-Munoz"
2018,"Leganés","La Liga","Naranjo","ESP","MF,FW","23",1994,6.2,17,10,3,12,2,4,12,33.3,8,11,1,10,3,20,4,0,"https://fbref.com/en/players/2a70c756/Naranjo"
2018,"Leganés","La Liga","Rubén Pérez","ESP","MF","28",1989,28,99,61,47,48,4,48,101,47.5,53,30,5,25,77,176,40,0,"https://fbref.com/en/players/3c7bc9bd/Ruben-Perez"
2018,"Leganés","La Liga","Omar Ramos","ESP","FW,MF","29",1988,16.1,22,14,6,8,8,9,22,40.9,13,16,1,15,14,36,15,0,"https://fbref.com/en/players/0657888a/Omar-Ramos"
2018,"Leganés","La Liga","Diego Rico","ESP","DF","24",1993,24.8,68,43,37,21,10,36,53,67.9,17,30,6,24,76,144,61,0,"https://fbref.com/en/players/d9ba39fc/Diego-Rico"
2018,"Leganés","La Liga","Sergio Segura García","ESP","DF","21",1995,0.3,NA,2,NA,NA,NA,NA,NA,NA,NA,NA,NA,NA,1,NA,NA,NA,"https://fbref.com/en/players/3536fdc1/Sergio-Segura-Garcia"
2018,"Leganés","La Liga","Jaime Sierra Mateos","ESP","FW,MF","19",1998,0.3,1,1,1,0,0,0,1,0,1,0,0,0,1,2,0,0,"https://fbref.com/en/players/aaa4239e/Jaime-Sierra-Mateos"
2018,"Leganés","La Liga","Dimitris Siovas","GRE","DF","28",1988,22.9,48,33,43,5,0,29,46,63,17,27,12,15,62,110,89,0,"https://fbref.com/en/players/92d38e6c/Dimitris-Siovas"
2018,"Leganés","La Liga","Tito","ESP","DF","32",1985,6.8,8,5,5,3,0,6,18,33.3,12,12,5,7,12,20,16,0,"https://fbref.com/en/players/7cefa219/Tito"
2018,"Leganés","La Liga","Joseba Zaldúa","ESP","DF","25",1992,28.4,68,52,31,31,6,39,62,62.9,23,28,5,23,61,129,85,0,"https://fbref.com/en/players/5ca20b7a/Joseba-Zaldua"
2018,"Leganés","La Liga","Nabil El Zhar","MAR","FW,MF","30",1986,22,11,6,4,6,1,3,18,16.7,15,14,1,13,18,29,3,0,"https://fbref.com/en/players/37f96552/Nabil-El-Zhar"
2018,"Leicester City","Premier League","Marc Albrighton","ENG","MF,FW","27",1989,28.2,52,33,16,29,7,16,52,30.8,36,32,4,28,27,79,34,0,"https://fbref.com/en/players/b827d5b3/Marc-Albrighton"
2018,"Leicester City","Premier League","Daniel Amartey","GHA","DF","22",1994,5.4,8,4,7,1,0,3,7,42.9,4,7,3,4,7,15,21,1,"https://fbref.com/en/players/1a4ef233/Daniel-Amartey"
2018,"Leicester City","Premier League","Harvey Barnes","ENG","MF,FW","19",1997,0.1,0,0,0,0,0,0,0,NA,0,0,0,0,0,0,0,0,"https://fbref.com/en/players/3ea50f67/Harvey-Barnes"
2018,"Leicester City","Premier League","Yohan Benalouane","TUN","DF","30",1987,1,7,3,6,1,0,4,6,66.7,2,1,1,0,1,8,4,0,"https://fbref.com/en/players/8309b068/Yohan-Benalouane"
2018,"Leicester City","Premier League","Ben Chilwell","ENG","DF","20",1996,20.6,36,26,21,10,5,15,32,46.9,17,31,4,27,28,64,71,3,"https://fbref.com/en/players/d2424d1b/Ben-Chilwell"
2018,"Leicester City","Premier League","Hamza Choudhury","ENG","MF,DF","19",1997,4.2,9,5,6,3,0,2,10,20,8,12,1,11,8,17,4,0,"https://fbref.com/en/players/7d2d3329/Hamza-Choudhury"
2018,"Leicester City","Premier League","Fousseni Diabaté","MLI","MF,FW","21",1995,6.5,9,6,5,3,1,1,4,25,3,6,0,6,8,17,8,0,"https://fbref.com/en/players/d07e3b41/Fousseni-Diabate"
2018,"Leicester City","Premier League","Aleksandar Dragović","AUT","DF","26",1991,8.5,13,10,13,0,0,7,13,53.8,6,16,8,8,16,29,46,0,"https://fbref.com/en/players/6fd8a334/Aleksandar-Dragovic"
2018,"Leicester City","Premier League","Christian Fuchs","AUT","DF","31",1986,21.3,41,27,25,12,4,14,40,35,26,23,3,20,58,99,86,0,"https://fbref.com/en/players/a67a09fb/Christian-Fuchs"
2018,"Leicester City","Premier League","Demarai Gray","ENG","MF,FW","21",1996,18.9,17,15,6,9,2,4,23,17.4,19,27,0,27,11,28,14,1,"https://fbref.com/en/players/4468ec10/Demarai-Gray"
2018,"Leicester City","Premier League","Ben Hamer","ENG","GK","29",1987,3.1,0,0,0,0,0,0,1,0,1,0,0,0,0,0,3,1,"https://fbref.com/en/players/d822a850/Ben-Hamer"
2018,"Leicester City","Premier League","Vicente Iborra","ESP","MF","29",1988,15.7,23,18,13,10,0,9,36,25,27,25,11,14,19,42,49,1,"https://fbref.com/en/players/ad1ffcfd/Vicente-Iborra"
2018,"Leicester City","Premier League","Kelechi Iheanacho","NGA","FW,MF","20",1996,9.2,9,6,3,5,1,3,20,15,17,10,2,8,3,12,4,0,"https://fbref.com/en/players/c92e1a31/Kelechi-Iheanacho"
2018,"Leicester City","Premier League","Eldin Jakupović","SUI","GK","32",1984,2,0,0,0,0,0,0,0,NA,0,0,0,0,0,0,4,0,"https://fbref.com/en/players/1148323a/Eldin-Jakupovic"
2018,"Leicester City","Premier League","Matty James","ENG","MF","26",1991,11,19,10,7,11,1,2,10,20,8,14,2,12,17,36,25,0,"https://fbref.com/en/players/ebd0a048/Matty-James"
2018,"Leicester City","Premier League","Andy King","WAL","MF","28",1988,6,8,5,0,5,3,0,3,0,3,4,2,2,5,13,13,0,"https://fbref.com/en/players/d790907f/Andy-King"
2018,"Leicester City","Premier League","Harry Maguire","ENG","DF","24",1993,38,63,46,47,15,1,26,43,60.5,17,35,28,7,48,111,181,1,"https://fbref.com/en/players/d8931174/Harry-Maguire"
2018,"Leicester City","Premier League","Riyad Mahrez","ALG","MF,FW","26",1991,32.8,39,27,16,17,6,10,63,15.9,53,32,1,31,18,57,15,0,"https://fbref.com/en/players/892d5bb1/Riyad-Mahrez"
2018,"Leicester City","Premier League","Wes Morgan","JAM","DF","33",1984,31.3,35,25,26,8,1,12,18,66.7,6,41,27,14,31,66,146,1,"https://fbref.com/en/players/80c31c97/Wes-Morgan"
2018,"Leicester City","Premier League","Wilfred Ndidi","NGA","MF","20",1996,32.2,138,89,68,65,5,45,119,37.8,74,67,10,57,51,189,103,2,"https://fbref.com/en/players/6b47c5db/Wilfred-Ndidi"
2018,"Leicester City","Premier League","Shinji Okazaki","JPN","FW,MF","31",1986,14.7,25,16,3,18,4,4,28,14.3,24,15,1,14,8,33,6,0,"https://fbref.com/en/players/68796d61/Shinji-Okazaki"
2018,"Leicester City","Premier League","Kasper Schmeichel","DEN","GK","30",1986,32.9,1,0,1,0,0,1,3,33.3,2,1,0,1,0,1,18,5,"https://fbref.com/en/players/53af52f3/Kasper-Schmeichel"
2018,"Leicester City","Premier League","Adrien Silva","POR","MF","28",1989,8.5,22,13,8,13,1,6,28,21.4,22,12,2,10,14,36,0,0,"https://fbref.com/en/players/d6f88a1d/Adrien-Silva"
2018,"Leicester City","Premier League","Danny Simpson","ENG","DF","30",1987,25.6,38,22,31,6,1,22,45,48.9,23,31,19,12,34,72,132,1,"https://fbref.com/en/players/3201b03d/Danny-Simpson"
2018,"Leicester City","Premier League","Islam Slimani","ALG","FW","29",1988,2.8,2,2,1,1,0,1,4,25,3,2,0,2,0,2,2,0,"https://fbref.com/en/players/ffec9769/Islam-Slimani"
2018,"Leicester City","Premier League","Leonardo Ulloa","ARG","FW","31",1986,0.2,1,0,0,0,1,0,0,NA,0,0,0,0,0,1,1,0,"https://fbref.com/en/players/eed56f6c/Leonardo-Ulloa"
2018,"Leicester City","Premier League","Jamie Vardy","ENG","FW","30",1987,36.1,15,9,3,7,5,1,8,12.5,7,21,1,20,2,17,17,0,"https://fbref.com/en/players/45963054/Jamie-Vardy"
2018,"Levante","La Liga","Aly Abeid","MTN","DF","19",1997,0.9,2,1,1,1,0,0,1,0,1,1,0,1,3,5,3,0,"https://fbref.com/en/players/bbe88396/Aly-Abeid"
2018,"Levante","La Liga","Álex Alegría","ESP","FW","24",1992,7,8,5,1,3,4,2,6,33.3,4,7,0,7,4,12,9,0,"https://fbref.com/en/players/46166b49/Alex-Alegria"
2018,"Levante","La Liga","Enis Bardhi","MKD","MF","22",1995,17.6,39,26,14,16,9,10,38,26.3,28,11,0,11,16,55,7,0,"https://fbref.com/en/players/cac2537b/Enis-Bardhi"
2018,"Levante","La Liga","Emmanuel Boateng","GHA","FW","21",1996,14.2,4,3,0,0,4,0,6,0,6,8,1,7,5,9,17,0,"https://fbref.com/en/players/2e23c66b/Emmanuel-Boateng"
2018,"Levante","La Liga","Erick Cabaco","URU","DF","22",1995,11.6,25,14,21,4,0,14,20,70,6,10,8,2,17,42,71,2,"https://fbref.com/en/players/e7ab4179/Erick-Cabaco"
2018,"Levante","La Liga","José Campaña","ESP","MF","24",1993,30.4,57,36,25,27,5,19,58,32.8,39,31,10,21,45,102,37,0,"https://fbref.com/en/players/61220da2/Jose-Campana"
2018,"Levante","La Liga","Chema","ESP","DF","25",1992,22.4,20,13,14,6,0,9,18,50,9,43,27,16,30,50,110,1,"https://fbref.com/en/players/7f203b54/Chema"
2018,"Levante","La Liga","Coke","ESP","DF","30",1987,15.4,35,23,26,7,2,18,39,46.2,21,17,5,12,34,69,46,0,"https://fbref.com/en/players/6d8f8441/Coke"
2018,"Levante","La Liga","Cheick Doukouré","CIV","MF","24",1992,11.4,34,19,18,15,1,6,22,27.3,16,15,4,11,14,48,4,0,"https://fbref.com/en/players/e208bcc8/Cheick-Doukoure"
2018,"Levante","La Liga","Raúl Fernández","ESP","GK","29",1988,11,0,0,0,0,0,0,0,NA,0,1,0,1,0,0,10,1,"https://fbref.com/en/players/6fb59070/Raul-Fernandez"
2018,"Levante","La Liga","Samu García","ESP","FW,MF","27",1990,2.1,9,7,1,6,2,2,5,40,3,3,0,3,1,10,2,0,"https://fbref.com/en/players/5f7db81a/Samu-Garcia"
2018,"Levante","La Liga","Hacen","MTN","FW,MF","19",1997,0.9,0,0,0,0,0,0,0,NA,0,4,2,2,1,1,0,0,"https://fbref.com/en/players/7c689c48/Hacen"
2018,"Levante","La Liga","Ivi","ESP","MF,FW","23",1994,19.6,48,34,19,23,6,21,62,33.9,41,21,1,20,15,63,15,0,"https://fbref.com/en/players/d2fa73e7/Ivi"
2018,"Levante","La Liga","Jason","ESP","FW,MF","23",1994,19.8,32,25,11,14,7,11,38,28.9,27,14,1,13,20,52,8,0,"https://fbref.com/en/players/9038c2a1/Jason"
2018,"Levante","La Liga","Jefferson Lerma","COL","MF","22",1994,23.7,51,35,26,23,2,17,45,37.8,28,25,10,15,49,100,43,0,"https://fbref.com/en/players/9b5ce51a/Jefferson-Lerma"
2018,"Levante","La Liga","Iván López","ESP","DF","23",1993,1.9,1,1,1,0,0,0,0,NA,0,2,2,0,8,9,2,0,"https://fbref.com/en/players/576575e5/Ivan-Lopez"
2018,"Levante","La Liga","Pedro López Muñoz","ESP","DF","33",1983,17.7,33,23,21,10,2,17,30,56.7,13,22,7,15,26,59,45,0,"https://fbref.com/en/players/a60823a4/Pedro-Lopez-Munoz"
2018,"Levante","La Liga","José Luis Morales","ESP","MF,FW","30",1987,34,37,23,15,15,7,13,65,20,52,28,0,28,26,63,20,0,"https://fbref.com/en/players/4a478107/Jose-Luis-Morales"
2018,"Levante","La Liga","Saša Lukić","SRB","MF","20",1996,11,21,16,9,8,4,5,16,31.3,11,14,6,8,17,38,13,0,"https://fbref.com/en/players/c6e8cf1f/Sasa-Lukic"
2018,"Levante","La Liga","Antonio Luna","ESP","DF","26",1991,22.5,39,26,23,13,3,24,41,58.5,17,26,9,17,36,75,68,0,"https://fbref.com/en/players/ed239245/Antonio-Luna"
2018,"Levante","La Liga","Roger Martí","ESP","FW","26",1991,10.7,8,4,2,5,1,2,13,15.4,11,11,0,11,1,9,5,0,"https://fbref.com/en/players/0ae4e09a/Roger-Marti"
2018,"Levante","La Liga","Shaquell Moore","USA","DF","20",1996,4.7,8,6,3,3,2,3,7,42.9,4,4,0,4,13,21,11,0,"https://fbref.com/en/players/3b9f859b/Shaquell-Moore"
2018,"Levante","La Liga","Fahad Al Muwallad","KSA","MF","22",1994,0.3,0,0,0,0,0,0,1,0,1,0,0,0,1,1,0,0,"https://fbref.com/en/players/23f32ea1/Fahad-Al-Muwallad"
2018,"Levante","La Liga","Nano","ESP","FW","22",1995,3.1,7,6,2,4,1,1,1,100,0,4,0,4,0,7,0,0,"https://fbref.com/en/players/217011a0/Nano"
2018,"Levante","La Liga","Oier Olazábal","ESP","GK","27",1989,26,0,0,0,0,0,0,2,0,2,1,0,1,1,1,12,3,"https://fbref.com/en/players/b5bdf144/Oier-Olazabal"
2018,"Levante","La Liga","Giampaolo Pazzini","ITA","FW","32",1984,4.9,0,0,0,0,0,0,0,NA,0,1,0,1,1,1,1,0,"https://fbref.com/en/players/6ca663b4/Giampaolo-Pazzini"
2018,"Levante","La Liga","Sergio Postigo","ESP","DF","28",1988,26.9,36,23,30,5,1,18,32,56.3,14,27,13,14,40,76,140,1,"https://fbref.com/en/players/474ecac8/Sergio-Postigo"
2018,"Levante","La Liga","Rober","ESP","DF,MF","22",1995,21.2,35,22,27,8,0,17,32,53.1,15,29,18,11,41,76,75,1,"https://fbref.com/en/players/c00097d2/Rober"
2018,"Levante","La Liga","Rubén Rochina","ESP","MF,DF","26",1991,1.7,8,5,5,2,1,4,6,66.7,2,0,0,0,2,10,0,0,"https://fbref.com/en/players/ecd8c01e/Ruben-Rochina"
2018,"Levante","La Liga","Armando Sadiku","ALB","FW","26",1991,3,1,1,0,1,0,0,1,0,1,4,2,2,2,3,2,0,"https://fbref.com/en/players/8b6d1830/Armando-Sadiku"
2018,"Levante","La Liga","Toño","ESP","DF","27",1989,12,12,11,11,1,0,5,10,50,5,4,0,4,6,18,29,0,"https://fbref.com/en/players/d4ef9ac5/Tono"
2018,"Levante","La Liga","Enes Ünal","TUR","FW","20",1997,6.6,6,6,2,2,2,1,10,10,9,7,1,6,2,8,5,0,"https://fbref.com/en/players/f8eca1b6/Enes-Unal"
2018,"Levante","La Liga","Koke Vegas","ESP","GK","21",1995,1,0,0,0,0,0,0,0,NA,0,0,0,0,0,0,1,0,"https://fbref.com/en/players/bfb15d99/Koke-Vegas"
2018,"Leverkusen","Bundesliga","Lucas Alario","ARG","FW","24",1992,17.2,16,10,2,12,2,3,8,37.5,5,17,4,13,4,20,16,0,"https://fbref.com/en/players/834d0be5/Lucas-Alario"
2018,"Leverkusen","Bundesliga","Charles Aránguiz","CHI","MF","28",1989,25.6,75,61,17,50,8,33,62,53.2,29,46,5,41,48,123,27,2,"https://fbref.com/en/players/56413b1f/Charles-Aranguiz"
2018,"Leverkusen","Bundesliga","Leon Bailey","JAM","FW,DF","19",1997,24.6,16,12,7,4,5,8,13,61.5,5,28,0,28,15,31,6,0,"https://fbref.com/en/players/3a233281/Leon-Bailey"
2018,"Leverkusen","Bundesliga","Julian Baumgartlinger","AUT","MF,DF","29",1988,15.5,47,37,21,21,5,14,29,48.3,15,25,2,23,18,65,23,0,"https://fbref.com/en/players/69374ff5/Julian-Baumgartlinger"
2018,"Leverkusen","Bundesliga","Karim Bellarabi","GER","MF,FW","27",1990,12.7,22,17,10,9,3,10,19,52.6,9,26,1,25,13,35,5,0,"https://fbref.com/en/players/bee0bab1/Karim-Bellarabi"
2018,"Leverkusen","Bundesliga","Lars Bender","GER","DF,MF","28",1989,17.7,63,52,26,32,5,35,53,66,18,34,7,27,28,91,40,0,"https://fbref.com/en/players/c50281a0/Lars-Bender"
2018,"Leverkusen","Bundesliga","Sven Bender","GER","DF","28",1989,26.1,51,37,33,18,0,26,34,76.5,8,49,21,28,50,101,123,1,"https://fbref.com/en/players/070ec0b1/Sven-Bender"
2018,"Leverkusen","Bundesliga","Julian Brandt","GER","FW,MF","21",1996,25.8,24,18,11,9,4,11,29,37.9,18,23,1,22,16,40,12,1,"https://fbref.com/en/players/a167537f/Julian-Brandt"
2018,"Leverkusen","Bundesliga","Aleksandar Dragović","AUT","DF","26",1991,0.5,0,0,0,0,0,0,1,0,1,0,0,0,0,0,0,1,"https://fbref.com/en/players/6fd8a334/Aleksandar-Dragovic"
2018,"Leverkusen","Bundesliga","Kai Havertz","GER","MF,FW","18",1999,23.8,34,23,8,23,3,12,25,48,13,33,2,31,19,53,23,0,"https://fbref.com/en/players/fed7cb61/Kai-Havertz"
2018,"Leverkusen","Bundesliga","Benjamin Henrichs","GER","DF","20",1997,14.1,42,28,23,16,3,27,43,62.8,16,23,3,20,31,73,32,0,"https://fbref.com/en/players/0a89e877/Benjamin-Henrichs"
2018,"Leverkusen","Bundesliga","Tin Jedvaj","CRO","DF","21",1995,6.7,10,6,2,6,2,8,15,53.3,7,9,1,8,9,19,18,0,"https://fbref.com/en/players/f820504e/Tin-Jedvaj"
2018,"Leverkusen","Bundesliga","Kevin Kampl","SVN","MF","26",1990,0.3,1,1,1,0,0,1,1,100,0,0,0,0,0,1,0,0,"https://fbref.com/en/players/b825a650/Kevin-Kampl"
2018,"Leverkusen","Bundesliga","Stefan Kießling","GER","DF,MF","33",1984,0.9,0,0,0,0,0,0,0,NA,0,2,0,2,0,0,1,0,"https://fbref.com/en/players/c419e035/Stefan-Kiessling"
2018,"Leverkusen","Bundesliga","Dominik Kohr","GER","MF","23",1994,18.5,49,26,20,25,4,25,41,61,16,39,5,34,30,79,24,0,"https://fbref.com/en/players/0fbecd11/Dominik-Kohr"
2018,"Leverkusen","Bundesliga","Bernd Leno","GER","GK","25",1992,33,0,0,0,0,0,0,1,0,1,0,0,0,1,1,11,2,"https://fbref.com/en/players/2628fd2b/Bernd-Leno"
2018,"Leverkusen","Bundesliga","Admir Mehmedi","SUI","DF,MF","26",1991,7.8,20,18,6,11,3,4,13,30.8,9,13,0,13,13,33,5,0,"https://fbref.com/en/players/b500b384/Admir-Mehmedi"
2018,"Leverkusen","Bundesliga","Ramazan Özcan","AUT","GK","33",1984,1,0,0,0,0,0,0,1,0,1,0,0,0,0,0,0,0,"https://fbref.com/en/players/a165a577/Ramazan-Ozcan"
2018,"Leverkusen","Bundesliga","Joel Pohjanpalo","FIN","MF,FW","22",1994,1.3,0,0,0,0,0,0,2,0,2,1,1,0,0,0,2,0,"https://fbref.com/en/players/ea003d07/Joel-Pohjanpalo"
2018,"Leverkusen","Bundesliga","André Ramalho","BRA","DF,FW","25",1992,0.4,3,1,2,1,0,2,2,100,0,1,0,1,1,4,1,0,"https://fbref.com/en/players/7483d9f9/Andre-Ramalho"
2018,"Leverkusen","Bundesliga","Panagiotis Retsos","GRE","DF","18",1998,19.1,48,40,32,14,2,33,46,71.7,13,29,8,21,29,77,47,0,"https://fbref.com/en/players/4bd00a50/Panagiotis-Retsos"
2018,"Leverkusen","Bundesliga","Jonathan Tah","GER","DF","21",1996,27,47,34,35,12,0,30,38,78.9,8,22,13,9,34,81,112,2,"https://fbref.com/en/players/bd142efb/Jonathan-Tah"
2018,"Leverkusen","Bundesliga","Kevin Volland","GER","FW,MF","25",1992,28.8,23,20,7,8,8,11,26,42.3,15,16,1,15,3,26,35,0,"https://fbref.com/en/players/64f69877/Kevin-Volland"
2018,"Leverkusen","Bundesliga","Wendell","BRA","DF","24",1993,23.5,54,41,29,20,5,32,58,55.2,26,44,8,36,28,82,58,0,"https://fbref.com/en/players/f9acca3a/Wendell"
2018,"Lille","Ligue 1","Júnior Alonso","PAR","DF","24",1993,30.9,58,31,36,22,0,28,50,56,22,26,16,10,56,114,153,1,"https://fbref.com/en/players/b18a3023/Junior-Alonso"
2018,"Lille","Ligue 1","Ibrahim Amadou","FRA","MF,DF","24",1993,26.7,43,29,24,19,0,14,27,51.9,13,30,13,17,41,84,70,3,"https://fbref.com/en/players/9260926b/Ibrahim-Amadou"
2018,"Lille","Ligue 1","Luiz Araújo","BRA","FW,MF","21",1996,22.4,41,31,23,17,1,10,47,21.3,37,24,0,24,16,57,11,1,"https://fbref.com/en/players/fa18c72e/Luiz-Araujo"
2018,"Lille","Ligue 1","Farès Bahlouli","FRA","MF,FW","22",1995,3.4,10,8,4,3,3,2,7,28.6,5,7,0,7,1,11,1,0,"https://fbref.com/en/players/776972d5/Fares-Bahlouli"
2018,"Lille","Ligue 1","Fodé Ballo-Touré","SEN","DF","20",1997,22.8,50,36,29,16,5,21,47,44.7,26,27,2,25,28,78,47,1,"https://fbref.com/en/players/f449640d/Fode-Ballo-Toure"
2018,"Lille","Ligue 1","Yassine Benzia","ALG","MF,FW","22",1994,25.4,62,41,21,31,10,17,62,27.4,45,31,4,27,28,90,14,0,"https://fbref.com/en/players/6fbde63a/Yassine-Benzia"
2018,"Lille","Ligue 1","Yves Bissouma","MLI","MF,DF","20",1996,17.3,67,50,30,32,5,19,39,48.7,20,13,2,11,31,98,31,1,"https://fbref.com/en/players/6c203af0/Yves-Bissouma"
2018,"Lille","Ligue 1","Kouadio-Yves Dabila","CIV","DF","20",1997,10.5,20,11,14,4,2,6,10,60,4,14,6,8,10,30,46,0,"https://fbref.com/en/players/3067cbef/Kouadio-Yves-Dabila"
2018,"Lille","Ligue 1","Imad Faraj","MAR","MF,DF","18",1999,1.8,5,2,2,1,2,4,8,50,4,1,0,1,4,9,3,0,"https://fbref.com/en/players/b396a0b1/Imad-Faraj"
2018,"Lille","Ligue 1","Anwar El Ghazi","NED","FW,MF","22",1995,18.3,23,18,7,13,3,9,29,31,20,11,1,10,7,30,7,1,"https://fbref.com/en/players/ffa90327/Anwar-El-Ghazi"
2018,"Lille","Ligue 1","Edgar Ié","POR","DF","23",1994,35,74,42,55,18,1,31,69,44.9,38,57,26,31,84,158,135,3,"https://fbref.com/en/players/3767b3b7/Edgar-Ie"
2018,"Lille","Ligue 1","Hervé Koffi","BFA","GK","20",1996,4,0,0,0,0,0,0,0,NA,0,0,0,0,1,1,1,1,"https://fbref.com/en/players/faf873a7/Herve-Koffi"
2018,"Lille","Ligue 1","Rominigue Kouamé","MLI","DF,MF","20",1996,2.2,5,2,2,2,1,2,3,66.7,1,1,0,1,5,10,0,0,"https://fbref.com/en/players/86a2ba20/Rominigue-Kouame"
2018,"Lille","Ligue 1","Thiago Maia","BRA","MF,DF","20",1997,27.4,55,40,26,26,3,15,61,24.6,46,32,10,22,61,116,47,1,"https://fbref.com/en/players/91e58f66/Thiago-Maia"
2018,"Lille","Ligue 1","Mike Maignan","FRA","GK","22",1995,33.7,1,1,1,0,0,1,1,100,0,0,0,0,0,1,8,6,"https://fbref.com/en/players/fcb38f57/Mike-Maignan"
2018,"Lille","Ligue 1","Kévin Malcuit","MAR","DF","26",1991,20.2,51,37,31,16,4,17,25,68,8,13,5,8,38,89,47,0,"https://fbref.com/en/players/d6a889ea/Kevin-Malcuit"
2018,"Lille","Ligue 1","Thiago Mendes","BRA","MF","25",1992,25.5,25,16,10,11,4,5,23,21.7,18,21,3,18,25,50,29,0,"https://fbref.com/en/players/c6e5d20f/Thiago-Mendes"
2018,"Lille","Ligue 1","Hamza Mendyl","MAR","DF,MF","19",1997,9.5,18,10,12,6,0,11,20,55,9,5,0,5,17,35,26,0,"https://fbref.com/en/players/f99fe221/Hamza-Mendyl"
2018,"Lille","Ligue 1","Lebo Mothiba","RSA","FW","21",1996,13.2,8,5,4,0,4,0,7,0,7,6,2,4,2,10,11,0,"https://fbref.com/en/players/3eaf8817/Lebo-Mothiba"
2018,"Lille","Ligue 1","Nicolas Pépé","CIV","FW,MF","22",1995,31.6,30,18,14,11,5,11,42,26.2,31,23,0,23,10,40,20,0,"https://fbref.com/en/players/57e3f0c7/Nicolas-Pepe"
2018,"Lille","Ligue 1","Ezequiel Ponce","ARG","FW","20",1997,12.2,9,8,3,5,1,0,7,0,7,2,1,1,3,12,11,0,"https://fbref.com/en/players/ccbbe661/Ezequiel-Ponce"
2018,"Lille","Ligue 1","Nicolas de Préville","FRA","FW,MF","26",1991,3.2,3,3,0,1,2,1,5,20,4,3,0,3,0,3,2,0,"https://fbref.com/en/players/b0547a87/Nicolas-de-Preville"
2018,"Lille","Ligue 1","Adama Soumaoro","FRA","DF","25",1992,13.2,9,5,7,2,0,2,3,66.7,1,22,16,6,16,25,50,1,"https://fbref.com/en/players/7b075c75/Adama-Soumaoro"
2018,"Lille","Ligue 1","Boubakary Soumaré","FRA","MF","18",1999,5.7,13,9,8,5,0,3,14,21.4,11,8,1,7,7,20,6,1,"https://fbref.com/en/players/ae59b359/Boubakary-Soumare"
2018,"Lille","Ligue 1","Xeka","POR","MF","22",1994,0.2,1,0,1,0,0,0,0,NA,0,1,0,1,1,2,0,0,"https://fbref.com/en/players/f3600c02/Xeka"
2018,"Liverpool","Premier League","Trent Alexander-Arnold","ENG","DF","18",1998,17.5,37,25,23,9,5,22,36,61.1,14,20,5,15,28,65,46,1,"https://fbref.com/en/players/cd1acf9d/Trent-Alexander-Arnold"
2018,"Liverpool","Premier League","Emre Can","GER","MF","23",1994,23.2,67,54,32,29,6,18,43,41.9,25,32,4,28,28,95,37,1,"https://fbref.com/en/players/a65ce836/Emre-Can"
2018,"Liverpool","Premier League","Nathaniel Clyne","ENG","DF,FW","26",1991,1.9,3,1,2,1,0,0,1,0,1,2,1,1,0,3,3,0,"https://fbref.com/en/players/0442183b/Nathaniel-Clyne"
2018,"Liverpool","Premier League","Philippe Coutinho","BRA","MF,FW","25",1992,12.3,17,14,4,10,3,3,21,14.3,18,10,0,10,10,27,5,1,"https://fbref.com/en/players/0ef89a37/Philippe-Coutinho"
2018,"Liverpool","Premier League","Roberto Firmino","BRA","FW","25",1991,30.7,65,50,9,36,20,8,58,13.8,50,40,2,38,18,83,10,0,"https://fbref.com/en/players/4c370d81/Roberto-Firmino"
2018,"Liverpool","Premier League","Joe Gomez","ENG","DF","20",1997,21.1,58,45,32,23,3,21,40,52.5,19,19,8,11,34,92,57,1,"https://fbref.com/en/players/7a11550b/Joe-Gomez"
2018,"Liverpool","Premier League","Marko Grujić","SRB","MF,DF","21",1996,0.2,2,2,0,1,1,2,2,100,0,0,0,0,0,2,0,0,"https://fbref.com/en/players/8b8e759d/Marko-Grujic"
2018,"Liverpool","Premier League","Jordan Henderson","ENG","MF","27",1990,24.1,51,33,13,32,6,18,52,34.6,34,33,2,31,31,82,27,0,"https://fbref.com/en/players/935e6b8f/Jordan-Henderson"
2018,"Liverpool","Premier League","Danny Ings","ENG","FW","25",1992,3,5,3,1,3,1,0,0,NA,0,4,0,4,2,7,1,0,"https://fbref.com/en/players/07802f7f/Danny-Ings"
2018,"Liverpool","Premier League","Loris Karius","GER","GK","24",1993,19,0,0,0,0,0,0,0,NA,0,0,0,0,1,1,4,0,"https://fbref.com/en/players/32e7ce92/Loris-Karius"
2018,"Liverpool","Premier League","Ragnar Klavan","EST","DF","31",1985,16.1,14,10,6,7,1,6,12,50,6,11,5,6,15,29,85,1,"https://fbref.com/en/players/008a6e6d/Ragnar-Klavan"
2018,"Liverpool","Premier League","Adam Lallana","ENG","MF,FW","29",1988,3.4,3,1,3,0,0,2,10,20,8,3,0,3,1,4,1,0,"https://fbref.com/en/players/99813635/Adam-Lallana"
2018,"Liverpool","Premier League","Dejan Lovren","CRO","DF","28",1989,23.6,26,17,14,11,1,12,22,54.5,10,26,15,11,38,64,146,2,"https://fbref.com/en/players/1a2935f6/Dejan-Lovren"
2018,"Liverpool","Premier League","Sadio Mané","SEN","FW","25",1992,24.3,28,20,8,11,9,3,23,13,20,20,0,20,9,37,8,0,"https://fbref.com/en/players/c691bfe2/Sadio-Mane"
2018,"Liverpool","Premier League","Joël Matip","CMR","DF","25",1991,22.2,35,24,23,11,1,12,24,50,12,26,15,11,35,70,101,1,"https://fbref.com/en/players/b217ef29/Joel-Matip"
2018,"Liverpool","Premier League","Simon Mignolet","BEL","GK","29",1988,19,2,1,2,0,0,1,3,33.3,2,0,0,0,0,2,5,3,"https://fbref.com/en/players/d436eb94/Simon-Mignolet"
2018,"Liverpool","Premier League","James Milner","ENG","MF","31",1986,19.7,58,45,18,32,8,15,39,38.5,24,33,5,28,21,79,23,0,"https://fbref.com/en/players/2f90f6b8/James-Milner"
2018,"Liverpool","Premier League","Alberto Moreno","ESP","DF","25",1992,14.1,35,26,21,12,2,13,29,44.8,16,19,2,17,12,47,44,0,"https://fbref.com/en/players/11b9265b/Alberto-Moreno"
2018,"Liverpool","Premier League","Divock Origi","BEL","FW","22",1995,0.1,0,0,0,0,0,0,0,NA,0,0,0,0,0,0,0,0,"https://fbref.com/en/players/43a166b4/Divock-Origi"
2018,"Liverpool","Premier League","Alex Oxlade-Chamberlain","ENG","MF,FW","23",1993,16.6,32,21,13,14,5,6,21,28.6,15,24,0,24,20,52,14,0,"https://fbref.com/en/players/38c7feef/Alex-Oxlade-Chamberlain"
2018,"Liverpool","Premier League","Andrew Robertson","SCO","DF","23",1994,21.6,31,17,19,9,3,15,29,51.7,14,22,2,20,26,57,56,0,"https://fbref.com/en/players/2e4f5f03/Andrew-Robertson"
2018,"Liverpool","Premier League","Mohamed Salah","EGY","FW","25",1992,32.3,12,6,2,5,5,3,23,13,20,10,0,10,5,17,5,0,"https://fbref.com/en/players/e342ad68/Mohamed-Salah"
2018,"Liverpool","Premier League","Dominic Solanke","ENG","FW","19",1997,6.6,7,4,0,6,1,1,4,25,3,5,1,4,2,9,9,0,"https://fbref.com/en/players/e77dc3b2/Dominic-Solanke"
2018,"Liverpool","Premier League","Daniel Sturridge","ENG","FW","27",1989,4.8,0,0,0,0,0,0,1,0,1,1,0,1,0,0,1,0,"https://fbref.com/en/players/1b7ec703/Daniel-Sturridge"
2018,"Liverpool","Premier League","Virgil van Dijk","NED","DF","26",1991,14,15,8,7,7,1,4,5,80,1,8,2,6,18,33,80,1,"https://fbref.com/en/players/e06683ca/Virgil-van-Dijk"
2018,"Liverpool","Premier League","Georginio Wijnaldum","NED","MF","26",1990,26.5,34,23,13,16,5,11,23,47.8,12,20,2,18,25,59,20,0,"https://fbref.com/en/players/eb58eef0/Georginio-Wijnaldum"
2018,"Liverpool","Premier League","Ben Woodburn","WAL","FW","17",1999,0.1,0,0,0,0,0,0,0,NA,0,0,0,0,0,0,0,0,"https://fbref.com/en/players/8aadeaef/Ben-Woodburn"
2018,"Lyon","Ligue 1","Houssem Aouar","FRA","MF,FW","19",1998,27,66,42,22,39,5,20,66,30.3,46,30,0,30,39,105,34,0,"https://fbref.com/en/players/a5db0bec/Houssem-Aouar"
2018,"Lyon","Ligue 1","Pape Cheikh Diop","SEN","MF","19",1997,0.1,0,0,0,0,0,0,0,NA,0,0,0,0,0,0,0,0,"https://fbref.com/en/players/873ce3a2/Pape-Cheikh-Diop"
2018,"Lyon","Ligue 1","Maxwel Cornet","CIV","FW","20",1996,14.1,17,12,6,9,2,3,25,12,22,11,1,10,14,31,14,0,"https://fbref.com/en/players/beb391dd/Maxwel-Cornet"
2018,"Lyon","Ligue 1","Sergi Darder","ESP","MF","23",1993,2.3,9,3,1,5,3,1,7,14.3,6,0,0,0,3,12,3,0,"https://fbref.com/en/players/070a3904/Sergi-Darder"
2018,"Lyon","Ligue 1","Mouctar Diakhaby","GUI","DF","20",1996,8.1,10,6,7,3,0,4,7,57.1,3,14,9,5,12,22,52,1,"https://fbref.com/en/players/d2110326/Mouctar-Diakhaby"
2018,"Lyon","Ligue 1","Nabil Fekir","FRA","MF,FW","24",1993,27.5,45,33,11,24,10,8,40,20,32,11,0,11,8,53,5,0,"https://fbref.com/en/players/bece776f/Nabil-Fekir"
2018,"Lyon","Ligue 1","Jordan Ferri","FRA","MF","25",1992,7.1,20,11,8,11,1,7,20,35,13,11,1,10,5,25,11,2,"https://fbref.com/en/players/375622c5/Jordan-Ferri"
2018,"Lyon","Ligue 1","Willem Geubbels","FRA","FW,MF","15",2001,0.4,2,2,1,1,0,0,1,0,1,0,0,0,0,2,0,0,"https://fbref.com/en/players/9836e892/Willem-Geubbels"
2018,"Lyon","Ligue 1","Mathieu Gorgelin","FRA","GK","26",1990,4,0,0,0,0,0,0,0,NA,0,0,0,0,0,0,0,1,"https://fbref.com/en/players/4d3e9033/Mathieu-Gorgelin"
2018,"Lyon","Ligue 1","Amine Gouiri","FRA","FW,MF","17",2000,0.9,1,1,1,0,0,0,1,0,1,0,0,0,2,3,0,0,"https://fbref.com/en/players/aad56ca3/Amine-Gouiri"
2018,"Lyon","Ligue 1","Clément Grenier","FRA","FW","26",1991,0.1,1,1,1,0,0,0,0,NA,0,0,0,0,0,1,0,0,"https://fbref.com/en/players/8b298f56/Clement-Grenier"
2018,"Lyon","Ligue 1","Anthony Lopes","POR","GK","26",1990,34,0,0,0,0,0,0,0,NA,0,0,0,0,1,1,17,4,"https://fbref.com/en/players/f00de885/Anthony-Lopes"
2018,"Lyon","Ligue 1","Myziane Maolida","FRA","FW,MF","18",1999,3.7,5,5,3,2,0,0,2,0,2,1,0,1,0,5,0,0,"https://fbref.com/en/players/706a60e1/Myziane-Maolida"
2018,"Lyon","Ligue 1","Fernando Marçal","BRA","DF","28",1989,14.4,34,20,22,8,4,14,29,48.3,15,14,6,8,26,60,69,0,"https://fbref.com/en/players/9ae9eaea/Fernando-Marcal"
2018,"Lyon","Ligue 1","Marcelo","BRA","DF","30",1987,34.5,27,25,16,10,1,9,25,36,16,32,18,14,57,84,235,4,"https://fbref.com/en/players/e3d0b0c4/Marcelo"
2018,"Lyon","Ligue 1","Mariano","DOM","FW","23",1993,27.9,16,11,0,5,11,2,23,8.7,21,9,1,8,3,19,20,0,"https://fbref.com/en/players/5c4dc0ff/Mariano"
2018,"Lyon","Ligue 1","Christopher Martins","LUX","MF","20",1997,0.8,3,2,0,3,0,1,2,50,1,0,0,0,1,4,0,0,"https://fbref.com/en/players/0e96a5e1/Christopher-Martins"
2018,"Lyon","Ligue 1","Memphis","NED","FW","23",1994,28.4,13,9,4,3,6,3,28,10.7,25,15,0,15,9,22,5,0,"https://fbref.com/en/players/8f696594/Memphis"
2018,"Lyon","Ligue 1","Ferland Mendy","FRA","DF","22",1995,23.6,45,28,29,13,3,20,31,64.5,11,18,5,13,25,70,43,0,"https://fbref.com/en/players/3cefcaef/Ferland-Mendy"
2018,"Lyon","Ligue 1","Jérémy Morel","MAD","DF","33",1984,32.4,39,27,23,15,1,18,23,78.3,5,28,23,5,46,85,129,5,"https://fbref.com/en/players/e97150c0/Jeremy-Morel"
2018,"Lyon","Ligue 1","Tanguy Ndombele","FRA","MF","20",1996,26.1,62,39,23,31,8,11,40,27.5,29,53,8,45,36,98,9,0,"https://fbref.com/en/players/5cdddffa/Tanguy-Ndombele"
2018,"Lyon","Ligue 1","Rafael","BRA","DF","27",1990,20.1,54,28,30,18,6,22,43,51.2,21,20,3,17,42,96,53,0,"https://fbref.com/en/players/9a1f2e1c/Rafael"
2018,"Lyon","Ligue 1","Kenny Tete","NED","DF","21",1995,17.9,37,25,24,10,3,15,26,57.7,11,20,7,13,29,66,52,0,"https://fbref.com/en/players/77d7c96f/Kenny-Tete"
2018,"Lyon","Ligue 1","Lucas Tousart","FRA","MF","20",1997,34.8,98,59,41,55,2,38,98,38.8,60,41,16,25,52,150,79,0,"https://fbref.com/en/players/71ec39ef/Lucas-Tousart"
2018,"Lyon","Ligue 1","Bertrand Traoré","BFA","FW","21",1995,25.4,32,20,7,20,5,10,35,28.6,25,24,3,21,39,71,31,1,"https://fbref.com/en/players/c47541e0/Bertrand-Traore"
2018,"Lyon","Ligue 1","Mapou Yanga-Mbiwa","FRA","DF","28",1989,1.4,3,2,3,0,0,1,1,100,0,0,0,0,1,4,2,0,"https://fbref.com/en/players/20573d10/Mapou-Yanga-Mbiwa"
2018,"M'Gladbach","Bundesliga","László Bénes","SVK","MF","19",1997,0.4,0,0,0,0,0,0,1,0,1,2,1,1,1,1,2,0,"https://fbref.com/en/players/fe888e39/Laszlo-Benes"
2018,"M'Gladbach","Bundesliga","Marcel Benger","GER","MF","19",1998,0,0,0,0,0,0,0,0,NA,0,0,0,0,0,0,0,0,"https://fbref.com/en/players/379c0717/Marcel-Benger"
2018,"M'Gladbach","Bundesliga","Raúl Bobadilla","PAR","FW,MF","30",1987,5,7,6,1,3,3,4,8,50,4,6,0,6,0,7,1,0,"https://fbref.com/en/players/9b285700/Raul-Bobadilla"
2018,"M'Gladbach","Bundesliga","Mickaël Cuisance","FRA","MF,FW","17",1999,13.4,31,20,16,11,4,19,29,65.5,10,22,4,18,10,41,10,1,"https://fbref.com/en/players/5722eced/Mickael-Cuisance"
2018,"M'Gladbach","Bundesliga","Josip Drmić","SUI","FW,MF","24",1992,5.2,0,0,0,0,0,0,4,0,4,1,0,1,0,0,1,1,"https://fbref.com/en/players/15ea94de/Josip-Drmic"
2018,"M'Gladbach","Bundesliga","Mandela Egbo","ENG","DF,MF","19",1997,0.1,0,0,0,0,0,0,0,NA,0,0,0,0,0,0,2,0,"https://fbref.com/en/players/5603d397/Mandela-Egbo"
2018,"M'Gladbach","Bundesliga","Nico Elvedi","SUI","DF","20",1996,32.4,66,46,41,22,3,37,55,67.3,18,39,9,30,51,117,108,3,"https://fbref.com/en/players/48035304/Nico-Elvedi"
2018,"M'Gladbach","Bundesliga","Matthias Ginter","GER","DF","23",1994,34,48,37,27,20,1,35,45,77.8,10,40,17,23,40,88,114,1,"https://fbref.com/en/players/f521b80a/Matthias-Ginter"
2018,"M'Gladbach","Bundesliga","Vincenzo Grifo","ITA","MF,FW","24",1993,8.7,8,5,3,3,2,4,8,50,4,8,1,7,5,13,6,0,"https://fbref.com/en/players/54e4866f/Vincenzo-Grifo"
2018,"M'Gladbach","Bundesliga","Thorgan Hazard","BEL","MF,FW","24",1993,32.7,49,32,16,23,10,20,54,37,34,39,1,38,28,77,18,0,"https://fbref.com/en/players/50871bcc/Thorgan-Hazard"
2018,"M'Gladbach","Bundesliga","Patrick Herrmann","GER","MF,FW","26",1991,12.5,29,21,9,13,7,17,29,58.6,12,13,0,13,17,46,19,0,"https://fbref.com/en/players/dfb6490a/Patrick-Herrmann"
2018,"M'Gladbach","Bundesliga","Jonas Hofmann","GER","MF,FW","25",1992,11.5,23,19,12,11,0,12,26,46.2,14,15,4,11,12,35,16,0,"https://fbref.com/en/players/2903a856/Jonas-Hofmann"
2018,"M'Gladbach","Bundesliga","Tony Jantschke","GER","DF","27",1990,8.1,13,11,9,4,0,8,13,61.5,5,10,1,9,6,19,25,0,"https://fbref.com/en/players/34b54da7/Tony-Jantschke"
2018,"M'Gladbach","Bundesliga","Fabian Johnson","USA","MF,DF","29",1987,5.2,16,10,7,7,2,6,7,85.7,1,10,2,8,2,18,13,0,"https://fbref.com/en/players/76e5da9d/Fabian-Johnson"
2018,"M'Gladbach","Bundesliga","Christoph Kramer","GER","MF","26",1991,23.9,89,70,43,34,12,39,76,51.3,37,29,4,25,43,132,37,1,"https://fbref.com/en/players/496aeede/Christoph-Kramer"
2018,"M'Gladbach","Bundesliga","Florian Mayer","GER","DF","19",1998,0.2,1,1,1,0,0,1,1,100,0,0,0,0,0,1,1,0,"https://fbref.com/en/players/45870256/Florian-Mayer"
2018,"M'Gladbach","Bundesliga","Reece Oxford","ENG","DF,MF","18",1998,5.1,8,6,3,4,1,3,4,75,1,4,0,4,9,17,26,1,"https://fbref.com/en/players/8b6e0db2/Reece-Oxford"
2018,"M'Gladbach","Bundesliga","Raffael","BRA","FW","32",1985,23,40,32,12,23,5,17,36,47.2,19,18,0,18,8,48,2,0,"https://fbref.com/en/players/791af558/Raffael"
2018,"M'Gladbach","Bundesliga","Tobias Sippel","GER","GK","29",1988,4.8,1,1,1,0,0,1,2,50,1,0,0,0,0,1,5,1,"https://fbref.com/en/players/0d8a37c2/Tobias-Sippel"
2018,"M'Gladbach","Bundesliga","Yann Sommer","SUI","GK","28",1988,29.2,0,0,0,0,0,0,0,NA,0,0,0,0,3,3,6,3,"https://fbref.com/en/players/420c18a1/Yann-Sommer"
2018,"M'Gladbach","Bundesliga","Lars Stindl","GER","FW,MF","28",1988,30.3,52,39,11,29,12,14,38,36.8,24,53,4,49,31,83,32,1,"https://fbref.com/en/players/7cd6badb/Lars-Stindl"
2018,"M'Gladbach","Bundesliga","Tobias Strobl","GER","MF","27",1990,1.3,3,1,0,2,1,0,1,0,1,2,0,2,6,9,2,0,"https://fbref.com/en/players/17780d2b/Tobias-Strobl"
2018,"M'Gladbach","Bundesliga","Ibrahima Traoré","GUI","MF","29",1988,2.2,4,2,2,2,0,4,7,57.1,3,2,0,2,0,4,1,0,"https://fbref.com/en/players/096a77c4/Ibrahima-Traore"
2018,"M'Gladbach","Bundesliga","Jannik Vestergaard","DEN","DF","24",1992,32,58,41,43,15,0,32,48,66.7,16,55,39,16,40,98,161,3,"https://fbref.com/en/players/1900032e/Jannik-Vestergaard"
2018,"M'Gladbach","Bundesliga","Julio Villalba","PAR","DF","18",1998,0.1,0,0,0,0,0,0,0,NA,0,0,0,0,0,0,0,0,"https://fbref.com/en/players/57200916/Julio-Villalba"
2018,"M'Gladbach","Bundesliga","Oscar Wendt","SWE","DF","31",1985,27.3,54,40,31,19,4,30,45,66.7,15,46,12,34,27,81,71,0,"https://fbref.com/en/players/b69261a0/Oscar-Wendt"
2018,"M'Gladbach","Bundesliga","Denis Zakaria","SUI","MF","20",1996,25.5,74,48,38,32,4,40,61,65.6,21,52,9,43,45,119,40,1,"https://fbref.com/en/players/384d58d9/Denis-Zakaria"
2018,"Mainz 05","Bundesliga","René Adler","GER","GK","32",1985,14,1,1,1,0,0,1,1,100,0,0,0,0,0,1,8,1,"https://fbref.com/en/players/f71890f5/Rene-Adler"
2018,"Mainz 05","Bundesliga","Ridle Baku","GER","MF","19",1998,2.6,3,3,1,1,1,0,1,0,1,3,0,3,3,6,2,0,"https://fbref.com/en/players/442b56fa/Ridle-Baku"
2018,"Mainz 05","Bundesliga","Leon Balogun","NGA","DF","29",1988,13,39,32,27,11,1,22,31,71,9,21,9,12,32,71,64,0,"https://fbref.com/en/players/78e68b4d/Leon-Balogun"
2018,"Mainz 05","Bundesliga","Stefan Bell","GER","DF","25",1991,24.2,36,25,23,13,0,27,39,69.2,12,35,18,17,46,82,123,2,"https://fbref.com/en/players/857a5abe/Stefan-Bell"
2018,"Mainz 05","Bundesliga","Emil Berggreen","DEN","FW","24",1993,7.4,2,2,0,0,2,1,4,25,3,7,1,6,1,3,10,0,"https://fbref.com/en/players/8be4fd6a/Emil-Berggreen"
2018,"Mainz 05","Bundesliga","Pablo de Blasis","ARG","FW,MF","29",1988,18.4,39,23,19,11,9,16,33,48.5,17,33,0,33,10,49,34,0,"https://fbref.com/en/players/9ab48bde/Pablo-de-Blasis"
2018,"Mainz 05","Bundesliga","Daniel Brosinski","GER","DF,FW","29",1988,27.8,45,35,21,18,6,22,44,50,22,46,11,35,24,69,75,2,"https://fbref.com/en/players/a7813ac4/Daniel-Brosinski"
2018,"Mainz 05","Bundesliga","Abdou Diallo","SEN","DF","21",1996,26.8,75,53,45,25,5,38,50,76,12,37,14,23,50,125,75,0,"https://fbref.com/en/players/fc62f087/Abdou-Diallo"
2018,"Mainz 05","Bundesliga","Giulio Donati","ITA","DF,FW","27",1990,25.4,56,42,30,21,5,34,50,68,16,38,8,30,35,91,66,1,"https://fbref.com/en/players/22051fbe/Giulio-Donati"
2018,"Mainz 05","Bundesliga","Viktor Fischer","DEN","FW,MF","23",1994,3.7,4,4,2,1,1,2,5,40,3,2,0,2,3,7,2,0,"https://fbref.com/en/players/b5920350/Viktor-Fischer"
2018,"Mainz 05","Bundesliga","Fabian Frei","SUI","MF","28",1989,8.9,22,15,7,12,3,8,15,53.3,7,10,0,10,16,38,17,1,"https://fbref.com/en/players/9fb640a8/Fabian-Frei"
2018,"Mainz 05","Bundesliga","Jean-Philippe Gbamin","CIV","MF,DF","21",1995,28.8,78,63,48,26,4,43,65,66.2,22,50,10,40,50,128,80,0,"https://fbref.com/en/players/6bd603db/Jean-Philippe-Gbamin"
2018,"Mainz 05","Bundesliga","Alexander Hack","GER","DF","23",1993,14.3,46,34,25,19,2,24,37,64.9,13,31,18,13,26,72,87,2,"https://fbref.com/en/players/a5ec3ede/Alexander-Hack"
2018,"Mainz 05","Bundesliga","Gerrit Holtmann","PHI","FW,DF","22",1995,10,16,13,8,5,3,11,22,50,11,19,2,17,12,28,9,0,"https://fbref.com/en/players/2979c05a/Gerrit-Holtmann"
2018,"Mainz 05","Bundesliga","Nigel de Jong","NED","MF","32",1984,8.2,17,12,7,9,1,10,14,71.4,4,5,1,4,12,29,22,1,"https://fbref.com/en/players/a0e209bc/Nigel-de-Jong"
2018,"Mainz 05","Bundesliga","Kenan Kodro","BIH","FW,DF","23",1993,2.6,1,1,0,1,0,0,0,NA,0,1,0,1,3,4,0,0,"https://fbref.com/en/players/e82d2807/Kenan-Kodro"
2018,"Mainz 05","Bundesliga","Danny Latza","GER","MF","27",1989,26.1,67,48,28,33,6,33,73,45.2,40,43,8,35,26,93,47,1,"https://fbref.com/en/players/33b554b7/Danny-Latza"
2018,"Mainz 05","Bundesliga","Alexandru Maxim","ROU","MF","27",1990,10.6,17,12,6,8,3,7,22,31.8,15,20,2,18,6,23,3,0,"https://fbref.com/en/players/61fc9685/Alexandru-Maxim"
2018,"Mainz 05","Bundesliga","Florian Müller","GER","GK","19",1997,5,0,0,0,0,0,0,0,NA,0,0,0,0,0,0,1,1,"https://fbref.com/en/players/cbac6ec9/Florian-Muller"
2018,"Mainz 05","Bundesliga","Yoshinori Mutō","JPN","FW","25",1992,21.2,21,15,6,8,7,5,14,35.7,9,16,0,16,6,27,12,0,"https://fbref.com/en/players/5343eb4e/Yoshinori-Muto"
2018,"Mainz 05","Bundesliga","Karim Onisiwo","AUT","DF,FW","25",1992,2.8,7,5,5,1,1,3,7,42.9,4,4,0,4,1,8,8,0,"https://fbref.com/en/players/f26834c7/Karim-Onisiwo"
2018,"Mainz 05","Bundesliga","Levin Öztunalı","GER","FW,MF","21",1996,19.3,26,19,8,15,3,10,20,50,10,25,0,25,11,37,9,0,"https://fbref.com/en/players/66385c46/Levin-Oztunali"
2018,"Mainz 05","Bundesliga","Robin Quaison","SWE","FW","23",1993,15.7,17,14,1,10,6,7,11,63.6,4,16,2,14,7,24,9,0,"https://fbref.com/en/players/74c7c2db/Robin-Quaison"
2018,"Mainz 05","Bundesliga","Jairo Samperio","ESP","MF,FW","24",1993,0.4,1,1,0,1,0,1,1,100,0,0,0,0,0,1,0,0,"https://fbref.com/en/players/c0a0c18f/Jairo-Samperio"
2018,"Mainz 05","Bundesliga","Suat Serdar","GER","MF","20",1997,18.9,59,47,21,26,12,27,64,42.2,37,38,3,35,21,80,17,1,"https://fbref.com/en/players/b3325a30/Suat-Serdar"
2018,"Mainz 05","Bundesliga","Anthony Ujah","NGA","FW","26",1990,2.3,4,3,0,2,2,1,1,100,0,2,0,2,0,4,6,0,"https://fbref.com/en/players/99be8fb5/Anthony-Ujah"
2018,"Mainz 05","Bundesliga","Robin Zentner","GER","GK","22",1994,15,0,0,0,0,0,0,1,0,1,0,0,0,1,1,10,2,"https://fbref.com/en/players/5c4bf6ba/Robin-Zentner"
2018,"Manchester City","Premier League","Sergio Agüero","ARG","FW","29",1988,21.8,9,6,2,6,1,2,17,11.8,15,12,1,11,6,15,3,0,"https://fbref.com/en/players/4d034881/Sergio-Aguero"
2018,"Manchester City","Premier League","Claudio Bravo","CHI","GK","34",1983,2.5,0,0,0,0,0,0,1,0,1,0,0,0,0,0,0,0,"https://fbref.com/en/players/10072610/Claudio-Bravo"
2018,"Manchester City","Premier League","Danilo","BRA","DF","26",1991,15,43,29,25,12,6,19,35,54.3,16,15,6,9,19,62,33,0,"https://fbref.com/en/players/94b2001f/Danilo"
2018,"Manchester City","Premier League","Kevin De Bruyne","BEL","MF","26",1991,34.1,62,43,23,25,14,23,80,28.8,57,45,2,43,25,87,14,2,"https://fbref.com/en/players/e46012d4/Kevin-De-Bruyne"
2018,"Manchester City","Premier League","Fabian Delph","ENG","DF","27",1989,19.3,46,34,21,16,9,18,37,48.6,19,16,0,16,30,76,42,2,"https://fbref.com/en/players/111c3236/Fabian-Delph"
2018,"Manchester City","Premier League","Brahim Díaz","ESP","FW,DF","17",1999,0.6,1,0,1,0,0,0,0,NA,0,3,0,3,1,2,0,0,"https://fbref.com/en/players/407feb71/Brahim-Diaz"
2018,"Manchester City","Premier League","Ederson","BRA","GK","23",1993,35.5,1,1,1,0,0,0,0,NA,0,1,0,1,0,1,15,6,"https://fbref.com/en/players/3bb7b8b4/Ederson"
2018,"Manchester City","Premier League","Fernandinho","BRA","MF","32",1985,32,62,35,22,28,12,24,65,36.9,41,38,6,32,47,109,68,2,"https://fbref.com/en/players/101da2b5/Fernandinho"
2018,"Manchester City","Premier League","Phil Foden","ENG","MF,FW","17",2000,0.5,1,1,0,1,0,0,1,0,1,0,0,0,0,1,1,0,"https://fbref.com/en/players/ed1e53f3/Phil-Foden"
2018,"Manchester City","Premier League","İlkay Gündoğan","GER","MF","26",1990,16.9,27,15,8,14,5,9,37,24.3,28,14,1,13,16,43,12,0,"https://fbref.com/en/players/819b3158/Ilkay-Gundogan"
2018,"Manchester City","Premier League","Gabriel Jesus","BRA","FW","20",1997,18.5,23,15,6,10,7,3,22,13.6,19,16,0,16,8,31,6,0,"https://fbref.com/en/players/b66315ae/Gabriel-Jesus"
2018,"Manchester City","Premier League","Vincent Kompany","BEL","DF","31",1986,15.5,20,11,14,5,1,13,19,68.4,6,10,8,2,16,36,73,1,"https://fbref.com/en/players/d2bff301/Vincent-Kompany"
2018,"Manchester City","Premier League","Aymeric Laporte","ESP","DF","23",1994,9,8,7,6,2,0,3,8,37.5,5,2,1,1,11,19,27,0,"https://fbref.com/en/players/119b9a8e/Aymeric-Laporte"
2018,"Manchester City","Premier League","Eliaquim Mangala","FRA","DF","26",1991,5.4,5,3,5,0,0,1,3,33.3,2,4,3,1,2,7,24,0,"https://fbref.com/en/players/f520049f/Eliaquim-Mangala"
2018,"Manchester City","Premier League","Benjamin Mendy","FRA","DF,FW","23",1994,4,5,4,2,0,3,5,7,71.4,2,5,0,5,8,13,9,0,"https://fbref.com/en/players/5271c8f1/Benjamin-Mendy"
2018,"Manchester City","Premier League","Lukas Nmecha","GER","FW","18",1998,0.2,0,0,0,0,0,0,0,NA,0,0,0,0,0,0,0,0,"https://fbref.com/en/players/0cc5f4a5/Lukas-Nmecha"
2018,"Manchester City","Premier League","Nicolás Otamendi","ARG","DF","29",1988,33,58,43,35,22,1,19,44,43.2,25,21,10,11,48,106,129,3,"https://fbref.com/en/players/0d267745/Nicolas-Otamendi"
2018,"Manchester City","Premier League","Leroy Sané","GER","FW","21",1996,26.9,27,21,14,7,6,8,22,36.4,14,22,1,21,13,40,6,0,"https://fbref.com/en/players/2b114be3/Leroy-Sane"
2018,"Manchester City","Premier League","Bernardo Silva","POR","FW,MF","22",1994,17,27,18,11,9,7,6,30,20,24,17,1,16,10,37,12,1,"https://fbref.com/en/players/3eb22ec9/Bernardo-Silva"
2018,"Manchester City","Premier League","David Silva","ESP","MF","31",1986,27,32,21,11,17,4,9,45,20,36,28,5,23,18,50,7,0,"https://fbref.com/en/players/e2716bd0/David-Silva"
2018,"Manchester City","Premier League","Raheem Sterling","ENG","FW","22",1994,28.7,19,14,7,7,5,3,32,9.4,29,24,0,24,9,28,9,0,"https://fbref.com/en/players/b400bde0/Raheem-Sterling"
2018,"Manchester City","Premier League","John Stones","ENG","DF","23",1994,14.5,15,11,11,4,0,4,11,36.4,7,8,5,3,19,34,44,0,"https://fbref.com/en/players/5eecec3d/John-Stones"
2018,"Manchester City","Premier League","Yaya Touré","CIV","MF","34",1983,2.6,2,2,1,0,1,1,1,100,0,3,1,2,5,7,4,0,"https://fbref.com/en/players/c204f844/Yaya-Toure"
2018,"Manchester City","Premier League","Kyle Walker","ENG","DF","27",1990,30.9,47,31,20,21,6,18,31,58.1,13,21,2,19,29,76,75,2,"https://fbref.com/en/players/86dd77d1/Kyle-Walker"
2018,"Manchester City","Premier League","Oleksandr Zinchenko","UKR","DF","20",1996,5.9,23,16,11,9,3,7,13,53.8,6,3,0,3,6,29,7,0,"https://fbref.com/en/players/51cf8561/Oleksandr-Zinchenko"
2018,"Manchester Utd","Premier League","Eric Bailly","CIV","DF","23",1994,11.1,17,10,10,5,2,5,12,41.7,7,11,6,5,25,42,58,1,"https://fbref.com/en/players/a1232f4e/Eric-Bailly"
2018,"Manchester Utd","Premier League","Daley Blind","NED","DF,MF","27",1990,4,6,4,3,2,1,2,7,28.6,5,3,0,3,7,13,14,0,"https://fbref.com/en/players/691bef82/Daley-Blind"
2018,"Manchester Utd","Premier League","Michael Carrick","ENG","MF","36",1981,1.2,1,1,0,1,0,0,1,0,1,2,0,2,1,2,3,0,"https://fbref.com/en/players/ab7263c1/Michael-Carrick"
2018,"Manchester Utd","Premier League","Matteo Darmian","ITA","DF","27",1989,4.9,16,14,7,7,2,6,19,31.6,13,5,3,2,7,23,23,0,"https://fbref.com/en/players/96e0490d/Matteo-Darmian"
2018,"Manchester Utd","Premier League","Marouane Fellaini","BEL","MF","29",1987,7.6,15,8,6,8,1,2,11,18.2,9,12,3,9,14,29,19,1,"https://fbref.com/en/players/87575fd9/Marouane-Fellaini"
2018,"Manchester Utd","Premier League","David de Gea","ESP","GK","26",1990,37,0,0,0,0,0,0,1,0,1,1,0,1,0,0,9,3,"https://fbref.com/en/players/7ba6d84e/David-de-Gea"
2018,"Manchester Utd","Premier League","Ander Herrera","ESP","MF","27",1989,14.1,56,29,32,20,4,20,69,29,49,33,6,27,34,90,22,2,"https://fbref.com/en/players/436a9dd0/Ander-Herrera"
2018,"Manchester Utd","Premier League","Zlatan Ibrahimović","SWE","MF,FW","35",1981,1.2,2,1,1,0,1,0,1,0,1,0,0,0,0,2,1,0,"https://fbref.com/en/players/4cde5509/Zlatan-Ibrahimovic"
2018,"Manchester Utd","Premier League","Phil Jones","ENG","DF","25",1992,21.9,25,18,20,5,0,9,20,45,11,25,17,8,41,66,133,2,"https://fbref.com/en/players/def899bd/Phil-Jones"
2018,"Manchester Utd","Premier League","Victor Lindelöf","SWE","DF","23",1994,14.3,17,11,10,6,1,9,14,64.3,5,15,11,4,13,30,67,1,"https://fbref.com/en/players/f5deef4c/Victor-Lindelof"
2018,"Manchester Utd","Premier League","Jesse Lingard","ENG","MF,FW","24",1992,20.2,30,21,10,13,7,5,27,18.5,22,18,3,15,9,39,13,0,"https://fbref.com/en/players/810e3c74/Jesse-Lingard"
2018,"Manchester Utd","Premier League","Romelu Lukaku","BEL","FW","24",1993,31.9,7,4,1,3,3,0,13,0,13,9,2,7,3,10,22,2,"https://fbref.com/en/players/5eae500a/Romelu-Lukaku"
2018,"Manchester Utd","Premier League","Anthony Martial","FRA","FW","21",1995,17.6,15,13,9,2,4,3,12,25,9,5,1,4,3,18,7,0,"https://fbref.com/en/players/8b788c01/Anthony-Martial"
2018,"Manchester Utd","Premier League","Juan Mata","ESP","FW","29",1988,21.4,18,13,4,12,2,2,24,8.3,22,10,0,10,15,33,10,1,"https://fbref.com/en/players/29733c72/Juan-Mata"
2018,"Manchester Utd","Premier League","Nemanja Matić","SRB","MF","28",1988,34.6,70,42,32,34,4,23,71,32.4,48,50,13,37,64,134,62,2,"https://fbref.com/en/players/eb7822d7/Nemanja-Matic"
2018,"Manchester Utd","Premier League","Scott McTominay","SCO","MF","20",1996,7,11,9,4,5,2,5,13,38.5,8,3,0,3,13,24,9,0,"https://fbref.com/en/players/d93c2511/Scott-McTominay"
2018,"Manchester Utd","Premier League","Henrikh Mkhitaryan","ARM","MF,FW","28",1989,10.2,15,11,4,7,4,5,25,20,20,8,0,8,7,22,3,0,"https://fbref.com/en/players/dd0daf32/Henrikh-Mkhitaryan"
2018,"Manchester Utd","Premier League","Paul Pogba","FRA","MF","24",1993,23.9,33,23,13,15,5,5,33,15.2,28,16,0,16,21,54,26,0,"https://fbref.com/en/players/867239d3/Paul-Pogba"
2018,"Manchester Utd","Premier League","Marcus Rashford","ENG","FW,MF","19",1997,20.1,14,11,4,5,5,6,18,33.3,12,18,0,18,8,22,19,0,"https://fbref.com/en/players/a1d5bd30/Marcus-Rashford"
2018,"Manchester Utd","Premier League","Marcos Rojo","ARG","DF","27",1990,7.1,7,5,6,0,1,1,8,12.5,7,11,6,5,7,14,56,2,"https://fbref.com/en/players/e0991c04/Marcos-Rojo"
2018,"Manchester Utd","Premier League","Sergio Romero","ARG","GK","30",1987,1,0,0,0,0,0,0,0,NA,0,0,0,0,0,0,0,0,"https://fbref.com/en/players/1e26e376/Sergio-Romero"
2018,"Manchester Utd","Premier League","Alexis Sánchez","CHI","FW,MF","28",1988,11.6,21,17,10,4,7,4,27,14.8,23,8,0,8,17,38,0,0,"https://fbref.com/en/players/2c0f8e9e/Alexis-Sanchez"
2018,"Manchester Utd","Premier League","Luke Shaw","ENG","DF","22",1995,8.8,18,15,10,7,1,11,18,61.1,7,16,2,14,4,22,22,1,"https://fbref.com/en/players/9c94165b/Luke-Shaw"
2018,"Manchester Utd","Premier League","Chris Smalling","ENG","DF","27",1989,28.2,40,25,28,12,0,16,28,57.1,12,32,28,4,63,103,162,1,"https://fbref.com/en/players/b6964eb6/Chris-Smalling"
2018,"Manchester Utd","Premier League","Axel Tuanzebe","ENG","FW","19",1997,0,0,0,0,0,0,0,0,NA,0,0,0,0,0,0,0,0,"https://fbref.com/en/players/2baec6ce/Axel-Tuanzebe"
2018,"Manchester Utd","Premier League","Antonio Valencia","ECU","DF","31",1985,30.4,57,32,21,28,8,16,36,44.4,20,47,6,41,48,105,80,0,"https://fbref.com/en/players/08aa17d0/Antonio-Valencia"
2018,"Manchester Utd","Premier League","Ashley Young","ENG","DF","32",1985,27.1,53,32,30,17,6,18,47,38.3,29,24,5,19,57,110,86,1,"https://fbref.com/en/players/be927d03/Ashley-Young"
2018,"Marseille","Ligue 1","Aymen Abdennour","TUN","DF","27",1989,5.5,7,3,5,2,0,4,7,57.1,3,5,5,0,4,11,20,0,"https://fbref.com/en/players/2f798b41/Aymen-Abdennour"
2018,"Marseille","Ligue 1","Jordan Amavi","FRA","DF","23",1994,24.4,52,35,32,12,8,23,56,41.1,33,28,11,17,45,97,86,1,"https://fbref.com/en/players/22721b88/Jordan-Amavi"
2018,"Marseille","Ligue 1","Henri Bedimo","CMR","DF,FW","33",1984,0.5,0,0,0,0,0,0,1,0,1,0,0,0,1,1,1,0,"https://fbref.com/en/players/0d57f1c1/Henri-Bedimo"
2018,"Marseille","Ligue 1","Rémy Cabella","FRA","FW,MF","27",1990,0.7,7,4,2,2,3,2,4,50,2,0,0,0,1,8,0,0,"https://fbref.com/en/players/148e136f/Remy-Cabella"
2018,"Marseille","Ligue 1","Dória","BRA","DF","22",1994,0.9,2,2,0,2,0,0,0,NA,0,3,1,2,1,3,1,0,"https://fbref.com/en/players/d28b4a9d/Doria"
2018,"Marseille","Ligue 1","Patrice Evra","FRA","DF","36",1981,3.9,6,5,5,1,0,3,6,50,3,2,2,0,3,9,16,0,"https://fbref.com/en/players/51a3caf1/Patrice-Evra"
2018,"Marseille","Ligue 1","Valère Germain","FRA","FW","27",1990,24.1,16,11,5,7,4,3,18,16.7,15,11,0,11,6,22,19,0,"https://fbref.com/en/players/ea0ff634/Valere-Germain"
2018,"Marseille","Ligue 1","Luiz Gustavo","BRA","MF,DF","30",1987,33.5,89,54,45,40,4,26,62,41.9,36,44,13,31,50,139,56,1,"https://fbref.com/en/players/82671804/Luiz-Gustavo"
2018,"Marseille","Ligue 1","Tomáš Hubočan","SVK","DF","31",1985,1,1,0,1,0,0,0,4,0,4,0,0,0,0,1,1,0,"https://fbref.com/en/players/97b87472/Tomas-Hubocan"
2018,"Marseille","Ligue 1","Boubacar Kamara","FRA","DF,MF","17",1999,5.1,14,14,9,5,0,8,12,66.7,4,7,3,4,3,17,18,0,"https://fbref.com/en/players/cc77354e/Boubacar-Kamara"
2018,"Marseille","Ligue 1","Maxime Lopez","FRA","MF,FW","19",1997,15.3,30,20,12,12,6,12,56,21.4,44,16,2,14,7,37,6,1,"https://fbref.com/en/players/20094685/Maxime-Lopez"
2018,"Marseille","Ligue 1","Steve Mandanda","FRA","GK","32",1985,30,0,0,0,0,0,0,0,NA,0,0,0,0,0,0,10,3,"https://fbref.com/en/players/1d2d5cc8/Steve-Mandanda"
2018,"Marseille","Ligue 1","Kostas Mitroglou","GRE","FW","29",1988,9.7,3,2,1,2,0,1,4,25,3,1,1,0,0,3,2,0,"https://fbref.com/en/players/c6ac6579/Kostas-Mitroglou"
2018,"Marseille","Ligue 1","Clinton N'Jie","CMR","FW","23",1993,9.7,10,6,2,5,3,2,9,22.2,7,5,0,5,3,13,0,0,"https://fbref.com/en/players/77f278a0/Clinton-NJie"
2018,"Marseille","Ligue 1","Lucas Ocampos","ARG","FW","23",1994,22.6,83,57,30,44,9,30,93,32.3,63,42,3,39,30,113,26,0,"https://fbref.com/en/players/a08b974a/Lucas-Ocampos"
2018,"Marseille","Ligue 1","Dimitri Payet","FRA","MF,FW","30",1987,26.1,22,11,5,13,4,8,37,21.6,29,19,2,17,19,41,7,1,"https://fbref.com/en/players/58ae47b2/Dimitri-Payet"
2018,"Marseille","Ligue 1","Yohann Pelé","FRA","GK","34",1982,8.2,0,0,0,0,0,0,1,0,1,0,0,0,1,1,2,0,"https://fbref.com/en/players/76806215/Yohann-Pele"
2018,"Marseille","Ligue 1","Adil Rami","FRA","DF","31",1985,32.8,39,29,22,15,2,22,41,53.7,19,25,19,6,45,84,163,3,"https://fbref.com/en/players/8dbff17c/Adil-Rami"
2018,"Marseille","Ligue 1","Rolando","POR","DF","31",1985,27.9,44,29,28,15,1,23,40,57.5,17,22,14,8,37,81,126,0,"https://fbref.com/en/players/0eeafda5/Rolando"
2018,"Marseille","Ligue 1","Hiroki Sakai","JPN","DF","27",1990,28,66,45,30,30,6,32,49,65.3,17,32,7,25,45,111,90,1,"https://fbref.com/en/players/d63e2912/Hiroki-Sakai"
2018,"Marseille","Ligue 1","Morgan Sanson","FRA","MF","22",1994,24.1,64,40,13,34,17,21,71,29.6,50,30,0,30,25,89,5,1,"https://fbref.com/en/players/6e7f1353/Morgan-Sanson"
2018,"Marseille","Ligue 1","Yusuf Sari","TUR","FW","18",1998,0,0,0,0,0,0,0,0,NA,0,0,0,0,0,0,0,0,"https://fbref.com/en/players/a2da58b1/Yusuf-Sari"
2018,"Marseille","Ligue 1","Bouna Sarr","SEN","DF,FW","25",1992,19.9,65,42,42,20,3,22,38,57.9,16,20,4,16,32,97,53,2,"https://fbref.com/en/players/1a4b9094/Bouna-Sarr"
2018,"Marseille","Ligue 1","Grégory Sertic","FRA","DF,MF","27",1989,3.9,5,3,3,2,0,2,6,33.3,4,8,7,1,6,11,23,0,"https://fbref.com/en/players/c4527123/Gregory-Sertic"
2018,"Marseille","Ligue 1","Florian Thauvin","FRA","FW","24",1993,32.8,44,28,16,20,8,15,46,32.6,31,22,1,21,17,61,20,0,"https://fbref.com/en/players/2b9fdeea/Florian-Thauvin"
2018,"Marseille","Ligue 1","Andre-Frank Zambo Anguissa","CMR","MF","21",1995,27.1,88,65,23,57,8,32,94,34,62,50,7,43,67,155,46,3,"https://fbref.com/en/players/6bb2c084/Andre-Frank-Zambo-Anguissa"
2018,"Metz","Ligue 1","Benoît Assou-Ekotto","CMR","DF","33",1984,11.7,12,9,5,6,1,5,15,33.3,10,7,4,3,46,58,21,0,"https://fbref.com/en/players/a557e6b0/Benoit-Assou-Ekotto"
2018,"Metz","Ligue 1","Iván Balliu","ALB","DF","25",1992,21.7,34,22,22,6,6,12,28,42.9,16,23,9,14,27,61,64,1,"https://fbref.com/en/players/cee88597/Ivan-Balliu"
2018,"Metz","Ligue 1","Nicolas Basin","FRA","DF","19",1998,3.5,9,7,5,3,1,4,9,44.4,5,6,3,3,8,17,14,0,"https://fbref.com/en/players/67d251a2/Nicolas-Basin"
2018,"Metz","Ligue 1","Quentin Beunardeau","FRA","GK","23",1994,0.4,0,0,0,0,0,0,0,NA,0,0,0,0,0,0,0,0,"https://fbref.com/en/players/15285503/Quentin-Beunardeau"
2018,"Metz","Ligue 1","Milan Biševac","SRB","DF","33",1983,7.9,7,5,5,1,1,5,7,71.4,2,2,0,2,5,12,43,0,"https://fbref.com/en/players/a51728e3/Milan-Bisevac"
2018,"Metz","Ligue 1","Farid Boulaya","ALG","MF,FW","24",1993,2,5,1,4,1,0,3,6,50,3,1,0,1,1,6,2,0,"https://fbref.com/en/players/a0791826/Farid-Boulaya"
2018,"Metz","Ligue 1","Cafú","POR","MF","24",1993,7.6,9,7,3,4,2,3,11,27.3,8,3,1,2,12,21,13,0,"https://fbref.com/en/players/85322440/Cafu"
2018,"Metz","Ligue 1","Renaud Cohade","FRA","MF","32",1984,36.6,143,86,63,71,9,46,119,38.7,73,70,10,60,53,196,91,0,"https://fbref.com/en/players/4e7d66f8/Renaud-Cohade"
2018,"Metz","Ligue 1","Fallou Diagne","SEN","DF,MF","27",1989,24.9,33,20,21,12,0,7,22,31.8,15,33,18,15,46,79,116,3,"https://fbref.com/en/players/cd387ff4/Fallou-Diagne"
2018,"Metz","Ligue 1","Habib Diallo","SEN","FW,MF","22",1995,0.2,0,0,0,0,0,0,0,NA,0,0,0,0,0,0,0,0,"https://fbref.com/en/players/6605d143/Habib-Diallo"
2018,"Metz","Ligue 1","Thomas Didillon","FRA","GK","21",1995,9,0,0,0,0,0,0,1,0,1,0,0,0,0,0,5,2,"https://fbref.com/en/players/a3d524cb/Thomas-Didillon"
2018,"Metz","Ligue 1","Mathieu Dossevi","TOG","FW,MF","29",1988,27.9,35,25,15,15,5,7,39,17.9,32,24,3,21,28,63,12,0,"https://fbref.com/en/players/6421dd73/Mathieu-Dossevi"
2018,"Metz","Ligue 1","Simon Falette","GUI","DF","25",1992,1,0,0,0,0,0,0,0,NA,0,0,0,0,1,1,8,0,"https://fbref.com/en/players/b82880c6/Simon-Falette"
2018,"Metz","Ligue 1","Brian Fernández","ARG","FW","22",1994,1.4,0,0,0,0,0,0,1,0,1,2,0,2,0,0,0,0,"https://fbref.com/en/players/857e2586/Brian-Fernandez"
2018,"Metz","Ligue 1","Lilian Fournier","FRA","FW","19",1998,0.2,0,0,0,0,0,0,0,NA,0,0,0,0,0,0,0,0,"https://fbref.com/en/players/5aca2a18/Lilian-Fournier"
2018,"Metz","Ligue 1","Lemouya Goudiaby","SEN","DF","20",1997,0.9,2,1,0,2,0,1,3,33.3,2,2,1,1,0,2,3,0,"https://fbref.com/en/players/e893fc23/Lemouya-Goudiaby"
2018,"Metz","Ligue 1","Gauthier Hein","FRA","FW","20",1996,0.9,2,2,2,0,0,2,4,50,2,1,0,1,2,4,1,0,"https://fbref.com/en/players/563fcd6b/Gauthier-Hein"
2018,"Metz","Ligue 1","Ablie Jallow","GAM","FW","18",1998,1.4,1,1,1,0,0,0,5,0,5,1,0,1,3,4,1,0,"https://fbref.com/en/players/1bc6135b/Ablie-Jallow"
2018,"Metz","Ligue 1","Yann Jouffre","FRA","FW,MF","33",1984,3.1,3,2,0,2,1,1,6,16.7,5,5,1,4,3,6,2,0,"https://fbref.com/en/players/5d66c10d/Yann-Jouffre"
2018,"Metz","Ligue 1","Eiji Kawashima","JPN","GK","34",1983,28.5,1,1,1,0,0,1,3,33.3,2,0,0,0,3,4,9,2,"https://fbref.com/en/players/a4527d33/Eiji-Kawashima"
2018,"Metz","Ligue 1","Dylan Lempereur","FRA","DF","18",1998,1.6,5,3,3,1,1,2,6,33.3,4,1,0,1,0,5,6,0,"https://fbref.com/en/players/47c2e669/Dylan-Lempereur"
2018,"Metz","Ligue 1","Georges Mandjeck","CMR","MF,DF","28",1988,10.8,25,14,8,16,1,8,18,44.4,10,9,3,6,18,43,21,1,"https://fbref.com/en/players/de343d38/Georges-Mandjeck"
2018,"Metz","Ligue 1","Danijel Milićević","BIH","MF,FW","31",1986,7.9,8,4,0,4,4,1,9,11.1,8,5,0,5,3,11,2,0,"https://fbref.com/en/players/1251f42e/Danijel-Milicevic"
2018,"Metz","Ligue 1","Florent Mollet","FRA","MF,FW","25",1991,15.7,25,18,10,12,3,3,25,12,22,8,1,7,11,36,8,0,"https://fbref.com/en/players/7e82a78f/Florent-Mollet"
2018,"Metz","Ligue 1","Opa Nguette","SEN","FW,MF","23",1994,11.4,27,22,11,12,4,5,21,23.8,16,10,0,10,18,45,13,0,"https://fbref.com/en/players/75a63397/Opa-Nguette"
2018,"Metz","Ligue 1","Moussa Niakhate","FRA","DF","21",1996,34.5,57,38,44,12,1,22,37,59.5,15,27,14,13,55,112,139,1,"https://fbref.com/en/players/00242715/Moussa-Niakhate"
2018,"Metz","Ligue 1","Ibrahima Niane","SEN","FW,MF","18",1999,9.4,6,5,4,1,1,2,8,25,6,6,0,6,4,10,8,0,"https://fbref.com/en/players/46faabfa/Ibrahima-Niane"
2018,"Metz","Ligue 1","Julian Palmieri","FRA","DF","30",1986,12.5,29,15,17,9,3,17,29,58.6,12,16,2,14,22,51,31,0,"https://fbref.com/en/players/25444898/Julian-Palmieri"
2018,"Metz","Ligue 1","Chris Philipps","LUX","MF,DF","23",1994,9.4,22,12,10,10,2,5,26,19.2,21,13,5,8,30,52,18,0,"https://fbref.com/en/players/8e2d5426/Chris-Philipps"
2018,"Metz","Ligue 1","Gerónimo Poblete","ARG","MF","24",1993,18.4,58,37,23,29,6,25,66,37.9,41,19,0,19,24,82,22,1,"https://fbref.com/en/players/31bbb7e2/Geronimo-Poblete"
2018,"Metz","Ligue 1","Emmanuel Rivière","FRA","FW","27",1990,22.3,10,3,1,6,3,1,12,8.3,11,8,0,8,2,12,5,0,"https://fbref.com/en/players/2bae5658/Emmanuel-Riviere"
2018,"Metz","Ligue 1","Jonathan Rivierez","MTQ","DF","28",1989,22.9,81,59,50,26,5,41,80,51.3,39,21,7,14,39,120,73,0,"https://fbref.com/en/players/7af0e1f8/Jonathan-Rivierez"
2018,"Metz","Ligue 1","Nolan Roux","FRA","FW,MF","29",1988,31.5,24,17,8,10,6,7,38,18.4,31,32,2,30,25,49,22,0,"https://fbref.com/en/players/3071a619/Nolan-Roux"
2018,"Metz","Ligue 1","Vahid Selimović","LUX","DF","20",1997,11.7,20,14,10,9,1,11,14,78.6,3,10,8,2,17,37,58,1,"https://fbref.com/en/players/6aeb647a/Vahid-Selimovic"
2018,"Metz","Ligue 1","Vincent Thill","LUX","MF","17",2000,0.3,0,0,0,0,0,0,0,NA,0,0,0,0,0,0,0,0,"https://fbref.com/en/players/7de29631/Vincent-Thill"
2018,"Metz","Ligue 1","Matthieu Udol","FRA","DF","21",1996,3.9,14,8,13,1,0,5,14,35.7,9,10,2,8,5,19,17,0,"https://fbref.com/en/players/cc41f558/Matthieu-Udol"
2018,"Milan","Serie A","Ignazio Abate","ITA","DF","30",1986,11.7,20,17,10,9,1,6,11,54.5,5,22,2,20,8,28,29,0,"https://fbref.com/en/players/1c529186/Ignazio-Abate"
2018,"Milan","Serie A","Luca Antonelli","ITA","DF,FW","30",1987,1.6,1,1,0,0,1,0,2,0,2,1,0,1,1,2,8,0,"https://fbref.com/en/players/40f0ed6c/Luca-Antonelli"
2018,"Milan","Serie A","Lucas Biglia","ARG","MF","31",1986,22.7,59,36,28,26,5,22,61,36.1,39,49,12,37,28,87,51,1,"https://fbref.com/en/players/5710a281/Lucas-Biglia"
2018,"Milan","Serie A","Giacomo Bonaventura","ITA","MF","27",1989,28.2,31,20,7,19,5,9,45,20,36,31,6,25,33,64,17,0,"https://fbref.com/en/players/d995ed27/Giacomo-Bonaventura"
2018,"Milan","Serie A","Leonardo Bonucci","ITA","DF","30",1987,34.3,30,21,22,7,1,11,18,61.1,7,31,22,9,51,81,132,0,"https://fbref.com/en/players/52ec54d0/Leonardo-Bonucci"
2018,"Milan","Serie A","Fabio Borini","ITA","DF,FW","26",1991,17.9,38,23,12,18,8,16,37,43.2,21,32,6,26,13,51,43,0,"https://fbref.com/en/players/ef5b337e/Fabio-Borini"
2018,"Milan","Serie A","Davide Calabria","ITA","DF","20",1996,17.4,64,50,33,24,7,21,41,51.2,20,19,4,15,33,97,82,1,"https://fbref.com/en/players/2146785a/Davide-Calabria"
2018,"Milan","Serie A","Hakan Çalhanoğlu","TUR","FW,MF","23",1994,24.1,37,27,11,18,8,8,31,25.8,23,29,2,27,22,59,15,0,"https://fbref.com/en/players/cd0fa27b/Hakan-Calhanoglu"
2018,"Milan","Serie A","Andrea Conti","ITA","DF","23",1994,1.7,4,2,1,3,0,2,3,66.7,1,3,0,3,1,5,5,0,"https://fbref.com/en/players/8fef5412/Andrea-Conti"
2018,"Milan","Serie A","Patrick Cutrone","ITA","FW","19",1998,16.7,11,10,2,7,2,1,10,10,9,11,1,10,3,14,12,0,"https://fbref.com/en/players/a4fe8cda/Patrick-Cutrone"
2018,"Milan","Serie A","Gianluigi Donnarumma","ITA","GK","18",1999,38,1,0,1,0,0,1,1,100,0,0,0,0,1,2,13,8,"https://fbref.com/en/players/08f5afaa/Gianluigi-Donnarumma"
2018,"Milan","Serie A","Nikola Kalinić","CRO","FW","29",1988,20.1,6,5,1,4,1,0,8,0,8,4,1,3,3,9,12,0,"https://fbref.com/en/players/d4931a5a/Nikola-Kalinic"
2018,"Milan","Serie A","Franck Kessié","CIV","MF","20",1996,36.3,48,34,20,19,9,17,44,38.6,27,47,11,36,26,74,45,3,"https://fbref.com/en/players/05e19d6a/Franck-Kessie"
2018,"Milan","Serie A","Manuel Locatelli","ITA","MF","19",1998,7.6,16,13,6,9,1,4,18,22.2,14,10,2,8,9,25,13,0,"https://fbref.com/en/players/a8a874f1/Manuel-Locatelli"
2018,"Milan","Serie A","José Mauri","ITA","MF","21",1996,0.1,0,0,0,0,0,0,0,NA,0,0,0,0,0,0,0,0,"https://fbref.com/en/players/644faf10/Jose-Mauri"
2018,"Milan","Serie A","Riccardo Montolivo","ITA","MF","32",1985,12.1,29,21,11,15,3,7,24,29.2,17,17,4,13,19,48,15,0,"https://fbref.com/en/players/b746d309/Riccardo-Montolivo"
2018,"Milan","Serie A","Mateo Musacchio","ARG","DF","26",1990,13.4,22,15,13,7,2,8,16,50,8,9,3,6,12,34,58,1,"https://fbref.com/en/players/91899ca8/Mateo-Musacchio"
2018,"Milan","Serie A","Ricardo Rodríguez","SUI","DF","24",1992,33.4,48,29,24,18,6,18,28,64.3,10,36,6,30,33,81,93,3,"https://fbref.com/en/players/7f78ad23/Ricardo-Rodriguez"
2018,"Milan","Serie A","Alessio Romagnoli","ITA","DF","22",1995,26.1,20,14,17,2,1,9,14,64.3,5,24,14,10,23,43,154,1,"https://fbref.com/en/players/3ead85f9/Alessio-Romagnoli"
2018,"Milan","Serie A","André Silva","POR","FW","21",1995,10.4,5,4,1,0,4,2,7,28.6,5,10,1,9,4,9,6,0,"https://fbref.com/en/players/3effaa34/Andre-Silva"
2018,"Milan","Serie A","Suso","ESP","FW,MF","23",1993,31.4,18,14,3,5,10,4,31,12.9,27,25,0,25,16,34,2,1,"https://fbref.com/en/players/4e219ad2/Suso"
2018,"Milan","Serie A","Emanuele Torrasi","ITA","MF","18",1999,0.1,NA,NA,NA,NA,NA,NA,NA,NA,NA,NA,NA,NA,NA,NA,NA,NA,"https://fbref.com/en/players/16bc48f8/Emanuele-Torrasi"
2018,"Milan","Serie A","Cristián Zapata","COL","DF","30",1986,11,25,20,21,4,0,15,16,93.8,1,12,6,6,15,40,50,1,"https://fbref.com/en/players/b1deecf8/Cristian-Zapata"
2018,"Monaco","Ligue 1","Keita Baldé","SEN","FW,MF","22",1995,16.4,12,8,5,6,1,1,11,9.1,10,10,1,9,6,18,5,0,"https://fbref.com/en/players/509a4ccb/Keita-Balde"
2018,"Monaco","Ligue 1","Gil Bastião Dias","POR","MF","20",1996,0.1,1,1,0,1,0,0,0,NA,0,0,0,0,0,1,0,0,"https://fbref.com/en/players/e61bdd69/Gil-Bastiao-Dias"
2018,"Monaco","Ligue 1","Diego Benaglio","SUI","GK","33",1983,2.5,0,0,0,0,0,0,0,NA,0,0,0,0,0,0,0,0,"https://fbref.com/en/players/b7e7937d/Diego-Benaglio"
2018,"Monaco","Ligue 1","Gabriel Boschilia","BRA","FW,MF","21",1996,0.9,4,1,1,2,1,1,4,25,3,1,0,1,0,4,0,0,"https://fbref.com/en/players/e90af77c/Gabriel-Boschilia"
2018,"Monaco","Ligue 1","Guido Carrillo","ARG","FW","26",1991,4.7,3,1,0,2,1,0,4,0,4,3,1,2,0,3,8,0,"https://fbref.com/en/players/8f898ba8/Guido-Carrillo"
2018,"Monaco","Ligue 1","Adama Diakhaby","FRA","FW","21",1996,9.4,23,15,6,12,5,6,16,37.5,10,13,0,13,13,36,5,0,"https://fbref.com/en/players/65585e3a/Adama-Diakhaby"
2018,"Monaco","Ligue 1","Fabinho","BRA","MF","23",1993,34,114,64,38,67,9,48,112,42.9,64,48,13,35,43,157,62,0,"https://fbref.com/en/players/7f3b388c/Fabinho"
2018,"Monaco","Ligue 1","Radamel Falcao","COL","FW","31",1986,23.7,11,6,0,8,3,2,13,15.4,11,13,3,10,10,21,11,0,"https://fbref.com/en/players/66116290/Radamel-Falcao"
2018,"Monaco","Ligue 1","Rachid Ghezzal","ALG","FW,MF","25",1992,11.2,31,24,6,22,3,7,34,20.6,27,17,0,17,11,42,2,1,"https://fbref.com/en/players/dc3a9a0d/Rachid-Ghezzal"
2018,"Monaco","Ligue 1","Kamil Glik","POL","DF","29",1988,36,36,23,22,12,2,15,29,51.7,14,28,18,10,54,90,279,2,"https://fbref.com/en/players/c6056d58/Kamil-Glik"
2018,"Monaco","Ligue 1","Jemerson","BRA","DF","24",1992,31.7,48,32,32,15,1,24,31,77.4,7,46,32,14,56,104,169,1,"https://fbref.com/en/players/7cab69b5/Jemerson"
2018,"Monaco","Ligue 1","Jorge","BRA","DF","21",1996,21.3,69,40,34,25,10,23,38,60.5,15,19,2,17,66,135,86,0,"https://fbref.com/en/players/13c44fc5/Jorge"
2018,"Monaco","Ligue 1","Stevan Jovetić","MNE","FW","27",1989,8.4,4,4,0,3,1,0,9,0,9,5,0,5,3,7,3,0,"https://fbref.com/en/players/f36c432f/Stevan-Jovetic"
2018,"Monaco","Ligue 1","Terence Kongolo","NED","DF","23",1994,2.9,6,4,4,2,0,0,2,0,2,5,3,2,5,11,14,0,"https://fbref.com/en/players/1f9a3a04/Terence-Kongolo"
2018,"Monaco","Ligue 1","Thomas Lemar","FRA","MF,FW","21",1995,26.4,33,17,9,19,5,10,41,24.4,31,22,1,21,18,51,16,1,"https://fbref.com/en/players/4dbd0916/Thomas-Lemar"
2018,"Monaco","Ligue 1","Rony Lopes","POR","FW,MF","21",1995,28.1,55,32,15,27,13,21,78,26.9,57,23,2,21,16,71,22,0,"https://fbref.com/en/players/7c2965bb/Rony-Lopes"
2018,"Monaco","Ligue 1","Kylian Mbappé","FRA","FW,MF","18",1998,0.8,1,1,0,1,0,0,0,NA,0,0,0,0,1,2,0,0,"https://fbref.com/en/players/42fd9c7f/Kylian-Mbappe"
2018,"Monaco","Ligue 1","Jordi Mboula","ESP","MF","18",1999,0.3,0,0,0,0,0,0,0,NA,0,2,0,2,0,0,2,0,"https://fbref.com/en/players/4887118d/Jordi-Mboula"
2018,"Monaco","Ligue 1","Soualiho Meïté","FRA","MF","23",1994,1.1,2,1,1,1,0,2,5,40,3,1,0,1,3,5,3,0,"https://fbref.com/en/players/5cec2c74/Soualiho-Meite"
2018,"Monaco","Ligue 1","João Moutinho","POR","MF","30",1986,31.1,65,41,19,37,9,27,80,33.8,53,52,12,40,36,101,54,0,"https://fbref.com/en/players/f5a00fa4/Joao-Moutinho"
2018,"Monaco","Ligue 1","Kévin N'Doram","FRA","MF,DF","21",1996,8,16,10,6,9,1,6,24,25,18,6,2,4,16,32,29,0,"https://fbref.com/en/players/e50623a0/Kevin-NDoram"
2018,"Monaco","Ligue 1","Pietro Pellegri","ITA","FW","16",2001,0.3,0,0,0,0,0,0,2,0,2,1,0,1,0,0,0,0,"https://fbref.com/en/players/a44d3a3c/Pietro-Pellegri"
2018,"Monaco","Ligue 1","Andrea Raggi","ITA","DF","33",1984,17.9,20,10,15,4,1,10,27,37,17,12,6,6,31,51,66,0,"https://fbref.com/en/players/bd4f5f94/Andrea-Raggi"
2018,"Monaco","Ligue 1","Allan Saint-Maximin","FRA","MF","20",1997,0.2,0,0,0,0,0,0,0,NA,0,0,0,0,0,0,0,0,"https://fbref.com/en/players/2b16cb1a/Allan-Saint-Maximin"
2018,"Monaco","Ligue 1","Julien Serrano","FRA","DF","19",1998,3.1,2,2,1,0,1,1,2,50,1,2,0,2,4,6,14,0,"https://fbref.com/en/players/7fb301af/Julien-Serrano"
2018,"Monaco","Ligue 1","Djibril Sidibé","FRA","DF","25",1992,23.9,59,39,24,27,8,23,45,51.1,22,20,4,16,46,105,52,1,"https://fbref.com/en/players/4c5b714f/Djibril-Sidibe"
2018,"Monaco","Ligue 1","Danijel Subašić","CRO","GK","32",1984,32.7,0,0,0,0,0,0,2,0,2,1,0,1,0,0,13,2,"https://fbref.com/en/players/f6db3bd5/Danijel-Subasic"
2018,"Monaco","Ligue 1","Seydou Sy","SEN","GK","21",1995,2.8,0,0,0,0,0,0,0,NA,0,0,0,0,0,0,2,0,"https://fbref.com/en/players/8417953b/Seydou-Sy"
2018,"Monaco","Ligue 1","Moussa Sylla","FRA","FW","17",1999,3.4,0,0,0,0,0,0,2,0,2,2,0,2,0,0,1,0,"https://fbref.com/en/players/d8b97bb3/Moussa-Sylla"
2018,"Monaco","Ligue 1","Youri Tielemans","BEL","MF","20",1997,17.4,47,24,14,28,5,17,55,30.9,38,24,5,19,34,81,20,1,"https://fbref.com/en/players/56f7a928/Youri-Tielemans"
2018,"Monaco","Ligue 1","Almamy Touré","MLI","DF","21",1996,13.9,51,29,31,13,7,18,30,60,12,15,2,13,22,73,61,0,"https://fbref.com/en/players/c8c60119/Almamy-Toure"
2018,"Monaco","Ligue 1","Adama Traoré","MLI","MF,FW","22",1995,2.1,6,4,0,4,2,1,4,25,3,3,0,3,3,9,1,0,"https://fbref.com/en/players/1a6f2a66/Adama-Traore"
2018,"Montpellier","Ligue 1","Ruben Aguilar","FRA","DF","24",1993,27.3,91,50,37,41,13,36,71,50.7,35,25,3,22,37,128,90,0,"https://fbref.com/en/players/3dd738a1/Ruben-Aguilar"
2018,"Montpellier","Ligue 1","Kévin Bérigaud","FRA","FW,MF","29",1988,3,4,3,1,1,2,2,6,33.3,4,1,0,1,0,4,1,0,"https://fbref.com/en/players/3250c6cd/Kevin-Berigaud"
2018,"Montpellier","Ligue 1","Souleymane Camara","SEN","FW","34",1982,10.4,6,4,0,5,1,0,3,0,3,3,1,2,2,8,15,0,"https://fbref.com/en/players/c58270f8/Souleymane-Camara"
2018,"Montpellier","Ligue 1","Daniel Congré","FRA","DF","32",1985,29.3,62,46,36,24,2,31,59,52.5,28,29,16,13,56,118,124,2,"https://fbref.com/en/players/3f5b4635/Daniel-Congre"
2018,"Montpellier","Ligue 1","Nicolas Cozza","FRA","DF,MF","18",1999,6.4,21,11,12,8,1,7,16,43.8,9,5,2,3,13,34,12,0,"https://fbref.com/en/players/8f325097/Nicolas-Cozza"
2018,"Montpellier","Ligue 1","Keagan Dolly","RSA","MF,FW","24",1993,9.8,12,7,2,7,3,1,11,9.1,10,11,0,11,1,13,2,0,"https://fbref.com/en/players/ccb1c3af/Keagan-Dolly"
2018,"Montpellier","Ligue 1","Vitorino Hilton","BRA","DF","39",1977,27,44,26,33,11,0,13,36,36.1,23,28,14,14,58,102,140,5,"https://fbref.com/en/players/c4bbea9f/Vitorino-Hilton"
2018,"Montpellier","Ligue 1","Jonathan Ikone","FRA","MF,FW","19",1998,11.1,13,10,3,6,4,4,14,28.6,10,8,0,8,6,19,3,0,"https://fbref.com/en/players/42eaa028/Jonathan-Ikone"
2018,"Montpellier","Ligue 1","Paul Lasne","FRA","MF","28",1989,34,68,45,27,39,2,12,54,22.2,42,20,1,19,57,125,26,0,"https://fbref.com/en/players/542cc80f/Paul-Lasne"
2018,"Montpellier","Ligue 1","Benjamin Lecomte","FRA","GK","26",1991,38,1,1,1,0,0,0,0,NA,0,1,0,1,0,1,14,1,"https://fbref.com/en/players/2fa2a875/Benjamin-Lecomte"
2018,"Montpellier","Ligue 1","Isaac Mbenza","BEL","FW,MF","21",1996,23.3,16,11,4,8,4,6,16,37.5,10,8,1,7,4,20,5,0,"https://fbref.com/en/players/aa1a8c7e/Isaac-Mbenza"
2018,"Montpellier","Ligue 1","Pedro Mendes","POR","DF","26",1990,31.7,62,50,37,19,6,23,41,56.1,18,36,25,11,44,106,152,0,"https://fbref.com/en/players/6690ef25/Pedro-Mendes"
2018,"Montpellier","Ligue 1","Nordi Mukiele","FRA","DF","19",1997,31,70,55,41,25,4,25,44,56.8,19,26,14,12,73,143,104,2,"https://fbref.com/en/players/ac73ec79/Nordi-Mukiele"
2018,"Montpellier","Ligue 1","Casimir Ninga","CHA","FW,MF","24",1993,14.3,12,7,1,6,5,2,10,20,8,12,2,10,4,16,13,0,"https://fbref.com/en/players/91f2da4c/Casimir-Ninga"
2018,"Montpellier","Ligue 1","Ambroise Oyongo","CMR","DF","26",1991,2.2,2,1,1,1,0,0,1,0,1,2,1,1,6,8,6,0,"https://fbref.com/en/players/e3e05edf/Ambroise-Oyongo"
2018,"Montpellier","Ligue 1","Facundo Píriz","URU","MF","27",1990,9,25,16,9,12,4,6,35,17.1,29,10,1,9,18,43,14,0,"https://fbref.com/en/players/fca455cc/Facundo-Piriz"
2018,"Montpellier","Ligue 1","Morgan Poaty","CGO","DF","20",1997,1.9,0,0,0,0,0,0,1,0,1,5,3,2,1,1,2,0,"https://fbref.com/en/players/7add56e1/Morgan-Poaty"
2018,"Montpellier","Ligue 1","Jérémie Porsan-Clémenté","FRA","DF","19",1997,1,3,2,1,2,0,2,2,100,0,1,0,1,1,4,4,1,"https://fbref.com/en/players/fa27b5a0/Jeremie-Porsan-Clemente"
2018,"Montpellier","Ligue 1","Jérôme Roussillon","FRA","DF","24",1993,20.9,40,27,17,19,4,15,26,57.7,11,26,3,23,15,55,52,0,"https://fbref.com/en/players/13203c45/Jerome-Roussillon"
2018,"Montpellier","Ligue 1","Junior Sambia","FRA","MF","20",1996,17.1,21,12,6,11,4,6,28,21.4,22,16,0,16,20,41,18,0,"https://fbref.com/en/players/24eb7ed6/Junior-Sambia"
2018,"Montpellier","Ligue 1","Stéphane Sessègnon","BEN","MF,FW","33",1984,10.9,4,4,2,2,0,1,7,14.3,6,0,0,0,0,4,2,0,"https://fbref.com/en/players/35c5f9b1/Stephane-Sessegnon"
2018,"Montpellier","Ligue 1","Giovanni Sio","CIV","FW","28",1989,24.4,14,8,2,9,3,0,20,0,20,11,0,11,6,20,23,1,"https://fbref.com/en/players/0fe7f7bc/Giovanni-Sio"
2018,"Montpellier","Ligue 1","Ellyes Skhiri","TUN","MF","22",1995,33.9,89,54,34,47,8,37,88,42,51,59,10,49,77,166,57,4,"https://fbref.com/en/players/c2211709/Ellyes-Skhiri"
2018,"Málaga","La Liga","Borja Bastón","ESP","FW","24",1992,10.9,9,7,1,6,2,1,13,7.7,12,7,0,7,3,12,5,0,"https://fbref.com/en/players/8c44e37b/Borja-Baston"
2018,"Málaga","La Liga","Paul Baysse","FRA","DF","29",1988,13.8,25,16,21,3,1,10,17,58.8,7,10,6,4,20,45,84,0,"https://fbref.com/en/players/2515040a/Paul-Baysse"
2018,"Málaga","La Liga","Alberto Bueno","ESP","MF,FW","29",1988,2.5,3,2,2,1,0,2,11,18.2,9,2,0,2,1,4,2,0,"https://fbref.com/en/players/9b878773/Alberto-Bueno"
2018,"Málaga","La Liga","Chory Castro","URU","MF,FW","32",1984,22.9,37,24,15,14,8,11,32,34.4,21,21,2,19,23,60,13,0,"https://fbref.com/en/players/8cc3d96e/Chory-Castro"
2018,"Málaga","La Liga","Emanuel Cecchini","ARG","MF,DF","20",1996,0.3,3,1,2,1,0,2,3,66.7,1,0,0,0,2,5,2,0,"https://fbref.com/en/players/5c256395/Emanuel-Cecchini"
2018,"Málaga","La Liga","Cifu","ESP","DF","26",1990,1.2,2,1,0,1,1,1,5,20,4,1,1,0,2,4,2,0,"https://fbref.com/en/players/90f83973/Cifu"
2018,"Málaga","La Liga","Juan Cruz","ESP","FW","17",2000,0.1,2,2,0,2,0,0,0,NA,0,0,0,0,0,2,0,0,"https://fbref.com/en/players/cc2dd8a5/Juan-Cruz"
2018,"Málaga","La Liga","Youssef En-Nesyri","MAR","FW","20",1997,17.7,31,25,10,14,7,6,26,23.1,20,11,0,11,9,40,32,0,"https://fbref.com/en/players/04e17fd5/Youssef-En-Nesyri"
2018,"Málaga","La Liga","Samu García","ESP","MF","27",1990,2,8,6,4,3,1,3,10,30,7,4,0,4,6,14,3,0,"https://fbref.com/en/players/5f7db81a/Samu-Garcia"
2018,"Málaga","La Liga","Adrián González","ESP","MF,FW","29",1988,26,40,25,14,22,4,12,50,24,38,25,8,17,38,78,34,0,"https://fbref.com/en/players/57ebd662/Adrian-Gonzalez"
2018,"Málaga","La Liga","Diego González","ESP","DF","22",1995,15.9,27,19,20,7,0,18,26,69.2,8,25,10,15,19,46,69,0,"https://fbref.com/en/players/4ac7608e/Diego-Gonzalez"
2018,"Málaga","La Liga","Luis Hernández","ESP","DF","28",1989,36,49,43,37,9,3,17,33,51.5,16,32,21,11,77,126,185,1,"https://fbref.com/en/players/02d2c436/Luis-Hernandez"
2018,"Málaga","La Liga","Brown Ideye","NGA","FW","28",1988,8.1,2,2,0,2,0,0,5,0,5,2,0,2,1,3,11,0,"https://fbref.com/en/players/f519b556/Brown-Ideye"
2018,"Málaga","La Liga","Manuel Iturra","CHI","MF","33",1984,17.6,70,45,36,27,7,22,55,40,33,19,2,17,29,99,23,0,"https://fbref.com/en/players/000b3da6/Manuel-Iturra"
2018,"Málaga","La Liga","Jony","ESP","FW,MF","26",1991,2.4,3,2,2,0,1,0,4,0,4,1,0,1,2,5,1,0,"https://fbref.com/en/players/244f57b9/Jony"
2018,"Málaga","La Liga","Juankar","ESP","DF","27",1990,8.7,23,17,13,8,2,11,20,55,9,8,1,7,19,42,26,0,"https://fbref.com/en/players/e9a12436/Juankar"
2018,"Málaga","La Liga","Juanpi","VEN","MF,FW","23",1994,6.8,11,8,2,7,2,3,8,37.5,5,7,0,7,6,17,1,0,"https://fbref.com/en/players/d79afcfc/Juanpi"
2018,"Málaga","La Liga","Keko","ESP","MF,FW","25",1991,13.4,38,23,17,13,8,15,47,31.9,32,25,3,22,13,51,9,0,"https://fbref.com/en/players/1512328c/Keko"
2018,"Málaga","La Liga","Zdravko Kuzmanović","SRB","MF","29",1987,5.3,4,4,1,3,0,0,5,0,5,2,2,0,4,8,9,0,"https://fbref.com/en/players/6df0dc74/Zdravko-Kuzmanovic"
2018,"Málaga","La Liga","Mehdi Lacen","ALG","MF","33",1984,11.7,35,19,18,17,0,14,38,36.8,24,13,1,12,15,50,11,0,"https://fbref.com/en/players/a3a306f6/Mehdi-Lacen"
2018,"Málaga","La Liga","Maxime Lestienne","BEL","MF","25",1992,7.4,8,5,5,0,3,3,15,20,12,7,1,6,6,14,6,0,"https://fbref.com/en/players/ac290817/Maxime-Lestienne"
2018,"Málaga","La Liga","Alberto López","ESP","DF","22",1995,0.5,1,1,0,1,0,1,1,100,0,1,0,1,2,3,2,0,"https://fbref.com/en/players/c0de5ff5/Alberto-Lopez"
2018,"Málaga","La Liga","Ignasi Miquel","ESP","DF","24",1992,19.7,19,10,11,7,1,4,15,26.7,11,23,13,10,33,52,113,0,"https://fbref.com/en/players/174f09a6/Ignasi-Miquel"
2018,"Málaga","La Liga","Álex Mula","ESP","FW,MF","21",1996,6.2,7,3,3,4,0,2,12,16.7,10,5,0,5,6,13,1,0,"https://fbref.com/en/players/bd207a4d/Alex-Mula"
2018,"Málaga","La Liga","Javier Ontiveros","ESP","MF,FW","19",1997,4.3,10,7,8,2,0,2,4,50,2,4,2,2,4,14,4,0,"https://fbref.com/en/players/a83d8b0c/Javier-Ontiveros"
2018,"Málaga","La Liga","Adalberto Peñaranda","VEN","FW,MF","20",1997,8.9,10,6,2,6,2,2,3,66.7,1,8,1,7,0,10,1,0,"https://fbref.com/en/players/4b3f2936/Adalberto-Penaranda"
2018,"Málaga","La Liga","Andrés Prieto","ESP","GK","23",1993,4,0,0,0,0,0,0,0,NA,0,0,0,0,0,0,2,0,"https://fbref.com/en/players/113fb4ea/Andres-Prieto"
2018,"Málaga","La Liga","Recio","ESP","MF","26",1991,20.4,54,42,26,23,5,17,62,27.4,45,15,3,12,30,84,17,0,"https://fbref.com/en/players/54073b28/Recio"
2018,"Málaga","La Liga","Federico Ricca","URU","DF","22",1994,12.3,43,24,32,9,2,23,33,69.7,10,10,2,8,24,67,46,0,"https://fbref.com/en/players/54f5ce34/Federico-Ricca"
2018,"Málaga","La Liga","Roberto","ESP","GK","31",1986,34,0,0,0,0,0,0,0,NA,0,0,0,0,2,2,15,0,"https://fbref.com/en/players/ba3ca78f/Roberto"
2018,"Málaga","La Liga","Álex Robles","ESP","DF","18",1999,1,2,1,1,1,0,0,0,NA,0,1,0,1,3,5,4,0,"https://fbref.com/en/players/df9326db/Alex-Robles"
2018,"Málaga","La Liga","Iván Rodríguez","ESP","DF","21",1996,0.2,1,1,0,1,0,0,0,NA,0,0,0,0,1,2,1,0,"https://fbref.com/en/players/aa55fe48/Ivan-Rodriguez"
2018,"Málaga","La Liga","Diego Rolán","URU","FW,MF","24",1993,21.6,33,25,7,13,13,9,44,20.5,35,18,1,17,12,45,9,0,"https://fbref.com/en/players/d1491e00/Diego-Rolan"
2018,"Málaga","La Liga","Esteban Rolón","ARG","MF","22",1995,4.6,6,4,4,2,0,2,4,50,2,7,1,6,9,15,8,1,"https://fbref.com/en/players/10e25802/Esteban-Rolon"
2018,"Málaga","La Liga","Roberto Rosales","VEN","DF","28",1988,34.7,104,69,52,40,12,50,84,59.5,34,37,13,24,58,162,104,1,"https://fbref.com/en/players/81069528/Roberto-Rosales"
2018,"Málaga","La Liga","Isaac Success","NGA","MF,FW","21",1996,5.5,9,7,4,4,1,3,8,37.5,5,2,0,2,5,14,0,0,"https://fbref.com/en/players/f573a8bf/Isaac-Success"
2018,"Málaga","La Liga","Miguel Torres","ESP","DF","31",1986,7.5,16,13,13,3,0,6,14,42.9,8,9,7,2,13,29,35,0,"https://fbref.com/en/players/44b61913/Miguel-Torres"
2018,"Nantes","Ligue 1","David Alcibiade","FRA","DF","25",1991,2.3,9,5,5,3,1,2,4,50,2,5,3,2,7,16,8,0,"https://fbref.com/en/players/9b8970ce/David-Alcibiade"
2018,"Nantes","Ligue 1","Chidozie Awaziem","NGA","DF","20",1997,16.8,43,30,33,10,0,28,40,70,12,18,11,7,16,59,97,0,"https://fbref.com/en/players/70d8e84c/Chidozie-Awaziem"
2018,"Nantes","Ligue 1","Yacine Bammou","MAR","MF,FW","25",1991,8.1,18,11,6,10,2,4,14,28.6,10,16,4,12,6,24,9,0,"https://fbref.com/en/players/a1d04509/Yacine-Bammou"
2018,"Nantes","Ligue 1","Diego Carlos","BRA","DF","24",1993,25.5,70,42,51,15,4,28,38,73.7,10,50,29,21,29,99,155,3,"https://fbref.com/en/players/b4a014b1/Diego-Carlos"
2018,"Nantes","Ligue 1","Kalifa Coulibaly","MLI","FW","25",1991,3.8,6,6,3,1,2,2,4,50,2,0,0,0,0,6,6,0,"https://fbref.com/en/players/9980269a/Kalifa-Coulibaly"
2018,"Nantes","Ligue 1","Koffi Djidji","CIV","DF","24",1992,26.8,55,39,32,20,3,19,29,65.5,10,34,15,19,45,100,126,0,"https://fbref.com/en/players/933d3b51/Koffi-Djidji"
2018,"Nantes","Ligue 1","Leo Dubois","FRA","DF","22",1994,33.6,50,39,33,15,2,20,47,42.6,27,47,13,34,50,100,99,2,"https://fbref.com/en/players/ff0ab48c/Leo-Dubois"
2018,"Nantes","Ligue 1","Maxime Dupé","FRA","GK","24",1993,1,0,0,0,0,0,0,0,NA,0,0,0,0,0,0,2,0,"https://fbref.com/en/players/0e12089d/Maxime-Dupe"
2018,"Nantes","Ligue 1","Najib Gandi","FRA","FW,MF","23",1994,1.1,6,5,3,2,1,4,6,66.7,2,4,1,3,4,10,3,0,"https://fbref.com/en/players/56b52c4e/Najib-Gandi"
2018,"Nantes","Ligue 1","Yassine El Ghanassy","BEL","MF,FW","27",1990,7.2,7,4,1,3,3,1,4,25,3,1,0,1,4,11,4,0,"https://fbref.com/en/players/0049d544/Yassine-El-Ghanassy"
2018,"Nantes","Ligue 1","Guillaume Gillet","BEL","MF","33",1984,0.2,0,0,0,0,0,0,0,NA,0,1,1,0,0,0,0,0,"https://fbref.com/en/players/3f944dad/Guillaume-Gillet"
2018,"Nantes","Ligue 1","Andrei Girotto","BRA","MF","25",1992,16.9,57,38,15,37,5,21,52,40.4,31,32,7,25,15,72,45,1,"https://fbref.com/en/players/3befc2b6/Andrei-Girotto"
2018,"Nantes","Ligue 1","Jules Iloki","FRA","MF,FW","25",1992,15.8,13,9,1,9,3,3,16,18.8,13,8,0,8,12,25,16,0,"https://fbref.com/en/players/f352a2db/Jules-Iloki"
2018,"Nantes","Ligue 1","Alexander Kačaniklić","SWE","MF,FW","25",1991,3.5,8,5,7,1,0,5,10,50,5,5,2,3,6,14,7,0,"https://fbref.com/en/players/8ba3a754/Alexander-Kacaniklic"
2018,"Nantes","Ligue 1","Joris Kayembe","BEL","FW,MF","22",1994,1,1,0,1,0,0,0,4,0,4,0,0,0,0,1,4,0,"https://fbref.com/en/players/4657faba/Joris-Kayembe"
2018,"Nantes","Ligue 1","Rene Krhin","SVN","MF","27",1990,14.6,18,12,7,11,0,3,17,17.6,14,11,2,9,16,34,39,0,"https://fbref.com/en/players/9a506145/Rene-Krhin"
2018,"Nantes","Ligue 1","Enock Kwateng","FRA","DF","20",1997,1,8,6,6,2,0,7,11,63.6,4,2,0,2,1,9,7,0,"https://fbref.com/en/players/4bf69118/Enock-Kwateng"
2018,"Nantes","Ligue 1","Lucas Lima","BRA","DF,FW","25",1991,29.5,73,46,40,27,6,31,68,45.6,37,42,6,36,38,111,85,0,"https://fbref.com/en/players/0f52f925/Lucas-Lima"
2018,"Nantes","Ligue 1","Samuel Moutoussamy","COD","MF","20",1996,4.8,15,7,6,7,2,5,8,62.5,3,7,1,6,3,18,4,0,"https://fbref.com/en/players/af0c835b/Samuel-Moutoussamy"
2018,"Nantes","Ligue 1","Préjuce Nakoulma","BFA","FW","30",1987,12.8,10,8,3,6,1,2,7,28.6,5,2,0,2,5,15,0,0,"https://fbref.com/en/players/8e87af42/Prejuce-Nakoulma"
2018,"Nantes","Ligue 1","Santy Ngom","SEN","FW,MF","24",1993,5.2,10,5,5,5,0,1,8,12.5,7,9,1,8,2,12,2,0,"https://fbref.com/en/players/45076ff8/Santy-Ngom"
2018,"Nantes","Ligue 1","Nicolas Pallois","FRA","DF","29",1987,27,39,28,25,9,5,18,36,50,18,34,19,15,35,74,182,3,"https://fbref.com/en/players/779847d6/Nicolas-Pallois"
2018,"Nantes","Ligue 1","Valentin Rongier","FRA","MF","22",1994,26.1,73,49,25,39,9,17,64,26.6,47,42,6,36,40,113,13,1,"https://fbref.com/en/players/ed45c4a5/Valentin-Rongier"
2018,"Nantes","Ligue 1","Emiliano Sala","ARG","FW","26",1990,33.7,19,11,3,9,7,5,33,15.2,28,27,3,24,9,28,50,0,"https://fbref.com/en/players/5d59e0df/Emiliano-Sala"
2018,"Nantes","Ligue 1","Kolbeinn Sigþórsson","ISL","FW","27",1990,0.3,0,0,0,0,0,0,0,NA,0,0,0,0,1,1,0,0,"https://fbref.com/en/players/adf825b9/Kolbeinn-Sigthorsson"
2018,"Nantes","Ligue 1","Mariusz Stępiński","POL","FW","22",1995,0,0,0,0,0,0,0,0,NA,0,0,0,0,0,0,0,0,"https://fbref.com/en/players/7b536033/Mariusz-Stepinski"
2018,"Nantes","Ligue 1","Ciprian Tătărușanu","ROU","GK","31",1986,37,1,0,1,0,0,1,2,50,1,0,0,0,1,2,12,3,"https://fbref.com/en/players/b056e3da/Ciprian-Tatarusanu"
2018,"Nantes","Ligue 1","Adrien Thomasson","FRA","MF,FW","23",1993,28.6,71,52,41,23,7,22,73,30.1,51,58,4,54,18,89,20,0,"https://fbref.com/en/players/c76b7567/Adrien-Thomasson"
2018,"Nantes","Ligue 1","Abdoulaye Touré","FRA","MF","23",1994,31.2,74,52,28,38,8,23,67,34.3,44,40,10,30,62,136,49,1,"https://fbref.com/en/players/ef7cd87a/Abdoulaye-Toure"
2018,"Nantes","Ligue 1","Anthony Walongwa","COD","DF","23",1993,1,2,1,2,0,0,0,0,NA,0,0,0,0,1,3,8,0,"https://fbref.com/en/players/eb78322b/Anthony-Walongwa"
2018,"Napoli","Serie A","Raúl Albiol","ESP","DF","31",1985,30.5,29,19,15,14,0,13,19,68.4,6,18,13,5,32,61,129,1,"https://fbref.com/en/players/4bd414c1/Raul-Albiol"
2018,"Napoli","Serie A","Allan","BRA","MF","26",1991,31.7,107,68,24,65,18,36,104,34.6,68,52,3,49,28,135,16,0,"https://fbref.com/en/players/cc700722/Allan"
2018,"Napoli","Serie A","José Callejón","ESP","FW","30",1987,36,33,27,15,14,4,10,47,21.3,37,42,5,37,22,55,31,0,"https://fbref.com/en/players/78841da9/Jose-Callejon"
2018,"Napoli","Serie A","Vlad Chiricheș","ROU","DF","27",1989,6.5,8,4,7,1,0,2,5,40,3,2,1,1,16,24,19,1,"https://fbref.com/en/players/c316607a/Vlad-Chiriches"
2018,"Napoli","Serie A","Amadou Diawara","GUI","MF","20",1997,7.3,11,9,3,7,1,1,7,14.3,6,12,2,10,9,20,5,0,"https://fbref.com/en/players/bf309d24/Amadou-Diawara"
2018,"Napoli","Serie A","Faouzi Ghoulam","ALG","DF","26",1991,10.9,8,4,3,5,0,4,6,66.7,2,10,2,8,15,23,19,0,"https://fbref.com/en/players/c5adc293/Faouzi-Ghoulam"
2018,"Napoli","Serie A","Emanuele Giaccherini","ITA","FW,MF","32",1985,0.7,1,1,0,1,0,0,0,NA,0,0,0,0,0,1,0,0,"https://fbref.com/en/players/1c50f354/Emanuele-Giaccherini"
2018,"Napoli","Serie A","Marek Hamšík","SVK","MF","30",1987,26.3,36,22,10,15,11,15,37,40.5,22,35,2,33,14,50,16,0,"https://fbref.com/en/players/e6ad16b2/Marek-Hamsik"
2018,"Napoli","Serie A","Elseid Hysaj","ALB","DF","23",1994,34.7,64,45,28,30,6,32,56,57.1,24,35,4,31,43,107,68,4,"https://fbref.com/en/players/2f3452eb/Elseid-Hysaj"
2018,"Napoli","Serie A","Lorenzo Insigne","ITA","FW","26",1991,34.3,29,17,11,13,5,13,33,39.4,20,20,0,20,17,46,4,0,"https://fbref.com/en/players/2f557579/Lorenzo-Insigne"
2018,"Napoli","Serie A","Jorginho","ITA","MF","25",1991,29.4,62,46,14,39,9,15,68,22.1,53,32,3,29,50,112,12,2,"https://fbref.com/en/players/45db685d/Jorginho"
2018,"Napoli","Serie A","Kalidou Koulibaly","SEN","DF","26",1991,34.1,54,42,31,19,4,20,40,50,20,36,16,20,40,94,119,3,"https://fbref.com/en/players/da974c7b/Kalidou-Koulibaly"
2018,"Napoli","Serie A","Christian Maggio","ITA","DF","35",1982,7.1,17,10,9,6,2,7,19,36.8,12,15,4,11,13,30,21,0,"https://fbref.com/en/players/31d7f557/Christian-Maggio"
2018,"Napoli","Serie A","Nikola Maksimović","SRB","DF","25",1991,1.1,1,1,0,1,0,1,1,100,0,1,0,1,0,1,5,0,"https://fbref.com/en/players/16b9d5cf/Nikola-Maksimovic"
2018,"Napoli","Serie A","Dries Mertens","BEL","FW","30",1987,33.4,28,22,5,13,10,5,36,13.9,31,18,2,16,5,33,8,1,"https://fbref.com/en/players/89b2c8a9/Dries-Mertens"
2018,"Napoli","Serie A","Arkadiusz Milik","POL","FW,MF","23",1994,5,2,1,0,1,1,0,1,0,1,5,0,5,1,3,4,0,"https://fbref.com/en/players/85613cf0/Arkadiusz-Milik"
2018,"Napoli","Serie A","Adam Ounas","ALG","FW","20",1996,1.1,4,3,0,2,2,1,4,25,3,2,0,2,0,4,2,0,"https://fbref.com/en/players/ed90babd/Adam-Ounas"
2018,"Napoli","Serie A","Pepe Reina","ESP","GK","34",1982,37,1,0,1,0,0,1,2,50,1,0,0,0,0,1,13,2,"https://fbref.com/en/players/e358587b/Pepe-Reina"
2018,"Napoli","Serie A","Marko Rog","CRO","MF,FW","22",1995,3.2,11,7,3,6,2,1,11,9.1,10,4,1,3,2,13,1,0,"https://fbref.com/en/players/b6b2b820/Marko-Rog"
2018,"Napoli","Serie A","Mário Rui","POR","DF","26",1991,23.2,55,39,18,32,5,30,52,57.7,22,30,5,25,14,69,43,1,"https://fbref.com/en/players/0b5a292a/Mario-Rui"
2018,"Napoli","Serie A","Luigi Sepe","ITA","GK","26",1991,1,0,0,0,0,0,0,0,NA,0,0,0,0,0,0,1,0,"https://fbref.com/en/players/343f753a/Luigi-Sepe"
2018,"Napoli","Serie A","Lorenzo Tonelli","ITA","DF","27",1990,3.9,7,1,4,3,0,5,9,55.6,4,2,1,1,7,14,10,0,"https://fbref.com/en/players/8cc29864/Lorenzo-Tonelli"
2018,"Napoli","Serie A","Piotr Zieliński","POL","MF,FW","23",1994,18.5,31,19,7,21,3,9,24,37.5,15,32,3,29,13,44,19,1,"https://fbref.com/en/players/a5296e55/Piotr-Zielinski"
2018,"Newcastle Utd","Premier League","Rolando Aarons","ENG","MF,FW","21",1995,1.5,4,4,3,1,0,4,6,66.7,2,3,0,3,1,5,0,0,"https://fbref.com/en/players/c5942695/Rolando-Aarons"
2018,"Newcastle Utd","Premier League","Christian Atsu","GHA","FW,MF","25",1992,19.8,17,16,10,7,0,7,20,35,13,35,5,30,13,30,27,1,"https://fbref.com/en/players/8816329f/Christian-Atsu"
2018,"Newcastle Utd","Premier League","Ciaran Clark","IRL","DF","27",1989,19.4,25,17,17,8,0,11,21,52.4,10,15,10,5,17,42,144,1,"https://fbref.com/en/players/2b91cf8e/Ciaran-Clark"
2018,"Newcastle Utd","Premier League","Karl Darlow","ENG","GK","26",1990,10,0,0,0,0,0,0,0,NA,0,0,0,0,0,0,3,4,"https://fbref.com/en/players/cde3309f/Karl-Darlow"
2018,"Newcastle Utd","Premier League","Mohamed Diamé","SEN","MF","30",1987,22.7,89,64,33,48,8,16,62,25.8,46,44,7,37,48,137,30,2,"https://fbref.com/en/players/b7d082af/Mohamed-Diame"
2018,"Newcastle Utd","Premier League","Martin Dúbravka","SVK","GK","28",1989,12,0,0,0,0,0,0,0,NA,0,0,0,0,0,0,3,2,"https://fbref.com/en/players/3a949a25/Martin-Dubravka"
2018,"Newcastle Utd","Premier League","Paul Dummett","WAL","DF","25",1991,17.8,28,19,21,7,0,13,27,48.1,14,27,10,17,23,51,107,1,"https://fbref.com/en/players/3fe6bd8c/Paul-Dummett"
2018,"Newcastle Utd","Premier League","Rob Elliot","IRL","GK","31",1986,16,0,0,0,0,0,0,1,0,1,0,0,0,0,0,8,0,"https://fbref.com/en/players/b1b25949/Rob-Elliot"
2018,"Newcastle Utd","Premier League","Jesús Gámez","ESP","DF","32",1985,1.1,4,2,1,0,3,1,3,33.3,2,2,0,2,2,6,5,0,"https://fbref.com/en/players/bd1d1cbb/Jesus-Gamez"
2018,"Newcastle Utd","Premier League","Dwight Gayle","ENG","FW","26",1990,21.8,12,10,2,8,2,1,21,4.8,20,16,2,14,6,18,17,0,"https://fbref.com/en/players/e58a03c6/Dwight-Gayle"
2018,"Newcastle Utd","Premier League","Massadio Haïdara","MLI","FW","24",1992,0,0,0,0,0,0,0,0,NA,0,0,0,0,0,0,0,0,"https://fbref.com/en/players/5167c97e/Massadio-Haidara"
2018,"Newcastle Utd","Premier League","Isaac Hayden","ENG","MF","22",1995,15.3,40,23,23,16,1,12,34,35.3,22,21,6,15,23,63,43,0,"https://fbref.com/en/players/c951a6df/Isaac-Hayden"
2018,"Newcastle Utd","Premier League","Joselu","ESP","FW","27",1990,19,22,17,10,11,1,7,34,20.6,27,25,2,23,11,33,39,0,"https://fbref.com/en/players/6265208f/Joselu"
2018,"Newcastle Utd","Premier League","Kenedy","BRA","MF,DF","21",1996,11.4,31,17,16,13,2,12,35,34.3,23,12,1,11,14,45,11,0,"https://fbref.com/en/players/5eebbfdf/Kenedy"
2018,"Newcastle Utd","Premier League","Jamaal Lascelles","ENG","DF","23",1993,32.5,31,19,19,11,1,12,19,63.2,7,33,24,9,28,59,232,1,"https://fbref.com/en/players/450ab6fc/Jamaal-Lascelles"
2018,"Newcastle Utd","Premier League","Florian Lejeune","FRA","DF","26",1991,23.4,34,20,26,8,0,14,30,46.7,16,21,15,6,46,80,154,0,"https://fbref.com/en/players/6eaed4eb/Florian-Lejeune"
2018,"Newcastle Utd","Premier League","Javier Manquillo","ESP","DF","23",1994,19.5,36,22,25,8,3,15,30,50,15,25,6,19,18,54,65,0,"https://fbref.com/en/players/758dd7f0/Javier-Manquillo"
2018,"Newcastle Utd","Premier League","Chancel Mbemba","COD","DF","22",1994,7.5,16,12,13,3,0,10,17,58.8,7,7,3,4,15,31,44,1,"https://fbref.com/en/players/e76cb9cc/Chancel-Mbemba"
2018,"Newcastle Utd","Premier League","Mikel Merino","ESP","MF","21",1996,15,56,40,21,32,3,17,56,30.4,39,36,8,28,34,90,25,0,"https://fbref.com/en/players/d080ed5e/Mikel-Merino"
2018,"Newcastle Utd","Premier League","Aleksandar Mitrović","SRB","FW","22",1994,1.1,1,1,0,1,0,0,1,0,1,1,0,1,0,1,2,0,"https://fbref.com/en/players/3925dbd6/Aleksandar-Mitrovic"
2018,"Newcastle Utd","Premier League","Jacob Murphy","ENG","MF,FW","22",1995,12.8,13,10,5,4,4,7,27,25.9,20,16,0,16,6,19,13,2,"https://fbref.com/en/players/de112b84/Jacob-Murphy"
2018,"Newcastle Utd","Premier League","Ayoze Pérez","ESP","MF,FW","24",1993,27.7,39,21,11,15,13,12,54,22.2,42,36,1,35,24,63,28,0,"https://fbref.com/en/players/819aa8e7/Ayoze-Perez"
2018,"Newcastle Utd","Premier League","Matt Ritchie","SCO","MF,FW","27",1989,31.2,46,32,22,18,6,14,53,26.4,39,37,5,32,35,81,63,1,"https://fbref.com/en/players/71ef519e/Matt-Ritchie"
2018,"Newcastle Utd","Premier League","Henri Saivet","SEN","MF","26",1990,0.9,5,3,4,1,0,2,5,40,3,0,0,0,4,9,8,1,"https://fbref.com/en/players/f3709655/Henri-Saivet"
2018,"Newcastle Utd","Premier League","Jonjo Shelvey","ENG","MF","25",1992,25.2,39,24,17,21,1,8,26,30.8,18,26,5,21,28,67,33,0,"https://fbref.com/en/players/3727dd3c/Jonjo-Shelvey"
2018,"Newcastle Utd","Premier League","Islam Slimani","ALG","FW","29",1988,1.5,0,0,0,0,0,0,2,0,2,0,0,0,1,1,1,0,"https://fbref.com/en/players/ffec9769/Islam-Slimani"
2018,"Newcastle Utd","Premier League","DeAndre Yedlin","USA","DF","24",1993,31.6,57,33,39,14,4,26,54,48.1,28,37,7,30,44,101,114,0,"https://fbref.com/en/players/ae0a7ddf/DeAndre-Yedlin"
2018,"Nice","Ligue 1","Mario Balotelli","ITA","FW","26",1990,25.2,7,4,1,3,3,0,6,0,6,9,2,7,8,15,26,0,"https://fbref.com/en/players/8ff07990/Mario-Balotelli"
2018,"Nice","Ligue 1","Walter Benítez","ARG","GK","24",1993,28,0,0,0,0,0,0,2,0,2,0,0,0,0,0,5,3,"https://fbref.com/en/players/8a2248b4/Walter-Benitez"
2018,"Nice","Ligue 1","Patrick Burner","MTQ","DF","21",1996,10,18,12,13,5,0,7,20,35,13,6,0,6,13,31,23,0,"https://fbref.com/en/players/8746d5d0/Patrick-Burner"
2018,"Nice","Ligue 1","Yoan Cardinale","FRA","GK","23",1994,10,0,0,0,0,0,0,0,NA,0,0,0,0,0,0,0,3,"https://fbref.com/en/players/950ff24d/Yoan-Cardinale"
2018,"Nice","Ligue 1","Racine Coly","SEN","DF","21",1995,6.9,15,12,9,5,1,9,19,47.4,10,5,2,3,15,30,18,0,"https://fbref.com/en/players/166a981d/Racine-Coly"
2018,"Nice","Ligue 1","Wylan Cyprien","FRA","MF","22",1995,10.6,9,7,4,4,1,2,11,18.2,9,7,1,6,11,20,7,2,"https://fbref.com/en/players/3e092724/Wylan-Cyprien"
2018,"Nice","Ligue 1","Dante","BRA","DF","33",1983,32.4,43,28,32,10,1,21,36,58.3,15,44,25,19,47,90,130,2,"https://fbref.com/en/players/fd2bc67d/Dante"
2018,"Nice","Ligue 1","Valentin Eysseric","FRA","FW","25",1992,1,0,0,0,0,0,0,0,NA,0,4,0,4,1,1,0,0,"https://fbref.com/en/players/ae82fa48/Valentin-Eysseric"
2018,"Nice","Ligue 1","Ignatius Ganago","CMR","FW,MF","18",1999,0.8,0,0,0,0,0,0,2,0,2,1,0,1,0,0,1,0,"https://fbref.com/en/players/23c63b7f/Ignatius-Ganago"
2018,"Nice","Ligue 1","Christophe Jallet","FRA","DF","33",1983,13,29,21,21,8,0,11,26,42.3,15,18,6,12,16,45,47,0,"https://fbref.com/en/players/46d50339/Christophe-Jallet"
2018,"Nice","Ligue 1","Vincent Koziello","FRA","MF","21",1995,9,16,8,9,5,2,5,16,31.3,11,8,3,5,19,35,7,1,"https://fbref.com/en/players/9a493fb7/Vincent-Koziello"
2018,"Nice","Ligue 1","Mickaël Le Bihan","FRA","FW,MF","27",1990,1.2,0,0,0,0,0,0,3,0,3,0,0,0,1,1,0,0,"https://fbref.com/en/players/d512db65/Mickael-Le-Bihan"
2018,"Nice","Ligue 1","Maxime Le Marchand","FRA","DF","27",1989,28.2,48,36,28,18,2,20,41,48.8,21,36,13,23,65,113,105,4,"https://fbref.com/en/players/321a71a7/Maxime-Le-Marchand"
2018,"Nice","Ligue 1","Pierre Lees-Melou","FRA","MF,FW","24",1993,32.1,78,47,29,39,10,27,76,35.5,49,52,11,41,34,112,38,2,"https://fbref.com/en/players/f5044e54/Pierre-Lees-Melou"
2018,"Nice","Ligue 1","Arnaud Lusamba","COD","MF","20",1997,1.8,12,9,4,6,2,3,7,42.9,4,5,0,5,1,13,1,0,"https://fbref.com/en/players/54131505/Arnaud-Lusamba"
2018,"Nice","Ligue 1","Hicham Mahou","FRA","MF,FW","18",1999,0.6,1,1,1,0,0,1,3,33.3,2,0,0,0,3,4,0,0,"https://fbref.com/en/players/f329ec76/Hicham-Mahou"
2018,"Nice","Ligue 1","Jean-Victor Makengo","FRA","FW,MF","19",1998,2.7,4,2,2,2,0,1,2,50,1,1,0,1,3,7,1,1,"https://fbref.com/en/players/22bfb57e/Jean-Victor-Makengo"
2018,"Nice","Ligue 1","Vincent Marcel","FRA","MF,FW","20",1997,0.5,1,1,0,1,0,0,1,0,1,1,0,1,0,1,0,0,"https://fbref.com/en/players/51fa3fed/Vincent-Marcel"
2018,"Nice","Ligue 1","Marlon","BRA","DF","21",1995,21.4,36,26,22,13,1,15,22,68.2,7,19,15,4,15,51,72,2,"https://fbref.com/en/players/cdf65d12/Marlon"
2018,"Nice","Ligue 1","Nampalys Mendy","SEN","MF","25",1992,10.7,13,6,8,5,0,5,17,29.4,12,9,1,8,13,26,10,1,"https://fbref.com/en/players/1598599e/Nampalys-Mendy"
2018,"Nice","Ligue 1","Romain Perraud","FRA","FW","19",1997,0,0,0,0,0,0,0,0,NA,0,0,0,0,0,0,0,0,"https://fbref.com/en/players/6dfd8f05/Romain-Perraud"
2018,"Nice","Ligue 1","Alassane Pléa","FRA","FW","24",1993,33.8,15,9,5,7,3,5,32,15.6,27,14,3,11,8,23,21,0,"https://fbref.com/en/players/bc6bd723/Alassane-Plea"
2018,"Nice","Ligue 1","Ihsan Sacko","FRA","FW,MF","20",1997,2.9,1,1,0,1,0,0,1,0,1,1,0,1,2,3,1,0,"https://fbref.com/en/players/68a87d66/Ihsan-Sacko"
2018,"Nice","Ligue 1","Allan Saint-Maximin","FRA","FW,MF","20",1997,25,18,14,13,2,3,12,28,42.9,16,12,1,11,11,29,10,0,"https://fbref.com/en/players/2b16cb1a/Allan-Saint-Maximin"
2018,"Nice","Ligue 1","Malang Sarr","FRA","DF","18",1999,14.7,24,18,17,7,0,8,18,44.4,10,14,6,8,31,55,44,2,"https://fbref.com/en/players/4315f30d/Malang-Sarr"
2018,"Nice","Ligue 1","Jean Seri","CIV","MF","26",1991,29.1,25,14,9,12,4,9,56,16.1,47,16,4,12,26,51,15,4,"https://fbref.com/en/players/10efd0e1/Jean-Seri"
2018,"Nice","Ligue 1","Wesley Sneijder","NED","MF,FW","33",1984,4.4,0,0,0,0,0,0,3,0,3,1,0,1,2,2,2,1,"https://fbref.com/en/players/ad625c12/Wesley-Sneijder"
2018,"Nice","Ligue 1","Arnaud Souquet","FRA","DF","25",1992,26.8,89,68,58,26,5,36,56,64.3,20,46,16,30,39,128,72,2,"https://fbref.com/en/players/4e0afc5d/Arnaud-Souquet"
2018,"Nice","Ligue 1","Bassem Srarfi","TUN","FW,MF","20",1997,9.7,17,11,6,9,2,4,14,28.6,10,12,0,12,7,24,6,1,"https://fbref.com/en/players/84549a07/Bassem-Srarfi"
2018,"Nice","Ligue 1","Adrien Tameze","CMR","MF","23",1994,18.7,58,36,32,21,5,26,47,55.3,21,26,5,21,41,99,22,1,"https://fbref.com/en/players/8da74c05/Adrien-Tameze"
2018,"Nice","Ligue 1","Rémi Walter","FRA","MF,FW","22",1995,5.5,11,7,4,6,1,3,7,42.9,4,2,1,1,5,16,3,0,"https://fbref.com/en/players/0984c5d5/Remi-Walter"
2018,"Paris S-G","Ligue 1","Yacine Adli","FRA","FW","17",2000,0.1,0,0,0,0,0,0,0,NA,0,0,0,0,0,0,0,0,"https://fbref.com/en/players/26777636/Yacine-Adli"
2018,"Paris S-G","Ligue 1","Dani Alves","BRA","DF","34",1983,22.9,80,57,45,27,8,33,58,56.9,25,24,3,21,28,108,21,0,"https://fbref.com/en/players/c9e99e49/Dani-Alves"
2018,"Paris S-G","Ligue 1","Alphonse Areola","FRA","GK","24",1993,34,0,0,0,0,0,0,1,0,1,0,0,0,0,0,7,4,"https://fbref.com/en/players/2f965a72/Alphonse-Areola"
2018,"Paris S-G","Ligue 1","Yuri Berchiche","ESP","DF","27",1990,19.1,39,27,21,11,7,12,25,48,13,15,2,13,24,63,53,0,"https://fbref.com/en/players/b6e50615/Yuri-Berchiche"
2018,"Paris S-G","Ligue 1","Edinson Cavani","URU","FW","30",1987,28.7,15,9,5,4,6,2,16,12.5,14,10,1,9,5,20,22,0,"https://fbref.com/en/players/527f063d/Edinson-Cavani"
2018,"Paris S-G","Ligue 1","Ángel Di María","ARG","FW","29",1988,23.5,13,10,5,3,5,7,39,17.9,32,18,2,16,10,23,8,0,"https://fbref.com/en/players/19cda00b/Angel-Di-Maria"
2018,"Paris S-G","Ligue 1","Lassana Diarra","FRA","MF","32",1985,6.7,12,4,4,7,1,8,12,66.7,4,3,1,2,6,18,6,0,"https://fbref.com/en/players/79584585/Lassana-Diarra"
2018,"Paris S-G","Ligue 1","Julian Draxler","GER","MF,FW","23",1993,18.9,20,14,4,13,3,6,32,18.8,26,18,2,16,28,48,8,0,"https://fbref.com/en/players/1a992676/Julian-Draxler"
2018,"Paris S-G","Ligue 1","Gonçalo Guedes","POR","FW","20",1996,0.1,0,0,0,0,0,0,0,NA,0,0,0,0,0,0,0,0,"https://fbref.com/en/players/e6bc67d7/Goncalo-Guedes"
2018,"Paris S-G","Ligue 1","Presnel Kimpembe","FRA","DF","21",1995,26.9,39,28,20,18,1,9,14,64.3,5,17,10,7,24,63,80,1,"https://fbref.com/en/players/aef6e670/Presnel-Kimpembe"
2018,"Paris S-G","Ligue 1","Layvin Kurzawa","FRA","DF","24",1992,18.9,44,32,20,15,9,15,39,38.5,24,16,3,13,35,79,41,2,"https://fbref.com/en/players/41e7ef1c/Layvin-Kurzawa"
2018,"Paris S-G","Ligue 1","Giovani Lo Celso","ARG","MF","21",1996,19.7,77,58,26,36,15,26,74,35.1,48,30,5,25,19,96,12,1,"https://fbref.com/en/players/d7553721/Giovani-Lo-Celso"
2018,"Paris S-G","Ligue 1","Marquinhos","BRA","DF","23",1994,25.1,28,14,14,14,0,13,21,61.9,8,36,22,14,14,42,114,2,"https://fbref.com/en/players/d5f2f82b/Marquinhos"
2018,"Paris S-G","Ligue 1","Blaise Matuidi","FRA","MF","30",1987,0.3,1,1,1,0,0,0,0,NA,0,2,1,1,0,1,0,0,"https://fbref.com/en/players/c0cddebe/Blaise-Matuidi"
2018,"Paris S-G","Ligue 1","Kylian Mbappé","FRA","FW","18",1998,23.3,11,8,3,3,5,1,13,7.7,12,4,1,3,0,11,1,0,"https://fbref.com/en/players/42fd9c7f/Kylian-Mbappe"
2018,"Paris S-G","Ligue 1","Thomas Meunier","BEL","DF","25",1991,17.5,38,21,22,12,4,18,34,52.9,16,7,2,5,18,56,54,2,"https://fbref.com/en/players/e162b013/Thomas-Meunier"
2018,"Paris S-G","Ligue 1","Thiago Motta","ITA","MF","34",1982,12.8,28,21,14,11,3,8,24,33.3,16,15,6,9,21,49,26,1,"https://fbref.com/en/players/57ef0d97/Thiago-Motta"
2018,"Paris S-G","Ligue 1","Lucas Moura","BRA","FW","24",1992,0.8,1,1,0,1,0,0,1,0,1,0,0,0,0,1,0,0,"https://fbref.com/en/players/2b622f01/Lucas-Moura"
2018,"Paris S-G","Ligue 1","Stanley N'Soki","FRA","DF","18",1999,0.3,0,0,0,0,0,0,1,0,1,0,0,0,0,0,1,0,"https://fbref.com/en/players/61590953/Stanley-NSoki"
2018,"Paris S-G","Ligue 1","Neymar","BRA","FW","25",1992,19.8,20,14,3,11,6,7,40,17.5,33,4,0,4,5,25,2,0,"https://fbref.com/en/players/69384e5d/Neymar"
2018,"Paris S-G","Ligue 1","Christopher Nkunku","FRA","FW,MF","19",1997,7,5,2,2,2,1,3,14,21.4,11,8,2,6,5,10,2,1,"https://fbref.com/en/players/7c56da38/Christopher-Nkunku"
2018,"Paris S-G","Ligue 1","Javier Pastore","ARG","MF,FW","28",1989,15,33,21,9,16,8,5,23,21.7,18,13,0,13,10,43,14,1,"https://fbref.com/en/players/881ef58c/Javier-Pastore"
2018,"Paris S-G","Ligue 1","Adrien Rabiot","FRA","MF","22",1995,26.2,59,36,27,23,9,15,36,41.7,21,29,10,19,33,92,22,1,"https://fbref.com/en/players/8794e251/Adrien-Rabiot"
2018,"Paris S-G","Ligue 1","Kévin Rimane","GUF","DF","26",1991,0.1,0,0,0,0,0,0,0,NA,0,0,0,0,0,0,0,0,"https://fbref.com/en/players/7a137df4/Kevin-Rimane"
2018,"Paris S-G","Ligue 1","Thiago Silva","BRA","DF","32",1984,23.5,31,23,19,12,0,12,21,57.1,9,28,18,10,18,49,114,0,"https://fbref.com/en/players/86e7deaf/Thiago-Silva"
2018,"Paris S-G","Ligue 1","Kevin Trapp","GER","GK","27",1990,4,0,0,0,0,0,0,0,NA,0,0,0,0,0,0,1,0,"https://fbref.com/en/players/ce17b5eb/Kevin-Trapp"
2018,"Paris S-G","Ligue 1","Marco Verratti","ITA","MF","24",1992,19.1,51,33,20,25,6,12,55,21.8,43,25,6,19,26,77,11,3,"https://fbref.com/en/players/1467af0d/Marco-Verratti"
2018,"Paris S-G","Ligue 1","Timothy Weah","USA","FW","17",2000,1.4,1,1,1,0,0,1,1,100,0,0,0,0,0,1,0,0,"https://fbref.com/en/players/8eec784d/Timothy-Weah"
2018,"RB Leipzig","Bundesliga","Jean-Kévin Augustin","FRA","FW","20",1997,14.1,16,11,4,11,1,3,7,42.9,4,17,1,16,4,20,4,0,"https://fbref.com/en/players/97bfa797/Jean-Kevin-Augustin"
2018,"RB Leipzig","Bundesliga","Bernardo","BRA","DF","22",1995,15,43,30,18,22,3,29,40,72.5,11,30,6,24,18,61,81,0,"https://fbref.com/en/players/17370b95/Bernardo"
2018,"RB Leipzig","Bundesliga","Bruma","POR","MF,FW","22",1994,17.9,18,16,7,7,4,9,18,50,9,28,2,26,12,30,11,0,"https://fbref.com/en/players/5caa62a7/Bruma"
2018,"RB Leipzig","Bundesliga","Marvin Compper","GER","DF","32",1985,1,2,2,0,2,0,2,3,66.7,1,2,2,0,0,2,8,0,"https://fbref.com/en/players/3e99c613/Marvin-Compper"
2018,"RB Leipzig","Bundesliga","Diego Demme","GER","MF","25",1991,25.4,81,57,29,48,4,47,87,54,40,31,3,28,48,129,29,0,"https://fbref.com/en/players/dc3fa3b5/Diego-Demme"
2018,"RB Leipzig","Bundesliga","Emil Forsberg","SWE","MF","25",1991,15.2,24,17,3,15,6,9,21,42.9,12,19,1,18,8,32,4,0,"https://fbref.com/en/players/9a2e0ccc/Emil-Forsberg"
2018,"RB Leipzig","Bundesliga","Péter Gulácsi","HUN","GK","27",1990,33,0,0,0,0,0,0,2,0,2,0,0,0,0,0,12,4,"https://fbref.com/en/players/bcb2ccd8/Peter-Gulacsi"
2018,"RB Leipzig","Bundesliga","Marcel Halstenberg","GER","DF","25",1991,13.1,29,19,16,9,4,15,19,78.9,4,15,1,14,23,52,42,1,"https://fbref.com/en/players/8ff2354e/Marcel-Halstenberg"
2018,"RB Leipzig","Bundesliga","Stefan Ilsanker","AUT","DF,MF","28",1989,14.3,37,29,23,11,3,22,39,56.4,17,23,10,13,25,62,55,1,"https://fbref.com/en/players/8494acc4/Stefan-Ilsanker"
2018,"RB Leipzig","Bundesliga","Dominik Kaiser","GER","MF,FW","28",1988,3.1,5,5,1,3,1,4,11,36.4,7,6,0,6,1,6,8,0,"https://fbref.com/en/players/733fecf1/Dominik-Kaiser"
2018,"RB Leipzig","Bundesliga","Kevin Kampl","SVN","MF","26",1990,22.4,42,33,16,20,6,16,39,41,23,37,2,35,33,75,33,0,"https://fbref.com/en/players/b825a650/Kevin-Kampl"
2018,"RB Leipzig","Bundesliga","Naby Keïta","GUI","MF","22",1995,21.8,65,48,25,33,7,17,43,39.5,26,26,3,23,36,101,18,0,"https://fbref.com/en/players/f25c8e3a/Naby-Keita"
2018,"RB Leipzig","Bundesliga","Lukas Klostermann","GER","DF","21",1996,24.3,56,41,34,18,4,28,37,75.7,9,33,6,27,33,89,79,0,"https://fbref.com/en/players/ca8033cb/Lukas-Klostermann"
2018,"RB Leipzig","Bundesliga","Ibrahima Konaté","FRA","DF","18",1999,13.6,32,25,20,12,0,18,23,78.3,5,14,3,11,20,52,66,0,"https://fbref.com/en/players/5ed9b537/Ibrahima-Konate"
2018,"RB Leipzig","Bundesliga","Konrad Laimer","AUT","DF,MF","20",1997,14.9,57,39,31,22,4,28,57,49.1,29,37,2,35,11,68,32,0,"https://fbref.com/en/players/c1b7847c/Konrad-Laimer"
2018,"RB Leipzig","Bundesliga","Ademola Lookman","NGA","MF,FW","19",1997,6.4,5,4,2,3,0,0,0,NA,0,3,0,3,2,7,2,0,"https://fbref.com/en/players/7c104bb7/Ademola-Lookman"
2018,"RB Leipzig","Bundesliga","Yvon Mvogo","SUI","GK","23",1994,1,0,0,0,0,0,0,0,NA,0,0,0,0,0,0,1,1,"https://fbref.com/en/players/dc29b608/Yvon-Mvogo"
2018,"RB Leipzig","Bundesliga","Willi Orban","HUN","DF","24",1992,23.6,49,30,35,14,0,29,43,67.4,14,45,18,27,28,77,155,1,"https://fbref.com/en/players/20030c06/Willi-Orban"
2018,"RB Leipzig","Bundesliga","Yussuf Poulsen","DEN","FW","23",1994,18.5,23,19,2,13,8,7,12,58.3,5,24,5,19,9,32,8,0,"https://fbref.com/en/players/d2416c2e/Yussuf-Poulsen"
2018,"RB Leipzig","Bundesliga","Marcel Sabitzer","AUT","MF,FW","23",1994,19.9,38,28,12,20,6,23,49,46.9,26,23,2,21,24,62,21,1,"https://fbref.com/en/players/e280527c/Marcel-Sabitzer"
2018,"RB Leipzig","Bundesliga","Benno Schmitz","GER","DF","22",1994,0.9,3,2,2,1,0,2,3,66.7,1,0,0,0,0,3,1,0,"https://fbref.com/en/players/ad00b1a8/Benno-Schmitz"
2018,"RB Leipzig","Bundesliga","Dayot Upamecano","FRA","DF","18",1998,25.2,57,43,36,17,4,31,45,68.9,14,32,9,23,55,112,141,1,"https://fbref.com/en/players/d248cd8f/Dayot-Upamecano"
2018,"RB Leipzig","Bundesliga","Timo Werner","GER","FW","21",1996,27.7,16,11,2,8,6,3,19,15.8,16,26,0,26,7,23,11,0,"https://fbref.com/en/players/49fe9070/Timo-Werner"
2018,"Real Madrid","La Liga","Marco Asensio","ESP","FW,MF","21",1996,20.5,26,17,7,13,6,11,26,42.3,15,15,0,15,9,35,2,0,"https://fbref.com/en/players/45af8a54/Marco-Asensio"
2018,"Real Madrid","La Liga","Gareth Bale","WAL","FW,MF","28",1989,20,19,13,7,8,4,3,14,21.4,11,13,1,12,12,31,18,0,"https://fbref.com/en/players/a58bb1e1/Gareth-Bale"
2018,"Real Madrid","La Liga","Karim Benzema","FRA","FW","29",1987,23.9,14,8,2,6,6,3,20,15,17,18,0,18,8,22,19,0,"https://fbref.com/en/players/70d74ece/Karim-Benzema"
2018,"Real Madrid","La Liga","Dani Carvajal","ESP","DF","25",1992,24.7,59,40,27,22,10,22,38,57.9,16,33,15,18,38,97,42,2,"https://fbref.com/en/players/4958bfb2/Dani-Carvajal"
2018,"Real Madrid","La Liga","Casemiro","BRA","MF","25",1992,28.8,109,78,64,39,6,42,84,50,42,56,11,45,63,172,49,3,"https://fbref.com/en/players/4d224fe8/Casemiro"
2018,"Real Madrid","La Liga","Kiko Casilla","ESP","GK","30",1986,10,1,0,1,0,0,1,1,100,0,0,0,0,2,3,6,2,"https://fbref.com/en/players/58bc7d18/Kiko-Casilla"
2018,"Real Madrid","La Liga","Dani Ceballos","ESP","MF","20",1996,4.5,8,7,3,2,3,4,16,25,12,6,0,6,5,13,1,0,"https://fbref.com/en/players/c0617e2b/Dani-Ceballos"
2018,"Real Madrid","La Liga","Achraf Hakimi","MAR","DF","18",1998,8.4,21,15,9,6,6,11,25,44,14,9,1,8,10,31,19,1,"https://fbref.com/en/players/e42d61c7/Achraf-Hakimi"
2018,"Real Madrid","La Liga","Theo Hernández","FRA","DF","19",1997,10.7,21,15,16,2,3,13,25,52,12,9,2,7,17,38,20,0,"https://fbref.com/en/players/d4c9725f/Theo-Hernandez"
2018,"Real Madrid","La Liga","Isco","ESP","MF","25",1992,19.7,22,12,5,10,7,5,35,14.3,30,11,0,11,15,37,2,0,"https://fbref.com/en/players/a0b4bb3e/Isco"
2018,"Real Madrid","La Liga","Mateo Kovačić","CRO","MF","23",1994,11,37,27,19,18,0,8,27,29.6,19,9,4,5,5,42,5,0,"https://fbref.com/en/players/79c0821a/Mateo-Kovacic"
2018,"Real Madrid","La Liga","Toni Kroos","GER","MF","27",1990,25.1,55,35,19,29,7,22,59,37.3,37,20,2,18,16,71,10,1,"https://fbref.com/en/players/6ce1f46f/Toni-Kroos"
2018,"Real Madrid","La Liga","Marcos Llorente","ESP","MF","22",1995,6.1,15,8,7,8,0,6,11,54.5,5,7,0,7,5,20,8,0,"https://fbref.com/en/players/02c15616/Marcos-Llorente"
2018,"Real Madrid","La Liga","Marcelo","BRA","DF","29",1988,25.1,53,37,19,23,11,22,58,37.9,36,26,2,24,30,83,23,2,"https://fbref.com/en/players/603116a7/Marcelo"
2018,"Real Madrid","La Liga","Borja Mayoral","ESP","FW,MF","20",1997,3.8,6,3,0,4,2,1,5,20,4,3,0,3,0,6,0,0,"https://fbref.com/en/players/64e8ed6d/Borja-Mayoral"
2018,"Real Madrid","La Liga","Luka Modrić","CRO","MF","31",1985,21.9,33,22,14,15,4,15,41,36.6,26,13,4,9,31,64,7,0,"https://fbref.com/en/players/6025fab1/Luka-Modric"
2018,"Real Madrid","La Liga","Nacho","ESP","DF","27",1990,23,55,40,29,19,7,20,38,52.6,18,21,9,12,46,101,51,0,"https://fbref.com/en/players/2946f9a1/Nacho"
2018,"Real Madrid","La Liga","Keylor Navas","CRC","GK","30",1986,27,2,1,2,0,0,1,1,100,0,0,0,0,3,5,10,2,"https://fbref.com/en/players/ecada4fc/Keylor-Navas"
2018,"Real Madrid","La Liga","Sergio Ramos","ESP","DF","31",1986,25.4,40,29,22,18,0,19,28,67.9,9,22,12,10,47,87,91,0,"https://fbref.com/en/players/08511d65/Sergio-Ramos"
2018,"Real Madrid","La Liga","Cristiano Ronaldo","POR","FW","32",1985,25.4,7,4,3,3,1,1,6,16.7,5,10,3,7,6,13,14,0,"https://fbref.com/en/players/dea698d9/Cristiano-Ronaldo"
2018,"Real Madrid","La Liga","Jesús Vallejo","ESP","DF","20",1997,7,8,7,6,2,0,2,5,40,3,6,5,1,16,24,21,1,"https://fbref.com/en/players/c2111b45/Jesus-Vallejo"
2018,"Real Madrid","La Liga","Raphaël Varane","FRA","DF","24",1993,25.8,28,19,20,7,1,8,15,53.3,7,27,10,17,33,61,109,2,"https://fbref.com/en/players/9f8e9423/Raphael-Varane"
2018,"Real Madrid","La Liga","Lucas Vázquez","ESP","MF,FW","26",1991,18.7,48,33,16,21,11,12,42,28.6,30,28,2,26,7,55,9,0,"https://fbref.com/en/players/fd51b456/Lucas-Vazquez"
2018,"Real Madrid","La Liga","Luca Zidane","FRA","GK","19",1998,1,0,0,0,0,0,0,1,0,1,0,0,0,0,0,0,0,"https://fbref.com/en/players/c818c4d9/Luca-Zidane"
2018,"Real Sociedad","La Liga","Imanol Agirretxe","ESP","FW","30",1987,2.6,0,0,0,0,0,0,1,0,1,0,0,0,0,0,2,0,"https://fbref.com/en/players/c84c1afc/Imanol-Agirretxe"
2018,"Real Sociedad","La Liga","Miguel Ángel Moyá","ESP","GK","33",1984,8.5,0,0,0,0,0,0,1,0,1,0,0,0,2,2,7,0,"https://fbref.com/en/players/011d8c56/Miguel-Angel-Moya"
2018,"Real Sociedad","La Liga","Jon Bautista","ESP","FW,MF","22",1995,2,0,0,0,0,0,0,1,0,1,2,0,2,0,0,0,0,"https://fbref.com/en/players/debc6b55/Jon-Bautista"
2018,"Real Sociedad","La Liga","Sergio Canales","ESP","MF,FW","26",1991,21.4,30,24,6,18,6,9,32,28.1,23,25,0,25,11,41,3,0,"https://fbref.com/en/players/a6de370d/Sergio-Canales"
2018,"Real Sociedad","La Liga","Aritz Elustondo","ESP","DF","23",1994,17.7,32,20,20,9,3,19,30,63.3,11,20,7,13,45,77,84,0,"https://fbref.com/en/players/f7dc2ae5/Aritz-Elustondo"
2018,"Real Sociedad","La Liga","Andoni Gorosabel","ESP","DF","20",1996,0.8,3,2,1,2,0,2,5,40,3,1,0,1,4,7,1,0,"https://fbref.com/en/players/6f5f82c0/Andoni-Gorosabel"
2018,"Real Sociedad","La Liga","Jon Guridi","ESP","MF","22",1995,0.6,1,0,1,0,0,0,1,0,1,1,0,1,0,1,0,0,"https://fbref.com/en/players/4c0a6a48/Jon-Guridi"
2018,"Real Sociedad","La Liga","Asier Illarramendi","ESP","MF","27",1990,35.1,85,57,35,41,9,37,90,41.1,53,44,8,36,75,160,35,0,"https://fbref.com/en/players/5ce0b5ba/Asier-Illarramendi"
2018,"Real Sociedad","La Liga","Adnan Januzaj","BEL","FW","22",1995,17.5,16,11,2,8,6,5,18,27.8,13,12,0,12,11,27,5,0,"https://fbref.com/en/players/4737cebe/Adnan-Januzaj"
2018,"Real Sociedad","La Liga","Willian José","BRA","FW","25",1991,30.8,10,7,1,5,4,2,9,22.2,7,10,1,9,5,15,31,0,"https://fbref.com/en/players/d87e2cae/Willian-Jose"
2018,"Real Sociedad","La Liga","Juanmi","ESP","FW,MF","24",1993,16.5,22,13,7,12,3,4,22,18.2,18,11,0,11,10,32,6,0,"https://fbref.com/en/players/84399660/Juanmi"
2018,"Real Sociedad","La Liga","Alberto de la Bella","ESP","DF","31",1985,17,36,22,25,10,1,16,28,57.1,12,19,5,14,21,57,54,0,"https://fbref.com/en/players/8497faf7/Alberto-de-la-Bella"
2018,"Real Sociedad","La Liga","Diego Llorente","ESP","DF","23",1993,25.8,30,22,16,13,1,18,29,62.1,11,41,18,23,43,73,96,0,"https://fbref.com/en/players/bba30585/Diego-Llorente"
2018,"Real Sociedad","La Liga","Carlos Martínez","ESP","DF","31",1986,0,0,0,0,0,0,0,0,NA,0,0,0,0,0,0,0,0,"https://fbref.com/en/players/d9b0cc38/Carlos-Martinez"
2018,"Real Sociedad","La Liga","Iñigo Martínez","ESP","DF","26",1991,11.7,14,9,9,4,1,5,11,45.5,6,9,4,5,23,37,55,0,"https://fbref.com/en/players/3fc45c73/Inigo-Martinez"
2018,"Real Sociedad","La Liga","Héctor Moreno","MEX","DF","29",1988,8,7,3,7,0,0,5,7,71.4,2,3,3,0,10,17,17,0,"https://fbref.com/en/players/5d311e8d/Hector-Moreno"
2018,"Real Sociedad","La Liga","Raúl Navas","ESP","DF","29",1988,19.9,22,15,18,4,0,14,26,53.8,12,23,13,10,30,52,73,0,"https://fbref.com/en/players/ad178594/Raul-Navas"
2018,"Real Sociedad","La Liga","Álvaro Odriozola","ESP","DF","21",1995,32.4,41,27,22,15,4,20,35,57.1,15,25,7,18,26,67,50,0,"https://fbref.com/en/players/1d1691ad/Alvaro-Odriozola"
2018,"Real Sociedad","La Liga","Mikel Oyarzabal","ESP","FW,MF","20",1997,30.8,33,23,10,13,10,7,39,17.9,32,32,2,30,18,51,19,0,"https://fbref.com/en/players/8c3c640c/Mikel-Oyarzabal"
2018,"Real Sociedad","La Liga","Rubén Pardo","ESP","MF","24",1992,2.5,1,0,0,1,0,1,2,50,1,5,0,5,5,6,1,0,"https://fbref.com/en/players/2306bfde/Ruben-Pardo"
2018,"Real Sociedad","La Liga","Xabi Prieto","ESP","MF,FW","33",1983,21.4,18,14,5,9,4,2,10,20,8,8,2,6,7,25,20,0,"https://fbref.com/en/players/d054d8b0/Xabi-Prieto"
2018,"Real Sociedad","La Liga","Toño Ramírez","ESP","GK","30",1986,3.5,0,0,0,0,0,0,1,0,1,0,0,0,0,0,1,3,"https://fbref.com/en/players/dc4511f3/Tono-Ramirez"
2018,"Real Sociedad","La Liga","Kévin Rodrigues","POR","DF","23",1994,18.2,44,32,18,20,6,19,34,55.9,15,22,6,16,27,71,39,0,"https://fbref.com/en/players/f1bed920/Kevin-Rodrigues"
2018,"Real Sociedad","La Liga","Gerónimo Rulli","ARG","GK","25",1992,26,2,1,2,0,0,2,6,33.3,4,0,0,0,0,2,10,2,"https://fbref.com/en/players/625c144a/Geronimo-Rulli"
2018,"Real Sociedad","La Liga","Carlos Vela","MEX","FW","28",1989,4.2,12,7,5,3,4,6,7,85.7,1,2,0,2,0,12,1,0,"https://fbref.com/en/players/e0cd04e0/Carlos-Vela"
2018,"Real Sociedad","La Liga","Igor Zubeldia","ESP","MF","20",1997,17.6,39,29,17,16,6,14,42,33.3,28,20,5,15,32,71,31,0,"https://fbref.com/en/players/5c7845f6/Igor-Zubeldia"
2018,"Real Sociedad","La Liga","David Zurutuza","ESP","MF","31",1986,24.9,49,36,22,25,2,20,49,40.8,29,32,10,22,41,90,24,1,"https://fbref.com/en/players/d9bda115/David-Zurutuza"
2018,"Rennes","Ligue 1","Morgan Amalfitano","FRA","MF,FW","32",1985,8.3,8,5,3,3,2,2,5,40,3,6,0,6,4,12,7,0,"https://fbref.com/en/players/ab914649/Morgan-Amalfitano"
2018,"Rennes","Ligue 1","Benjamin André","FRA","MF","26",1990,33.5,93,54,36,50,7,43,113,38.1,70,56,4,52,57,150,96,1,"https://fbref.com/en/players/ef9c1c95/Benjamin-Andre"
2018,"Rennes","Ligue 1","Ludovic Baal","GUF","DF","31",1986,12.9,41,27,29,8,4,13,35,37.1,22,13,2,11,15,56,37,1,"https://fbref.com/en/players/d3ce9f1f/Ludovic-Baal"
2018,"Rennes","Ligue 1","Ramy Bensebaini","ALG","DF","22",1995,26,56,39,31,21,4,26,55,47.3,29,24,16,8,37,93,177,1,"https://fbref.com/en/players/378825c7/Ramy-Bensebaini"
2018,"Rennes","Ligue 1","Benjamin Bourigeaud","FRA","MF,FW","23",1994,34.5,55,30,18,30,7,20,93,21.5,73,48,4,44,45,100,29,0,"https://fbref.com/en/players/20e73fac/Benjamin-Bourigeaud"
2018,"Rennes","Ligue 1","Brandon","ESP","FW,MF","22",1995,4,10,9,3,4,3,1,11,9.1,10,11,1,10,5,15,1,0,"https://fbref.com/en/players/3e016e5a/Brandon"
2018,"Rennes","Ligue 1","Romain Danzé","FRA","DF","31",1986,7.6,12,7,3,4,5,8,13,61.5,5,11,2,9,3,15,34,0,"https://fbref.com/en/players/a5876fca/Romain-Danze"
2018,"Rennes","Ligue 1","Abdoulaye Diallo","SEN","GK","25",1992,3,0,0,0,0,0,0,0,NA,0,0,0,0,0,0,4,1,"https://fbref.com/en/players/26383ea5/Abdoulaye-Diallo"
2018,"Rennes","Ligue 1","Afonso Figueiredo","POR","DF,FW","24",1993,2.5,6,3,3,3,0,3,5,60,2,0,0,0,0,6,4,0,"https://fbref.com/en/players/f51edbf3/Afonso-Figueiredo"
2018,"Rennes","Ligue 1","Jérémy Gélin","FRA","DF,MF","20",1997,25.7,37,18,22,14,1,20,53,37.7,33,22,12,10,37,74,92,3,"https://fbref.com/en/players/4c700f46/Jeremy-Gelin"
2018,"Rennes","Ligue 1","Joris Gnagnon","FRA","DF","20",1997,32.4,42,29,29,9,4,21,31,67.7,10,22,16,6,29,71,154,2,"https://fbref.com/en/players/1232e1dc/Joris-Gnagnon"
2018,"Rennes","Ligue 1","Yoann Gourcuff","FRA","MF,FW","31",1986,4.7,7,5,1,3,3,0,2,0,2,5,0,5,2,9,2,0,"https://fbref.com/en/players/3acddfdd/Yoann-Gourcuff"
2018,"Rennes","Ligue 1","Adrien Hunou","FRA","FW,MF","23",1994,16.2,27,15,11,8,8,11,42,26.2,31,22,1,21,9,36,8,1,"https://fbref.com/en/players/d14229f3/Adrien-Hunou"
2018,"Rennes","Ligue 1","Nicolas Janvier","FRA","MF","18",1998,0.8,4,1,1,1,2,1,2,50,1,1,0,1,1,5,0,0,"https://fbref.com/en/players/22a62523/Nicolas-Janvier"
2018,"Rennes","Ligue 1","Wahbi Khazri","TUN","FW,MF","26",1991,21.3,26,18,7,10,9,7,39,17.9,32,29,0,29,7,33,7,0,"https://fbref.com/en/players/2677a1de/Wahbi-Khazri"
2018,"Rennes","Ligue 1","Tomáš Koubek","CZE","GK","24",1992,34,0,0,0,0,0,0,1,0,1,0,0,0,3,3,22,3,"https://fbref.com/en/players/dc366c36/Tomas-Koubek"
2018,"Rennes","Ligue 1","James Lea Siliki","CMR","MF","21",1996,20.2,31,21,9,19,3,6,41,14.6,35,21,1,20,18,49,14,1,"https://fbref.com/en/players/7cf431a5/James-Lea-Siliki"
2018,"Rennes","Ligue 1","Raïs M'Bolhi","ALG","GK","31",1986,1,0,0,0,0,0,0,1,0,1,0,0,0,0,0,0,0,"https://fbref.com/en/players/c121a641/Rais-MBolhi"
2018,"Rennes","Ligue 1","Faitout Maouassa","FRA","MF,FW","19",1998,9.9,6,3,2,3,1,2,10,20,8,12,2,10,6,12,5,0,"https://fbref.com/en/players/e54a9890/Faitout-Maouassa"
2018,"Rennes","Ligue 1","Mexer","MOZ","DF","28",1988,13.3,15,12,9,6,0,9,12,75,3,13,7,6,16,31,98,2,"https://fbref.com/en/players/ce492295/Mexer"
2018,"Rennes","Ligue 1","Ndombe Mubele","COD","FW,MF","23",1994,13.6,14,8,5,6,3,5,13,38.5,8,9,0,9,3,17,3,0,"https://fbref.com/en/players/176674ab/Ndombe-Mubele"
2018,"Rennes","Ligue 1","Gerzino Nyamsi","FRA","DF","20",1997,3,4,2,4,0,0,0,3,0,3,2,2,0,3,7,18,2,"https://fbref.com/en/players/6043997c/Gerzino-Nyamsi"
2018,"Rennes","Ligue 1","Sanjin Prcić","BIH","MF","23",1993,17.4,37,18,9,24,4,8,39,20.5,31,19,5,14,30,67,25,0,"https://fbref.com/en/players/51c30111/Sanjin-Prcic"
2018,"Rennes","Ligue 1","Diafra Sakho","SEN","FW","27",1989,8.6,5,4,1,2,2,0,7,0,7,4,0,4,2,7,11,0,"https://fbref.com/en/players/57c433c8/Diafra-Sakho"
2018,"Rennes","Ligue 1","Ismaila Sarr","SEN","FW,MF","19",1998,20.6,20,10,5,10,5,7,29,24.1,22,17,0,17,9,29,3,1,"https://fbref.com/en/players/bfdb33aa/Ismaila-Sarr"
2018,"Rennes","Ligue 1","Jordan Tell","FRA","FW,MF","20",1997,1.3,4,4,1,3,0,0,1,0,1,0,0,0,1,5,0,0,"https://fbref.com/en/players/4f093689/Jordan-Tell"
2018,"Rennes","Ligue 1","Hamari Traoré","MLI","DF","25",1992,29.3,79,55,43,31,5,41,66,62.1,25,31,12,19,61,140,117,0,"https://fbref.com/en/players/a4b1028a/Hamari-Traore"
2018,"Rennes","Ligue 1","Mehdi Zeffane","ALG","DF,MF","25",1992,11,17,12,10,5,2,9,25,36,16,10,2,8,12,29,44,0,"https://fbref.com/en/players/c8c02ac7/Mehdi-Zeffane"
2018,"Roma","Serie A","Alisson","BRA","GK","24",1992,37,1,0,1,0,0,0,1,0,1,0,0,0,2,3,22,4,"https://fbref.com/en/players/7a2e46a8/Alisson"
2018,"Roma","Serie A","Mirko Antonucci","ITA","FW","18",1999,0.3,0,0,0,0,0,0,0,NA,0,0,0,0,0,0,0,0,"https://fbref.com/en/players/91976866/Mirko-Antonucci"
2018,"Roma","Serie A","Elio Capradossi","ITA","DF","21",1996,0.9,1,0,1,0,0,0,0,NA,0,2,2,0,2,3,13,0,"https://fbref.com/en/players/174944a3/Elio-Capradossi"
2018,"Roma","Serie A","Daniele De Rossi","ITA","MF","34",1983,20.3,23,13,12,9,2,9,33,27.3,24,18,13,5,43,66,45,2,"https://fbref.com/en/players/532d2690/Daniele-De-Rossi"
2018,"Roma","Serie A","Grégoire Defrel","MTQ","FW,MF","26",1991,5.4,8,3,1,1,6,2,8,25,6,5,0,5,3,11,6,0,"https://fbref.com/en/players/854ee61a/Gregoire-Defrel"
2018,"Roma","Serie A","Edin Džeko","BIH","FW","31",1986,33.5,15,10,1,9,5,3,15,20,12,9,1,8,4,19,36,0,"https://fbref.com/en/players/3bb7f478/Edin-Dzeko"
2018,"Roma","Serie A","Federico Fazio","ARG","DF","30",1987,32.5,56,43,38,18,0,25,31,80.6,6,30,22,8,46,102,161,3,"https://fbref.com/en/players/4e358a2d/Federico-Fazio"
2018,"Roma","Serie A","Alessandro Florenzi","ITA","DF","26",1991,26.5,38,28,20,13,5,18,47,38.3,29,19,8,11,44,82,62,1,"https://fbref.com/en/players/e288d4b3/Alessandro-Florenzi"
2018,"Roma","Serie A","Gerson","BRA","MF,FW","20",1997,10.1,20,12,10,8,2,2,7,28.6,5,15,2,13,11,31,11,1,"https://fbref.com/en/players/8827bf46/Gerson"
2018,"Roma","Serie A","Maxime Gonalons","FRA","MF","28",1989,12.2,26,18,7,12,7,9,23,39.1,14,15,4,11,23,49,19,1,"https://fbref.com/en/players/b8c1de25/Maxime-Gonalons"
2018,"Roma","Serie A","Juan Jesus","BRA","DF","26",1991,18.4,42,30,25,15,2,18,34,52.9,16,18,9,9,39,81,63,0,"https://fbref.com/en/players/79083382/Juan-Jesus"
2018,"Roma","Serie A","Rick Karsdorp","NED","DF","22",1995,0.9,1,1,1,0,0,0,0,NA,0,0,0,0,1,2,0,0,"https://fbref.com/en/players/9f84febe/Rick-Karsdorp"
2018,"Roma","Serie A","Aleksandar Kolarov","SRB","DF","31",1985,34,58,47,34,16,8,27,49,55.1,22,24,7,17,53,111,100,2,"https://fbref.com/en/players/eda40760/Aleksandar-Kolarov"
2018,"Roma","Serie A","Kostas Manolas","GRE","DF","26",1991,26,23,20,14,7,2,9,15,60,6,31,24,7,46,69,133,2,"https://fbref.com/en/players/c707411f/Kostas-Manolas"
2018,"Roma","Serie A","Héctor Moreno","MEX","DF","29",1988,2.6,2,2,1,1,0,0,1,0,1,1,1,0,3,5,5,0,"https://fbref.com/en/players/5d311e8d/Hector-Moreno"
2018,"Roma","Serie A","Radja Nainggolan","BEL","MF","29",1988,29,49,36,14,28,7,9,33,27.3,24,18,1,17,18,67,31,1,"https://fbref.com/en/players/1f9328da/Radja-Nainggolan"
2018,"Roma","Serie A","Emerson Palmieri","ITA","DF","22",1994,0.2,0,0,0,0,0,0,0,NA,0,0,0,0,0,0,0,0,"https://fbref.com/en/players/e0bc6fdc/Emerson-Palmieri"
2018,"Roma","Serie A","Lorenzo Pellegrini","ITA","MF","21",1996,20,36,20,16,11,9,10,35,28.6,25,21,2,19,41,77,21,1,"https://fbref.com/en/players/4a5a45c7/Lorenzo-Pellegrini"
2018,"Roma","Serie A","Bruno Peres","BRA","DF","27",1990,12.8,26,17,16,7,3,10,23,43.5,13,9,2,7,22,48,28,1,"https://fbref.com/en/players/852351df/Bruno-Peres"
2018,"Roma","Serie A","Diego Perotti","ARG","FW,MF","29",1988,17.9,25,17,6,14,5,8,20,40,12,19,0,19,11,36,13,0,"https://fbref.com/en/players/a40d5a0c/Diego-Perotti"
2018,"Roma","Serie A","Patrik Schick","CZE","FW,MF","21",1996,11,9,7,1,5,3,1,9,11.1,8,14,0,14,2,11,11,0,"https://fbref.com/en/players/5d4f7d61/Patrik-Schick"
2018,"Roma","Serie A","Stephan El Shaarawy","ITA","FW","24",1992,23.9,22,16,9,8,5,5,21,23.8,16,16,1,15,24,46,8,0,"https://fbref.com/en/players/d3aaad90/Stephan-El-Shaarawy"
2018,"Roma","Serie A","Jonathan Silva","ARG","DF","23",1994,1.2,0,0,0,0,0,0,1,0,1,1,1,0,3,3,1,0,"https://fbref.com/en/players/f2308b33/Jonathan-Silva"
2018,"Roma","Serie A","Łukasz Skorupski","POL","GK","26",1991,1,0,0,0,0,0,0,0,NA,0,0,0,0,0,0,1,0,"https://fbref.com/en/players/ab4449d6/Lukasz-Skorupski"
2018,"Roma","Serie A","Kevin Strootman","NED","MF","27",1990,25.1,57,38,19,24,14,15,46,32.6,31,27,3,24,27,84,21,0,"https://fbref.com/en/players/ef2e5e1a/Kevin-Strootman"
2018,"Roma","Serie A","Marco Tumminello","ITA","FW","18",1998,0,0,0,0,0,0,0,0,NA,0,0,0,0,0,0,0,0,"https://fbref.com/en/players/5bdd44d8/Marco-Tumminello"
2018,"Roma","Serie A","Cengiz Ünder","TUR","FW","20",1997,13.9,10,6,4,6,0,3,18,16.7,15,8,1,7,9,19,10,0,"https://fbref.com/en/players/1880614f/Cengiz-Under"
2018,"SPAL","Serie A","Mirco Antenucci","ITA","FW","32",1984,28.6,16,13,6,8,2,0,21,0,21,14,0,14,11,27,15,0,"https://fbref.com/en/players/43a2e16c/Mirco-Antenucci"
2018,"SPAL","Serie A","Federico Bonazzoli","ITA","FW,DF","20",1997,2,1,0,0,1,0,0,0,NA,0,3,0,3,0,1,0,0,"https://fbref.com/en/players/bf57eaab/Federico-Bonazzoli"
2018,"SPAL","Serie A","Marco Borriello","ITA","FW","35",1982,8.6,4,2,2,1,1,0,1,0,1,1,0,1,1,5,6,0,"https://fbref.com/en/players/a889ffc7/Marco-Borriello"
2018,"SPAL","Serie A","Thiago Cionek","POL","DF","31",1986,15,28,21,18,6,4,11,20,55,9,19,9,10,35,63,99,0,"https://fbref.com/en/players/46f5c54d/Thiago-Cionek"
2018,"SPAL","Serie A","Filippo Costa","ITA","DF","22",1995,16.4,19,12,7,7,5,7,17,41.2,10,23,6,17,22,41,50,0,"https://fbref.com/en/players/00528660/Filippo-Costa"
2018,"SPAL","Serie A","Michele Cremonesi","ITA","DF","29",1988,4.3,4,2,2,2,0,1,4,25,3,5,3,2,7,11,28,0,"https://fbref.com/en/players/53636fce/Michele-Cremonesi"
2018,"SPAL","Serie A","Felipe dal Belo","BRA","DF","33",1984,28.6,51,34,32,16,3,25,49,51,24,42,24,18,48,99,157,1,"https://fbref.com/en/players/8cea6319/Felipe-dal-Belo"
2018,"SPAL","Serie A","Boukary Dramé","SEN","DF,MF","32",1985,1.1,1,1,1,0,0,0,0,NA,0,0,0,0,2,3,4,0,"https://fbref.com/en/players/a5cd894b/Boukary-Drame"
2018,"SPAL","Serie A","Sergio Floccari","ITA","FW","35",1981,9.8,13,9,7,5,1,6,11,54.5,5,6,1,5,2,15,6,0,"https://fbref.com/en/players/df301450/Sergio-Floccari"
2018,"SPAL","Serie A","Alfred Gomis","SEN","GK","23",1993,25.1,0,0,0,0,0,0,1,0,1,0,0,0,1,1,10,3,"https://fbref.com/en/players/cecbce23/Alfred-Gomis"
2018,"SPAL","Serie A","Alberto Grassi","ITA","MF","22",1995,25,44,33,22,12,10,16,35,45.7,19,27,8,19,47,91,55,0,"https://fbref.com/en/players/6cc97b6a/Alberto-Grassi"
2018,"SPAL","Serie A","Jasmin Kurtić","SVN","MF,FW","28",1989,16,28,18,13,11,4,5,21,23.8,16,13,1,12,17,45,25,0,"https://fbref.com/en/players/144607cc/Jasmin-Kurtic"
2018,"SPAL","Serie A","Manuel Lazzari","ITA","DF","23",1993,34.6,61,47,33,21,7,27,62,43.5,35,32,7,25,31,92,73,2,"https://fbref.com/en/players/02caf6e0/Manuel-Lazzari"
2018,"SPAL","Serie A","Everton Luiz","BRA","MF","29",1988,7.1,22,16,10,10,2,6,29,20.7,23,8,1,7,10,32,8,1,"https://fbref.com/en/players/3799e138/Everton-Luiz"
2018,"SPAL","Serie A","Gabriele Marchegiani","ITA","GK","21",1996,0,0,0,0,0,0,0,0,NA,0,0,0,0,0,0,0,0,"https://fbref.com/en/players/8cf63012/Gabriele-Marchegiani"
2018,"SPAL","Serie A","Federico Mattiello","ITA","DF","22",1995,24.5,59,40,31,22,6,21,44,47.7,23,53,15,38,64,123,66,0,"https://fbref.com/en/players/fba81826/Federico-Mattiello"
2018,"SPAL","Serie A","Alex Meret","ITA","GK","20",1997,12.9,0,0,0,0,0,0,1,0,1,0,0,0,0,0,5,0,"https://fbref.com/en/players/9413b19f/Alex-Meret"
2018,"SPAL","Serie A","Luca Mora","ITA","MF","29",1988,10.4,19,17,6,8,5,5,17,29.4,12,9,3,6,4,23,20,0,"https://fbref.com/en/players/42fff925/Luca-Mora"
2018,"SPAL","Serie A","Marios Oikonomou","GRE","DF","24",1992,1.9,5,3,4,1,0,0,2,0,2,0,0,0,4,9,12,0,"https://fbref.com/en/players/3b9858f5/Marios-Oikonomou"
2018,"SPAL","Serie A","Alberto Paloschi","ITA","FW","27",1990,24.3,10,7,0,9,1,0,10,0,10,2,1,1,4,14,11,0,"https://fbref.com/en/players/b5cae4e6/Alberto-Paloschi"
2018,"SPAL","Serie A","Luca Rizzo","ITA","MF","25",1992,5.4,18,10,7,10,1,5,17,29.4,12,10,0,10,3,21,5,1,"https://fbref.com/en/players/a3e4b724/Luca-Rizzo"
2018,"SPAL","Serie A","Bartosz Salamon","POL","DF","26",1991,19.2,28,22,21,7,0,12,21,57.1,9,24,18,6,58,86,148,0,"https://fbref.com/en/players/9b30df1e/Bartosz-Salamon"
2018,"SPAL","Serie A","Pasquale Schiattarella","ITA","MF","30",1987,22.1,40,31,20,15,5,13,43,30.2,30,7,2,5,24,64,26,0,"https://fbref.com/en/players/bd84fc61/Pasquale-Schiattarella"
2018,"SPAL","Serie A","Eros Schiavon","ITA","MF,DF","34",1983,4.3,6,5,2,3,1,1,7,14.3,6,6,2,4,2,8,4,0,"https://fbref.com/en/players/c4f97172/Eros-Schiavon"
2018,"SPAL","Serie A","Lorenco Šimić","CRO","DF","21",1996,3.5,5,3,5,0,0,3,4,75,1,7,4,3,11,16,15,0,"https://fbref.com/en/players/65e4dede/Lorenco-Simic"
2018,"SPAL","Serie A","Sauli Väisänen","FIN","DF","23",1994,6,12,9,9,3,0,6,8,75,2,5,4,1,13,25,26,0,"https://fbref.com/en/players/23214a49/Sauli-Vaisanen"
2018,"SPAL","Serie A","Francesco Vicari","ITA","DF","22",1994,31.7,38,22,25,13,0,21,39,53.8,18,33,27,6,45,83,210,1,"https://fbref.com/en/players/de045b15/Francesco-Vicari"
2018,"SPAL","Serie A","Mattia Vitale","ITA","MF,FW","19",1997,1.1,2,1,2,0,0,0,0,NA,0,1,0,1,3,5,1,0,"https://fbref.com/en/players/8e4b894b/Mattia-Vitale"
2018,"SPAL","Serie A","Federico Viviani","ITA","MF","25",1992,27.6,52,36,23,26,3,18,55,32.7,37,39,9,30,58,110,26,2,"https://fbref.com/en/players/2258c078/Federico-Viviani"
2018,"Saint-Étienne","Ligue 1","Jonathan Bamba","FRA","FW","21",1996,28.6,30,21,18,11,1,12,61,19.7,49,30,4,26,19,49,17,0,"https://fbref.com/en/players/b2bd0f6c/Jonathan-Bamba"
2018,"Saint-Étienne","Ligue 1","Robert Berić","SVN","FW","26",1991,11.6,6,4,1,3,2,1,16,6.3,15,9,1,8,5,11,4,0,"https://fbref.com/en/players/9001138b/Robert-Beric"
2018,"Saint-Étienne","Ligue 1","Rémy Cabella","FRA","MF,FW","27",1990,25.1,58,39,29,22,7,17,73,23.3,56,31,0,31,14,72,4,2,"https://fbref.com/en/players/148e136f/Remy-Cabella"
2018,"Saint-Étienne","Ligue 1","Bryan Dabo","BFA","MF,FW","25",1992,14.3,25,16,12,10,3,7,29,24.1,22,12,1,11,11,36,22,0,"https://fbref.com/en/players/c53083ad/Bryan-Dabo"
2018,"Saint-Étienne","Ligue 1","Mathieu Debuchy","FRA","DF","32",1985,14.6,34,25,22,8,4,17,30,56.7,13,16,10,6,27,61,73,0,"https://fbref.com/en/players/92232aad/Mathieu-Debuchy"
2018,"Saint-Étienne","Ligue 1","Lois Diony","FRA","FW","24",1992,10.3,3,0,1,2,0,0,3,0,3,5,1,4,1,4,8,0,"https://fbref.com/en/players/4be0b467/Lois-Diony"
2018,"Saint-Étienne","Ligue 1","Assane Dioussé","SEN","MF","19",1997,14.9,32,21,14,14,4,13,34,38.2,21,29,2,27,11,43,16,2,"https://fbref.com/en/players/7f622eef/Assane-Diousse"
2018,"Saint-Étienne","Ligue 1","Vagner Gonçalves","CPV","FW","21",1996,1.2,0,0,0,0,0,0,3,0,3,2,0,2,0,0,0,0,"https://fbref.com/en/players/743fd71f/Vagner-Goncalves"
2018,"Saint-Étienne","Ligue 1","Romain Hamouma","FRA","FW","30",1987,20.5,19,13,7,6,6,1,22,4.5,21,15,4,11,13,32,8,1,"https://fbref.com/en/players/0b4d8274/Romain-Hamouma"
2018,"Saint-Étienne","Ligue 1","Hernani","BRA","MF,FW","23",1994,6,21,13,9,9,3,10,22,45.5,12,15,2,13,6,27,5,0,"https://fbref.com/en/players/6f5ead86/Hernani"
2018,"Saint-Étienne","Ligue 1","Saidy Janko","GAM","DF","21",1995,15.8,43,30,25,14,4,14,24,58.3,10,21,1,20,14,57,50,0,"https://fbref.com/en/players/689c9cf4/Saidy-Janko"
2018,"Saint-Étienne","Ligue 1","Léo Lacroix","SUI","DF","25",1992,8.6,13,8,8,5,0,5,9,55.6,4,6,3,3,11,24,54,1,"https://fbref.com/en/players/5984e9f9/Leo-Lacroix"
2018,"Saint-Étienne","Ligue 1","Cheikh M'Bengue","SEN","DF","29",1988,5.4,8,4,8,0,0,4,4,100,0,6,4,2,8,16,22,1,"https://fbref.com/en/players/88fdac8b/Cheikh-MBengue"
2018,"Saint-Étienne","Ligue 1","Yann M'Vila","FRA","MF","27",1990,16.4,26,16,11,12,3,7,24,29.2,17,13,1,12,31,57,56,0,"https://fbref.com/en/players/d4133fa1/Yann-MVila"
2018,"Saint-Étienne","Ligue 1","Habib Maïga","CIV","MF,DF","21",1996,7.9,29,18,16,10,3,12,30,40,18,8,4,4,19,48,10,0,"https://fbref.com/en/players/e768de1f/Habib-Maiga"
2018,"Saint-Étienne","Ligue 1","Kévin Monnet-Paquet","FRA","FW,MF","28",1988,19.6,33,25,9,19,5,11,48,22.9,37,15,2,13,13,46,23,1,"https://fbref.com/en/players/4a57580c/Kevin-Monnet-Paquet"
2018,"Saint-Étienne","Ligue 1","Jessy Moulin","FRA","GK","31",1986,3.4,0,0,0,0,0,0,0,NA,0,0,0,0,0,0,3,2,"https://fbref.com/en/players/28a65a2c/Jessy-Moulin"
2018,"Saint-Étienne","Ligue 1","Paul-Georges Ntep","CMR","FW,MF","25",1992,5.7,14,8,8,5,1,8,17,47.1,9,4,1,3,3,17,4,0,"https://fbref.com/en/players/81aeb1dd/Paul-Georges-Ntep"
2018,"Saint-Étienne","Ligue 1","Vincent Pajot","FRA","MF","26",1990,14.3,24,16,9,13,2,3,17,17.6,14,21,9,12,24,48,34,0,"https://fbref.com/en/players/f86ca403/Vincent-Pajot"
2018,"Saint-Étienne","Ligue 1","Loïc Perrin","FRA","DF","31",1985,27.4,39,26,28,10,1,21,31,67.7,10,35,22,13,36,75,142,1,"https://fbref.com/en/players/6b200d45/Loic-Perrin"
2018,"Saint-Étienne","Ligue 1","Ronaël Pierre-Gabriel","FRA","DF","19",1998,13,43,31,33,7,3,17,28,60.7,11,11,2,9,9,52,35,0,"https://fbref.com/en/players/64ba07c0/Ronael-Pierre-Gabriel"
2018,"Saint-Étienne","Ligue 1","Florentin Pogba","GUI","DF","26",1990,3.6,6,0,4,2,0,3,5,60,2,2,2,0,1,7,12,0,"https://fbref.com/en/players/1e23a224/Florentin-Pogba"
2018,"Saint-Étienne","Ligue 1","Stéphane Ruffier","FRA","GK","30",1986,34.6,0,0,0,0,0,0,0,NA,0,0,0,0,0,0,14,1,"https://fbref.com/en/players/cac76a72/Stephane-Ruffier"
2018,"Saint-Étienne","Ligue 1","Ole Selnæs","NOR","MF","23",1994,22.9,73,45,29,42,2,18,61,29.5,43,37,15,22,34,107,53,1,"https://fbref.com/en/players/4db2157a/Ole-Selnaes"
2018,"Saint-Étienne","Ligue 1","Gabriel Silva","BRA","DF","26",1991,23.1,28,20,19,4,5,19,31,61.3,12,21,6,15,37,65,83,1,"https://fbref.com/en/players/4914ed4a/Gabriel-Silva"
2018,"Saint-Étienne","Ligue 1","Rayan Souici","FRA","MF","19",1998,0.1,0,0,0,0,0,0,0,NA,0,1,0,1,0,0,0,0,"https://fbref.com/en/players/e3ad3368/Rayan-Souici"
2018,"Saint-Étienne","Ligue 1","Neven Subotić","SRB","DF","28",1988,16,23,14,16,7,0,10,27,37,17,13,9,4,18,41,96,1,"https://fbref.com/en/players/821233cc/Neven-Subotic"
2018,"Saint-Étienne","Ligue 1","Alexander Søderlund","NOR","FW","29",1987,4,1,1,1,0,0,0,2,0,2,1,0,1,2,3,2,0,"https://fbref.com/en/players/e61d33f1/Alexander-Soderlund"
2018,"Saint-Étienne","Ligue 1","Oussama Tannane","MAR","FW","23",1994,2.3,12,6,4,5,3,2,5,40,3,2,0,2,3,15,2,0,"https://fbref.com/en/players/730bd100/Oussama-Tannane"
2018,"Saint-Étienne","Ligue 1","Kévin Théophile-Catherine","FRA","DF","27",1989,24.1,36,27,23,13,0,11,24,45.8,13,19,15,4,31,67,113,1,"https://fbref.com/en/players/6b994195/Kevin-Theophile-Catherine"
2018,"Sampdoria","Serie A","Ricky Álvarez","ARG","MF","29",1988,3,4,2,1,3,0,1,4,25,3,5,0,5,2,6,3,0,"https://fbref.com/en/players/92a5ac34/Ricky-Alvarez"
2018,"Sampdoria","Serie A","Joachim Andersen","DEN","DF","21",1996,6.1,8,3,6,2,0,4,4,100,0,6,4,2,9,17,41,1,"https://fbref.com/en/players/e34fc66d/Joachim-Andersen"
2018,"Sampdoria","Serie A","Édgar Barreto","PAR","MF","33",1984,21.8,67,42,23,32,12,18,70,25.7,52,45,2,43,21,88,29,3,"https://fbref.com/en/players/43a1bea5/Edgar-Barreto"
2018,"Sampdoria","Serie A","Vid Belec","SVN","GK","27",1990,2,0,0,0,0,0,0,0,NA,0,0,0,0,0,0,1,0,"https://fbref.com/en/players/4f8ce0e1/Vid-Belec"
2018,"Sampdoria","Serie A","Bartosz Bereszyński","POL","DF","25",1992,27.6,63,47,30,28,5,31,53,58.5,22,33,8,25,30,93,98,2,"https://fbref.com/en/players/61b3978f/Bartosz-Bereszynski"
2018,"Sampdoria","Serie A","Federico Bonazzoli","ITA","FW","20",1997,0.3,0,0,0,0,0,0,0,NA,0,0,0,0,0,0,0,0,"https://fbref.com/en/players/bf57eaab/Federico-Bonazzoli"
2018,"Sampdoria","Serie A","Leonardo Capezzi","ITA","MF","22",1995,2.4,8,4,5,3,0,4,6,66.7,2,6,0,6,0,8,3,0,"https://fbref.com/en/players/07ea0ef2/Leonardo-Capezzi"
2018,"Sampdoria","Serie A","Gianluca Caprari","ITA","FW,MF","24",1993,20.1,19,11,2,11,6,0,10,0,10,25,2,23,5,24,3,0,"https://fbref.com/en/players/54e53b7e/Gianluca-Caprari"
2018,"Sampdoria","Serie A","Dawid Kownacki","POL","FW","20",1997,9.1,8,7,1,4,3,3,11,27.3,8,7,0,7,1,9,5,0,"https://fbref.com/en/players/be5e1c4c/Dawid-Kownacki"
2018,"Sampdoria","Serie A","Karol Linetty","POL","MF","22",1995,23.8,66,49,25,31,10,17,77,22.1,60,40,2,38,18,84,13,0,"https://fbref.com/en/players/d023d70f/Karol-Linetty"
2018,"Sampdoria","Serie A","Gian Marco Ferrari","ITA","DF","25",1992,29.4,12,8,8,4,0,5,10,50,5,42,38,4,31,43,149,4,"https://fbref.com/en/players/8650af85/Gian-Marco-Ferrari"
2018,"Sampdoria","Serie A","Nicola Murru","ITA","DF","22",1994,16.1,40,31,18,18,4,24,38,63.2,14,29,4,25,17,57,60,1,"https://fbref.com/en/players/d183e9d6/Nicola-Murru"
2018,"Sampdoria","Serie A","Daniel Pavlović","BIH","DF","29",1988,1,3,1,1,1,1,1,1,100,0,0,0,0,0,3,5,0,"https://fbref.com/en/players/47146acb/Daniel-Pavlovic"
2018,"Sampdoria","Serie A","Dennis Praet","BEL","MF","23",1994,29.5,85,57,34,36,15,38,73,52.1,35,49,1,48,37,122,22,0,"https://fbref.com/en/players/86695068/Dennis-Praet"
2018,"Sampdoria","Serie A","Christian Puggioni","ITA","GK","36",1981,9,0,0,0,0,0,0,0,NA,0,0,0,0,0,0,6,1,"https://fbref.com/en/players/b39dfab0/Christian-Puggioni"
2018,"Sampdoria","Serie A","Fabio Quagliarella","ITA","FW","34",1983,30.2,11,9,1,3,7,2,25,8,23,34,0,34,7,18,23,0,"https://fbref.com/en/players/ee4f2f3b/Fabio-Quagliarella"
2018,"Sampdoria","Serie A","Gastón Ramírez","URU","MF","26",1990,24.6,33,20,4,15,14,9,56,16.1,47,30,3,27,18,51,24,0,"https://fbref.com/en/players/2c851997/Gaston-Ramirez"
2018,"Sampdoria","Serie A","Vasco Regini","ITA","DF","26",1990,12,13,7,11,0,2,6,11,54.5,5,14,7,7,11,24,68,0,"https://fbref.com/en/players/339c6ed4/Vasco-Regini"
2018,"Sampdoria","Serie A","Jacopo Sala","ITA","DF","25",1991,11,17,10,12,4,1,4,10,40,6,9,1,8,8,25,28,2,"https://fbref.com/en/players/da5a981b/Jacopo-Sala"
2018,"Sampdoria","Serie A","Matías Silvestre","ARG","DF","32",1984,34,12,8,10,1,1,6,12,50,6,33,26,7,11,23,154,3,"https://fbref.com/en/players/b6ca47a2/Matias-Silvestre"
2018,"Sampdoria","Serie A","Ognjen Stijepović","MNE","FW,MF","17",1999,0.1,0,0,0,0,0,0,0,NA,0,0,0,0,0,0,0,0,"https://fbref.com/en/players/80ad4216/Ognjen-Stijepovic"
2018,"Sampdoria","Serie A","Ivan Strinić","CRO","DF","30",1987,13.9,35,24,22,12,1,17,38,44.7,21,21,2,19,22,57,46,2,"https://fbref.com/en/players/52e2ef8f/Ivan-Strinic"
2018,"Sampdoria","Serie A","Lucas Torreira","URU","MF","21",1996,35.3,101,73,36,57,8,30,77,39,47,52,17,35,72,173,36,1,"https://fbref.com/en/players/52611641/Lucas-Torreira"
2018,"Sampdoria","Serie A","Valerio Verre","ITA","MF","23",1994,4,7,3,3,2,2,2,7,28.6,5,12,0,12,8,15,7,0,"https://fbref.com/en/players/33ecf462/Valerio-Verre"
2018,"Sampdoria","Serie A","Emiliano Viviano","ITA","GK","31",1985,27,0,0,0,0,0,0,0,NA,0,0,0,0,2,2,10,4,"https://fbref.com/en/players/03760df0/Emiliano-Viviano"
2018,"Sampdoria","Serie A","Duván Zapata","COL","FW","26",1991,23.4,12,7,1,7,4,1,6,16.7,5,13,0,13,5,17,22,1,"https://fbref.com/en/players/d3de9af0/Duvan-Zapata"
2018,"Sampdoria","Serie A","Filip Đuričić","SRB","MF","25",1992,0.1,0,0,0,0,0,0,1,0,1,0,0,0,0,0,0,0,"https://fbref.com/en/players/eccbe56a/Filip-Djuricic"
2018,"Sassuolo","Serie A","Francesco Acerbi","ITA","DF","29",1988,38,51,32,26,22,3,22,36,61.1,14,42,21,21,88,139,255,1,"https://fbref.com/en/players/b96b595c/Francesco-Acerbi"
2018,"Sassuolo","Serie A","Claud Adjapong","ITA","DF,FW","19",1998,13.6,35,26,24,5,6,11,13,84.6,2,16,3,13,23,58,37,0,"https://fbref.com/en/players/ce5b170a/Claud-Adjapong"
2018,"Sassuolo","Serie A","Khouma Babacar","SEN","FW","24",1993,8.3,10,6,2,4,4,2,6,33.3,4,8,0,8,3,13,1,0,"https://fbref.com/en/players/422ec08a/Khouma-Babacar"
2018,"Sassuolo","Serie A","Domenico Berardi","ITA","FW","22",1994,25.5,31,17,9,16,6,11,65,16.9,54,23,0,23,17,48,14,1,"https://fbref.com/en/players/53a0e358/Domenico-Berardi"
2018,"Sassuolo","Serie A","Davide Biondini","ITA","MF","34",1983,2.3,4,4,2,2,0,1,2,50,1,1,0,1,3,7,1,0,"https://fbref.com/en/players/b4c3070a/Davide-Biondini"
2018,"Sassuolo","Serie A","Paolo Cannavaro","ITA","DF","36",1981,16,17,9,11,5,1,8,20,40,12,17,13,4,27,44,94,1,"https://fbref.com/en/players/46ed55b6/Paolo-Cannavaro"
2018,"Sassuolo","Serie A","Francesco Cassata","ITA","MF","20",1997,5.1,12,7,6,5,1,2,10,20,8,3,0,3,5,17,0,0,"https://fbref.com/en/players/96960855/Francesco-Cassata"
2018,"Sassuolo","Serie A","Andrea Consigli","ITA","GK","30",1987,36.8,0,0,0,0,0,0,2,0,2,0,0,0,0,0,27,6,"https://fbref.com/en/players/8cabdc1e/Andrea-Consigli"
2018,"Sassuolo","Serie A","Cristian Dell'Orco","ITA","DF","23",1994,4.7,4,1,1,2,1,1,3,33.3,2,5,1,4,10,14,19,0,"https://fbref.com/en/players/b0243215/Cristian-DellOrco"
2018,"Sassuolo","Serie A","Alfred Duncan","GHA","MF","24",1993,21.6,39,29,16,18,5,15,52,28.8,37,32,2,30,19,58,29,1,"https://fbref.com/en/players/528492ea/Alfred-Duncan"
2018,"Sassuolo","Serie A","Diego Falcinelli","ITA","FW","26",1991,14.6,4,4,1,2,1,1,13,7.7,12,12,2,10,2,6,9,0,"https://fbref.com/en/players/a39b9ef6/Diego-Falcinelli"
2018,"Sassuolo","Serie A","Marcello Gazzola","ITA","DF","32",1985,8.2,10,9,3,6,1,8,12,66.7,4,10,2,8,8,18,25,0,"https://fbref.com/en/players/93390969/Marcello-Gazzola"
2018,"Sassuolo","Serie A","Edoardo Goldaniga","ITA","DF","23",1993,12.8,14,8,10,4,0,5,9,55.6,4,10,5,5,19,33,56,0,"https://fbref.com/en/players/4b029b31/Edoardo-Goldaniga"
2018,"Sassuolo","Serie A","Mauricio Lemos","URU","DF","21",1995,7.8,11,9,8,3,0,7,14,50,7,10,5,5,9,20,33,1,"https://fbref.com/en/players/dbe5a587/Mauricio-Lemos"
2018,"Sassuolo","Serie A","Timo Letschert","NED","DF","24",1993,4.6,13,8,10,3,0,5,8,62.5,3,9,3,6,7,20,23,0,"https://fbref.com/en/players/be9938ed/Timo-Letschert"
2018,"Sassuolo","Serie A","Pol Lirola","ESP","DF,FW","19",1997,22.5,34,21,26,6,2,20,35,57.1,15,11,4,7,28,62,88,1,"https://fbref.com/en/players/ff800ed8/Pol-Lirola"
2018,"Sassuolo","Serie A","Francesco Magnanelli","ITA","MF","32",1984,27.7,56,38,30,20,6,20,65,30.8,45,26,7,19,58,114,78,2,"https://fbref.com/en/players/07767f42/Francesco-Magnanelli"
2018,"Sassuolo","Serie A","Alessandro Matri","ITA","FW","32",1984,10.2,2,1,1,1,0,0,3,0,3,1,0,1,0,2,5,0,"https://fbref.com/en/players/58d97e77/Alessandro-Matri"
2018,"Sassuolo","Serie A","Luca Mazzitelli","ITA","MF","21",1995,11.3,37,24,14,15,8,10,36,27.8,26,21,2,19,21,58,19,0,"https://fbref.com/en/players/dc61b402/Luca-Mazzitelli"
2018,"Sassuolo","Serie A","Simone Missiroli","ITA","MF","31",1986,32.4,62,37,25,31,6,14,72,19.4,58,46,8,38,67,129,70,0,"https://fbref.com/en/players/331c0a43/Simone-Missiroli"
2018,"Sassuolo","Serie A","Gianluca Pegolo","ITA","GK","36",1981,1.2,0,0,0,0,0,0,0,NA,0,0,0,0,0,0,0,0,"https://fbref.com/en/players/f058ed1f/Gianluca-Pegolo"
2018,"Sassuolo","Serie A","Federico Peluso","ITA","DF","33",1984,28.8,46,34,29,13,4,14,26,53.8,12,39,13,26,40,86,132,1,"https://fbref.com/en/players/4f2908e5/Federico-Peluso"
2018,"Sassuolo","Serie A","Nicholas Pierini","ITA","MF,FW","18",1998,0.5,1,1,0,0,1,0,0,NA,0,1,0,1,1,2,0,0,"https://fbref.com/en/players/7cc89a5f/Nicholas-Pierini"
2018,"Sassuolo","Serie A","Matteo Politano","ITA","FW","23",1993,31.2,23,16,8,10,5,3,32,9.4,29,13,2,11,14,37,13,0,"https://fbref.com/en/players/5e861944/Matteo-Politano"
2018,"Sassuolo","Serie A","Antonino Ragusa","ITA","FW,MF","27",1990,9.2,17,7,11,4,2,8,23,34.8,15,12,1,11,6,23,16,0,"https://fbref.com/en/players/e967e202/Antonino-Ragusa"
2018,"Sassuolo","Serie A","Rogério","BRA","DF","19",1998,10.1,18,14,10,5,3,7,15,46.7,8,11,1,10,9,27,31,0,"https://fbref.com/en/players/10e7f486/Rogerio"
2018,"Sassuolo","Serie A","Gianluca Scamacca","ITA","FW,MF","18",1999,0.3,0,0,0,0,0,0,0,NA,0,1,0,1,0,0,0,0,"https://fbref.com/en/players/8790f988/Gianluca-Scamacca"
2018,"Sassuolo","Serie A","Stefano Sensi","ITA","MF","21",1995,11.6,17,13,11,6,0,9,22,40.9,13,16,3,13,22,39,10,1,"https://fbref.com/en/players/b70bde8f/Stefano-Sensi"
2018,"Schalke 04","Bundesliga","Nabil Bentaleb","ALG","MF","22",1994,11.2,25,22,7,17,1,8,23,34.8,15,18,6,12,23,48,27,2,"https://fbref.com/en/players/3189f61a/Nabil-Bentaleb"
2018,"Schalke 04","Bundesliga","Guido Burgstaller","AUT","FW","28",1989,25.8,14,9,0,10,4,4,14,28.6,10,28,3,25,10,24,9,0,"https://fbref.com/en/players/2bcc6d52/Guido-Burgstaller"
2018,"Schalke 04","Bundesliga","Daniel Caligiuri","ITA","DF,MF","29",1988,32.4,100,66,48,43,9,49,94,52.1,45,59,4,55,67,167,71,0,"https://fbref.com/en/players/d1273f09/Daniel-Caligiuri"
2018,"Schalke 04","Bundesliga","Coke","ESP","MF","30",1987,0,0,0,0,0,0,0,0,NA,0,0,0,0,0,0,0,0,"https://fbref.com/en/players/6d8f8441/Coke"
2018,"Schalke 04","Bundesliga","Franco Di Santo","ARG","FW,MF","28",1989,18.4,17,13,3,13,1,7,15,46.7,8,12,1,11,2,19,24,0,"https://fbref.com/en/players/549c6ba7/Franco-Di-Santo"
2018,"Schalke 04","Bundesliga","Breel Embolo","SUI","FW,MF","20",1997,10.2,14,10,3,7,4,2,9,22.2,7,13,0,13,6,20,3,0,"https://fbref.com/en/players/0b4f388a/Breel-Embolo"
2018,"Schalke 04","Bundesliga","Ralf Fährmann","GER","GK","28",1988,33.5,1,0,1,0,0,1,3,33.3,2,1,0,1,1,2,12,7,"https://fbref.com/en/players/1e43fad8/Ralf-Fahrmann"
2018,"Schalke 04","Bundesliga","Leon Goretzka","GER","MF","22",1995,22,50,34,22,22,6,14,50,28,36,45,4,41,41,91,35,0,"https://fbref.com/en/players/cc86b9a3/Leon-Goretzka"
2018,"Schalke 04","Bundesliga","Amine Harit","MAR","MF,FW","20",1997,22.7,39,27,11,21,7,13,37,35.1,24,23,0,23,19,58,11,0,"https://fbref.com/en/players/e7d59f4f/Amine-Harit"
2018,"Schalke 04","Bundesliga","Pablo Insua","ESP","DF","23",1993,0.3,0,0,0,0,0,0,0,NA,0,1,1,0,0,0,1,0,"https://fbref.com/en/players/4b5e7e90/Pablo-Insua"
2018,"Schalke 04","Bundesliga","Thilo Kehrer","GER","DF","20",1996,26.3,81,64,41,36,4,46,68,67.6,22,42,12,30,35,116,113,2,"https://fbref.com/en/players/51dbeea9/Thilo-Kehrer"
2018,"Schalke 04","Bundesliga","Yevhen Konoplyanka","UKR","FW,MF","27",1989,17.4,11,9,3,4,4,3,11,27.3,8,18,1,17,5,16,6,0,"https://fbref.com/en/players/d9a5d930/Yevhen-Konoplyanka"
2018,"Schalke 04","Bundesliga","Weston McKennie","USA","MF","18",1998,14,36,23,11,21,4,13,32,40.6,19,16,2,14,20,56,32,0,"https://fbref.com/en/players/01c3aff5/Weston-McKennie"
2018,"Schalke 04","Bundesliga","Max Meyer","GER","MF","21",1995,19.2,48,38,23,21,4,19,47,40.4,28,25,3,22,54,102,11,0,"https://fbref.com/en/players/eba42d2b/Max-Meyer"
2018,"Schalke 04","Bundesliga","Naldo","BRA","DF","34",1982,34,51,36,38,12,1,31,46,67.4,15,39,21,18,55,106,200,1,"https://fbref.com/en/players/03bd0bf4/Naldo"
2018,"Schalke 04","Bundesliga","Matija Nastasić","SRB","DF","24",1993,22.1,48,38,37,10,1,28,37,75.7,9,40,22,18,36,84,85,0,"https://fbref.com/en/players/f35430a4/Matija-Nastasic"
2018,"Schalke 04","Bundesliga","Alexander Nübel","GER","GK","20",1996,0.5,0,0,0,0,0,0,0,NA,0,0,0,0,0,0,0,0,"https://fbref.com/en/players/afb0c500/Alexander-Nubel"
2018,"Schalke 04","Bundesliga","Bastian Oczipka","GER","DF,MF","28",1989,25.8,60,48,29,26,5,29,37,78.4,8,41,2,39,40,100,40,1,"https://fbref.com/en/players/d1661819/Bastian-Oczipka"
2018,"Schalke 04","Bundesliga","Marko Pjaca","CRO","FW,MF","22",1995,2.9,5,3,2,3,0,4,6,66.7,2,3,0,3,1,6,2,0,"https://fbref.com/en/players/2c38b327/Marko-Pjaca"
2018,"Schalke 04","Bundesliga","Baba Rahman","GHA","DF","23",1994,0.4,1,0,0,1,0,0,0,NA,0,2,0,2,2,3,1,0,"https://fbref.com/en/players/e4086af3/Baba-Rahman"
2018,"Schalke 04","Bundesliga","Fabian Reese","GER","FW,MF","19",1997,0.8,2,2,1,1,0,1,2,50,1,1,0,1,2,4,1,0,"https://fbref.com/en/players/b1823b08/Fabian-Reese"
2018,"Schalke 04","Bundesliga","Alessandro Schöpf","AUT","DF,FW","23",1994,9,22,17,10,9,3,11,23,47.8,12,16,0,16,15,37,13,1,"https://fbref.com/en/players/106bca06/Alessandro-Schopf"
2018,"Schalke 04","Bundesliga","Benjamin Stambouli","FRA","DF,MF","26",1990,24.4,95,75,45,48,2,49,74,66.2,25,39,7,32,64,159,76,1,"https://fbref.com/en/players/5939baa2/Benjamin-Stambouli"
2018,"Schalke 04","Bundesliga","Cedric Teuchert","GER","FW","20",1997,0.4,0,0,0,0,0,0,0,NA,0,1,0,1,0,0,0,0,"https://fbref.com/en/players/f956479d/Cedric-Teuchert"
2018,"Sevilla","La Liga","José Alonso Lara","ESP","MF","17",2000,0.1,0,0,0,0,0,0,0,NA,0,0,0,0,0,0,0,0,"https://fbref.com/en/players/7e28d6f7/Jose-Alonso-Lara"
2018,"Sevilla","La Liga","Guilherme Arana","BRA","DF","20",1997,2.1,4,2,3,1,0,1,1,100,0,0,0,0,5,9,8,0,"https://fbref.com/en/players/2b15a82a/Guilherme-Arana"
2018,"Sevilla","La Liga","Éver Banega","ARG","MF","29",1988,26.7,71,53,25,37,9,22,63,34.9,41,23,1,22,12,83,17,3,"https://fbref.com/en/players/fa937f7a/Ever-Banega"
2018,"Sevilla","La Liga","Wissam Ben Yedder","FRA","FW","26",1990,18.9,12,8,2,5,5,1,2,50,1,10,0,10,5,17,2,0,"https://fbref.com/en/players/942b4f90/Wissam-Ben-Yedder"
2018,"Sevilla","La Liga","Lionel Carole","FRA","DF","26",1991,6,12,6,7,5,0,5,7,71.4,2,6,3,3,6,18,29,0,"https://fbref.com/en/players/5b5724d2/Lionel-Carole"
2018,"Sevilla","La Liga","Daniel Carriço","POR","DF","28",1988,5.1,7,7,6,1,0,4,7,57.1,3,6,3,3,10,17,22,0,"https://fbref.com/en/players/e1deea75/Daniel-Carrico"
2018,"Sevilla","La Liga","Sébastien Corchia","FRA","DF","26",1990,9.1,18,13,7,8,3,9,16,56.3,7,18,4,14,16,34,20,0,"https://fbref.com/en/players/0e7ccfc4/Sebastien-Corchia"
2018,"Sevilla","La Liga","Joaquín Correa","ARG","FW","22",1994,13.3,15,10,7,6,2,8,29,27.6,21,15,1,14,2,17,12,0,"https://fbref.com/en/players/45b9b619/Joaquin-Correa"
2018,"Sevilla","La Liga","Sergio Escudero","ESP","DF","27",1989,25.9,78,49,40,26,12,32,62,51.6,30,35,6,29,66,144,69,1,"https://fbref.com/en/players/b0616e3d/Sergio-Escudero"
2018,"Sevilla","La Liga","Carlos Fernández","ESP","FW","21",1996,1.5,2,1,1,1,0,0,2,0,2,1,0,1,0,2,0,0,"https://fbref.com/en/players/e08647d6/Carlos-Fernandez"
2018,"Sevilla","La Liga","Ganso","BRA","MF","27",1989,5.8,15,11,3,12,0,3,11,27.3,8,7,0,7,2,17,4,0,"https://fbref.com/en/players/23593121/Ganso"
2018,"Sevilla","La Liga","Johannes Geis","GER","DF,MF","23",1993,7.5,20,15,12,7,1,11,21,52.4,10,13,5,8,10,30,27,1,"https://fbref.com/en/players/294450ba/Johannes-Geis"
2018,"Sevilla","La Liga","Simon Kjær","DEN","DF","28",1989,17.5,35,24,25,8,2,13,22,59.1,9,16,10,6,32,67,109,0,"https://fbref.com/en/players/8b8a56ce/Simon-Kjaer"
2018,"Sevilla","La Liga","Michael Krohn-Dehli","DEN","MF,FW","34",1983,6,13,7,4,5,4,6,11,54.5,5,5,0,5,4,17,7,0,"https://fbref.com/en/players/1c8dc17d/Michael-Krohn-Dehli"
2018,"Sevilla","La Liga","Borja Lasso","ESP","MF","23",1994,0.6,4,1,2,2,0,1,2,50,1,3,0,3,0,4,0,0,"https://fbref.com/en/players/d9faee7e/Borja-Lasso"
2018,"Sevilla","La Liga","Miguel Layún","MEX","DF","29",1988,13.2,28,19,14,12,2,17,36,47.2,19,18,4,14,15,43,44,1,"https://fbref.com/en/players/ad6295d4/Miguel-Layun"
2018,"Sevilla","La Liga","Clément Lenglet","FRA","DF","22",1995,33.3,67,50,32,35,0,21,38,55.3,17,44,27,17,35,102,157,1,"https://fbref.com/en/players/4f28a6ff/Clement-Lenglet"
2018,"Sevilla","La Liga","Gabriel Mercado","ARG","DF","30",1987,23.5,55,37,35,18,2,36,67,53.7,31,32,20,12,42,97,83,1,"https://fbref.com/en/players/bf97c188/Gabriel-Mercado"
2018,"Sevilla","La Liga","Roque Mesa","ESP","MF","28",1989,3.8,13,10,2,7,4,6,8,75,2,3,2,1,0,13,5,0,"https://fbref.com/en/players/7c4243d4/Roque-Mesa"
2018,"Sevilla","La Liga","Walter Montoya","ARG","FW","24",1993,0.8,1,1,1,0,0,1,3,33.3,2,1,0,1,0,1,3,0,"https://fbref.com/en/players/39e9c09a/Walter-Montoya"
2018,"Sevilla","La Liga","Luis Muriel","COL","FW","26",1991,17.9,16,9,2,8,6,2,23,8.7,21,16,2,14,3,19,4,1,"https://fbref.com/en/players/eb2fe5b6/Luis-Muriel"
2018,"Sevilla","La Liga","Jesús Navas","ESP","FW,DF","31",1985,19.6,32,25,17,9,6,12,26,46.2,14,14,5,9,19,51,37,0,"https://fbref.com/en/players/3f10bd22/Jesus-Navas"
2018,"Sevilla","La Liga","Nolito","ESP","FW,MF","30",1986,17.8,49,36,21,21,7,14,33,42.4,19,17,2,15,10,59,17,0,"https://fbref.com/en/players/b2d0ec1b/Nolito"
2018,"Sevilla","La Liga","Steven Nzonzi","FRA","MF","28",1988,24.6,39,26,14,19,6,20,30,66.7,10,27,8,19,28,67,36,2,"https://fbref.com/en/players/c7526c18/Steven-Nzonzi"
2018,"Sevilla","La Liga","Nicolás Pareja","ARG","DF","33",1984,4.5,11,8,7,3,1,3,5,60,2,8,1,7,13,24,24,0,"https://fbref.com/en/players/a92669f6/Nicolas-Pareja"
2018,"Sevilla","La Liga","Guido Pizarro","ARG","MF","27",1990,19.5,75,47,36,36,3,29,67,43.3,38,20,7,13,26,101,48,0,"https://fbref.com/en/players/faec2ec4/Guido-Pizarro"
2018,"Sevilla","La Liga","Sandro Ramírez","ESP","FW,MF","22",1995,8,8,8,1,5,2,1,7,14.3,6,2,0,2,4,12,2,0,"https://fbref.com/en/players/833fb62e/Sandro-Ramirez"
2018,"Sevilla","La Liga","Sergio Rico","ESP","GK","23",1993,24,1,1,1,0,0,0,2,0,2,0,0,0,1,2,5,3,"https://fbref.com/en/players/5f0241b2/Sergio-Rico"
2018,"Sevilla","La Liga","Pablo Sarabia","ESP","FW,MF","25",1992,26.6,27,19,10,13,4,11,49,22.4,38,39,1,38,30,57,34,1,"https://fbref.com/en/players/9744ff80/Pablo-Sarabia"
2018,"Sevilla","La Liga","David Soria","ESP","GK","24",1993,14,1,0,1,0,0,1,1,100,0,0,0,0,2,3,13,2,"https://fbref.com/en/players/8f8c6934/David-Soria"
2018,"Sevilla","La Liga","Franco Vázquez","ARG","MF","28",1989,20.4,39,32,16,15,8,6,34,17.6,28,20,2,18,11,50,11,0,"https://fbref.com/en/players/467bae22/Franco-Vazquez"
2018,"Southampton","Premier League","Charlie Austin","ENG","FW","28",1989,11.5,7,5,1,3,3,3,10,30,7,15,3,12,1,8,10,0,"https://fbref.com/en/players/8d228291/Charlie-Austin"
2018,"Southampton","Premier League","Jan Bednarek","POL","DF","21",1996,4.7,6,3,6,0,0,3,6,50,3,2,1,1,5,11,27,0,"https://fbref.com/en/players/4115ce4e/Jan-Bednarek"
2018,"Southampton","Premier League","Ryan Bertrand","ENG","DF","27",1989,34.8,48,35,27,17,4,19,31,61.3,12,28,9,19,44,92,74,0,"https://fbref.com/en/players/01226327/Ryan-Bertrand"
2018,"Southampton","Premier League","Sofiane Boufal","MAR","FW,MF","23",1993,13.5,37,24,12,14,11,12,35,34.3,23,20,1,19,6,43,6,0,"https://fbref.com/en/players/b0c71810/Sofiane-Boufal"
2018,"Southampton","Premier League","Guido Carrillo","ARG","FW","26",1991,5,5,1,0,3,2,0,1,0,1,4,0,4,0,5,5,0,"https://fbref.com/en/players/8f898ba8/Guido-Carrillo"
2018,"Southampton","Premier League","Steven Davis","NIR","MF","32",1985,16.9,30,21,10,17,3,11,30,36.7,19,22,6,16,15,45,24,1,"https://fbref.com/en/players/cf15bbb1/Steven-Davis"
2018,"Southampton","Premier League","Fraser Forster","ENG","GK","29",1988,20,0,0,0,0,0,0,0,NA,0,0,0,0,0,0,7,4,"https://fbref.com/en/players/c3e39f12/Fraser-Forster"
2018,"Southampton","Premier League","Manolo Gabbiadini","ITA","FW","25",1991,12,3,2,0,2,1,1,15,6.7,14,3,0,3,4,7,6,0,"https://fbref.com/en/players/8f866fe8/Manolo-Gabbiadini"
2018,"Southampton","Premier League","Wesley Hoedt","NED","DF","23",1994,28,60,51,48,12,0,36,61,59,25,32,17,15,40,100,177,2,"https://fbref.com/en/players/875898c7/Wesley-Hoedt"
2018,"Southampton","Premier League","Pierre Højbjerg","DEN","MF","21",1995,18.6,45,29,24,18,3,13,56,23.2,43,30,3,27,37,82,26,1,"https://fbref.com/en/players/8b04d6c1/Pierre-Hojbjerg"
2018,"Southampton","Premier League","Mario Lemina","GAB","MF","23",1993,19.1,55,40,21,29,5,12,30,40,18,18,6,12,36,91,36,4,"https://fbref.com/en/players/2b471f99/Mario-Lemina"
2018,"Southampton","Premier League","Shane Long","IRL","FW","30",1987,17.6,25,20,1,19,5,10,30,33.3,20,14,2,12,12,37,29,0,"https://fbref.com/en/players/9f472354/Shane-Long"
2018,"Southampton","Premier League","Alex McCarthy","ENG","GK","27",1989,18,0,0,0,0,0,0,0,NA,0,0,0,0,1,1,8,0,"https://fbref.com/en/players/36c2ca73/Alex-McCarthy"
2018,"Southampton","Premier League","Sam McQueen","ENG","DF,MF","22",1995,1.6,4,4,4,0,0,2,4,50,2,2,1,1,3,7,3,0,"https://fbref.com/en/players/b27b49b4/Sam-McQueen"
2018,"Southampton","Premier League","Michael Obafemi","IRL","FW","17",2000,0.1,0,0,0,0,0,0,0,NA,0,0,0,0,0,0,0,0,"https://fbref.com/en/players/caa1a7f0/Michael-Obafemi"
2018,"Southampton","Premier League","Jérémy Pied","FRA","DF","28",1989,2,9,6,8,1,0,6,9,66.7,3,3,2,1,8,17,4,0,"https://fbref.com/en/players/a634b9d2/Jeremy-Pied"
2018,"Southampton","Premier League","Nathan Redmond","ENG","FW,MF","23",1994,21.6,32,17,16,14,2,12,31,38.7,19,20,0,20,15,47,17,2,"https://fbref.com/en/players/ab651565/Nathan-Redmond"
2018,"Southampton","Premier League","Oriol Romeu","ESP","MF","25",1991,32.2,93,64,41,44,8,32,100,32,68,59,19,40,69,162,77,2,"https://fbref.com/en/players/4b511457/Oriol-Romeu"
2018,"Southampton","Premier League","Josh Sims","ENG","FW,MF","20",1997,1.8,4,3,1,2,1,2,7,28.6,5,5,0,5,1,5,0,0,"https://fbref.com/en/players/6d6f09dc/Josh-Sims"
2018,"Southampton","Premier League","Cédric Soares","POR","DF","25",1991,31,54,34,40,10,4,22,31,71,9,32,8,24,24,78,109,2,"https://fbref.com/en/players/839c14e1/Cedric-Soares"
2018,"Southampton","Premier League","Jack Stephens","ENG","DF","23",1994,22,29,20,24,5,0,13,25,52,12,30,18,12,41,70,108,2,"https://fbref.com/en/players/6adbc307/Jack-Stephens"
2018,"Southampton","Premier League","Dušan Tadić","SRB","MF,FW","28",1988,31,46,29,16,22,8,11,35,31.4,24,38,2,36,19,65,29,1,"https://fbref.com/en/players/2475dcc6/Dusan-Tadic"
2018,"Southampton","Premier League","Matt Targett","ENG","DF","21",1995,1.8,6,3,5,0,1,1,3,33.3,2,3,2,1,3,9,7,1,"https://fbref.com/en/players/e514ab62/Matt-Targett"
2018,"Southampton","Premier League","Virgil van Dijk","NED","DF","26",1991,11,10,7,6,2,2,2,3,66.7,1,14,13,1,29,39,81,1,"https://fbref.com/en/players/e06683ca/Virgil-van-Dijk"
2018,"Southampton","Premier League","James Ward-Prowse","ENG","FW,MF","22",1994,19.1,23,16,9,11,3,3,27,11.1,24,29,1,28,8,31,31,0,"https://fbref.com/en/players/3515d404/James-Ward-Prowse"
2018,"Southampton","Premier League","Maya Yoshida","JPN","DF","28",1988,22.8,27,20,22,5,0,18,25,72,7,32,14,18,41,68,133,2,"https://fbref.com/en/players/caffaf5a/Maya-Yoshida"
2018,"Stoke City","Premier League","Charlie Adam","SCO","MF","31",1985,4.6,9,5,2,5,2,5,17,29.4,12,2,0,2,9,18,11,2,"https://fbref.com/en/players/aff418dc/Charlie-Adam"
2018,"Stoke City","Premier League","Ibrahim Afellay","NED","MF","31",1986,1.8,3,3,0,3,0,1,2,50,1,1,0,1,1,4,1,0,"https://fbref.com/en/players/9a8c6673/Ibrahim-Afellay"
2018,"Stoke City","Premier League","Joe Allen","WAL","MF","27",1990,34.9,96,62,41,43,12,27,87,31,60,43,9,34,58,154,68,1,"https://fbref.com/en/players/9feb8f24/Joe-Allen"
2018,"Stoke City","Premier League","Moritz Bauer","AUT","DF,MF","25",1992,14.5,24,17,17,7,0,10,26,38.5,16,9,1,8,12,36,48,0,"https://fbref.com/en/players/cfe6238d/Moritz-Bauer"
2018,"Stoke City","Premier League","Saido Berahino","BDI","FW","23",1993,5.5,2,2,0,1,1,0,1,0,1,4,1,3,1,3,2,0,"https://fbref.com/en/players/25b166d0/Saido-Berahino"
2018,"Stoke City","Premier League","Mame Biram Diouf","SEN","FW,DF","29",1987,28.8,48,36,26,15,7,8,21,38.1,13,22,0,22,14,62,76,1,"https://fbref.com/en/players/7f4f3e49/Mame-Biram-Diouf"
2018,"Stoke City","Premier League","Jack Butland","ENG","GK","24",1993,35,1,1,1,0,0,1,1,100,0,1,0,1,1,2,26,1,"https://fbref.com/en/players/cc70a1d5/Jack-Butland"
2018,"Stoke City","Premier League","Geoff Cameron","USA","DF,MF","32",1985,16.9,34,21,20,12,2,11,27,40.7,16,28,8,20,36,70,68,0,"https://fbref.com/en/players/1a160ea3/Geoff-Cameron"
2018,"Stoke City","Premier League","Tyrese Campbell","ENG","FW","17",1999,0.9,2,1,0,2,0,1,1,100,0,1,1,0,1,3,0,0,"https://fbref.com/en/players/38aefb74/Tyrese-Campbell"
2018,"Stoke City","Premier League","Peter Crouch","ENG","FW","36",1981,17.4,2,0,0,1,1,0,12,0,12,7,4,3,1,3,31,0,"https://fbref.com/en/players/73d9bdc7/Peter-Crouch"
2018,"Stoke City","Premier League","Tom Edwards","ENG","DF,MF","18",1999,5.3,15,9,10,5,0,8,8,100,0,5,2,3,5,20,20,0,"https://fbref.com/en/players/1b780599/Tom-Edwards"
2018,"Stoke City","Premier League","Darren Fletcher","SCO","MF","33",1984,24.7,47,26,23,20,4,15,55,27.3,40,13,3,10,26,73,33,3,"https://fbref.com/en/players/184e4970/Darren-Fletcher"
2018,"Stoke City","Premier League","Lee Grant","ENG","GK","34",1983,3,1,1,1,0,0,1,1,100,0,0,0,0,0,1,0,0,"https://fbref.com/en/players/9dab6e3b/Lee-Grant"
2018,"Stoke City","Premier League","Stephen Ireland","IRL","MF,FW","30",1986,1.5,3,1,2,1,0,1,5,20,4,4,2,2,1,4,1,0,"https://fbref.com/en/players/bcf30f17/Stephen-Ireland"
2018,"Stoke City","Premier League","Jesé","ESP","FW,MF","24",1993,6.8,10,7,3,5,2,3,13,23.1,10,5,0,5,0,10,3,0,"https://fbref.com/en/players/4a537185/Jese"
2018,"Stoke City","Premier League","Glen Johnson","ENG","DF","32",1984,6.1,7,5,5,2,0,3,12,25,9,7,2,5,10,17,23,0,"https://fbref.com/en/players/8cceca90/Glen-Johnson"
2018,"Stoke City","Premier League","Bojan Krkić","ESP","MF","26",1990,0.8,0,0,0,0,0,0,1,0,1,1,0,1,0,0,0,0,"https://fbref.com/en/players/9fa0a0b8/Bojan-Krkic"
2018,"Stoke City","Premier League","Bruno Martins Indi","NED","DF","25",1992,13.8,21,12,18,3,0,10,19,52.6,9,16,11,5,21,42,77,1,"https://fbref.com/en/players/7bc34048/Bruno-Martins-Indi"
2018,"Stoke City","Premier League","Eric Maxim Choupo-Moting","CMR","FW,MF","28",1989,25.7,42,30,21,16,5,9,32,28.1,23,31,3,28,23,65,29,1,"https://fbref.com/en/players/0e6bc38c/Eric-Maxim-Choupo-Moting"
2018,"Stoke City","Premier League","Badou Ndiaye","SEN","MF","26",1990,12.6,53,28,22,25,6,16,41,39,25,21,9,12,13,66,18,0,"https://fbref.com/en/players/960acc0a/Badou-Ndiaye"
2018,"Stoke City","Premier League","Julien Ngoy","BEL","MF","19",1997,0.2,1,1,0,1,0,1,2,50,1,0,0,0,0,1,0,0,"https://fbref.com/en/players/87449a74/Julien-Ngoy"
2018,"Stoke City","Premier League","Erik Pieters","NED","DF","28",1988,30.2,71,47,43,26,2,24,51,47.1,27,70,25,45,61,132,127,5,"https://fbref.com/en/players/1ef37668/Erik-Pieters"
2018,"Stoke City","Premier League","Xherdan Shaqiri","SUI","MF,FW","25",1991,33.8,25,17,9,11,5,10,39,25.6,29,9,1,8,16,41,6,2,"https://fbref.com/en/players/6421ec64/Xherdan-Shaqiri"
2018,"Stoke City","Premier League","Ryan Shawcross","ENG","DF","29",1987,26.3,36,20,25,9,2,13,25,52,12,33,23,10,40,76,224,1,"https://fbref.com/en/players/285a3d44/Ryan-Shawcross"
2018,"Stoke City","Premier League","Ramadan Sobhi","EGY","MF,FW","20",1997,13.8,32,21,17,14,1,11,36,30.6,25,14,0,14,14,46,14,0,"https://fbref.com/en/players/98be0d02/Ramadan-Sobhi"
2018,"Stoke City","Premier League","Kostas Stafylidis","GRE","DF,MF","23",1993,3.7,12,6,6,4,2,6,9,66.7,3,7,2,5,5,17,19,0,"https://fbref.com/en/players/861e0116/Kostas-Stafylidis"
2018,"Stoke City","Premier League","Lasse Sørensen","DEN","MF","17",1999,0.8,2,2,2,0,0,1,5,20,4,2,0,2,0,2,3,0,"https://fbref.com/en/players/ce9c203e/Lasse-Sorensen"
2018,"Stoke City","Premier League","Josh Tymon","ENG","DF","18",1999,1.8,5,1,4,1,0,2,3,66.7,1,1,0,1,1,6,3,0,"https://fbref.com/en/players/efe6f6ac/Josh-Tymon"
2018,"Stoke City","Premier League","Kevin Wimmer","AUT","DF","24",1992,14.7,24,17,17,7,0,9,20,45,11,25,12,13,30,54,88,0,"https://fbref.com/en/players/faf55ce4/Kevin-Wimmer"
2018,"Stoke City","Premier League","Kurt Zouma","FRA","DF","22",1994,32.1,50,38,35,13,2,21,28,75,7,42,23,19,61,111,246,2,"https://fbref.com/en/players/ce4246f5/Kurt-Zouma"
2018,"Strasbourg","Ligue 1","Jean-Eudes Aholou","CIV","MF","23",1994,33.4,70,34,32,37,1,17,55,30.9,38,29,7,22,75,145,58,1,"https://fbref.com/en/players/48b28bfd/Jean-Eudes-Aholou"
2018,"Strasbourg","Ligue 1","Stéphane Bahoken","CMR","FW","25",1992,18.5,16,11,3,8,5,4,22,18.2,18,18,1,17,9,25,1,0,"https://fbref.com/en/players/5046b7d4/Stephane-Bahoken"
2018,"Strasbourg","Ligue 1","Jérémy Blayac","FRA","FW","34",1983,10.2,5,3,0,3,2,2,9,22.2,7,7,2,5,1,6,11,0,"https://fbref.com/en/players/d9afac11/Jeremy-Blayac"
2018,"Strasbourg","Ligue 1","Landry Bonnefoi","FRA","GK","33",1983,3,0,0,0,0,0,0,0,NA,0,0,0,0,0,0,2,0,"https://fbref.com/en/players/e65dd8dc/Landry-Bonnefoi"
2018,"Strasbourg","Ligue 1","Benjamin Corgnet","FRA","MF,FW","30",1987,15.3,28,19,5,16,7,6,28,21.4,22,18,1,17,11,39,11,0,"https://fbref.com/en/players/cfd8dde3/Benjamin-Corgnet"
2018,"Strasbourg","Ligue 1","Nuno da Costa","CPV","FW,MF","26",1991,19.2,50,32,12,29,9,7,35,20,28,21,0,21,19,69,9,0,"https://fbref.com/en/players/909222de/Nuno-da-Costa"
2018,"Strasbourg","Ligue 1","Dimitri Foulquier","FRA","DF","24",1993,13.8,25,12,15,8,2,7,17,41.2,10,15,4,11,14,39,33,0,"https://fbref.com/en/players/45e17712/Dimitri-Foulquier"
2018,"Strasbourg","Ligue 1","Anthony Gonçalves","FRA","MF,FW","31",1986,19.5,50,31,14,32,4,15,50,30,35,27,0,27,25,75,27,0,"https://fbref.com/en/players/c27dfb82/Anthony-Goncalves"
2018,"Strasbourg","Ligue 1","Jérémy Grimm","FRA","MF","30",1987,9,23,17,15,6,2,9,24,37.5,15,11,3,8,19,42,31,1,"https://fbref.com/en/players/53283127/Jeremy-Grimm"
2018,"Strasbourg","Ligue 1","Bingourou Kamara","SEN","GK","20",1996,18.8,0,0,0,0,0,0,2,0,2,0,0,0,1,1,6,3,"https://fbref.com/en/players/3814120d/Bingourou-Kamara"
2018,"Strasbourg","Ligue 1","Bakary Koné","BFA","DF","29",1988,27.4,26,17,23,3,0,12,31,38.7,19,20,10,10,33,59,122,2,"https://fbref.com/en/players/1f713024/Bakary-Kone"
2018,"Strasbourg","Ligue 1","Kenny Lala","FRA","DF","25",1991,30.3,87,47,53,28,6,21,47,44.7,26,18,10,8,42,129,70,2,"https://fbref.com/en/players/770d7eb8/Kenny-Lala"
2018,"Strasbourg","Ligue 1","Dimitri Liénard","FRA","MF,FW","29",1988,28.9,77,51,37,32,8,30,84,35.7,54,35,2,33,52,129,41,1,"https://fbref.com/en/players/f7691f63/Dimitri-Lienard"
2018,"Strasbourg","Ligue 1","Kader Mangane","SEN","DF","34",1983,19.1,37,24,29,8,0,11,21,52.4,10,28,18,10,24,61,120,4,"https://fbref.com/en/players/dbb10755/Kader-Mangane"
2018,"Strasbourg","Ligue 1","Jonas Martin","FRA","MF","27",1990,33.6,73,50,41,28,4,17,54,31.5,37,30,3,27,33,106,36,0,"https://fbref.com/en/players/468fdbad/Jonas-Martin"
2018,"Strasbourg","Ligue 1","Pablo Martinez","FRA","DF","28",1989,23.5,41,34,28,12,1,22,49,44.9,27,25,12,13,51,92,112,3,"https://fbref.com/en/players/1ad8cb67/Pablo-Martinez"
2018,"Strasbourg","Ligue 1","Abdallah N'dour","SEN","DF","23",1993,2.8,9,5,6,3,0,5,10,50,5,6,1,5,2,11,5,0,"https://fbref.com/en/players/4749367a/Abdallah-Ndour"
2018,"Strasbourg","Ligue 1","Vincent Nogueira","FRA","MF","29",1988,0.7,0,0,0,0,0,0,0,NA,0,0,0,0,0,0,2,0,"https://fbref.com/en/players/268c3cfc/Vincent-Nogueira"
2018,"Strasbourg","Ligue 1","Alexandre Oukidja","ALG","GK","29",1988,16.2,0,0,0,0,0,0,1,0,1,0,0,0,3,3,9,1,"https://fbref.com/en/players/ae7d0ecd/Alexandre-Oukidja"
2018,"Strasbourg","Ligue 1","Idriss Saadi","ALG","FW","25",1992,10.5,6,5,2,3,1,2,11,18.2,9,3,2,1,5,11,1,0,"https://fbref.com/en/players/17f29fb0/Idriss-Saadi"
2018,"Strasbourg","Ligue 1","Ihsan Sacko","FRA","FW,MF","20",1997,7.9,10,8,6,0,4,2,10,20,8,2,0,2,5,15,6,0,"https://fbref.com/en/players/68a87d66/Ihsan-Sacko"
2018,"Strasbourg","Ligue 1","Yoann Salmier","GUF","DF","24",1992,12.3,15,13,10,5,0,5,12,41.7,7,11,6,5,26,41,62,1,"https://fbref.com/en/players/c3725db2/Yoann-Salmier"
2018,"Strasbourg","Ligue 1","Ernest Seka","GUI","DF","30",1987,24.2,60,47,41,14,5,40,61,65.6,21,25,8,17,51,111,98,1,"https://fbref.com/en/players/e1b3413d/Ernest-Seka"
2018,"Strasbourg","Ligue 1","Martin Terrier","FRA","FW,MF","20",1997,18.6,42,30,16,23,3,9,28,32.1,19,11,1,10,14,56,6,0,"https://fbref.com/en/players/5148dcc5/Martin-Terrier"
2018,"Strasbourg","Ligue 1","Kévin Zohi","MLI","MF","20",1996,0,0,0,0,0,0,0,0,NA,0,0,0,0,0,0,0,0,"https://fbref.com/en/players/775185ae/Kevin-Zohi"
2018,"Stuttgart","Bundesliga","Ailton","BRA","DF,MF","22",1995,1.2,8,5,3,5,0,4,8,50,4,5,0,5,2,10,5,0,"https://fbref.com/en/players/74ced675/Ailton"
2018,"Stuttgart","Bundesliga","Chadrac Akolo","COD","MF,FW","22",1995,12.2,20,14,3,12,5,6,14,42.9,8,19,0,19,5,25,5,0,"https://fbref.com/en/players/debc2f28/Chadrac-Akolo"
2018,"Stuttgart","Bundesliga","Dennis Aogo","GER","MF,DF","30",1987,21.7,35,26,17,18,0,14,22,63.6,8,27,3,24,29,64,27,1,"https://fbref.com/en/players/c311243f/Dennis-Aogo"
2018,"Stuttgart","Bundesliga","Takuma Asano","JPN","FW,MF","22",1994,8,7,5,3,3,1,2,8,25,6,7,0,7,3,10,2,0,"https://fbref.com/en/players/13ddc856/Takuma-Asano"
2018,"Stuttgart","Bundesliga","Santiago Ascacíbar","ARG","MF","20",1997,26.5,91,65,41,43,7,41,74,55.4,33,45,10,35,47,138,38,1,"https://fbref.com/en/players/e26fcca3/Santiago-Ascacibar"
2018,"Stuttgart","Bundesliga","Holger Badstuber","GER","DF,MF","28",1989,24.1,44,32,29,14,1,22,39,56.4,17,27,14,13,41,85,111,4,"https://fbref.com/en/players/45b7edae/Holger-Badstuber"
2018,"Stuttgart","Bundesliga","Timo Baumgartl","GER","DF","21",1996,29,87,71,55,29,3,56,75,74.7,19,50,21,29,34,121,132,1,"https://fbref.com/en/players/bd7d2e6d/Timo-Baumgartl"
2018,"Stuttgart","Bundesliga","Andreas Beck","GER","DF","30",1987,21.4,46,29,27,16,3,21,31,67.7,10,32,2,30,19,65,46,1,"https://fbref.com/en/players/00a6485f/Andreas-Beck"
2018,"Stuttgart","Bundesliga","Josip Brekalo","CRO","MF,FW","19",1998,8.1,20,12,7,8,5,6,8,75,2,8,2,6,3,23,1,0,"https://fbref.com/en/players/d4a2533d/Josip-Brekalo"
2018,"Stuttgart","Bundesliga","Jacob Bruun Larsen","DEN","MF,DF","18",1998,1.2,0,0,0,0,0,0,0,NA,0,1,0,1,1,1,2,0,"https://fbref.com/en/players/4e204552/Jacob-Bruun-Larsen"
2018,"Stuttgart","Bundesliga","Dženis Burnić","GER","MF","19",1998,3.4,9,6,2,5,2,4,10,40,6,2,0,2,4,13,3,0,"https://fbref.com/en/players/0dabaf14/Dzenis-Burnic"
2018,"Stuttgart","Bundesliga","Anastasios Donis","GRE","MF,FW","20",1996,10.5,20,14,10,6,4,6,8,75,2,2,0,2,9,29,7,0,"https://fbref.com/en/players/0f26fd24/Anastasios-Donis"
2018,"Stuttgart","Bundesliga","Christian Gentner","GER","MF","31",1985,26.8,91,67,35,44,12,44,84,52.4,40,41,5,36,35,126,52,0,"https://fbref.com/en/players/a4f94a0d/Christian-Gentner"
2018,"Stuttgart","Bundesliga","Daniel Ginczek","GER","FW","26",1991,16.9,8,4,3,5,0,2,12,16.7,10,16,1,15,5,13,13,0,"https://fbref.com/en/players/e5f63987/Daniel-Ginczek"
2018,"Stuttgart","Bundesliga","Mario Gómez","GER","FW","32",1985,15.4,13,11,0,8,5,2,10,20,8,6,0,6,4,17,17,0,"https://fbref.com/en/players/71a20ce8/Mario-Gomez"
2018,"Stuttgart","Bundesliga","Anto Grgić","SUI","MF","20",1996,0.1,0,0,0,0,0,0,0,NA,0,0,0,0,0,0,0,0,"https://fbref.com/en/players/126cf855/Anto-Grgic"
2018,"Stuttgart","Bundesliga","Emiliano Insúa","ARG","DF","28",1989,23.4,46,34,27,16,3,17,32,53.1,15,30,4,26,36,82,48,1,"https://fbref.com/en/players/f3cccffe/Emiliano-Insua"
2018,"Stuttgart","Bundesliga","Marcin Kamiński","POL","DF","25",1992,12.6,17,14,5,11,1,12,18,66.7,6,12,3,9,30,47,55,0,"https://fbref.com/en/players/463503e2/Marcin-Kaminski"
2018,"Stuttgart","Bundesliga","Orel Mangala","BEL","MF","19",1998,8.7,28,18,7,19,2,11,21,52.4,10,8,2,6,18,46,15,0,"https://fbref.com/en/players/a572e291/Orel-Mangala"
2018,"Stuttgart","Bundesliga","Ebenezer Ofori","GHA","MF","22",1995,0.1,0,0,0,0,0,0,1,0,1,1,0,1,0,0,0,0,"https://fbref.com/en/players/a5d77c4e/Ebenezer-Ofori"
2018,"Stuttgart","Bundesliga","Berkay Özcan","TUR","MF,FW","19",1998,11.1,19,10,7,9,3,7,11,63.6,4,14,2,12,3,22,8,0,"https://fbref.com/en/players/31114001/Berkay-Ozcan"
2018,"Stuttgart","Bundesliga","Benjamin Pavard","FRA","DF","21",1996,34,55,40,40,13,2,36,47,76.6,11,59,34,25,70,125,192,1,"https://fbref.com/en/players/45a03961/Benjamin-Pavard"
2018,"Stuttgart","Bundesliga","Simon Terodde","GER","FW","29",1988,10.6,9,6,1,7,1,2,5,40,3,8,2,6,5,14,8,0,"https://fbref.com/en/players/863ff1ee/Simon-Terodde"
2018,"Stuttgart","Bundesliga","Erik Thommy","GER","MF","22",1994,10.9,19,11,7,7,5,9,17,52.9,8,17,2,15,9,28,8,1,"https://fbref.com/en/players/df8e7b62/Erik-Thommy"
2018,"Stuttgart","Bundesliga","Ron-Robert Zieler","GER","GK","28",1989,34,1,1,1,0,0,1,1,100,0,2,0,2,1,2,14,5,"https://fbref.com/en/players/a0606ae8/Ron-Robert-Zieler"
2018,"Stuttgart","Bundesliga","Matthias Zimmermann","GER","DF","25",1992,0.9,3,1,2,1,0,3,4,75,1,0,0,0,1,4,5,1,"https://fbref.com/en/players/e199d5b0/Matthias-Zimmermann"
2018,"Swansea City","Premier League","Tammy Abraham","ENG","FW","19",1997,19.2,10,8,1,7,2,1,13,7.7,12,8,1,7,1,11,11,0,"https://fbref.com/en/players/f586779e/Tammy-Abraham"
2018,"Swansea City","Premier League","André Ayew","GHA","MF,FW","27",1989,10.6,15,10,3,10,2,2,13,15.4,11,13,1,12,5,20,8,0,"https://fbref.com/en/players/5dbefa9d/Andre-Ayew"
2018,"Swansea City","Premier League","Jordan Ayew","GHA","FW,MF","25",1991,31.7,82,60,20,35,27,15,54,27.8,39,43,3,40,24,106,20,1,"https://fbref.com/en/players/da052c14/Jordan-Ayew"
2018,"Swansea City","Premier League","Kyle Bartley","ENG","DF","26",1991,2.6,3,2,3,0,0,2,2,100,0,6,6,0,4,7,21,0,"https://fbref.com/en/players/18e96f64/Kyle-Bartley"
2018,"Swansea City","Premier League","Wilfried Bony","CIV","FW","28",1988,7.9,5,4,2,2,1,1,5,20,4,4,1,3,2,7,15,0,"https://fbref.com/en/players/61abe9b6/Wilfried-Bony"
2018,"Swansea City","Premier League","Leon Britton","ENG","MF","34",1982,3.4,6,5,0,5,1,5,8,62.5,3,3,1,2,1,7,1,0,"https://fbref.com/en/players/b92dd711/Leon-Britton"
2018,"Swansea City","Premier League","Tom Carroll","ENG","MF","25",1992,28.6,53,33,22,23,8,14,53,26.4,39,37,8,29,29,82,18,1,"https://fbref.com/en/players/5a1900a4/Tom-Carroll"
2018,"Swansea City","Premier League","Sam Clucas","ENG","MF","26",1990,22.7,34,19,21,11,2,10,29,34.5,19,31,7,24,29,63,34,1,"https://fbref.com/en/players/987718f5/Sam-Clucas"
2018,"Swansea City","Premier League","Mike van der Hoorn","NED","DF","24",1992,21.6,32,22,23,8,1,16,24,66.7,8,24,14,10,39,71,127,0,"https://fbref.com/en/players/25f50295/Mike-van-der-Hoorn"
2018,"Swansea City","Premier League","Nathan Dyer","ENG","MF,FW","29",1987,14.5,22,16,8,9,5,6,24,25,18,13,0,13,11,33,3,0,"https://fbref.com/en/players/6dfd5af0/Nathan-Dyer"
2018,"Swansea City","Premier League","Łukasz Fabiański","POL","GK","32",1985,38,0,0,0,0,0,0,0,NA,0,0,0,0,0,0,10,2,"https://fbref.com/en/players/9328b835/Lukasz-Fabianski"
2018,"Swansea City","Premier League","Leroy Fer","NED","MF","27",1990,15.5,44,32,18,21,5,13,30,43.3,17,18,4,14,12,56,24,3,"https://fbref.com/en/players/3cefa66a/Leroy-Fer"
2018,"Swansea City","Premier League","Federico Fernández","ARG","DF","28",1989,29.7,40,29,30,6,4,20,30,66.7,10,35,27,8,38,78,201,1,"https://fbref.com/en/players/f25b010f/Federico-Fernandez"
2018,"Swansea City","Premier League","Jay Fulton","SCO","MF","23",1994,0.2,0,0,0,0,0,0,0,NA,0,0,0,0,0,0,1,0,"https://fbref.com/en/players/434ad289/Jay-Fulton"
2018,"Swansea City","Premier League","Andy King","WAL","MF","28",1988,7.9,18,11,10,8,0,5,14,35.7,9,7,0,7,6,24,14,1,"https://fbref.com/en/players/d790907f/Andy-King"
2018,"Swansea City","Premier League","Alfie Mawson","ENG","DF","23",1994,38,32,22,24,8,0,16,27,59.3,11,41,32,9,35,67,229,5,"https://fbref.com/en/players/d368feb8/Alfie-Mawson"
2018,"Swansea City","Premier League","Oliver McBurnie","SCO","FW,MF","21",1996,3.1,4,3,0,2,2,1,3,33.3,2,2,0,2,0,4,3,0,"https://fbref.com/en/players/78b8ac63/Oliver-McBurnie"
2018,"Swansea City","Premier League","Roque Mesa","ESP","MF","28",1989,8.4,20,13,8,8,4,10,37,27,27,6,0,6,13,33,8,1,"https://fbref.com/en/players/7c4243d4/Roque-Mesa"
2018,"Swansea City","Premier League","Luciano Narsingh","NED","FW,MF","26",1990,6.9,7,5,1,5,1,2,7,28.6,5,7,0,7,3,10,3,0,"https://fbref.com/en/players/977ffc24/Luciano-Narsingh"
2018,"Swansea City","Premier League","Kyle Naughton","ENG","DF","28",1988,33.7,92,60,49,35,8,54,100,54,46,60,13,47,60,152,144,4,"https://fbref.com/en/players/e860c42f/Kyle-Naughton"
2018,"Swansea City","Premier League","Martin Olsson","SWE","DF","29",1988,35,34,26,18,10,6,12,29,41.4,17,21,4,17,31,65,81,0,"https://fbref.com/en/players/2f72f79e/Martin-Olsson"
2018,"Swansea City","Premier League","Àngel Rangel","ESP","DF","34",1982,1.7,4,3,2,2,0,1,3,33.3,2,0,0,0,3,7,4,0,"https://fbref.com/en/players/93ee387c/Angel-Rangel"
2018,"Swansea City","Premier League","Connor Roberts","WAL","DF","21",1995,3,6,4,5,1,0,3,3,100,0,2,0,2,3,9,6,0,"https://fbref.com/en/players/24fae784/Connor-Roberts"
2018,"Swansea City","Premier League","Wayne Routledge","ENG","MF,FW","32",1985,4.8,10,5,2,6,2,2,8,25,6,5,0,5,2,12,5,0,"https://fbref.com/en/players/1d387eee/Wayne-Routledge"
2018,"Swansea City","Premier League","Renato Sanches","POR","MF","19",1997,7.8,12,7,6,6,0,6,18,33.3,12,9,1,8,7,19,5,1,"https://fbref.com/en/players/032f894e/Renato-Sanches"
2018,"Swansea City","Premier League","Ki Sung-yueng","KOR","MF","28",1989,20.8,25,18,10,13,2,4,16,25,12,16,1,15,32,57,23,0,"https://fbref.com/en/players/1d8c99b0/Ki-Sung-yueng"
2018,"Torino","Serie A","Afriyie Acquah","GHA","MF","25",1992,10.6,8,6,2,6,0,1,7,14.3,6,8,1,7,16,24,10,2,"https://fbref.com/en/players/d7403bd5/Afriyie-Acquah"
2018,"Torino","Serie A","Cristian Ansaldi","ARG","DF","30",1986,20.8,49,33,25,20,4,14,37,37.8,23,23,5,18,20,69,61,0,"https://fbref.com/en/players/bbafc0c4/Cristian-Ansaldi"
2018,"Torino","Serie A","Antonio Barreca","ITA","DF","22",1995,5.2,9,8,3,5,1,4,4,100,0,3,0,3,5,14,16,0,"https://fbref.com/en/players/6a189491/Antonio-Barreca"
2018,"Torino","Serie A","Daniele Baselli","ITA","MF","25",1992,28,63,33,23,36,4,20,56,35.7,36,29,5,24,57,120,40,1,"https://fbref.com/en/players/ea06dd97/Daniele-Baselli"
2018,"Torino","Serie A","Andrea Belotti","ITA","FW","23",1993,29.8,32,23,9,15,8,3,30,10,27,14,1,13,6,38,19,1,"https://fbref.com/en/players/d705ba44/Andrea-Belotti"
2018,"Torino","Serie A","Álex Berenguer","ESP","FW","22",1995,11.6,18,15,7,8,3,5,17,29.4,12,22,3,19,10,28,13,0,"https://fbref.com/en/players/dc1c2fce/Alex-Berenguer"
2018,"Torino","Serie A","Kevin Bonifazi","ITA","DF,MF","21",1996,4.5,11,7,6,5,0,4,6,66.7,2,7,5,2,13,24,15,0,"https://fbref.com/en/players/fb77bfef/Kevin-Bonifazi"
2018,"Torino","Serie A","Lucas Boyé","ARG","FW","21",1996,1.7,9,8,5,3,1,1,3,33.3,2,5,0,5,2,11,2,0,"https://fbref.com/en/players/d49f3e6b/Lucas-Boye"
2018,"Torino","Serie A","Alessandro Buongiorno","ITA","DF","18",1999,0.1,0,0,0,0,0,0,0,NA,0,0,0,0,0,0,1,0,"https://fbref.com/en/players/4ae67f27/Alessandro-Buongiorno"
2018,"Torino","Serie A","Nicolás Burdisso","ARG","DF","36",1981,23,20,11,13,7,0,7,11,63.6,4,23,14,9,30,50,124,3,"https://fbref.com/en/players/9417f322/Nicolas-Burdisso"
2018,"Torino","Serie A","Lorenzo De Silvestri","ITA","DF","29",1988,32.8,39,25,19,13,7,16,26,61.5,10,47,10,37,27,66,165,0,"https://fbref.com/en/players/e74f0e59/Lorenzo-De-Silvestri"
2018,"Torino","Serie A","Simone Edera","ITA","FW,MF","20",1997,3.6,6,2,2,4,0,3,10,30,7,0,0,0,2,8,1,0,"https://fbref.com/en/players/8697c095/Simone-Edera"
2018,"Torino","Serie A","Iago Falque","ESP","FW,MF","27",1990,31.3,41,31,15,20,6,6,43,14,37,22,0,22,15,56,15,0,"https://fbref.com/en/players/440c84ed/Iago-Falque"
2018,"Torino","Serie A","Samuel Gustafson","SWE","MF,FW","22",1995,0.9,3,2,3,0,0,1,3,33.3,2,2,0,2,0,3,0,0,"https://fbref.com/en/players/b1e61f23/Samuel-Gustafson"
2018,"Torino","Serie A","Adem Ljajić","SRB","MF,FW","25",1991,24.1,12,9,4,6,2,5,13,38.5,8,11,1,10,9,21,13,0,"https://fbref.com/en/players/2648e18f/Adem-Ljajic"
2018,"Torino","Serie A","Lyanco","BRA","DF","20",1997,3.5,11,8,8,3,0,5,8,62.5,3,4,3,1,5,16,17,0,"https://fbref.com/en/players/b5bf1770/Lyanco"
2018,"Torino","Serie A","Vanja Milinković-Savić","SRB","GK","20",1997,1,0,0,0,0,0,0,0,NA,0,0,0,0,0,0,0,0,"https://fbref.com/en/players/9fa26bc2/Vanja-Milinkovic-Savic"
2018,"Torino","Serie A","Cristian Molinaro","ITA","DF","34",1983,17.4,37,29,19,14,4,11,18,61.1,7,15,4,11,22,59,70,1,"https://fbref.com/en/players/1c8c5aed/Cristian-Molinaro"
2018,"Torino","Serie A","Emiliano Moretti","ITA","DF","36",1981,19.8,31,18,25,6,0,14,16,87.5,2,30,23,7,21,52,77,2,"https://fbref.com/en/players/55667895/Emiliano-Moretti"
2018,"Torino","Serie A","M'Baye Niang","SEN","FW","22",1994,17,29,23,11,9,9,6,18,33.3,12,17,3,14,13,42,15,0,"https://fbref.com/en/players/2054d037/MBaye-Niang"
2018,"Torino","Serie A","Nicolas Nkoulou","CMR","DF","27",1990,36.2,56,40,40,15,1,22,33,66.7,11,44,22,22,57,113,163,1,"https://fbref.com/en/players/93cf32a8/Nicolas-Nkoulou"
2018,"Torino","Serie A","Joel Obi","NGA","MF","26",1991,13.9,45,25,20,20,5,8,26,30.8,18,17,3,14,24,69,15,0,"https://fbref.com/en/players/614c38fb/Joel-Obi"
2018,"Torino","Serie A","Tomás Rincón","VEN","MF","29",1988,33.3,66,40,30,34,2,24,66,36.4,42,33,8,25,57,123,61,1,"https://fbref.com/en/players/f1cfc209/Tomas-Rincon"
2018,"Torino","Serie A","Umar Sadiq","NGA","FW","20",1997,2.5,0,0,0,0,0,0,3,0,3,1,0,1,1,1,2,0,"https://fbref.com/en/players/686cbe7d/Umar-Sadiq"
2018,"Torino","Serie A","Salvatore Sirigu","ITA","GK","30",1987,37,0,0,0,0,0,0,0,NA,0,0,0,0,1,1,35,3,"https://fbref.com/en/players/10dc46f0/Salvatore-Sirigu"
2018,"Torino","Serie A","Mirko Valdifiori","ITA","MF","31",1986,6.9,13,9,5,7,1,2,11,18.2,9,3,1,2,6,19,9,0,"https://fbref.com/en/players/c710f7d5/Mirko-Valdifiori"
2018,"Torino","Serie A","Davide Zappacosta","ITA","DF,FW","25",1992,1.1,1,0,1,0,0,0,0,NA,0,0,0,0,2,3,1,0,"https://fbref.com/en/players/7fe90ccd/Davide-Zappacosta"
2018,"Tottenham","Premier League","Toby Alderweireld","BEL","DF","28",1989,13.1,19,13,7,11,1,8,15,53.3,7,11,5,6,4,23,55,0,"https://fbref.com/en/players/f7d50789/Toby-Alderweireld"
2018,"Tottenham","Premier League","Dele Alli","ENG","MF,FW","21",1996,32.9,46,30,15,21,10,8,34,23.5,26,33,7,26,19,65,22,1,"https://fbref.com/en/players/cea4ee8f/Dele-Alli"
2018,"Tottenham","Premier League","Serge Aurier","CIV","DF","24",1992,15.9,48,27,27,13,8,11,31,35.5,20,20,1,19,31,79,54,1,"https://fbref.com/en/players/5c2b4f07/Serge-Aurier"
2018,"Tottenham","Premier League","Ben Davies","WAL","DF","24",1993,25.8,47,33,13,21,13,25,48,52.1,23,24,5,19,28,75,70,1,"https://fbref.com/en/players/44781702/Ben-Davies"
2018,"Tottenham","Premier League","Mousa Dembélé","BEL","MF","30",1987,20.9,36,24,19,11,6,9,37,24.3,28,20,0,20,33,69,15,0,"https://fbref.com/en/players/f7ee69fb/Mousa-Dembele"
2018,"Tottenham","Premier League","Eric Dier","ENG","MF,DF","23",1994,31.4,61,43,15,39,7,17,42,40.5,25,32,11,21,48,109,93,7,"https://fbref.com/en/players/ac861941/Eric-Dier"
2018,"Tottenham","Premier League","Christian Eriksen","DEN","MF,FW","25",1992,35.8,51,29,16,30,5,17,59,28.8,42,38,1,37,31,82,21,0,"https://fbref.com/en/players/980522ec/Christian-Eriksen"
2018,"Tottenham","Premier League","Paulo Gazzaniga","ARG","GK","25",1992,1,0,0,0,0,0,0,1,0,1,0,0,0,0,0,0,0,"https://fbref.com/en/players/63d17038/Paulo-Gazzaniga"
2018,"Tottenham","Premier League","Son Heung-min","KOR","FW","25",1992,25.7,17,10,2,12,3,2,28,7.1,26,18,0,18,10,27,12,0,"https://fbref.com/en/players/92e7e919/Son-Heung-min"
2018,"Tottenham","Premier League","Vincent Janssen","NED","DF","23",1994,0,0,0,0,0,0,0,0,NA,0,0,0,0,0,0,0,0,"https://fbref.com/en/players/31dce0c8/Vincent-Janssen"
2018,"Tottenham","Premier League","Harry Kane","ENG","FW","24",1993,34.2,17,12,2,8,7,4,15,26.7,11,15,4,11,5,22,19,0,"https://fbref.com/en/players/21a66f6a/Harry-Kane"
2018,"Tottenham","Premier League","Érik Lamela","ARG","FW,MF","25",1992,9.4,23,13,9,7,7,3,20,15,17,11,1,10,7,30,5,0,"https://fbref.com/en/players/abe66106/Erik-Lamela"
2018,"Tottenham","Premier League","Fernando Llorente","ESP","FW,MF","32",1985,2.6,6,3,1,2,3,1,2,50,1,0,0,0,0,6,6,0,"https://fbref.com/en/players/82dbf623/Fernando-Llorente"
2018,"Tottenham","Premier League","Hugo Lloris","FRA","GK","30",1986,36,1,1,1,0,0,1,4,25,3,0,0,0,2,3,34,8,"https://fbref.com/en/players/8f62b6ee/Hugo-Lloris"
2018,"Tottenham","Premier League","Lucas Moura","BRA","FW,MF","24",1992,2.3,4,2,3,0,1,1,3,33.3,2,2,0,2,2,6,2,0,"https://fbref.com/en/players/2b622f01/Lucas-Moura"
2018,"Tottenham","Premier League","Georges-Kévin N'Koudou","CMR","MF","22",1995,0,0,0,0,0,0,0,0,NA,0,0,0,0,0,0,1,0,"https://fbref.com/en/players/76c131da/Georges-Kevin-NKoudou"
2018,"Tottenham","Premier League","Danny Rose","ENG","DF","27",1990,8.9,15,11,6,7,2,8,15,53.3,7,12,6,6,9,24,15,0,"https://fbref.com/en/players/89d10e53/Danny-Rose"
2018,"Tottenham","Premier League","Davinson Sánchez","COL","DF","21",1996,28.2,38,24,28,9,1,18,40,45,22,26,10,16,38,76,162,0,"https://fbref.com/en/players/da7b447d/Davinson-Sanchez"
2018,"Tottenham","Premier League","Moussa Sissoko","FRA","MF,FW","27",1989,15.4,23,17,14,5,4,9,12,75,3,11,1,10,9,32,23,1,"https://fbref.com/en/players/2acd49b9/Moussa-Sissoko"
2018,"Tottenham","Premier League","Kieran Trippier","ENG","DF","26",1990,21.3,52,30,29,21,2,21,44,47.7,23,31,6,25,20,72,53,1,"https://fbref.com/en/players/21512407/Kieran-Trippier"
2018,"Tottenham","Premier League","Jan Vertonghen","BEL","DF","30",1987,35.6,64,41,40,20,4,25,36,69.4,11,29,11,18,60,124,177,0,"https://fbref.com/en/players/ba23a904/Jan-Vertonghen"
2018,"Tottenham","Premier League","Michel Vorm","NED","GK","33",1983,1,0,0,0,0,0,0,0,NA,0,0,0,0,0,0,1,0,"https://fbref.com/en/players/1bebde9d/Michel-Vorm"
2018,"Tottenham","Premier League","Kyle Walker-Peters","ENG","DF","20",1997,2.1,5,4,4,1,0,2,4,50,2,2,0,2,3,8,8,0,"https://fbref.com/en/players/984a5a64/Kyle-Walker-Peters"
2018,"Tottenham","Premier League","Victor Wanyama","KEN","MF","26",1991,9.4,30,20,13,16,1,14,31,45.2,17,13,3,10,10,40,20,1,"https://fbref.com/en/players/e0900238/Victor-Wanyama"
2018,"Tottenham","Premier League","Harry Winks","ENG","MF","21",1996,8.6,15,12,8,5,2,8,16,50,8,12,2,10,11,26,10,1,"https://fbref.com/en/players/2f7acede/Harry-Winks"
2018,"Toulouse","Ligue 1","Kelvin Amian","FRA","DF","19",1998,35,59,43,45,10,4,22,31,71,9,25,7,18,45,104,127,1,"https://fbref.com/en/players/bcc81786/Kelvin-Amian"
2018,"Toulouse","Ligue 1","Alexis Blin","FRA","MF","20",1996,21,57,37,23,30,4,22,69,31.9,47,27,6,21,31,88,31,0,"https://fbref.com/en/players/c69ef855/Alexis-Blin"
2018,"Toulouse","Ligue 1","Yann Bodiger","FRA","MF","22",1995,2.5,3,1,0,3,0,1,6,16.7,5,0,0,0,2,5,3,0,"https://fbref.com/en/players/8c2c48a9/Yann-Bodiger"
2018,"Toulouse","Ligue 1","Quentin Boisgard","FRA","MF","20",1997,2,2,2,0,2,0,0,3,0,3,2,0,2,0,2,1,0,"https://fbref.com/en/players/f6496133/Quentin-Boisgard"
2018,"Toulouse","Ligue 1","Yannick Cahuzac","FRA","MF","32",1985,16.9,39,28,20,19,0,15,26,57.7,11,29,10,19,30,69,42,0,"https://fbref.com/en/players/677ee102/Yannick-Cahuzac"
2018,"Toulouse","Ligue 1","Andy Delort","ALG","FW","25",1991,25.9,20,13,2,9,9,4,19,21.1,15,10,0,10,12,32,22,0,"https://fbref.com/en/players/d33c706e/Andy-Delort"
2018,"Toulouse","Ligue 1","Issa Diop","FRA","DF","20",1997,34,58,43,35,22,1,21,48,43.8,27,38,25,13,76,134,128,0,"https://fbref.com/en/players/a712ca2b/Issa-Diop"
2018,"Toulouse","Ligue 1","Jimmy Durmaz","SWE","MF,FW","28",1989,11.4,16,9,5,5,6,6,14,42.9,8,2,0,2,14,30,9,0,"https://fbref.com/en/players/f09a8b75/Jimmy-Durmaz"
2018,"Toulouse","Ligue 1","Steven Fortes","CPV","DF","25",1992,1.7,4,2,3,1,0,1,3,33.3,2,0,0,0,3,7,6,0,"https://fbref.com/en/players/574aa9ec/Steven-Fortes"
2018,"Toulouse","Ligue 1","Max Gradel","CIV","FW,MF","29",1987,26.8,63,36,28,21,14,24,72,33.3,48,39,2,37,14,77,30,0,"https://fbref.com/en/players/c5a500ca/Max-Gradel"
2018,"Toulouse","Ligue 1","Giannelli Imbula","COD","MF","24",1992,24.9,29,19,10,15,4,7,29,24.1,22,17,2,15,20,49,13,3,"https://fbref.com/en/players/b86fe156/Giannelli-Imbula"
2018,"Toulouse","Ligue 1","Corentin Jean","FRA","FW,MF","22",1995,18.8,12,8,4,7,1,5,21,23.8,16,14,1,13,14,26,10,0,"https://fbref.com/en/players/7d9b37bf/Corentin-Jean"
2018,"Toulouse","Ligue 1","Christopher Jullien","FRA","DF","24",1993,28.9,36,25,27,9,0,15,32,46.9,17,29,19,10,40,76,182,5,"https://fbref.com/en/players/f323d995/Christopher-Jullien"
2018,"Toulouse","Ligue 1","Driss Khalid","MAR","FW","18",1999,0.3,1,0,0,0,1,0,0,NA,0,0,0,0,0,1,2,0,"https://fbref.com/en/players/abccacf7/Driss-Khalid"
2018,"Toulouse","Ligue 1","Alban Lafont","FRA","GK","18",1999,38,1,0,1,0,0,1,4,25,3,0,0,0,2,3,20,5,"https://fbref.com/en/players/4e7db402/Alban-Lafont"
2018,"Toulouse","Ligue 1","Zinédine Machach","FRA","FW,MF","21",1996,2.1,7,3,5,1,1,4,5,80,1,1,0,1,2,9,2,0,"https://fbref.com/en/players/31377e38/Zinedine-Machach"
2018,"Toulouse","Ligue 1","Clément Michelin","FRA","DF","20",1997,3.1,11,7,7,4,0,7,11,63.6,4,3,1,2,4,15,12,0,"https://fbref.com/en/players/cb9ec45d/Clement-Michelin"
2018,"Toulouse","Ligue 1","François Moubandje","SUI","DF","27",1990,18.9,28,15,20,7,1,10,34,29.4,24,23,7,16,27,55,75,0,"https://fbref.com/en/players/6ca88b2a/Francois-Moubandje"
2018,"Toulouse","Ligue 1","Ndombe Mubele","COD","FW,MF","23",1994,4.1,8,4,6,2,0,4,10,40,6,11,0,11,9,17,4,0,"https://fbref.com/en/players/176674ab/Ndombe-Mubele"
2018,"Toulouse","Ligue 1","Ibrahim Sangaré","CIV","MF","19",1997,17.6,72,47,35,34,3,29,69,42,40,33,7,26,24,96,19,1,"https://fbref.com/en/players/bced0375/Ibrahim-Sangare"
2018,"Toulouse","Ligue 1","Yaya Sanogo","FRA","FW","24",1993,16.8,11,6,1,5,5,3,11,27.3,8,6,1,5,6,17,14,1,"https://fbref.com/en/players/11ced928/Yaya-Sanogo"
2018,"Toulouse","Ligue 1","Somália","BRA","MF,FW","28",1988,22.2,65,45,21,36,8,14,54,25.9,40,34,2,32,34,99,35,0,"https://fbref.com/en/players/c1febb46/Somalia"
2018,"Toulouse","Ligue 1","Issiaga Sylla","GUI","DF,FW","23",1994,17.8,44,32,22,16,6,19,47,40.4,28,31,4,27,34,78,65,1,"https://fbref.com/en/players/b99bec05/Issiaga-Sylla"
2018,"Toulouse","Ligue 1","Ola Toivonen","SWE","FW,MF","31",1986,8.9,4,4,1,0,3,0,7,0,7,2,0,2,2,6,12,0,"https://fbref.com/en/players/de4fe7a2/Ola-Toivonen"
2018,"Toulouse","Ligue 1","Steeve Yago","BFA","DF","24",1992,17.5,49,36,28,17,4,20,37,54.1,17,16,7,9,34,83,64,1,"https://fbref.com/en/players/7f9111ea/Steeve-Yago"
2018,"Troyes","Ligue 1","Karim Azamoum","FRA","MF","27",1990,25,84,57,41,37,6,27,68,39.7,41,30,11,19,26,110,61,3,"https://fbref.com/en/players/eaf71a5e/Karim-Azamoum"
2018,"Troyes","Ligue 1","François Bellugou","FRA","MF","30",1987,24.2,48,33,23,21,4,21,49,42.9,28,20,6,14,28,76,45,0,"https://fbref.com/en/players/2174bc8d/Francois-Bellugou"
2018,"Troyes","Ligue 1","Chaouki Ben Saada","TUN","FW,MF","33",1984,3.8,11,8,5,3,3,2,11,18.2,9,3,0,3,2,13,3,0,"https://fbref.com/en/players/61d618fa/Chaouki-Ben-Saada"
2018,"Troyes","Ligue 1","Alois Confais","FRA","MF,DF","20",1996,6.8,8,6,7,1,0,3,9,33.3,6,7,4,3,4,12,15,1,"https://fbref.com/en/players/535b0343/Alois-Confais"
2018,"Troyes","Ligue 1","Jérémy Cordoval","GLP","DF","27",1990,10.2,20,16,12,7,1,9,14,64.3,5,12,2,10,9,29,35,0,"https://fbref.com/en/players/7d45b97a/Jeremy-Cordoval"
2018,"Troyes","Ligue 1","Stéphane Darbion","FRA","FW,MF","33",1984,19,19,14,13,4,2,5,40,12.5,35,21,2,19,20,39,17,0,"https://fbref.com/en/players/75d97aa6/Stephane-Darbion"
2018,"Troyes","Ligue 1","Mathieu Deplagne","FRA","DF","25",1991,26.8,52,38,33,14,5,20,48,41.7,28,26,10,16,60,112,95,2,"https://fbref.com/en/players/ff16ecad/Mathieu-Deplagne"
2018,"Troyes","Ligue 1","Tristan Dingomé","CMR","MF","26",1991,13.2,25,20,12,9,4,5,13,38.5,8,12,0,12,12,37,16,1,"https://fbref.com/en/players/92b56413/Tristan-Dingome"
2018,"Troyes","Ligue 1","Gabriel Dos Santos","BRA","DF","19",1997,0.9,1,1,1,0,0,0,1,0,1,2,1,1,0,1,4,1,"https://fbref.com/en/players/67ac5bb8/Gabriel-Dos-Santos"
2018,"Troyes","Ligue 1","Jimmy Giraudon","FRA","DF","25",1992,23.2,26,16,20,6,0,10,16,62.5,6,30,22,8,31,57,128,2,"https://fbref.com/en/players/6ba71da5/Jimmy-Giraudon"
2018,"Troyes","Ligue 1","Samuel Grandsir","FRA","FW,MF","20",1996,28.9,69,43,39,18,12,21,73,28.8,52,31,3,28,23,92,19,1,"https://fbref.com/en/players/d2448564/Samuel-Grandsir"
2018,"Troyes","Ligue 1","Christophe Hérelle","MTQ","DF","24",1992,32.9,39,26,27,12,0,16,30,53.3,14,38,27,11,56,95,241,1,"https://fbref.com/en/players/3681cfff/Christophe-Herelle"
2018,"Troyes","Ligue 1","Suk Hyun-jun","KOR","FW","26",1991,13.3,6,5,2,2,2,1,9,11.1,8,10,0,10,1,7,7,0,"https://fbref.com/en/players/7ffaf233/Suk-Hyun-jun"
2018,"Troyes","Ligue 1","Saîf-Eddine Khaoui","TUN","MF,FW","22",1995,21.7,57,25,22,27,8,15,50,30,35,12,2,10,27,84,9,0,"https://fbref.com/en/players/796b1c41/Saif-Eddine-Khaoui"
2018,"Troyes","Ligue 1","Bryan Mbeumo","CMR","FW,MF","17",1999,0.7,0,0,0,0,0,0,3,0,3,2,0,2,0,0,2,0,"https://fbref.com/en/players/6afaebf2/Bryan-Mbeumo"
2018,"Troyes","Ligue 1","Adama Niane","MLI","FW","24",1993,24,22,12,5,10,7,6,26,23.1,20,11,2,9,9,31,13,0,"https://fbref.com/en/players/1ac3b888/Adama-Niane"
2018,"Troyes","Ligue 1","Benjamin Nivet","FRA","MF,FW","40",1977,15.2,31,14,12,14,5,11,51,21.6,40,18,1,17,16,47,20,0,"https://fbref.com/en/players/1ec4e202/Benjamin-Nivet"
2018,"Troyes","Ligue 1","Johann Obiang","GAB","DF","24",1993,5.2,13,9,9,2,2,6,13,46.2,7,9,1,8,7,20,15,0,"https://fbref.com/en/players/c3512013/Johann-Obiang"
2018,"Troyes","Ligue 1","Bryan Pelé","FRA","FW,MF","25",1992,17.9,20,9,9,8,3,4,28,14.3,24,11,0,11,15,35,13,0,"https://fbref.com/en/players/88615858/Bryan-Pele"
2018,"Troyes","Ligue 1","Mamadou Samassa","MLI","GK","27",1990,21,0,0,0,0,0,0,2,0,2,0,0,0,0,0,12,3,"https://fbref.com/en/players/cfe852d8/Mamadou-Samassa"
2018,"Troyes","Ligue 1","Jonathan Tinhan","BEN","MF,FW","28",1989,0.8,1,0,0,1,0,0,1,0,1,1,0,1,1,2,0,0,"https://fbref.com/en/players/871fc5f8/Jonathan-Tinhan"
2018,"Troyes","Ligue 1","Charles Traore","MLI","DF","25",1992,33.3,60,32,46,9,5,26,56,46.4,30,52,16,36,57,117,171,0,"https://fbref.com/en/players/de488e56/Charles-Traore"
2018,"Troyes","Ligue 1","Oswaldo Vizcarrondo","VEN","DF","33",1984,19.1,21,15,17,3,1,14,37,37.8,23,18,16,2,20,41,129,2,"https://fbref.com/en/players/446aa6e1/Oswaldo-Vizcarrondo"
2018,"Troyes","Ligue 1","Rémi Walter","FRA","MF","22",1995,11.1,23,10,9,13,1,2,23,8.7,21,7,3,4,11,34,14,0,"https://fbref.com/en/players/0984c5d5/Remi-Walter"
2018,"Troyes","Ligue 1","Erwin Zelazny","FRA","GK","25",1991,17,1,1,1,0,0,1,2,50,1,0,0,0,2,3,10,1,"https://fbref.com/en/players/e750cba4/Erwin-Zelazny"
2018,"Udinese","Serie A","Ali Adnan Kadhim","IRQ","DF,FW","23",1993,18.6,54,35,35,14,5,29,50,58,21,31,6,25,41,95,90,0,"https://fbref.com/en/players/06050480/Ali-Adnan-Kadhim"
2018,"Udinese","Serie A","Gabriele Angella","ITA","DF","28",1989,9.9,15,13,11,3,1,8,11,72.7,3,11,9,2,21,36,66,0,"https://fbref.com/en/players/0c971997/Gabriele-Angella"
2018,"Udinese","Serie A","Riad Bajić","BIH","FW,MF","23",1994,0.9,0,0,0,0,0,0,0,NA,0,0,0,0,0,0,3,0,"https://fbref.com/en/players/49d399d5/Riad-Bajic"
2018,"Udinese","Serie A","Andrija Balić","CRO","MF","19",1997,12,18,9,5,12,1,8,27,29.6,19,6,3,3,16,34,13,0,"https://fbref.com/en/players/9be4ee80/Andrija-Balic"
2018,"Udinese","Serie A","Antonín Barák","CZE","MF","22",1994,30.1,58,38,22,27,9,21,58,36.2,37,34,2,32,18,76,26,1,"https://fbref.com/en/players/01efac19/Antonin-Barak"
2018,"Udinese","Serie A","Valon Behrami","SUI","MF","32",1985,15.5,63,46,30,27,6,8,44,18.2,36,47,15,32,22,85,19,0,"https://fbref.com/en/players/d3d758d8/Valon-Behrami"
2018,"Udinese","Serie A","Albano Bizzarri","ARG","GK","39",1977,32,2,2,2,0,0,2,2,100,0,0,0,0,1,3,12,4,"https://fbref.com/en/players/32b9b5fa/Albano-Bizzarri"
2018,"Udinese","Serie A","Rodrigo De Paul","ARG","FW,MF","23",1994,25.8,31,18,10,17,4,4,32,12.5,28,34,1,33,16,47,8,0,"https://fbref.com/en/players/162efffd/Rodrigo-De-Paul"
2018,"Udinese","Serie A","Seko Fofana","CIV","MF","22",1995,20.8,20,17,8,12,0,4,20,20,16,17,3,14,27,47,26,1,"https://fbref.com/en/players/5313ed43/Seko-Fofana"
2018,"Udinese","Serie A","Emil Hallfreðsson","ISL","MF","33",1984,8.5,19,14,9,7,3,7,24,29.2,17,13,2,11,20,39,16,0,"https://fbref.com/en/players/86015b20/Emil-Hallfredsson"
2018,"Udinese","Serie A","Svante Ingelsson","SWE","MF","19",1998,3.6,9,6,3,3,3,2,10,20,8,4,0,4,6,15,4,0,"https://fbref.com/en/players/4133cfcf/Svante-Ingelsson"
2018,"Udinese","Serie A","Jakub Jankto","CZE","MF,FW","21",1996,29.5,29,18,9,14,6,10,46,21.7,36,46,8,38,20,49,27,0,"https://fbref.com/en/players/1ea5f91c/Jakub-Jankto"
2018,"Udinese","Serie A","Danilo Larangeira","BRA","DF","33",1984,30.8,35,21,26,8,1,16,29,55.2,13,50,38,12,50,85,161,2,"https://fbref.com/en/players/fed5f993/Danilo-Larangeira"
2018,"Udinese","Serie A","Kevin Lasagna","ITA","FW","24",1992,23.7,10,7,0,8,2,2,7,28.6,5,27,4,23,8,18,18,0,"https://fbref.com/en/players/09538fdb/Kevin-Lasagna"
2018,"Udinese","Serie A","Maxi López","ARG","FW","33",1984,18.7,12,8,2,7,3,0,4,0,4,8,2,6,2,14,18,0,"https://fbref.com/en/players/ad469944/Maxi-Lopez"
2018,"Udinese","Serie A","Ryder Matos","BRA","MF","24",1993,1.9,3,1,1,1,1,1,1,100,0,2,0,2,2,5,3,0,"https://fbref.com/en/players/7280b54f/Ryder-Matos"
2018,"Udinese","Serie A","Bram Nuytinck","NED","DF","27",1990,26.2,65,41,40,24,1,25,39,64.1,14,43,24,19,37,102,124,1,"https://fbref.com/en/players/e33f36d5/Bram-Nuytinck"
2018,"Udinese","Serie A","Stipe Perica","CRO","FW","22",1995,10.5,8,5,2,5,1,2,13,15.4,11,7,1,6,3,11,9,0,"https://fbref.com/en/players/269b4638/Stipe-Perica"
2018,"Udinese","Serie A","Giuseppe Pezzella","ITA","DF,FW","19",1997,10,19,11,10,4,5,7,19,36.8,12,8,1,7,6,25,32,0,"https://fbref.com/en/players/149c5f5d/Giuseppe-Pezzella"
2018,"Udinese","Serie A","Simone Pontisso","ITA","MF","20",1997,0.1,1,0,0,1,0,0,0,NA,0,0,0,0,0,1,0,0,"https://fbref.com/en/players/8a2d3fdb/Simone-Pontisso"
2018,"Udinese","Serie A","Samir Santos","BRA","DF","22",1994,28.5,55,38,35,17,3,19,38,50,19,33,16,17,75,130,161,1,"https://fbref.com/en/players/92b4758e/Samir-Santos"
2018,"Udinese","Serie A","Simone Scuffet","ITA","GK","21",1996,6,0,0,0,0,0,0,0,NA,0,0,0,0,1,1,1,1,"https://fbref.com/en/players/41bd99ea/Simone-Scuffet"
2018,"Udinese","Serie A","Jens Stryger Larsen","DEN","DF","26",1991,28.1,36,27,25,10,1,21,39,53.8,18,35,14,21,31,67,82,2,"https://fbref.com/en/players/f91e81c9/Jens-Stryger-Larsen"
2018,"Udinese","Serie A","Cyril Théréau","FRA","FW,MF","34",1983,2,1,1,1,0,0,1,2,50,1,0,0,0,0,1,2,0,"https://fbref.com/en/players/4d3ab428/Cyril-Thereau"
2018,"Udinese","Serie A","Molla Wagué","MLI","DF","26",1991,0.6,1,0,0,1,0,0,0,NA,0,0,0,0,2,3,5,0,"https://fbref.com/en/players/a440d8ca/Molla-Wague"
2018,"Udinese","Serie A","Silvan Widmer","SUI","DF,FW","24",1993,18.1,45,32,30,15,0,22,40,55,18,22,5,17,28,73,59,0,"https://fbref.com/en/players/f68b64fc/Silvan-Widmer"
2018,"Udinese","Serie A","Francesco Zampano","ITA","DF","23",1993,4.6,9,7,5,3,1,5,10,50,5,4,0,4,6,15,7,0,"https://fbref.com/en/players/8e45910b/Francesco-Zampano"
2018,"Valencia","La Liga","João Cancelo","POR","MF","23",1994,1,1,1,0,1,0,1,1,100,0,1,0,1,2,3,0,0,"https://fbref.com/en/players/bd6351cd/Joao-Cancelo"
2018,"Valencia","La Liga","Francis Coquelin","FRA","MF,DF","26",1991,7.3,18,14,11,6,1,9,16,56.3,7,9,2,7,20,38,23,0,"https://fbref.com/en/players/a6951bf8/Francis-Coquelin"
2018,"Valencia","La Liga","Jaume Doménech","ESP","GK","26",1990,5,0,0,0,0,0,0,0,NA,0,0,0,0,0,0,2,0,"https://fbref.com/en/players/c9cb972b/Jaume-Domenech"
2018,"Valencia","La Liga","Ezequiel Garay","ARG","DF","30",1986,22.5,18,12,15,3,0,10,14,71.4,4,22,11,11,24,42,139,0,"https://fbref.com/en/players/ac3fb1be/Ezequiel-Garay"
2018,"Valencia","La Liga","Nacho Gil","ESP","MF","21",1995,2.5,6,1,2,4,0,1,8,12.5,7,6,0,6,2,8,2,0,"https://fbref.com/en/players/87ec1a2a/Nacho-Gil"
2018,"Valencia","La Liga","Gonçalo Guedes","POR","MF","20",1996,27.1,38,26,18,15,5,16,51,31.4,35,22,0,22,16,54,10,0,"https://fbref.com/en/players/e6bc67d7/Goncalo-Guedes"
2018,"Valencia","La Liga","Geoffrey Kondogbia","CTA","MF","24",1993,29,88,57,38,43,7,23,68,33.8,45,46,14,32,62,150,66,0,"https://fbref.com/en/players/cce181df/Geoffrey-Kondogbia"
2018,"Valencia","La Liga","Toni Lato","ESP","DF,MF","19",1997,8.9,30,16,22,6,2,16,27,59.3,11,9,3,6,9,39,23,0,"https://fbref.com/en/players/8e088e04/Toni-Lato"
2018,"Valencia","La Liga","José Luis Gayà","ESP","DF","22",1995,32.4,77,60,52,22,3,43,68,63.2,25,43,12,31,56,133,90,1,"https://fbref.com/en/players/b05e2dbd/Jose-Luis-Gaya"
2018,"Valencia","La Liga","Nemanja Maksimović","SRB","MF","22",1995,6.2,21,13,10,8,3,8,16,50,8,15,6,9,16,37,8,0,"https://fbref.com/en/players/00b28772/Nemanja-Maksimovic"
2018,"Valencia","La Liga","Álvaro Medrán","ESP","MF","23",1994,0.8,1,1,1,0,0,1,2,50,1,0,0,0,3,4,1,0,"https://fbref.com/en/players/31223bcf/Alvaro-Medran"
2018,"Valencia","La Liga","Santi Mina","ESP","FW","21",1995,17.3,17,9,4,9,4,4,22,18.2,18,14,1,13,2,19,19,0,"https://fbref.com/en/players/0b90bb97/Santi-Mina"
2018,"Valencia","La Liga","Martín Montoya","ESP","DF","26",1991,23.9,66,48,36,22,8,30,55,54.5,25,35,10,25,53,119,89,0,"https://fbref.com/en/players/5cec2487/Martin-Montoya"
2018,"Valencia","La Liga","Jeison Murillo","COL","DF","25",1992,15.3,31,24,25,6,0,14,21,66.7,7,18,9,9,29,60,85,1,"https://fbref.com/en/players/b233e8e4/Jeison-Murillo"
2018,"Valencia","La Liga","Neto","BRA","GK","28",1989,33,1,1,1,0,0,1,2,50,1,1,0,1,1,2,8,3,"https://fbref.com/en/players/a9dc785c/Neto"
2018,"Valencia","La Liga","Daniel Parejo","ESP","MF","28",1989,33.3,88,57,35,43,10,31,87,35.6,56,37,10,27,34,122,27,1,"https://fbref.com/en/players/7460ca0d/Daniel-Parejo"
2018,"Valencia","La Liga","Gabriel Paulista","BRA","DF","26",1990,28.7,47,27,41,4,2,32,46,69.6,14,30,14,16,51,98,142,2,"https://fbref.com/en/players/b7ca5c51/Gabriel-Paulista"
2018,"Valencia","La Liga","Andreas Pereira","BRA","MF","21",1996,12,26,15,12,11,3,10,30,33.3,20,9,1,8,11,37,5,0,"https://fbref.com/en/players/6639e500/Andreas-Pereira"
2018,"Valencia","La Liga","Rodrigo","ESP","FW","26",1991,29.8,23,13,9,12,2,3,21,14.3,18,14,2,12,17,40,11,1,"https://fbref.com/en/players/1fb1c435/Rodrigo"
2018,"Valencia","La Liga","Carlos Soler","ESP","MF","20",1997,26.3,51,32,21,21,9,22,53,41.5,31,25,1,24,5,56,19,0,"https://fbref.com/en/players/fed17f5a/Carlos-Soler"
2018,"Valencia","La Liga","Ferrán Torres","ESP","MF","17",2000,3.5,8,7,3,5,0,2,6,33.3,4,1,0,1,3,11,1,0,"https://fbref.com/en/players/9e1035f8/Ferran-Torres"
2018,"Valencia","La Liga","Rúben Vezo","POR","DF","23",1994,17.3,43,24,30,12,1,16,32,50,16,25,9,16,23,66,83,0,"https://fbref.com/en/players/c67cd65c/Ruben-Vezo"
2018,"Valencia","La Liga","Nacho Vidal","ESP","DF","22",1995,5,17,14,15,1,1,14,22,63.6,8,5,2,3,10,27,18,0,"https://fbref.com/en/players/3a9c4b7b/Nacho-Vidal"
2018,"Valencia","La Liga","Luciano Vietto","ARG","FW","23",1993,5.9,8,6,2,3,3,1,4,25,3,3,0,3,2,10,5,0,"https://fbref.com/en/players/2513a588/Luciano-Vietto"
2018,"Valencia","La Liga","Simone Zaza","ITA","FW","26",1991,23.1,21,14,4,10,7,1,20,5,19,26,1,25,8,29,34,0,"https://fbref.com/en/players/9592289a/Simone-Zaza"
2018,"Villarreal","La Liga","Sergio Asenjo","ESP","GK","28",1989,23,2,2,2,0,0,1,5,20,4,0,0,0,0,2,11,2,"https://fbref.com/en/players/9f0ea33f/Sergio-Asenjo"
2018,"Villarreal","La Liga","Carlos Bacca","COL","FW","30",1986,27.7,10,2,2,4,4,1,12,8.3,11,16,1,15,8,18,16,0,"https://fbref.com/en/players/09a9e921/Carlos-Bacca"
2018,"Villarreal","La Liga","Cédric Bakambu","COD","FW","26",1991,14,10,7,3,6,1,1,7,14.3,6,9,1,8,3,13,27,0,"https://fbref.com/en/players/0af4dcf0/Cedric-Bakambu"
2018,"Villarreal","La Liga","Mariano Barbosa","ARG","GK","33",1984,12.5,0,0,0,0,0,0,0,NA,0,0,0,0,1,1,4,0,"https://fbref.com/en/players/aad4f74f/Mariano-Barbosa"
2018,"Villarreal","La Liga","Daniele Bonera","ITA","DF","36",1981,13.2,16,11,8,7,1,10,15,66.7,5,17,12,5,12,28,72,0,"https://fbref.com/en/players/13b0c150/Daniele-Bonera"
2018,"Villarreal","La Liga","Samu Castillejo","ESP","MF,FW","22",1995,23,41,28,22,10,9,13,62,21,49,39,5,34,22,63,37,0,"https://fbref.com/en/players/130a7a3f/Samu-Castillejo"
2018,"Villarreal","La Liga","Denis Cheryshev","RUS","MF,FW","26",1990,10.3,27,16,12,10,5,6,23,26.1,17,18,1,17,13,40,10,0,"https://fbref.com/en/players/0ac94a23/Denis-Cheryshev"
2018,"Villarreal","La Liga","Chuca","ESP","MF","20",1997,1,1,0,1,0,0,1,3,33.3,2,1,1,0,1,2,1,1,"https://fbref.com/en/players/c4af5889/Chuca"
2018,"Villarreal","La Liga","Jaume Costa","ESP","DF","29",1988,28.2,67,43,39,22,6,33,51,64.7,18,30,8,22,46,113,97,0,"https://fbref.com/en/players/808d48f3/Jaume-Costa"
2018,"Villarreal","La Liga","Salem Al-Dawsari","KSA","MF","25",1991,0.4,1,0,0,1,0,1,1,100,0,1,0,1,0,1,0,0,"https://fbref.com/en/players/60ee859c/Salem-Al-Dawsari"
2018,"Villarreal","La Liga","Andrés Fernández","ESP","GK","30",1986,2.5,1,0,1,0,0,0,0,NA,0,0,0,0,0,1,4,0,"https://fbref.com/en/players/307fcd26/Andres-Fernandez"
2018,"Villarreal","La Liga","Pablo Fornals","ESP","MF,FW","21",1996,29.1,52,33,19,26,7,18,60,30,42,29,3,26,22,74,18,0,"https://fbref.com/en/players/82927de4/Pablo-Fornals"
2018,"Villarreal","La Liga","Javi Fuego","ESP","MF","33",1984,6,20,13,8,11,1,7,14,50,7,7,4,3,3,23,14,0,"https://fbref.com/en/players/2e8fc160/Javi-Fuego"
2018,"Villarreal","La Liga","Mario Gaspar","ESP","DF","26",1990,31.2,110,66,63,37,10,58,87,66.7,29,58,11,47,58,168,114,0,"https://fbref.com/en/players/fb5d47b3/Mario-Gaspar"
2018,"Villarreal","La Liga","Álvaro González","ESP","DF","27",1990,32.2,38,26,30,7,1,22,41,53.7,19,34,23,11,53,91,188,0,"https://fbref.com/en/players/42dcf26d/Alvaro-Gonzalez"
2018,"Villarreal","La Liga","Mario González","ESP","FW","21",1996,0.2,0,0,0,0,0,0,0,NA,0,1,0,1,0,0,0,0,"https://fbref.com/en/players/d189e48f/Mario-Gonzalez"
2018,"Villarreal","La Liga","Ramiro Guerra","URU","MF","20",1997,0.8,3,2,1,0,2,2,3,66.7,1,0,0,0,0,3,2,0,"https://fbref.com/en/players/07a0baa9/Ramiro-Guerra"
2018,"Villarreal","La Liga","Adrián Marín","ESP","DF","20",1997,2.6,6,4,3,3,0,2,8,25,6,2,0,2,3,9,8,0,"https://fbref.com/en/players/b7f2edff/Adrian-Marin"
2018,"Villarreal","La Liga","Roger Martínez","COL","FW","23",1994,2.6,1,1,0,1,0,0,2,0,2,2,0,2,0,1,1,0,"https://fbref.com/en/players/6f0d613a/Roger-Martinez"
2018,"Villarreal","La Liga","Alfred N'Diaye","SEN","DF,MF","27",1990,1.1,3,1,1,1,1,1,1,100,0,0,0,0,3,6,3,0,"https://fbref.com/en/players/7789bf63/Alfred-NDiaye"
2018,"Villarreal","La Liga","Darío Poveda","ESP","MF","20",1997,0,1,0,0,1,0,1,1,100,0,0,0,0,0,1,0,0,"https://fbref.com/en/players/cbdf7d5c/Dario-Poveda"
2018,"Villarreal","La Liga","Dani Raba","ESP","MF,FW","21",1995,12.3,25,21,9,12,4,9,45,20,36,21,1,20,17,42,10,0,"https://fbref.com/en/players/ea6a7ab4/Dani-Raba"
2018,"Villarreal","La Liga","Rodri","ESP","MF","21",1996,35.9,104,71,50,48,6,30,86,34.9,56,49,21,28,52,156,100,1,"https://fbref.com/en/players/6434f10d/Rodri"
2018,"Villarreal","La Liga","Víctor Ruiz","ESP","DF","28",1989,26.8,33,22,29,4,0,13,25,52,12,27,18,9,58,91,134,1,"https://fbref.com/en/players/b3dc6eca/Victor-Ruiz"
2018,"Villarreal","La Liga","Antonio Rukavina","SRB","DF","33",1984,14.1,25,22,12,9,4,17,25,68,8,11,3,8,16,41,68,0,"https://fbref.com/en/players/e12d7851/Antonio-Rukavina"
2018,"Villarreal","La Liga","Nicola Sansone","ITA","FW,MF","25",1991,7.1,8,4,2,4,2,2,17,11.8,15,1,0,1,1,9,2,0,"https://fbref.com/en/players/7eb97a8e/Nicola-Sansone"
2018,"Villarreal","La Liga","Rúben Semedo","POR","DF,MF","23",1994,2.6,6,5,6,0,0,4,6,66.7,2,5,1,4,5,11,13,2,"https://fbref.com/en/players/c904f3d5/Ruben-Semedo"
2018,"Villarreal","La Liga","Roberto Soriano","ITA","MF,FW","26",1991,12.7,30,20,10,16,4,3,16,18.8,13,14,0,14,4,34,9,0,"https://fbref.com/en/players/9d4c45d6/Roberto-Soriano"
2018,"Villarreal","La Liga","Leonardo Suárez","ARG","MF","21",1996,0.3,0,0,0,0,0,0,0,NA,0,0,0,0,0,0,1,0,"https://fbref.com/en/players/25c72b36/Leonardo-Suarez"
2018,"Villarreal","La Liga","Pau Torres","ESP","DF","20",1997,0.6,0,0,0,0,0,0,1,0,1,1,1,0,0,0,4,0,"https://fbref.com/en/players/532e1e4f/Pau-Torres"
2018,"Villarreal","La Liga","Manu Trigueros","ESP","MF","25",1991,30,61,41,23,34,4,21,71,29.6,50,38,13,25,22,83,44,0,"https://fbref.com/en/players/963829d0/Manu-Trigueros"
2018,"Villarreal","La Liga","Enes Ünal","TUR","FW","20",1997,12.5,9,5,0,4,5,0,12,0,12,16,3,13,4,13,11,0,"https://fbref.com/en/players/f8eca1b6/Enes-Unal"
2018,"Watford","Premier League","Nordin Amrabat","MAR","FW","30",1987,2.2,6,3,1,5,0,1,3,33.3,2,1,0,1,0,6,2,0,"https://fbref.com/en/players/7c2a398c/Nordin-Amrabat"
2018,"Watford","Premier League","Miguel Britos","URU","DF","32",1985,8.9,15,11,10,5,0,6,11,54.5,5,9,1,8,12,27,45,1,"https://fbref.com/en/players/356a9a62/Miguel-Britos"
2018,"Watford","Premier League","Étienne Capoue","FRA","MF","29",1988,17.1,43,26,15,25,3,19,47,40.4,28,21,1,20,43,86,38,0,"https://fbref.com/en/players/5acc4a10/Etienne-Capoue"
2018,"Watford","Premier League","André Carrillo","PER","FW,MF","26",1991,17.1,31,24,16,12,3,8,33,24.2,25,7,0,7,15,46,16,0,"https://fbref.com/en/players/7527558b/Andre-Carrillo"
2018,"Watford","Premier League","Craig Cathcart","NIR","DF","28",1989,5.8,8,5,5,3,0,4,5,80,1,8,6,2,3,11,38,0,"https://fbref.com/en/players/89e4b358/Craig-Cathcart"
2018,"Watford","Premier League","Nathaniel Chalobah","ENG","MF","22",1994,5,9,6,2,6,1,2,5,40,3,6,5,1,6,15,6,0,"https://fbref.com/en/players/422862ea/Nathaniel-Chalobah"
2018,"Watford","Premier League","Tom Cleverley","ENG","MF","27",1989,21.1,48,26,25,16,7,21,52,40.4,31,11,1,10,25,73,21,0,"https://fbref.com/en/players/6cdd8245/Tom-Cleverley"
2018,"Watford","Premier League","Troy Deeney","ENG","FW","29",1988,20.5,15,11,3,8,4,3,11,27.3,8,14,1,13,5,20,20,0,"https://fbref.com/en/players/82e34b69/Troy-Deeney"
2018,"Watford","Premier League","Gerard Deulofeu","ESP","FW,MF","23",1994,4.8,5,3,2,2,1,2,11,18.2,9,0,0,0,4,9,3,1,"https://fbref.com/en/players/39583cfd/Gerard-Deulofeu"
2018,"Watford","Premier League","Abdoulaye Doucouré","MLI","MF","24",1993,36.9,79,52,28,42,9,27,79,34.2,52,43,10,33,54,133,61,0,"https://fbref.com/en/players/02b29014/Abdoulaye-Doucoure"
2018,"Watford","Premier League","Kiko Femenía","ESP","DF,FW","26",1991,19,36,28,22,11,3,14,27,51.9,13,15,2,13,34,70,31,1,"https://fbref.com/en/players/e5d01ecf/Kiko-Femenia"
2018,"Watford","Premier League","Heurelho Gomes","BRA","GK","36",1981,23.6,0,0,0,0,0,0,1,0,1,1,0,1,2,2,15,3,"https://fbref.com/en/players/d596e193/Heurelho-Gomes"
2018,"Watford","Premier League","Andre Gray","JAM","FW","26",1991,16.6,2,1,0,1,1,0,3,0,3,11,0,11,4,6,3,0,"https://fbref.com/en/players/c24dba2a/Andre-Gray"
2018,"Watford","Premier League","José Holebas","GRE","DF","33",1984,26.5,51,31,34,14,3,18,44,40.9,26,24,8,16,29,80,95,2,"https://fbref.com/en/players/12aa7661/Jose-Holebas"
2018,"Watford","Premier League","Will Hughes","ENG","MF","22",1995,11,34,18,7,18,9,9,19,47.4,10,16,1,15,15,49,6,0,"https://fbref.com/en/players/a0666d3e/Will-Hughes"
2018,"Watford","Premier League","Daryl Janmaat","NED","DF","28",1989,20.2,46,31,29,10,7,22,52,42.3,30,16,5,11,33,79,61,0,"https://fbref.com/en/players/45da6694/Daryl-Janmaat"
2018,"Watford","Premier League","Christian Kabasele","BEL","DF","26",1991,25.9,42,25,28,14,0,21,36,58.3,15,37,23,14,34,76,185,0,"https://fbref.com/en/players/914ab9a1/Christian-Kabasele"
2018,"Watford","Premier League","Younès Kaboul","FRA","DF","31",1986,1.7,3,2,0,3,0,0,0,NA,0,4,2,2,2,5,15,0,"https://fbref.com/en/players/3680d723/Younes-Kaboul"
2018,"Watford","Premier League","Orestis Karnezis","GRE","GK","32",1985,14.4,0,0,0,0,0,0,2,0,2,0,0,0,1,1,3,3,"https://fbref.com/en/players/85b011bb/Orestis-Karnezis"
2018,"Watford","Premier League","Dodi Lukebakio","BEL","MF,FW","19",1997,0.2,1,0,1,0,0,0,0,NA,0,0,0,0,0,1,0,0,"https://fbref.com/en/players/0c61c77c/Dodi-Lukebakio"
2018,"Watford","Premier League","Adrian Mariappa","JAM","DF","30",1986,24.6,45,26,33,12,0,14,34,41.2,20,25,16,9,45,90,133,4,"https://fbref.com/en/players/8aa5f52c/Adrian-Mariappa"
2018,"Watford","Premier League","Stefano Okaka","ITA","FW","27",1989,5,6,4,0,6,0,3,6,50,3,3,0,3,0,6,0,0,"https://fbref.com/en/players/601ef102/Stefano-Okaka"
2018,"Watford","Premier League","Roberto Pereyra","ARG","MF,FW","26",1991,18,10,8,4,5,1,2,13,15.4,11,16,0,16,9,19,6,0,"https://fbref.com/en/players/75f2c59f/Roberto-Pereyra"
2018,"Watford","Premier League","Sebastian Prödl","AUT","DF","30",1987,17.4,22,17,19,3,0,8,15,53.3,7,20,9,11,31,53,92,1,"https://fbref.com/en/players/f5e6d08d/Sebastian-Prodl"
2018,"Watford","Premier League","Richarlison","BRA","FW,MF","20",1997,31.4,64,44,26,28,10,10,39,25.6,29,39,5,34,24,88,32,1,"https://fbref.com/en/players/fa031b34/Richarlison"
2018,"Watford","Premier League","Jerome Sinclair","ENG","MF,FW","20",1996,0.3,0,0,0,0,0,0,1,0,1,0,0,0,1,1,0,0,"https://fbref.com/en/players/1695c659/Jerome-Sinclair"
2018,"Watford","Premier League","Molla Wagué","MLI","DF","26",1991,4.9,5,3,3,2,0,2,5,40,3,1,0,1,9,14,30,0,"https://fbref.com/en/players/a440d8ca/Molla-Wague"
2018,"Watford","Premier League","Ben Watson","ENG","MF","32",1985,5.1,19,9,9,9,1,10,31,32.3,21,6,1,5,7,26,10,0,"https://fbref.com/en/players/df540668/Ben-Watson"
2018,"Watford","Premier League","Marvin Zeegelaar","NED","DF","26",1990,11,23,18,15,3,5,11,24,45.8,13,5,1,4,20,43,30,0,"https://fbref.com/en/players/8abd0c03/Marvin-Zeegelaar"
2018,"Werder Bremen","Bundesliga","Ludwig Augustinsson","SWE","DF,FW","23",1994,28.1,45,34,22,20,3,22,32,68.8,10,25,3,22,39,84,53,0,"https://fbref.com/en/players/9fec8860/Ludwig-Augustinsson"
2018,"Werder Bremen","Bundesliga","Philipp Bargfrede","GER","MF","28",1989,20.7,60,45,29,30,1,33,55,60,22,35,12,23,47,107,52,0,"https://fbref.com/en/players/3f7cd8f1/Philipp-Bargfrede"
2018,"Werder Bremen","Bundesliga","Fin Bartels","GER","FW","30",1987,12.5,12,9,4,3,5,4,12,33.3,8,5,1,4,7,19,1,1,"https://fbref.com/en/players/acc7b7ec/Fin-Bartels"
2018,"Werder Bremen","Bundesliga","Robert Bauer","GER","DF,FW","22",1995,10.6,31,25,21,9,1,15,25,60,10,8,2,6,21,52,25,2,"https://fbref.com/en/players/9b88e120/Robert-Bauer"
2018,"Werder Bremen","Bundesliga","Ishak Belfodil","ALG","FW","25",1992,15,7,6,2,3,2,0,3,0,3,10,1,9,1,8,9,0,"https://fbref.com/en/players/ff182fdc/Ishak-Belfodil"
2018,"Werder Bremen","Bundesliga","Luca Caldirola","ITA","DF","26",1991,1,1,0,0,1,0,1,1,100,0,1,0,1,3,4,3,0,"https://fbref.com/en/players/226008f1/Luca-Caldirola"
2018,"Werder Bremen","Bundesliga","Thomas Delaney","DEN","MF","25",1991,31.1,79,61,27,46,6,36,53,67.9,17,37,12,25,43,122,74,4,"https://fbref.com/en/players/fe641c1a/Thomas-Delaney"
2018,"Werder Bremen","Bundesliga","Johannes Eggestein","GER","FW,DF","19",1998,1.1,0,0,0,0,0,0,1,0,1,2,1,1,1,1,0,0,"https://fbref.com/en/players/d571df78/Johannes-Eggestein"
2018,"Werder Bremen","Bundesliga","Maximilian Eggestein","GER","MF","20",1996,29.9,70,48,32,34,4,34,58,58.6,24,41,6,35,40,110,51,0,"https://fbref.com/en/players/beb882a8/Maximilian-Eggestein"
2018,"Werder Bremen","Bundesliga","Marco Friedl","AUT","DF,MF","19",1998,6.7,9,8,4,4,1,7,10,70,3,10,1,9,8,17,17,1,"https://fbref.com/en/players/f86ad3f5/Marco-Friedl"
2018,"Werder Bremen","Bundesliga","Ulisses Garcia","SUI","FW","21",1996,1,1,1,1,0,0,1,2,50,1,0,0,0,0,1,3,0,"https://fbref.com/en/players/c952f633/Ulisses-Garcia"
2018,"Werder Bremen","Bundesliga","Theodor Gebre Selassie","CZE","DF,FW","30",1986,31.4,67,41,36,25,6,36,57,63.2,21,34,2,32,51,118,83,1,"https://fbref.com/en/players/3f65898c/Theodor-Gebre-Selassie"
2018,"Werder Bremen","Bundesliga","Jérôme Gondorf","GER","MF,FW","29",1988,8.9,12,9,3,9,0,4,18,22.2,14,11,2,9,6,18,12,0,"https://fbref.com/en/players/49ffe0f2/Jerome-Gondorf"
2018,"Werder Bremen","Bundesliga","Izet Hajrović","BIH","MF,FW","25",1991,2.1,1,0,1,0,0,0,1,0,1,0,0,0,2,3,1,0,"https://fbref.com/en/players/55537f53/Izet-Hajrovic"
2018,"Werder Bremen","Bundesliga","Aron Jóhannsson","USA","MF,FW","26",1990,3.1,4,3,2,2,0,1,7,14.3,6,3,0,3,1,5,5,0,"https://fbref.com/en/players/c0dc9fc7/Aron-Johannsson"
2018,"Werder Bremen","Bundesliga","Zlatko Junuzović","AUT","MF,FW","29",1987,18.1,35,23,17,12,6,18,38,47.4,20,23,2,21,18,53,12,0,"https://fbref.com/en/players/dba67bc4/Zlatko-Junuzovic"
2018,"Werder Bremen","Bundesliga","Florian Kainz","AUT","MF,FW","24",1992,19,33,25,9,18,6,9,19,47.4,10,23,0,23,17,50,13,0,"https://fbref.com/en/players/94c18565/Florian-Kainz"
2018,"Werder Bremen","Bundesliga","Ole Käuper","GER","MF","20",1997,0.8,6,5,2,4,0,1,4,25,3,1,0,1,2,8,0,0,"https://fbref.com/en/players/e5d652c1/Ole-Kauper"
2018,"Werder Bremen","Bundesliga","Max Kruse","GER","FW","29",1988,27.3,17,12,3,10,4,5,22,22.7,17,9,0,9,11,28,4,1,"https://fbref.com/en/players/f9446dcd/Max-Kruse"
2018,"Werder Bremen","Bundesliga","Sebastian Langkamp","GER","DF","29",1988,4.6,7,3,4,3,0,4,4,100,0,7,5,2,8,15,18,0,"https://fbref.com/en/players/74d70fb5/Sebastian-Langkamp"
2018,"Werder Bremen","Bundesliga","Niklas Moisander","FIN","DF","31",1985,25,36,28,22,13,1,24,36,66.7,12,21,9,12,38,74,98,2,"https://fbref.com/en/players/00844823/Niklas-Moisander"
2018,"Werder Bremen","Bundesliga","Jiří Pavlenka","CZE","GK","25",1992,34,1,1,1,0,0,0,0,NA,0,2,0,2,0,1,17,4,"https://fbref.com/en/players/0a1cb833/Jiri-Pavlenka"
2018,"Werder Bremen","Bundesliga","Milot Rashica","KVX","FW,MF","21",1996,4.3,2,2,1,1,0,1,8,12.5,7,3,0,3,3,5,4,0,"https://fbref.com/en/players/6c6a3300/Milot-Rashica"
2018,"Werder Bremen","Bundesliga","Lamine Sané","SEN","DF","30",1987,8.7,19,14,15,4,0,8,10,80,2,8,6,2,20,39,49,1,"https://fbref.com/en/players/125cb9fe/Lamine-Sane"
2018,"Werder Bremen","Bundesliga","Miloš Veljković","SRB","DF","21",1995,29.5,45,32,30,13,2,30,52,57.7,22,34,12,22,34,79,134,1,"https://fbref.com/en/players/a5ae8f8e/Milos-Veljkovic"
2018,"West Brom","Premier League","Gareth Barry","ENG","MF","36",1981,21.4,35,19,17,14,4,15,45,33.3,30,19,11,8,14,49,34,0,"https://fbref.com/en/players/7dbbe367/Gareth-Barry"
2018,"West Brom","Premier League","Chris Brunt","NIR","MF,DF","32",1984,21.3,41,24,19,21,1,11,31,35.5,20,28,4,24,22,63,45,1,"https://fbref.com/en/players/ec7e6ad1/Chris-Brunt"
2018,"West Brom","Premier League","Oliver Burke","SCO","FW,MF","20",1997,4.1,6,4,3,2,1,4,12,33.3,8,3,0,3,7,13,3,0,"https://fbref.com/en/players/f631c17f/Oliver-Burke"
2018,"West Brom","Premier League","Nacer Chadli","BEL","FW,MF","27",1989,2.9,1,0,1,0,0,1,4,25,3,0,0,0,0,1,4,0,"https://fbref.com/en/players/5b54bf3b/Nacer-Chadli"
2018,"West Brom","Premier League","Craig Dawson","ENG","DF","27",1990,27.9,38,28,25,7,6,13,36,36.1,23,39,26,13,52,90,140,0,"https://fbref.com/en/players/3e9e06cb/Craig-Dawson"
2018,"West Brom","Premier League","Jonny Evans","NIR","DF","29",1988,25.2,29,22,19,8,2,14,33,42.4,19,22,13,9,48,77,131,1,"https://fbref.com/en/players/f8fcd2a5/Jonny-Evans"
2018,"West Brom","Premier League","Sam Field","ENG","MF","19",1998,6,14,11,8,4,2,3,10,30,7,6,1,5,11,25,8,0,"https://fbref.com/en/players/bd8a7d05/Sam-Field"
2018,"West Brom","Premier League","Ben Foster","ENG","GK","34",1983,37,1,0,1,0,0,0,7,0,7,0,0,0,1,2,12,1,"https://fbref.com/en/players/d0b3ceb9/Ben-Foster"
2018,"West Brom","Premier League","Kieran Gibbs","ENG","DF","27",1989,31.4,41,24,27,10,4,16,30,53.3,14,32,12,20,48,89,102,0,"https://fbref.com/en/players/46ee5234/Kieran-Gibbs"
2018,"West Brom","Premier League","Rekeem Harper","ENG","MF","17",2000,0.2,1,1,0,1,0,0,0,NA,0,0,0,0,0,1,0,0,"https://fbref.com/en/players/3c066877/Rekeem-Harper"
2018,"West Brom","Premier League","Ahmed Hegazi","EGY","DF","26",1991,37.6,58,38,46,12,0,26,50,52,24,55,37,18,60,118,278,2,"https://fbref.com/en/players/5540c9dc/Ahmed-Hegazi"
2018,"West Brom","Premier League","Grzegorz Krychowiak","POL","MF","27",1990,18.2,39,24,18,17,4,12,49,24.5,37,23,5,18,45,84,23,0,"https://fbref.com/en/players/580d52dd/Grzegorz-Krychowiak"
2018,"West Brom","Premier League","Jake Livermore","ENG","MF","27",1989,29.7,72,41,27,35,10,24,64,37.5,40,44,9,35,26,98,36,2,"https://fbref.com/en/players/b98570d1/Jake-Livermore"
2018,"West Brom","Premier League","Gareth McAuley","NIR","DF","37",1979,5.1,8,7,6,2,0,3,7,42.9,4,7,4,3,11,19,16,0,"https://fbref.com/en/players/ac7d7378/Gareth-McAuley"
2018,"West Brom","Premier League","James McClean","IRL","MF,FW","28",1989,15.6,40,28,23,14,3,10,55,18.2,45,18,4,14,20,60,22,0,"https://fbref.com/en/players/53538b39/James-McClean"
2018,"West Brom","Premier League","James Morrison","SCO","MF","31",1986,2.3,2,1,0,2,0,1,4,25,3,1,1,0,1,3,1,0,"https://fbref.com/en/players/21a66e33/James-Morrison"
2018,"West Brom","Premier League","Boaz Myhill","WAL","GK","34",1982,1,0,0,0,0,0,0,0,NA,0,0,0,0,0,0,1,0,"https://fbref.com/en/players/7ca2d989/Boaz-Myhill"
2018,"West Brom","Premier League","Allan Nyom","CMR","DF","29",1988,25.7,64,39,43,17,4,28,43,65.1,15,20,9,11,27,91,93,0,"https://fbref.com/en/players/97572117/Allan-Nyom"
2018,"West Brom","Premier League","Matt Phillips","SCO","MF,DF","26",1991,23.3,27,16,17,5,5,10,29,34.5,19,21,1,20,24,51,43,0,"https://fbref.com/en/players/7bb5f40e/Matt-Phillips"
2018,"West Brom","Premier League","Hal Robson-Kanu","WAL","FW,MF","28",1989,9.2,5,4,1,2,2,0,13,0,13,9,3,6,4,9,9,0,"https://fbref.com/en/players/fb2dec57/Hal-Robson-Kanu"
2018,"West Brom","Premier League","Jay Rodriguez","ENG","FW,MF","28",1989,31.2,31,21,12,11,8,9,50,18,41,32,2,30,19,50,41,0,"https://fbref.com/en/players/4ab53cdb/Jay-Rodriguez"
2018,"West Brom","Premier League","Salomón Rondón","VEN","FW","27",1989,30.7,14,6,0,7,7,5,26,19.2,21,27,0,27,14,28,20,0,"https://fbref.com/en/players/b318a643/Salomon-Rondon"
2018,"West Brom","Premier League","Daniel Sturridge","ENG","FW","27",1989,1.3,0,0,0,0,0,0,0,NA,0,0,0,0,0,0,0,0,"https://fbref.com/en/players/1b7ec703/Daniel-Sturridge"
2018,"West Brom","Premier League","Claudio Yacob","ARG","MF","30",1987,10,36,27,23,13,0,13,27,48.1,14,14,6,8,16,52,25,2,"https://fbref.com/en/players/bda6ffd4/Claudio-Yacob"
2018,"West Ham","Premier League","Adrián","ESP","GK","30",1987,19,2,1,2,0,0,1,4,25,3,1,0,1,0,2,15,1,"https://fbref.com/en/players/f76e6b4e/Adrian"
2018,"West Ham","Premier League","Michail Antonio","JAM","FW,MF","27",1990,15,15,9,7,6,2,4,14,28.6,10,14,0,14,13,28,16,0,"https://fbref.com/en/players/ac05f970/Michail-Antonio"
2018,"West Ham","Premier League","Marko Arnautović","AUT","FW,MF","28",1989,25.7,21,16,9,8,4,7,19,36.8,12,20,3,17,13,34,35,0,"https://fbref.com/en/players/00459419/Marko-Arnautovic"
2018,"West Ham","Premier League","André Ayew","GHA","MF,FW","27",1989,9.9,19,14,6,10,3,6,19,31.6,13,5,0,5,4,23,3,0,"https://fbref.com/en/players/5dbefa9d/Andre-Ayew"
2018,"West Ham","Premier League","Sam Byram","ENG","DF,MF","23",1993,2.8,9,5,6,3,0,4,9,44.4,5,6,2,4,9,18,16,0,"https://fbref.com/en/players/1bf811d4/Sam-Byram"
2018,"West Ham","Premier League","Andy Carroll","ENG","FW","28",1989,8.3,3,3,2,0,1,0,1,0,1,3,2,1,2,5,15,0,"https://fbref.com/en/players/b581987a/Andy-Carroll"
2018,"West Ham","Premier League","James Collins","WAL","DF","33",1983,11.7,15,9,11,4,0,8,11,72.7,3,13,10,3,16,31,120,1,"https://fbref.com/en/players/c61f1719/James-Collins"
2018,"West Ham","Premier League","Aaron Cresswell","ENG","DF","27",1989,34.1,34,21,12,20,2,19,30,63.3,11,42,17,25,44,78,117,1,"https://fbref.com/en/players/4f974391/Aaron-Cresswell"
2018,"West Ham","Premier League","Josh Cullen","IRL","MF","21",1996,0.1,0,0,0,0,0,0,1,0,1,1,1,0,2,2,0,0,"https://fbref.com/en/players/f6d7d690/Josh-Cullen"
2018,"West Ham","Premier League","Patrice Evra","FRA","DF,MF","36",1981,2.5,6,4,5,1,0,6,8,75,2,4,1,3,7,13,6,0,"https://fbref.com/en/players/51a3caf1/Patrice-Evra"
2018,"West Ham","Premier League","Edimilson Fernandes","SUI","MF,DF","21",1996,9.4,17,9,10,7,0,9,21,42.9,12,13,1,12,16,33,8,0,"https://fbref.com/en/players/3bb625ac/Edimilson-Fernandes"
2018,"West Ham","Premier League","José Fonte","POR","DF","33",1983,7.6,11,6,5,6,0,2,6,33.3,4,12,9,3,14,25,37,1,"https://fbref.com/en/players/90f87966/Jose-Fonte"
2018,"West Ham","Premier League","Joe Hart","ENG","GK","30",1987,19,1,1,1,0,0,1,2,50,1,1,0,1,0,1,2,4,"https://fbref.com/en/players/cb4f24c6/Joe-Hart"
2018,"West Ham","Premier League","Javier Hernández","MEX","FW","29",1988,17.2,11,7,2,7,2,3,14,21.4,11,6,1,5,6,17,1,0,"https://fbref.com/en/players/189cee7b/Javier-Hernandez"
2018,"West Ham","Premier League","Jordan Hugill","ENG","FW","25",1992,0.3,0,0,0,0,0,0,1,0,1,0,0,0,0,0,0,0,"https://fbref.com/en/players/a36d4785/Jordan-Hugill"
2018,"West Ham","Premier League","Cheikhou Kouyaté","SEN","MF","27",1989,31.1,71,49,43,26,2,23,62,37.1,39,31,11,20,32,103,56,1,"https://fbref.com/en/players/8d3c902d/Cheikhou-Kouyate"
2018,"West Ham","Premier League","Manuel Lanzini","ARG","MF,FW","24",1993,22.7,20,11,6,11,3,2,34,5.9,32,7,1,6,30,50,5,2,"https://fbref.com/en/players/26f6dca8/Manuel-Lanzini"
2018,"West Ham","Premier League","João Mário","POR","MF","24",1993,11.4,14,11,6,5,3,6,19,31.6,13,7,0,7,8,22,4,1,"https://fbref.com/en/players/f0021247/Joao-Mario"
2018,"West Ham","Premier League","Arthur Masuaku","COD","DF","23",1993,20.8,58,37,36,16,6,25,58,43.1,33,25,2,23,26,84,38,1,"https://fbref.com/en/players/57df7a11/Arthur-Masuaku"
2018,"West Ham","Premier League","Mark Noble","ENG","MF","30",1987,26.7,61,36,32,22,7,16,76,21.1,60,28,10,18,47,108,32,1,"https://fbref.com/en/players/ff527768/Mark-Noble"
2018,"West Ham","Premier League","Pedro Obiang","EQG","MF","25",1992,17.4,53,34,20,29,4,17,51,33.3,34,37,16,21,24,77,27,1,"https://fbref.com/en/players/ba1e04b3/Pedro-Obiang"
2018,"West Ham","Premier League","Angelo Ogbonna","ITA","DF","29",1988,32,30,24,18,10,2,8,18,44.4,10,40,27,13,58,88,197,1,"https://fbref.com/en/players/74b2cd7e/Angelo-Ogbonna"
2018,"West Ham","Premier League","Reece Oxford","ENG","MF","18",1998,0.1,2,1,1,1,0,1,1,100,0,0,0,0,0,2,0,0,"https://fbref.com/en/players/8b6e0db2/Reece-Oxford"
2018,"West Ham","Premier League","Winston Reid","NZL","DF","29",1988,16.1,11,9,7,4,0,4,15,26.7,11,27,14,13,22,33,104,0,"https://fbref.com/en/players/562eed5c/Winston-Reid"
2018,"West Ham","Premier League","Declan Rice","ENG","DF,MF","18",1999,15.9,36,24,25,10,1,15,25,60,10,19,13,6,27,63,77,1,"https://fbref.com/en/players/1c7012b8/Declan-Rice"
2018,"West Ham","Premier League","Diafra Sakho","SEN","FW","27",1989,3.4,5,2,1,4,0,0,3,0,3,3,0,3,1,6,2,0,"https://fbref.com/en/players/57c433c8/Diafra-Sakho"
2018,"West Ham","Premier League","Pablo Zabaleta","ARG","DF,MF","32",1985,36.5,96,67,54,28,14,48,98,49,50,72,13,59,61,157,152,0,"https://fbref.com/en/players/6813ac34/Pablo-Zabaleta"
2018,"Wolfsburg","Bundesliga","Maximilian Arnold","GER","MF","23",1994,27.3,51,41,23,23,5,25,57,43.9,32,31,4,27,28,79,34,0,"https://fbref.com/en/players/86e119e0/Maximilian-Arnold"
2018,"Wolfsburg","Bundesliga","Riechedly Bazoer","NED","MF","20",1996,6.6,8,7,5,2,1,2,4,50,2,2,1,1,8,16,4,1,"https://fbref.com/en/players/da59a197/Riechedly-Bazoer"
2018,"Wolfsburg","Bundesliga","Josip Brekalo","CRO","FW","19",1998,9.7,15,12,6,7,2,6,12,50,6,17,0,17,4,19,3,0,"https://fbref.com/en/players/d4a2533d/Josip-Brekalo"
2018,"Wolfsburg","Bundesliga","John Brooks","USA","DF","24",1993,8.1,20,13,15,4,1,16,22,72.7,6,11,5,6,10,30,46,0,"https://fbref.com/en/players/e27da244/John-Brooks"
2018,"Wolfsburg","Bundesliga","Jeffrey Bruma","NED","DF","25",1991,11,13,11,13,0,0,6,14,42.9,8,17,12,5,14,27,43,2,"https://fbref.com/en/players/fbffc4b1/Jeffrey-Bruma"
2018,"Wolfsburg","Bundesliga","Jakub Błaszczykowski","POL","FW,MF","31",1985,5.8,12,8,8,2,2,6,13,46.2,7,11,3,8,5,17,3,0,"https://fbref.com/en/players/2b350e6b/Jakub-Blaszczykowski"
2018,"Wolfsburg","Bundesliga","Ignacio Camacho","ESP","MF,DF","27",1990,10.6,27,21,10,16,1,9,23,39.1,14,14,5,9,41,68,43,0,"https://fbref.com/en/players/8ed9b33a/Ignacio-Camacho"
2018,"Wolfsburg","Bundesliga","Koen Casteels","BEL","GK","25",1992,34,2,1,2,0,0,2,2,100,0,0,0,0,1,3,16,1,"https://fbref.com/en/players/db401046/Koen-Casteels"
2018,"Wolfsburg","Bundesliga","Daniel Didavi","GER","MF","27",1990,24.9,34,19,10,19,5,14,33,42.4,19,20,1,19,7,41,12,0,"https://fbref.com/en/players/d3096421/Daniel-Didavi"
2018,"Wolfsburg","Bundesliga","Landry Dimata","BEL","FW","19",1997,10,7,6,4,3,0,5,6,83.3,1,6,2,4,2,9,5,0,"https://fbref.com/en/players/b5f63410/Landry-Dimata"
2018,"Wolfsburg","Bundesliga","Ohis Felix Uduokhai","GER","DF","19",1997,17.3,42,23,27,13,2,17,24,70.8,7,23,10,13,34,76,66,6,"https://fbref.com/en/players/677da306/Ohis-Felix-Uduokhai"
2018,"Wolfsburg","Bundesliga","Yannick Gerhardt","GER","DF,MF","23",1994,13.6,37,28,18,14,5,22,34,64.7,12,25,5,20,15,52,31,0,"https://fbref.com/en/players/62ab9184/Yannick-Gerhardt"
2018,"Wolfsburg","Bundesliga","Mario Gómez","GER","FW","32",1985,10.4,6,6,2,3,1,2,6,33.3,4,10,1,9,0,6,16,0,"https://fbref.com/en/players/71a20ce8/Mario-Gomez"
2018,"Wolfsburg","Bundesliga","Josuha Guilavogui","FRA","MF","26",1990,26.7,65,46,43,20,2,30,50,60,20,34,10,24,66,131,63,0,"https://fbref.com/en/players/e6c43eec/Josuha-Guilavogui"
2018,"Wolfsburg","Bundesliga","Kaylen Hinds","ENG","FW","19",1998,1,1,1,1,0,0,0,0,NA,0,1,0,1,1,2,0,0,"https://fbref.com/en/players/fdd5d298/Kaylen-Hinds"
2018,"Wolfsburg","Bundesliga","Gian-Luca Itter","GER","DF","18",1999,4.6,19,12,15,2,2,14,22,63.6,8,6,0,6,5,24,15,0,"https://fbref.com/en/players/e6c15f6e/Gian-Luca-Itter"
2018,"Wolfsburg","Bundesliga","Paul Jaeckel","GER","DF","19",1998,3,3,3,3,0,0,1,2,50,1,5,2,3,1,4,8,0,"https://fbref.com/en/players/a93b6f4e/Paul-Jaeckel"
2018,"Wolfsburg","Bundesliga","Sebastian Jung","GER","DF","27",1990,0.9,2,2,1,1,0,1,1,100,0,0,0,0,0,2,5,0,"https://fbref.com/en/players/86b30561/Sebastian-Jung"
2018,"Wolfsburg","Bundesliga","Robin Knoche","GER","DF","25",1992,23.4,34,20,26,8,0,25,35,71.4,10,36,24,12,25,59,89,1,"https://fbref.com/en/players/6bd5cd5d/Robin-Knoche"
2018,"Wolfsburg","Bundesliga","Yunus Mallı","TUR","FW,MF","25",1992,24.9,25,17,8,14,3,12,25,48,13,23,0,23,12,37,17,0,"https://fbref.com/en/players/f3722c97/Yunus-Malli"
2018,"Wolfsburg","Bundesliga","Admir Mehmedi","SUI","FW,MF","26",1991,3.2,4,2,3,1,0,2,2,100,0,1,1,0,1,5,3,0,"https://fbref.com/en/players/b500b384/Admir-Mehmedi"
2018,"Wolfsburg","Bundesliga","Paul-Georges Ntep","CMR","FW,MF","25",1992,1.8,2,2,0,0,2,0,1,0,1,3,1,2,1,3,0,0,"https://fbref.com/en/players/81aeb1dd/Paul-Georges-Ntep"
2018,"Wolfsburg","Bundesliga","Divock Origi","BEL","FW","22",1995,21.9,6,5,2,3,1,1,7,14.3,6,16,2,14,3,9,17,0,"https://fbref.com/en/players/43a166b4/Divock-Origi"
2018,"Wolfsburg","Bundesliga","Victor Osimhen","NGA","FW,MF","18",1998,3.2,4,4,3,1,0,2,5,40,3,2,1,1,2,6,7,0,"https://fbref.com/en/players/8c90fd7a/Victor-Osimhen"
2018,"Wolfsburg","Bundesliga","Elvis Rexhbeçaj","GER","DF,MF","19",1997,1.4,4,2,1,2,1,1,1,100,0,3,0,3,2,6,3,0,"https://fbref.com/en/players/1ae836b1/Elvis-Rexhbecaj"
2018,"Wolfsburg","Bundesliga","Renato Steffen","SUI","FW,MF","25",1991,7.3,10,9,6,3,1,8,12,66.7,4,6,0,6,5,15,6,0,"https://fbref.com/en/players/dd669209/Renato-Steffen"
2018,"Wolfsburg","Bundesliga","Marcel Tisserand","COD","DF","24",1993,13.9,15,10,10,4,1,7,14,50,7,18,13,5,31,46,50,0,"https://fbref.com/en/players/45954ec7/Marcel-Tisserand"
2018,"Wolfsburg","Bundesliga","Paul Verhaegh","NED","DF","33",1983,29,45,38,21,22,2,24,33,72.7,9,38,10,28,33,78,60,0,"https://fbref.com/en/players/97655ccd/Paul-Verhaegh"
2018,"Wolfsburg","Bundesliga","William","BRA","DF","22",1995,17.9,76,61,43,26,7,46,86,53.5,40,41,6,35,46,122,65,1,"https://fbref.com/en/players/d4d0a9ad/William"
2019,"Alavés","La Liga","Martin Agirregabiria","ESP","DF","22",1996,22.6,45,29,32,10,3,28,46,60.9,18,33,11,22,27,72,65,1,"https://fbref.com/en/players/355c883a/Martin-Agirregabiria"
2019,"Alavés","La Liga","Borja Bastón","ESP","FW","25",1992,16,16,7,4,9,3,2,24,8.3,22,16,5,11,4,20,10,0,"https://fbref.com/en/players/8c44e37b/Borja-Baston"
2019,"Alavés","La Liga","Alejandro Blanco","ESP","FW,MF","19",1998,0.2,1,1,1,0,0,1,3,33.3,2,1,0,1,0,1,0,0,"https://fbref.com/en/players/c4dce677/Alejandro-Blanco"
2019,"Alavés","La Liga","Darko Brašanac","SRB","MF","26",1992,17.6,32,16,15,13,4,10,26,38.5,16,17,4,13,13,45,19,0,"https://fbref.com/en/players/4accb7e0/Darko-Brasanac"
2019,"Alavés","La Liga","Burgui","ESP","MF,FW","24",1993,6.2,6,6,4,2,0,1,3,33.3,2,4,0,4,0,6,2,1,"https://fbref.com/en/players/45e304c8/Burgui"
2019,"Alavés","La Liga","Jonathan Calleri","ARG","FW","24",1993,31.9,20,13,3,11,6,1,24,4.2,23,34,7,27,7,27,53,0,"https://fbref.com/en/players/6922f806/Jonathan-Calleri"
2019,"Alavés","La Liga","Rubén Duarte","ESP","DF","22",1995,30.8,72,35,45,20,7,34,64,53.1,30,46,12,34,57,129,130,1,"https://fbref.com/en/players/1fe0492d/Ruben-Duarte"
2019,"Alavés","La Liga","Rodrigo Ely","BRA","DF","24",1993,4.8,8,5,5,3,0,5,7,71.4,2,9,7,2,7,15,30,0,"https://fbref.com/en/players/fd47b4f2/Rodrigo-Ely"
2019,"Alavés","La Liga","Manu García","ESP","MF","32",1986,25.9,83,48,29,40,14,24,77,31.2,53,42,7,35,23,106,67,0,"https://fbref.com/en/players/05a4465d/Manu-Garcia"
2019,"Alavés","La Liga","Ibai Gómez","ESP","MF,FW","28",1989,16.1,14,8,9,3,2,6,19,31.6,13,10,0,10,8,22,17,0,"https://fbref.com/en/players/9d2a3d5f/Ibai-Gomez"
2019,"Alavés","La Liga","John Guidetti","SWE","FW","26",1992,7,4,1,0,3,1,0,4,0,4,4,0,4,1,5,6,0,"https://fbref.com/en/players/99bebd12/John-Guidetti"
2019,"Alavés","La Liga","Takashi Inui","JPN","MF,FW","30",1988,9.2,9,5,6,2,1,5,18,27.8,13,5,0,5,4,13,3,0,"https://fbref.com/en/players/61bd33d0/Takashi-Inui"
2019,"Alavés","La Liga","Jony","ESP","MF,FW","27",1991,33,20,14,6,7,7,7,37,18.9,30,18,0,18,22,42,12,2,"https://fbref.com/en/players/244f57b9/Jony"
2019,"Alavés","La Liga","Víctor Laguardia","ESP","DF","28",1989,36,47,34,37,10,0,24,33,72.7,9,42,19,23,53,100,232,0,"https://fbref.com/en/players/b7c99b9b/Victor-Laguardia"
2019,"Alavés","La Liga","Adrián Marín","ESP","DF,MF","21",1997,3.2,13,8,8,5,0,4,7,57.1,3,1,0,1,7,20,13,0,"https://fbref.com/en/players/b7f2edff/Adrian-Marin"
2019,"Alavés","La Liga","Guillermo Maripán","CHI","DF","24",1994,22.3,46,26,34,12,0,26,38,68.4,12,35,19,16,40,86,133,2,"https://fbref.com/en/players/d9764034/Guillermo-Maripan"
2019,"Alavés","La Liga","Ximo Navarro","ESP","DF","28",1990,28.1,57,35,44,12,1,32,45,71.1,13,25,11,14,47,104,143,1,"https://fbref.com/en/players/8db394aa/Ximo-Navarro"
2019,"Alavés","La Liga","Fernando Pacheco","ESP","GK","26",1992,35,0,0,0,0,0,0,1,0,1,0,0,0,1,1,23,0,"https://fbref.com/en/players/97852360/Fernando-Pacheco"
2019,"Alavés","La Liga","Tomás Pina Isla","ESP","MF","30",1987,26,64,41,23,36,5,18,46,39.1,28,15,4,11,41,105,43,1,"https://fbref.com/en/players/e54bd0a2/Tomas-Pina-Isla"
2019,"Alavés","La Liga","Diego Rolán","URU","MF,FW","25",1993,3.3,7,4,3,1,3,0,2,0,2,1,0,1,1,8,4,0,"https://fbref.com/en/players/d1491e00/Diego-Rolan"
2019,"Alavés","La Liga","Antonio Sivera","ESP","GK","21",1996,3,0,0,0,0,0,0,0,NA,0,0,0,0,0,0,4,1,"https://fbref.com/en/players/9970da54/Antonio-Sivera"
2019,"Alavés","La Liga","Rubén Sobrino","ESP","FW,MF","26",1992,10.7,16,11,7,6,3,5,13,38.5,8,16,1,15,2,18,13,0,"https://fbref.com/en/players/19b776e9/Ruben-Sobrino"
2019,"Alavés","La Liga","Daniel Torres","COL","MF","28",1989,0.8,2,1,2,0,0,0,3,0,3,0,0,0,2,4,0,0,"https://fbref.com/en/players/87882adc/Daniel-Torres"
2019,"Alavés","La Liga","Patrick Twumasi","GHA","MF,FW","24",1994,1.9,3,3,2,0,1,0,4,0,4,2,0,2,1,4,1,0,"https://fbref.com/en/players/e3993b65/Patrick-Twumasi"
2019,"Alavés","La Liga","Carlos Vigaray","ESP","DF","23",1994,7.2,15,8,10,4,1,9,15,60,6,6,1,5,6,21,24,1,"https://fbref.com/en/players/f69d934e/Carlos-Vigaray"
2019,"Alavés","La Liga","Wakaso","GHA","MF","28",1990,18.5,46,30,23,19,4,12,36,33.3,24,37,9,28,16,62,19,2,"https://fbref.com/en/players/999908af/Wakaso"
2019,"Amiens","Ligue 1","Khaled Adénon","BEN","DF","33",1985,22.2,31,22,20,11,0,16,28,57.1,12,26,11,15,31,62,101,0,"https://fbref.com/en/players/16714a62/Khaled-Adenon"
2019,"Amiens","Ligue 1","Alexis Blin","FRA","MF","21",1996,22.1,77,45,33,36,8,35,89,39.3,54,39,14,25,33,110,48,1,"https://fbref.com/en/players/c69ef855/Alexis-Blin"
2019,"Amiens","Ligue 1","Mathieu Bodmer","FRA","MF,FW","35",1982,11.9,15,11,3,11,1,3,10,30,7,3,0,3,2,17,10,0,"https://fbref.com/en/players/f3642ba8/Mathieu-Bodmer"
2019,"Amiens","Ligue 1","Quentin Cornette","FRA","FW,MF","24",1994,2.3,5,1,2,2,1,3,6,50,3,3,0,3,1,6,5,0,"https://fbref.com/en/players/5d42d487/Quentin-Cornette"
2019,"Amiens","Ligue 1","Bakaye Dibassy","MLI","DF","28",1989,32.7,38,26,18,16,4,18,27,66.7,9,40,21,19,44,82,102,0,"https://fbref.com/en/players/247accfd/Bakaye-Dibassy"
2019,"Amiens","Ligue 1","Juan Ferney Otero","COL","FW,MF","23",1995,24.2,29,13,11,12,6,13,46,28.3,33,23,3,20,22,51,18,0,"https://fbref.com/en/players/05816e19/Juan-Ferney-Otero"
2019,"Amiens","Ligue 1","Guessouma Fofana","MTN","MF","25",1992,2.1,6,4,3,3,0,1,3,33.3,2,2,1,1,3,9,0,0,"https://fbref.com/en/players/9dafff2a/Guessouma-Fofana"
2019,"Amiens","Ligue 1","Ganso","BRA","MF,FW","28",1989,5.8,12,8,2,8,2,2,15,13.3,13,5,1,4,6,18,0,0,"https://fbref.com/en/players/23593121/Ganso"
2019,"Amiens","Ligue 1","Saman Ghoddos","IRN","FW,MF","24",1993,20.3,33,17,14,15,4,13,32,40.6,19,15,2,13,7,40,13,0,"https://fbref.com/en/players/f7b1d4e0/Saman-Ghoddos"
2019,"Amiens","Ligue 1","Eddy Gnahoré","FRA","MF","24",1993,24.9,39,27,17,17,5,9,39,23.1,30,29,4,25,23,62,23,1,"https://fbref.com/en/players/a0434482/Eddy-Gnahore"
2019,"Amiens","Ligue 1","Prince-Désir Gouano","FRA","DF","24",1993,29.1,31,18,25,5,1,12,22,54.5,10,36,27,9,46,77,127,6,"https://fbref.com/en/players/7c6d6c96/Prince-Desir-Gouano"
2019,"Amiens","Ligue 1","Sehrou Guirassy","GUI","FW","22",1996,12.3,7,5,1,5,1,0,4,0,4,7,0,7,4,11,14,0,"https://fbref.com/en/players/923f4dda/Sehrou-Guirassy"
2019,"Amiens","Ligue 1","Régis Gurtner","FRA","GK","31",1986,38,1,1,1,0,0,0,1,0,1,0,0,0,1,2,7,3,"https://fbref.com/en/players/bc270726/Regis-Gurtner"
2019,"Amiens","Ligue 1","Oualid El Hajjam","MAR","DF,MF","27",1991,6,14,9,10,3,1,5,15,33.3,10,8,2,6,12,26,26,0,"https://fbref.com/en/players/9f29c204/Oualid-El-Hajjam"
2019,"Amiens","Ligue 1","Moussa Konaté","SEN","FW","25",1993,20.8,10,8,3,3,4,2,12,16.7,10,14,3,11,5,15,15,0,"https://fbref.com/en/players/fcbcbd94/Moussa-Konate"
2019,"Amiens","Ligue 1","Emil Krafth","SWE","DF","23",1994,33,55,35,34,14,7,32,65,49.2,33,27,12,15,23,78,94,4,"https://fbref.com/en/players/77cf6852/Emil-Krafth"
2019,"Amiens","Ligue 1","Rafał Kurzawa","POL","FW","25",1993,2.7,8,3,6,2,0,2,6,33.3,4,1,0,1,3,11,3,0,"https://fbref.com/en/players/3d3b0206/Rafal-Kurzawa"
2019,"Amiens","Ligue 1","Jordan Lefort","FRA","DF","24",1993,20,33,18,23,6,4,16,25,64,9,11,8,3,46,79,107,0,"https://fbref.com/en/players/c3e4ecbb/Jordan-Lefort"
2019,"Amiens","Ligue 1","Stiven Mendoza","COL","FW,MF","26",1992,20.9,29,18,10,12,7,14,38,36.8,24,18,0,18,17,46,12,0,"https://fbref.com/en/players/e68f2cb4/Stiven-Mendoza"
2019,"Amiens","Ligue 1","Thomas Monconduit","FRA","MF","27",1991,31.3,76,47,38,33,5,26,63,41.3,37,46,17,29,36,112,77,1,"https://fbref.com/en/players/84d94b91/Thomas-Monconduit"
2019,"Amiens","Ligue 1","Erik Pieters","NED","DF","29",1988,14,49,28,28,18,3,25,33,75.8,8,21,13,8,17,66,56,0,"https://fbref.com/en/players/1ef37668/Erik-Pieters"
2019,"Amiens","Ligue 1","Stanley Segarel","FRA","FW","24",1994,0.2,0,0,0,0,0,0,0,NA,0,0,0,0,0,0,0,0,"https://fbref.com/en/players/b2459674/Stanley-Segarel"
2019,"Amiens","Ligue 1","Sanasi Sy","FRA","MF","19",1999,0,0,0,0,0,0,0,0,NA,0,0,0,0,0,0,0,0,"https://fbref.com/en/players/62a54183/Sanasi-Sy"
2019,"Amiens","Ligue 1","Cheick Timite","CIV","FW,MF","20",1997,16.2,18,13,5,7,6,3,16,18.8,13,14,2,12,12,30,13,0,"https://fbref.com/en/players/2c92d3c0/Cheick-Timite"
2019,"Amiens","Ligue 1","Gaoussou Traoré","MLI","MF","18",1999,1.2,10,5,6,4,0,4,8,50,4,1,0,1,0,10,0,0,"https://fbref.com/en/players/42e8eba2/Gaoussou-Traore"
2019,"Amiens","Ligue 1","Bongani Zungu","RSA","MF","25",1992,2.6,3,2,0,1,2,2,8,25,6,0,0,0,2,5,5,0,"https://fbref.com/en/players/a8797cf1/Bongani-Zungu"
2019,"Angers","Ligue 1","Rayan Aït Nouri","FRA","DF,MF","17",2001,0.6,2,2,1,1,0,0,1,0,1,0,0,0,0,2,1,0,"https://fbref.com/en/players/9b398aea/Rayan-Ait-Nouri"
2019,"Angers","Ligue 1","Yoann Andreu","FRA","DF","29",1989,0,1,0,1,0,0,0,1,0,1,0,0,0,1,2,0,0,"https://fbref.com/en/players/872cd68c/Yoann-Andreu"
2019,"Angers","Ligue 1","Stéphane Bahoken","CMR","FW","26",1992,27.4,15,7,0,10,5,3,21,14.3,18,35,3,32,8,23,5,0,"https://fbref.com/en/players/5046b7d4/Stephane-Bahoken"
2019,"Angers","Ligue 1","Abdoulaye Bamba","CIV","DF","28",1990,28.6,51,29,31,14,6,24,44,54.5,20,20,4,16,37,88,86,0,"https://fbref.com/en/players/7fecbcdb/Abdoulaye-Bamba"
2019,"Angers","Ligue 1","Zacharie Boucher","FRA","GK","26",1992,2,0,0,0,0,0,0,0,NA,0,1,0,1,0,0,1,0,"https://fbref.com/en/players/249cdcff/Zacharie-Boucher"
2019,"Angers","Ligue 1","Ludovic Butelle","FRA","GK","35",1983,36,1,0,1,0,0,1,1,100,0,0,0,0,1,2,31,1,"https://fbref.com/en/players/26975a92/Ludovic-Butelle"
2019,"Angers","Ligue 1","Pierrick Capelle","FRA","DF,MF","31",1987,20.5,51,31,23,22,6,19,54,35.2,35,23,2,21,38,89,49,0,"https://fbref.com/en/players/79b2399c/Pierrick-Capelle"
2019,"Angers","Ligue 1","Angelo Fulgini","FRA","MF,FW","21",1996,18.2,38,22,18,13,7,12,31,38.7,19,21,3,18,28,66,15,0,"https://fbref.com/en/players/4b96c347/Angelo-Fulgini"
2019,"Angers","Ligue 1","Wilfried Kanga","CIV","FW","20",1998,5.5,0,0,0,0,0,0,1,0,1,3,0,3,0,0,4,0,"https://fbref.com/en/players/b4c816a9/Wilfried-Kanga"
2019,"Angers","Ligue 1","Cristian López","ESP","FW","29",1989,4.1,6,3,1,2,3,1,8,12.5,7,4,0,4,1,7,2,0,"https://fbref.com/en/players/c76577a0/Cristian-Lopez"
2019,"Angers","Ligue 1","Vincent Manceau","FRA","DF","29",1989,31,98,65,64,23,11,33,62,53.2,29,41,10,31,44,142,87,0,"https://fbref.com/en/players/c26a3918/Vincent-Manceau"
2019,"Angers","Ligue 1","Thomas Mangani","FRA","MF","31",1987,17.8,42,27,13,26,3,19,62,30.6,43,13,2,11,23,65,24,0,"https://fbref.com/en/players/c801616a/Thomas-Mangani"
2019,"Angers","Ligue 1","Harrison Manzala","COD","MF,FW","24",1994,0.8,2,2,1,0,1,0,0,NA,0,0,0,0,0,2,1,0,"https://fbref.com/en/players/392d98fc/Harrison-Manzala"
2019,"Angers","Ligue 1","Farid El Melali","ALG","MF,FW","21",1997,3.6,8,4,3,4,1,3,12,25,9,2,0,2,5,13,1,0,"https://fbref.com/en/players/d21e361a/Farid-El-Melali"
2019,"Angers","Ligue 1","Cheikh N'Doye","SEN","MF","32",1986,25.9,25,15,14,11,0,10,32,31.3,22,33,8,25,25,50,61,0,"https://fbref.com/en/players/f1b2365a/Cheikh-NDoye"
2019,"Angers","Ligue 1","Vincent Pajot","FRA","MF","27",1990,7.9,18,14,6,8,4,4,14,28.6,10,9,0,9,8,26,6,0,"https://fbref.com/en/players/f86ca403/Vincent-Pajot"
2019,"Angers","Ligue 1","Elhadji Pape Diaw","SEN","DF","23",1994,0.2,0,0,0,0,0,0,0,NA,0,0,0,0,1,1,0,0,"https://fbref.com/en/players/51450467/Elhadji-Pape-Diaw"
2019,"Angers","Ligue 1","Mateo Pavlović","BIH","DF","28",1990,27.7,26,18,24,2,0,12,24,50,12,37,29,8,20,46,164,2,"https://fbref.com/en/players/450e277f/Mateo-Pavlovic"
2019,"Angers","Ligue 1","Théo Pellenard","FRA","DF","24",1994,5.5,11,6,7,2,2,5,8,62.5,3,6,2,4,5,16,16,0,"https://fbref.com/en/players/97fb4608/Theo-Pellenard"
2019,"Angers","Ligue 1","Jeff Reine-Adélaïde","FRA","FW,MF","20",1998,28.4,40,22,18,19,3,17,40,42.5,23,20,0,20,19,59,10,0,"https://fbref.com/en/players/d504b3e1/Jeff-Reine-Adelaide"
2019,"Angers","Ligue 1","Baptiste Santamaria","FRA","MF","23",1995,36.1,118,60,48,63,7,51,106,48.1,55,41,4,37,57,175,57,2,"https://fbref.com/en/players/5e22e2a4/Baptiste-Santamaria"
2019,"Angers","Ligue 1","Flavien Tait","FRA","MF,FW","25",1993,33.2,58,35,33,16,9,23,59,39,36,29,2,27,28,86,15,0,"https://fbref.com/en/players/a0f9b535/Flavien-Tait"
2019,"Angers","Ligue 1","Romain Thomas","FRA","DF","30",1988,26.6,35,26,25,10,0,14,19,73.7,5,31,24,7,29,64,133,1,"https://fbref.com/en/players/275e2c51/Romain-Thomas"
2019,"Angers","Ligue 1","Ismaël Traoré","CIV","DF","31",1986,29.3,27,11,19,8,0,9,24,37.5,15,27,16,11,42,69,120,2,"https://fbref.com/en/players/b666421b/Ismael-Traore"
2019,"Arsenal","Premier League","Pierre-Emerick Aubameyang","GAB","FW","29",1989,30.3,21,17,6,9,6,8,28,28.6,20,26,0,26,8,29,22,0,"https://fbref.com/en/players/d5dd5f1f/Pierre-Emerick-Aubameyang"
2019,"Arsenal","Premier League","Héctor Bellerín","ESP","DF","23",1995,17,15,12,8,4,3,6,13,46.2,7,17,5,12,20,35,37,3,"https://fbref.com/en/players/f874dd44/Hector-Bellerin"
2019,"Arsenal","Premier League","Petr Čech","CZE","GK","36",1982,6.5,1,1,1,0,0,1,1,100,0,0,0,0,0,1,5,2,"https://fbref.com/en/players/71672fa0/Petr-Cech"
2019,"Arsenal","Premier League","Mohamed Elneny","EGY","MF","26",1992,4.2,13,4,9,1,3,1,2,50,1,7,4,3,2,15,8,0,"https://fbref.com/en/players/47a34c4f/Mohamed-Elneny"
2019,"Arsenal","Premier League","Mattéo Guendouzi","FRA","MF","19",1999,23.9,44,26,18,23,3,17,47,36.2,30,28,5,23,30,74,24,3,"https://fbref.com/en/players/5ea8ef20/Matteo-Guendouzi"
2019,"Arsenal","Premier League","Rob Holding","ENG","DF","22",1995,9,11,7,9,2,0,2,8,25,6,9,7,2,12,23,40,0,"https://fbref.com/en/players/d79a8c87/Rob-Holding"
2019,"Arsenal","Premier League","Alex Iwobi","NGA","FW,MF","22",1996,21.9,28,14,10,16,2,6,25,24,19,21,1,20,12,40,13,1,"https://fbref.com/en/players/6ca5ec4b/Alex-Iwobi"
2019,"Arsenal","Premier League","Carl Jenkinson","ENG","DF","26",1992,1.8,3,2,2,0,1,2,3,66.7,1,4,3,1,0,3,2,0,"https://fbref.com/en/players/874125a3/Carl-Jenkinson"
2019,"Arsenal","Premier League","Sead Kolašinac","BIH","DF,MF","25",1993,21,34,21,21,7,6,20,34,58.8,14,12,3,9,20,54,28,3,"https://fbref.com/en/players/3935e52e/Sead-Kolasinac"
2019,"Arsenal","Premier League","Laurent Koscielny","FRA","DF","32",1985,14.8,19,11,9,9,1,10,16,62.5,6,20,15,5,30,49,72,0,"https://fbref.com/en/players/f5efb153/Laurent-Koscielny"
2019,"Arsenal","Premier League","Alexandre Lacazette","FRA","FW","27",1991,27.8,35,16,6,19,10,5,28,17.9,23,27,1,26,15,50,31,0,"https://fbref.com/en/players/9dbb75ca/Alexandre-Lacazette"
2019,"Arsenal","Premier League","Bernd Leno","GER","GK","26",1992,31.5,0,0,0,0,0,0,3,0,3,0,0,0,4,4,16,6,"https://fbref.com/en/players/2628fd2b/Bernd-Leno"
2019,"Arsenal","Premier League","Stephan Lichtsteiner","SUI","DF","34",1984,10.4,15,9,5,4,6,9,16,56.3,7,11,4,7,9,24,25,1,"https://fbref.com/en/players/99b1d0e6/Stephan-Lichtsteiner"
2019,"Arsenal","Premier League","Ainsley Maitland-Niles","ENG","DF","20",1997,11,33,22,19,12,2,14,28,50,14,22,4,18,19,52,15,2,"https://fbref.com/en/players/e3a5814e/Ainsley-Maitland-Niles"
2019,"Arsenal","Premier League","Konstantinos Mavropanos","GRE","DF","20",1997,1.6,1,0,0,1,0,1,1,100,0,1,1,0,7,8,5,0,"https://fbref.com/en/players/00963611/Konstantinos-Mavropanos"
2019,"Arsenal","Premier League","Henrikh Mkhitaryan","ARM","FW,MF","29",1989,18.2,28,22,8,17,3,6,22,27.3,16,34,2,32,16,44,13,0,"https://fbref.com/en/players/dd0daf32/Henrikh-Mkhitaryan"
2019,"Arsenal","Premier League","Nacho Monreal","ESP","DF","32",1986,20.7,35,17,21,9,5,15,25,60,10,28,10,18,31,66,62,0,"https://fbref.com/en/players/d4cb83cc/Nacho-Monreal"
2019,"Arsenal","Premier League","Shkodran Mustafi","GER","DF","26",1992,29,62,45,42,17,3,31,40,77.5,9,34,17,17,58,120,168,1,"https://fbref.com/en/players/3f2d59fe/Shkodran-Mustafi"
2019,"Arsenal","Premier League","Eddie Nketiah","ENG","MF,FW","19",1999,0.7,1,1,0,1,0,0,0,NA,0,0,0,0,0,1,1,0,"https://fbref.com/en/players/a53649b7/Eddie-Nketiah"
2019,"Arsenal","Premier League","Mesut Özil","GER","MF,FW","29",1988,19.3,12,5,6,3,3,3,21,14.3,18,10,2,8,4,16,5,0,"https://fbref.com/en/players/16380240/Mesut-Ozil"
2019,"Arsenal","Premier League","Sokratis Papastathopoulos","GRE","DF","30",1988,24.4,42,25,30,11,1,15,28,53.6,13,34,17,17,26,68,112,1,"https://fbref.com/en/players/b682dcf6/Sokratis-Papastathopoulos"
2019,"Arsenal","Premier League","Aaron Ramsey","WAL","MF","27",1990,14.8,34,18,11,15,8,7,25,28,18,7,1,6,9,43,3,0,"https://fbref.com/en/players/ef619b0b/Aaron-Ramsey"
2019,"Arsenal","Premier League","Bukayo Saka","ENG","FW","16",2001,0.1,0,0,0,0,0,0,0,NA,0,0,0,0,0,0,0,0,"https://fbref.com/en/players/bc7dc64d/Bukayo-Saka"
2019,"Arsenal","Premier League","Denis Suárez","ESP","MF,FW","24",1994,0.8,1,1,0,1,0,0,5,0,5,0,0,0,1,2,0,0,"https://fbref.com/en/players/12c50af5/Denis-Suarez"
2019,"Arsenal","Premier League","Lucas Torreira","URU","MF","22",1996,26.5,65,39,24,32,9,25,57,43.9,32,34,7,27,41,106,33,2,"https://fbref.com/en/players/52611641/Lucas-Torreira"
2019,"Arsenal","Premier League","Danny Welbeck","ENG","FW,MF","27",1990,1.7,3,2,0,2,1,0,0,NA,0,2,0,2,1,4,2,0,"https://fbref.com/en/players/ce5143da/Danny-Welbeck"
2019,"Arsenal","Premier League","Joe Willock","ENG","MF,FW","18",1999,0.7,1,0,0,1,0,0,0,NA,0,1,0,1,1,2,0,0,"https://fbref.com/en/players/a3b03921/Joe-Willock"
2019,"Arsenal","Premier League","Granit Xhaka","SUI","MF,DF","25",1992,27.8,52,29,29,20,3,24,59,40.7,35,35,9,26,36,88,56,3,"https://fbref.com/en/players/e61b8aee/Granit-Xhaka"
2019,"Atalanta","Serie A","Ali Adnan Kadhim","IRQ","DF","24",1993,1.8,1,1,1,0,0,1,2,50,1,1,1,0,3,4,6,0,"https://fbref.com/en/players/06050480/Ali-Adnan-Kadhim"
2019,"Atalanta","Serie A","Musa Barrow","GAM","FW","19",1998,6.7,9,5,5,3,1,4,6,66.7,2,4,0,4,0,9,2,0,"https://fbref.com/en/players/e5bf73f3/Musa-Barrow"
2019,"Atalanta","Serie A","Etrit Berisha","ALB","GK","29",1989,18,0,0,0,0,0,0,2,0,2,0,0,0,0,0,5,3,"https://fbref.com/en/players/ee833569/Etrit-Berisha"
2019,"Atalanta","Serie A","Timothy Castagne","BEL","DF","22",1995,22.3,61,39,30,22,9,32,57,56.1,25,32,6,26,28,89,50,0,"https://fbref.com/en/players/197640fd/Timothy-Castagne"
2019,"Atalanta","Serie A","Berat Djimsiti","ALB","DF","25",1993,20.1,32,22,18,12,2,13,29,44.8,16,21,11,10,34,66,96,0,"https://fbref.com/en/players/6eee05f1/Berat-Djimsiti"
2019,"Atalanta","Serie A","Remo Freuler","SUI","MF","26",1992,33.6,84,45,34,34,16,30,70,42.9,40,62,12,50,38,122,45,0,"https://fbref.com/en/players/98d2c2c4/Remo-Freuler"
2019,"Atalanta","Serie A","Pierluigi Gollini","ITA","GK","23",1995,20,2,2,2,0,0,1,2,50,1,0,0,0,0,2,3,2,"https://fbref.com/en/players/f0f7f62f/Pierluigi-Gollini"
2019,"Atalanta","Serie A","Papu Gómez","ARG","MF,FW","30",1988,32.2,19,14,5,10,4,6,30,20,24,21,0,21,16,35,4,0,"https://fbref.com/en/players/6e4df551/Papu-Gomez"
2019,"Atalanta","Serie A","Robin Gosens","GER","DF,MF","24",1994,21.6,63,46,32,26,5,37,54,68.5,17,41,3,38,38,101,60,0,"https://fbref.com/en/players/2d970560/Robin-Gosens"
2019,"Atalanta","Serie A","Hans Hateboer","NED","DF","24",1994,33,43,31,19,19,5,17,34,50,17,29,5,24,23,66,47,1,"https://fbref.com/en/players/3b333ac3/Hans-Hateboer"
2019,"Atalanta","Serie A","Roger Ibanez","BRA","DF,FW","19",1998,0,0,0,0,0,0,0,0,NA,0,0,0,0,0,0,1,0,"https://fbref.com/en/players/82efe6fa/Roger-Ibanez"
2019,"Atalanta","Serie A","Josip Iličić","SVN","FW,MF","30",1988,23.8,15,7,2,7,6,5,20,25,15,20,1,19,5,20,2,0,"https://fbref.com/en/players/68252d6d/Josip-Ilicic"
2019,"Atalanta","Serie A","Dejan Kulusevski","SWE","MF","18",2000,1.2,3,3,0,2,1,1,3,33.3,2,1,0,1,0,3,0,0,"https://fbref.com/en/players/df3cda47/Dejan-Kulusevski"
2019,"Atalanta","Serie A","José Luis Palomino","ARG","DF","28",1990,25.1,49,31,31,15,3,23,38,60.5,15,34,17,17,68,117,79,0,"https://fbref.com/en/players/921f6058/Jose-Luis-Palomino"
2019,"Atalanta","Serie A","Gianluca Mancini","ITA","DF","22",1996,25,40,30,22,17,1,16,29,55.2,13,19,4,15,48,88,77,1,"https://fbref.com/en/players/5aa53281/Gianluca-Mancini"
2019,"Atalanta","Serie A","Andrea Masiello","ITA","DF","32",1986,20.4,28,14,13,15,0,17,29,58.6,12,21,6,15,44,72,49,0,"https://fbref.com/en/players/e0314d87/Andrea-Masiello"
2019,"Atalanta","Serie A","Mario Pašalić","CRO","MF","23",1995,18,32,19,9,13,10,7,29,24.1,22,19,4,15,12,44,14,1,"https://fbref.com/en/players/e599253a/Mario-Pasalic"
2019,"Atalanta","Serie A","Matteo Pessina","ITA","MF,FW","21",1997,2.6,4,2,0,4,0,2,3,66.7,1,2,1,1,0,4,4,0,"https://fbref.com/en/players/780e3631/Matteo-Pessina"
2019,"Atalanta","Serie A","Roberto Piccoli","ITA","FW,MF","17",2001,0.5,2,2,0,1,1,1,1,100,0,1,0,1,0,2,0,0,"https://fbref.com/en/players/1cadaf34/Roberto-Piccoli"
2019,"Atalanta","Serie A","Arkadiusz Reca","POL","DF","23",1995,0.5,2,0,1,0,1,0,1,0,1,0,0,0,3,5,0,0,"https://fbref.com/en/players/6213fd82/Arkadiusz-Reca"
2019,"Atalanta","Serie A","Emiliano Rigoni","ARG","FW,MF","25",1993,5.8,6,1,2,2,2,2,6,33.3,4,3,0,3,3,9,3,0,"https://fbref.com/en/players/a1216563/Emiliano-Rigoni"
2019,"Atalanta","Serie A","Marten de Roon","NED","MF","27",1991,33.1,102,57,32,61,9,34,94,36.2,60,48,9,39,53,155,49,1,"https://fbref.com/en/players/2a1beb34/Marten-de-Roon"
2019,"Atalanta","Serie A","Francesco Rossi","ITA","GK","27",1991,0,0,0,0,0,0,0,0,NA,0,0,0,0,0,0,0,0,"https://fbref.com/en/players/7b5f516f/Francesco-Rossi"
2019,"Atalanta","Serie A","Rafael Tolói","ITA","DF","27",1990,19.4,27,17,15,9,3,16,24,66.7,8,28,10,18,33,60,54,1,"https://fbref.com/en/players/c56dc39e/Rafael-Toloi"
2019,"Atalanta","Serie A","Marco Tumminello","ITA","FW,DF","19",1998,0.1,0,0,0,0,0,0,0,NA,0,0,0,0,0,0,0,0,"https://fbref.com/en/players/5bdd44d8/Marco-Tumminello"
2019,"Atalanta","Serie A","Luca Valzania","ITA","MF","22",1996,0.8,5,4,2,3,0,3,5,60,2,0,0,0,1,6,0,0,"https://fbref.com/en/players/2b28ba9f/Luca-Valzania"
2019,"Atalanta","Serie A","Duván Zapata","COL","FW","27",1991,32.2,9,5,3,2,4,1,9,11.1,8,26,6,20,4,13,25,0,"https://fbref.com/en/players/d3de9af0/Duvan-Zapata"
2019,"Athletic Club","La Liga","Aritz Aduriz","ESP","FW","37",1981,10.5,4,2,1,1,2,1,7,14.3,6,2,1,1,0,4,4,0,"https://fbref.com/en/players/293211e1/Aritz-Aduriz"
2019,"Athletic Club","La Liga","Yeray Álvarez","ESP","DF","23",1995,29,55,30,39,14,2,19,33,57.6,14,35,16,19,63,118,149,1,"https://fbref.com/en/players/3ecc11d8/Yeray-Alvarez"
2019,"Athletic Club","La Liga","Mikel Balenziaga","ESP","DF","30",1988,5.8,10,6,7,1,2,5,8,62.5,3,6,2,4,2,12,21,0,"https://fbref.com/en/players/1fe67e86/Mikel-Balenziaga"
2019,"Athletic Club","La Liga","Yuri Berchiche","ESP","DF,FW","28",1990,34.7,46,31,26,11,9,23,46,50,23,34,9,25,42,88,82,0,"https://fbref.com/en/players/b6e50615/Yuri-Berchiche"
2019,"Athletic Club","La Liga","Ander Capa","ESP","DF,FW","26",1992,18.2,43,27,32,8,3,13,27,48.1,14,20,2,18,30,73,47,0,"https://fbref.com/en/players/37f1cf47/Ander-Capa"
2019,"Athletic Club","La Liga","Iñigo Córdoba","ESP","FW,MF","21",1997,14.7,37,23,15,17,5,14,47,29.8,33,27,0,27,17,54,13,0,"https://fbref.com/en/players/49ea92be/Inigo-Cordoba"
2019,"Athletic Club","La Liga","Beñat Etxebarria","ESP","MF","31",1987,22.6,47,24,14,25,8,19,59,32.2,40,18,1,17,24,71,11,0,"https://fbref.com/en/players/b037bd4f/Benat-Etxebarria"
2019,"Athletic Club","La Liga","Cristian Ganea","ROU","DF","26",1992,0.5,0,0,0,0,0,0,3,0,3,1,0,1,1,1,2,0,"https://fbref.com/en/players/baf5665c/Cristian-Ganea"
2019,"Athletic Club","La Liga","Dani García","ESP","MF","28",1990,27.5,56,34,21,32,3,24,63,38.1,39,28,8,20,49,105,46,1,"https://fbref.com/en/players/240d3a0b/Dani-Garcia"
2019,"Athletic Club","La Liga","Raúl García","ESP","MF,FW","32",1986,26.3,61,41,13,37,11,22,68,32.4,46,56,1,55,21,82,39,0,"https://fbref.com/en/players/b418dbd4/Raul-Garcia"
2019,"Athletic Club","La Liga","Ibai Gómez","ESP","FW","28",1989,6.4,6,3,3,2,1,4,9,44.4,5,8,1,7,2,8,8,0,"https://fbref.com/en/players/9d2a3d5f/Ibai-Gomez"
2019,"Athletic Club","La Liga","Gorka Guruzeta","ESP","MF,FW","21",1996,0.6,1,1,1,0,0,0,2,0,2,1,0,1,2,3,0,0,"https://fbref.com/en/players/6b5ea2f4/Gorka-Guruzeta"
2019,"Athletic Club","La Liga","Iago Herrerín","ESP","GK","30",1988,31,0,0,0,0,0,0,2,0,2,0,0,0,0,0,11,2,"https://fbref.com/en/players/9109185e/Iago-Herrerin"
2019,"Athletic Club","La Liga","Ander Iturraspe","ESP","MF","29",1989,1.1,2,2,1,1,0,1,1,100,0,0,0,0,6,8,2,0,"https://fbref.com/en/players/6dce77a5/Ander-Iturraspe"
2019,"Athletic Club","La Liga","Kenan Kodro","BIH","FW,MF","24",1993,1.8,3,1,1,1,1,1,3,33.3,2,1,0,1,0,3,0,0,"https://fbref.com/en/players/e82d2807/Kenan-Kodro"
2019,"Athletic Club","La Liga","Iñigo Lekue","ESP","DF","25",1993,2.3,5,2,3,2,0,2,7,28.6,5,4,0,4,4,9,11,0,"https://fbref.com/en/players/59b7d823/Inigo-Lekue"
2019,"Athletic Club","La Liga","Unai López","ESP","MF","22",1995,3.6,7,5,3,2,2,2,12,16.7,10,10,3,7,1,8,2,0,"https://fbref.com/en/players/88050721/Unai-Lopez"
2019,"Athletic Club","La Liga","Óscar de Marcos","ESP","DF,FW","29",1989,26.9,60,32,34,17,9,29,62,46.8,33,29,4,25,27,87,62,0,"https://fbref.com/en/players/9f323c71/Oscar-de-Marcos"
2019,"Athletic Club","La Liga","Iñigo Martínez","ESP","DF","27",1991,32.2,53,26,36,16,1,23,37,62.2,14,24,14,10,69,122,144,0,"https://fbref.com/en/players/3fc45c73/Inigo-Martinez"
2019,"Athletic Club","La Liga","Iker Muniain","ESP","MF,FW","25",1992,26.5,29,20,10,14,5,6,29,20.7,23,17,3,14,12,41,6,0,"https://fbref.com/en/players/c05dfb74/Iker-Muniain"
2019,"Athletic Club","La Liga","Peru Nolaskoain","ESP","DF","19",1998,5.2,11,8,7,4,0,5,9,55.6,4,11,6,5,10,21,18,0,"https://fbref.com/en/players/857cb4f3/Peru-Nolaskoain"
2019,"Athletic Club","La Liga","Unai Núñez","ESP","DF","21",1997,11.8,15,11,11,4,0,7,11,63.6,4,20,12,8,28,43,60,2,"https://fbref.com/en/players/be170419/Unai-Nunez"
2019,"Athletic Club","La Liga","Mikel Rico","ESP","MF","33",1984,2.7,5,2,1,4,0,2,7,28.6,5,3,2,1,2,7,3,0,"https://fbref.com/en/players/def69cd0/Mikel-Rico"
2019,"Athletic Club","La Liga","Mikel San José","ESP","MF","29",1989,19.3,43,25,19,19,5,15,48,31.3,33,27,6,21,21,64,35,0,"https://fbref.com/en/players/003a5c72/Mikel-San-Jose"
2019,"Athletic Club","La Liga","Unai Simón","ESP","GK","21",1997,7,0,0,0,0,0,0,1,0,1,0,0,0,1,1,1,1,"https://fbref.com/en/players/5dcf3e90/Unai-Simon"
2019,"Athletic Club","La Liga","Markel Susaeta","ESP","FW,MF","30",1987,15.3,17,10,4,6,7,3,23,13,20,10,1,9,12,29,5,0,"https://fbref.com/en/players/6fd1ba62/Markel-Susaeta"
2019,"Athletic Club","La Liga","Iñaki Williams","GHA","FW","24",1994,33.6,27,18,9,7,11,5,22,22.7,17,22,1,21,7,34,33,0,"https://fbref.com/en/players/6a99e0b1/Inaki-Williams"
2019,"Atlético Madrid","La Liga","Antonio Adán","ESP","GK","31",1987,1,0,0,0,0,0,0,0,NA,0,0,0,0,0,0,0,0,"https://fbref.com/en/players/65d62814/Antonio-Adan"
2019,"Atlético Madrid","La Liga","Santiago Arias","COL","DF","26",1992,19.7,48,32,31,16,1,20,31,64.5,11,14,2,12,34,82,43,0,"https://fbref.com/en/players/fdd60087/Santiago-Arias"
2019,"Atlético Madrid","La Liga","Sergio Camello","ESP","FW","17",2001,0.5,1,0,1,0,0,1,1,100,0,0,0,0,0,1,0,0,"https://fbref.com/en/players/873619c6/Sergio-Camello"
2019,"Atlético Madrid","La Liga","Ángel Correa","ARG","MF,FW","23",1995,21.3,38,19,19,12,7,10,53,18.9,43,28,5,23,17,55,20,0,"https://fbref.com/en/players/01eb744d/Angel-Correa"
2019,"Atlético Madrid","La Liga","Diego Costa","ESP","FW","29",1988,12.4,4,1,0,4,0,1,8,12.5,7,5,0,5,2,6,6,0,"https://fbref.com/en/players/a190d597/Diego-Costa"
2019,"Atlético Madrid","La Liga","Borja Garcés","ESP","FW","18",1999,0.2,0,0,0,0,0,0,0,NA,0,0,0,0,0,0,0,0,"https://fbref.com/en/players/bc39454c/Borja-Garces"
2019,"Atlético Madrid","La Liga","Diego Godín","URU","DF","32",1986,27.9,52,30,33,19,0,20,42,47.6,22,22,9,13,45,97,141,2,"https://fbref.com/en/players/fc4f85b1/Diego-Godin"
2019,"Atlético Madrid","La Liga","Antoine Griezmann","FRA","FW,MF","27",1991,35.5,31,19,8,13,10,8,28,28.6,20,18,1,17,12,43,21,0,"https://fbref.com/en/players/df69b544/Antoine-Griezmann"
2019,"Atlético Madrid","La Liga","Lucas Hernández","FRA","DF","22",1996,12.4,35,25,20,14,1,17,20,85,3,17,9,8,14,49,49,0,"https://fbref.com/en/players/c3ee18ef/Lucas-Hernandez"
2019,"Atlético Madrid","La Liga","Carlos Isaac","ESP","DF","20",1998,1,0,0,0,0,0,0,2,0,2,2,0,2,1,1,2,0,"https://fbref.com/en/players/3e5a168c/Carlos-Isaac"
2019,"Atlético Madrid","La Liga","Juanfran","ESP","DF","33",1985,17.9,35,22,27,5,3,24,38,63.2,14,13,5,8,19,54,36,1,"https://fbref.com/en/players/cfd8d664/Juanfran"
2019,"Atlético Madrid","La Liga","Nikola Kalinić","CRO","FW","30",1988,7.1,6,4,2,4,0,1,3,33.3,2,1,0,1,2,8,2,0,"https://fbref.com/en/players/d4931a5a/Nikola-Kalinic"
2019,"Atlético Madrid","La Liga","Koke","ESP","MF","26",1992,28.7,84,46,41,32,11,34,86,39.5,52,25,5,20,31,115,37,1,"https://fbref.com/en/players/55126f3b/Koke"
2019,"Atlético Madrid","La Liga","Thomas Lemar","FRA","MF","22",1995,20.2,38,21,23,11,4,19,42,45.2,23,26,1,25,22,60,7,1,"https://fbref.com/en/players/4dbd0916/Thomas-Lemar"
2019,"Atlético Madrid","La Liga","Filipe Luís","BRA","DF","32",1985,22.6,66,36,33,25,8,32,58,55.2,26,18,3,15,44,110,47,0,"https://fbref.com/en/players/e4ed2628/Filipe-Luis"
2019,"Atlético Madrid","La Liga","José María Giménez","URU","DF","23",1995,19.7,26,15,20,6,0,13,26,50,13,27,14,13,44,70,128,2,"https://fbref.com/en/players/f0da930c/Jose-Maria-Gimenez"
2019,"Atlético Madrid","La Liga","Gelson Martins","POR","FW,MF","23",1995,2.5,5,3,3,1,1,3,4,75,1,1,0,1,1,6,1,0,"https://fbref.com/en/players/3ef0fa48/Gelson-Martins"
2019,"Atlético Madrid","La Liga","Victor Mollejo","ESP","FW,DF","17",2001,0.7,0,0,0,0,0,0,2,0,2,0,0,0,0,0,0,0,"https://fbref.com/en/players/23fffc06/Victor-Mollejo"
2019,"Atlético Madrid","La Liga","Francisco Montero","ESP","DF","19",1999,4.5,8,4,5,3,0,5,6,83.3,1,10,4,6,5,13,18,1,"https://fbref.com/en/players/3e96f3e7/Francisco-Montero"
2019,"Atlético Madrid","La Liga","Álvaro Morata","ESP","FW","25",1992,12,20,14,2,7,11,3,10,30,7,7,0,7,5,25,13,0,"https://fbref.com/en/players/129af0db/Alvaro-Morata"
2019,"Atlético Madrid","La Liga","Toni Moya","ESP","DF","20",1998,1,2,2,2,0,0,0,1,0,1,0,0,0,0,2,3,0,"https://fbref.com/en/players/9e098912/Toni-Moya"
2019,"Atlético Madrid","La Liga","Joaquín Muñoz","ESP","FW","19",1999,0,0,0,0,0,0,0,0,NA,0,0,0,0,0,0,0,0,"https://fbref.com/en/players/e9fbcc21/Joaquin-Munoz"
2019,"Atlético Madrid","La Liga","Saúl Ñíguez","ESP","MF,DF","23",1994,32.5,83,56,35,41,7,32,81,39.5,49,57,10,47,42,125,86,1,"https://fbref.com/en/players/c14bc029/Saul-Niguez"
2019,"Atlético Madrid","La Liga","Jan Oblak","SVN","GK","25",1993,37,1,0,1,0,0,1,1,100,0,0,0,0,1,2,13,1,"https://fbref.com/en/players/ee8508c0/Jan-Oblak"
2019,"Atlético Madrid","La Liga","Thomas Partey","GHA","MF","25",1993,23,66,42,32,25,9,21,49,42.9,28,26,5,21,49,115,22,2,"https://fbref.com/en/players/529f49ab/Thomas-Partey"
2019,"Atlético Madrid","La Liga","Rodri","ESP","MF","22",1996,30.4,103,70,45,50,8,39,75,52,36,35,11,24,41,144,68,0,"https://fbref.com/en/players/6434f10d/Rodri"
2019,"Atlético Madrid","La Liga","Stefan Savić","MNE","DF","27",1991,15.5,11,10,9,2,0,7,12,58.3,5,13,9,4,22,33,67,0,"https://fbref.com/en/players/f6ac68c1/Stefan-Savic"
2019,"Atlético Madrid","La Liga","Andrés Solano","COL","DF","20",1998,0.5,4,3,2,2,0,2,2,100,0,1,0,1,0,4,1,0,"https://fbref.com/en/players/c8764028/Andres-Solano"
2019,"Atlético Madrid","La Liga","Vitolo","ESP","MF,FW","28",1989,8.4,17,13,8,6,3,6,19,31.6,13,8,1,7,10,27,6,0,"https://fbref.com/en/players/db750822/Vitolo"
2019,"Augsburg","Bundesliga","Simon Asta","GER","DF","17",2001,1,6,3,4,2,0,2,2,100,0,2,1,1,3,9,1,0,"https://fbref.com/en/players/dfc85b89/Simon-Asta"
2019,"Augsburg","Bundesliga","Daniel Baier","GER","MF","34",1984,31.3,62,39,21,37,4,24,66,36.4,42,27,8,19,60,122,48,2,"https://fbref.com/en/players/f261abcb/Daniel-Baier"
2019,"Augsburg","Bundesliga","Caiuby","BRA","MF,FW","30",1988,11.2,12,10,5,6,1,3,11,27.3,8,16,1,15,5,17,10,0,"https://fbref.com/en/players/c6637acf/Caiuby"
2019,"Augsburg","Bundesliga","Jan-Ingwer Callsen-Bracker","GER","DF","33",1984,0.1,0,0,0,0,0,0,0,NA,0,0,0,0,0,0,0,0,"https://fbref.com/en/players/0999a593/Jan-Ingwer-Callsen-Bracker"
2019,"Augsburg","Bundesliga","Sergio Córdova","VEN","FW","20",1997,5.9,9,5,3,4,2,2,6,33.3,4,0,0,0,3,12,5,0,"https://fbref.com/en/players/229cd98a/Sergio-Cordova"
2019,"Augsburg","Bundesliga","Kevin Danso","AUT","DF","19",1998,13.9,25,14,21,3,1,11,14,78.6,3,25,17,8,19,44,72,0,"https://fbref.com/en/players/6e33125f/Kevin-Danso"
2019,"Augsburg","Bundesliga","Ji Dong-won","KOR","MF,FW","27",1991,9.9,10,6,5,3,2,6,16,37.5,10,13,2,11,8,18,10,0,"https://fbref.com/en/players/7d841904/Ji-Dong-won"
2019,"Augsburg","Bundesliga","Alfreð Finnbogason","ISL","FW","29",1989,14.8,7,3,2,5,0,1,9,11.1,8,6,1,5,3,10,11,0,"https://fbref.com/en/players/f9e7c4ac/Alfred-Finnbogason"
2019,"Augsburg","Bundesliga","Raphael Framberger","GER","DF,MF","22",1995,6.1,8,6,4,4,0,0,3,0,3,10,3,7,11,19,15,1,"https://fbref.com/en/players/626fab5f/Raphael-Framberger"
2019,"Augsburg","Bundesliga","Fabian Giefer","GER","GK","28",1990,4,0,0,0,0,0,0,2,0,2,0,0,0,0,0,1,2,"https://fbref.com/en/players/fbefefdb/Fabian-Giefer"
2019,"Augsburg","Bundesliga","Felix Götze","GER","MF","20",1998,1.4,4,2,2,2,0,3,3,100,0,1,0,1,3,7,7,0,"https://fbref.com/en/players/ee7cdd0c/Felix-Gotze"
2019,"Augsburg","Bundesliga","Jeffrey Gouweleeuw","NED","DF","27",1991,23.2,42,31,23,19,0,24,39,61.5,15,44,21,23,56,98,71,1,"https://fbref.com/en/players/1025db8e/Jeffrey-Gouweleeuw"
2019,"Augsburg","Bundesliga","Michael Gregoritsch","AUT","MF,FW","24",1994,27.6,22,13,7,9,6,4,28,14.3,24,29,10,19,15,37,58,0,"https://fbref.com/en/players/8e235926/Michael-Gregoritsch"
2019,"Augsburg","Bundesliga","André Hahn","GER","FW,MF","27",1990,22.8,64,38,22,39,3,22,53,41.5,31,28,2,26,27,91,32,0,"https://fbref.com/en/players/cd82452e/Andre-Hahn"
2019,"Augsburg","Bundesliga","Martin Hinteregger","AUT","DF","25",1992,17.5,48,35,31,16,1,24,35,68.6,11,24,13,11,22,70,68,0,"https://fbref.com/en/players/080440a4/Martin-Hinteregger"
2019,"Augsburg","Bundesliga","Koo Ja-cheol","KOR","MF","29",1989,18.2,36,23,10,20,6,12,30,40,18,28,5,23,27,63,21,0,"https://fbref.com/en/players/3c05e082/Koo-Ja-cheol"
2019,"Augsburg","Bundesliga","Christoph Janker","GER","MF,FW","33",1985,0.8,2,1,2,0,0,0,0,NA,0,1,0,1,0,2,1,0,"https://fbref.com/en/players/cf01fe3a/Christoph-Janker"
2019,"Augsburg","Bundesliga","Fredrik Jensen","FIN","FW,MF","20",1997,2.3,5,4,3,1,1,2,4,50,2,6,0,6,2,7,3,0,"https://fbref.com/en/players/3eeb80e0/Fredrik-Jensen"
2019,"Augsburg","Bundesliga","Rani Khedira","GER","DF,MF","24",1994,29.2,56,39,22,28,6,18,36,50,18,44,22,22,80,136,95,1,"https://fbref.com/en/players/59e4b92e/Rani-Khedira"
2019,"Augsburg","Bundesliga","Gregor Kobel","SUI","GK","20",1997,15.4,1,1,1,0,0,1,1,100,0,0,0,0,2,3,5,3,"https://fbref.com/en/players/cd59b9df/Gregor-Kobel"
2019,"Augsburg","Bundesliga","Andreas Luthe","GER","GK","31",1987,14.6,0,0,0,0,0,0,0,NA,0,0,0,0,0,0,4,0,"https://fbref.com/en/players/7fe12375/Andreas-Luthe"
2019,"Augsburg","Bundesliga","Philipp Max","GER","DF,MF","24",1993,28.5,35,24,17,15,3,21,39,53.8,18,16,3,13,22,57,46,1,"https://fbref.com/en/players/826e8b63/Philipp-Max"
2019,"Augsburg","Bundesliga","Jan Morávek","CZE","MF","28",1989,8.4,38,21,17,16,5,19,42,45.2,23,21,1,20,9,47,13,0,"https://fbref.com/en/players/e7d22eae/Jan-Moravek"
2019,"Augsburg","Bundesliga","Reece Oxford","ENG","DF","19",1998,5.6,12,9,9,3,0,4,6,66.7,2,10,9,1,11,23,39,0,"https://fbref.com/en/players/8b6e0db2/Reece-Oxford"
2019,"Augsburg","Bundesliga","Marco Richter","GER","MF,FW","20",1997,15.8,13,8,4,5,4,7,20,35,13,16,1,15,13,26,9,1,"https://fbref.com/en/players/f972644c/Marco-Richter"
2019,"Augsburg","Bundesliga","Julian Schieber","GER","FW","29",1989,2.9,3,2,1,2,0,0,1,0,1,1,0,1,1,4,3,0,"https://fbref.com/en/players/37c213cf/Julian-Schieber"
2019,"Augsburg","Bundesliga","Jonathan Schmid","FRA","DF","28",1990,28,44,22,23,19,2,16,28,57.1,12,22,8,14,43,87,70,2,"https://fbref.com/en/players/088ca1bd/Jonathan-Schmid"
2019,"Augsburg","Bundesliga","Kostas Stafylidis","GRE","DF","24",1993,10.2,22,14,17,4,1,10,19,52.6,9,13,2,11,15,37,31,0,"https://fbref.com/en/players/861e0116/Kostas-Stafylidis"
2019,"Augsburg","Bundesliga","Jozo Stanić","CRO","MF","19",1999,0,0,0,0,0,0,0,0,NA,0,0,0,0,0,0,0,0,"https://fbref.com/en/players/597ff9d3/Jozo-Stanic"
2019,"Augsburg","Bundesliga","Georg Teigl","AUT","MF,FW","27",1991,3.3,5,3,4,0,1,2,2,100,0,1,0,1,7,12,5,1,"https://fbref.com/en/players/c8cfb04d/Georg-Teigl"
2019,"Barcelona","La Liga","Jordi Alba","ESP","DF","29",1989,33.2,42,22,20,15,7,20,48,41.7,28,24,6,18,60,102,76,1,"https://fbref.com/en/players/4601e194/Jordi-Alba"
2019,"Barcelona","La Liga","Carles Aleñá","ESP","MF","20",1998,7.1,7,4,0,6,1,2,8,25,6,4,0,4,2,9,0,0,"https://fbref.com/en/players/6c811eb7/Carles-Alena"
2019,"Barcelona","La Liga","Kevin-Prince Boateng","GHA","FW","31",1987,2.7,3,2,0,1,2,0,1,0,1,1,0,1,1,4,4,0,"https://fbref.com/en/players/f4ec4fd0/Kevin-Prince-Boateng"
2019,"Barcelona","La Liga","Sergio Busquets","ESP","MF","30",1988,30.2,90,60,35,45,10,41,89,46.1,48,43,8,35,54,144,22,1,"https://fbref.com/en/players/5ab0ea87/Sergio-Busquets"
2019,"Barcelona","La Liga","Jasper Cillessen","NED","GK","29",1989,3,0,0,0,0,0,0,0,NA,0,0,0,0,0,0,3,2,"https://fbref.com/en/players/04ac8285/Jasper-Cillessen"
2019,"Barcelona","La Liga","Álex Collado","ESP","FW","19",1999,0.9,1,0,0,1,0,0,1,0,1,3,0,3,0,1,2,0,"https://fbref.com/en/players/85dace26/Alex-Collado"
2019,"Barcelona","La Liga","Philippe Coutinho","BRA","FW,MF","26",1992,22.4,16,11,1,6,9,7,22,31.8,15,21,2,19,12,28,8,0,"https://fbref.com/en/players/0ef89a37/Philippe-Coutinho"
2019,"Barcelona","La Liga","Ousmane Dembélé","FRA","FW,MF","21",1997,18.5,23,15,4,13,6,6,18,33.3,12,13,0,13,5,28,4,0,"https://fbref.com/en/players/b19db005/Ousmane-Dembele"
2019,"Barcelona","La Liga","Munir El Haddadi","MAR","FW","22",1995,1.7,3,3,1,1,1,1,3,33.3,2,1,0,1,0,3,1,0,"https://fbref.com/en/players/8696bc90/Munir-El-Haddadi"
2019,"Barcelona","La Liga","Clément Lenglet","FRA","DF","23",1995,21.5,47,29,26,19,2,22,36,61.1,14,30,20,10,21,68,70,0,"https://fbref.com/en/players/4f28a6ff/Clement-Lenglet"
2019,"Barcelona","La Liga","Malcom","BRA","FW,MF","21",1997,6.8,3,2,0,1,2,2,3,66.7,1,7,0,7,1,4,1,0,"https://fbref.com/en/players/6853490f/Malcom"
2019,"Barcelona","La Liga","Arthur Melo","BRA","MF","21",1996,15.9,15,10,5,6,4,6,13,46.2,7,8,0,8,9,24,9,1,"https://fbref.com/en/players/48b3dd60/Arthur-Melo"
2019,"Barcelona","La Liga","Lionel Messi","ARG","FW","31",1987,30.1,12,7,5,3,4,1,17,5.9,16,10,0,10,3,15,1,0,"https://fbref.com/en/players/d70ce98e/Lionel-Messi"
2019,"Barcelona","La Liga","Jeison Murillo","COL","DF","26",1992,1.3,2,2,1,1,0,0,3,0,3,0,0,0,0,2,5,1,"https://fbref.com/en/players/b233e8e4/Jeison-Murillo"
2019,"Barcelona","La Liga","Carles Pérez","ESP","FW","20",1998,0.2,0,0,0,0,0,0,0,NA,0,1,0,1,0,0,0,0,"https://fbref.com/en/players/a8f21b9f/Carles-Perez"
2019,"Barcelona","La Liga","Gerard Piqué","ESP","DF","31",1987,35,42,27,25,17,0,24,37,64.9,13,41,27,14,36,78,154,5,"https://fbref.com/en/players/adfc9123/Gerard-Pique"
2019,"Barcelona","La Liga","Riqui Puig","ESP","MF","18",1999,1.7,3,3,0,2,1,2,3,66.7,1,0,0,0,0,3,1,0,"https://fbref.com/en/players/f090a37a/Riqui-Puig"
2019,"Barcelona","La Liga","Rafinha","BRA","FW,MF","25",1993,2.5,8,6,2,3,3,2,2,100,0,5,1,4,1,9,2,0,"https://fbref.com/en/players/0c2ac3cb/Rafinha"
2019,"Barcelona","La Liga","Ivan Rakitić","CRO","MF","30",1988,29.4,30,24,10,14,6,12,37,32.4,25,32,8,24,51,81,33,0,"https://fbref.com/en/players/89f951b5/Ivan-Rakitic"
2019,"Barcelona","La Liga","Sergi Roberto","ESP","DF,MF","26",1992,23.2,28,20,15,9,4,16,24,66.7,8,18,3,15,43,71,31,0,"https://fbref.com/en/players/335fa267/Sergi-Roberto"
2019,"Barcelona","La Liga","Abel Ruiz","ESP","FW","18",2000,0.2,1,1,1,0,0,1,1,100,0,0,0,0,0,1,0,0,"https://fbref.com/en/players/6cbf8d0d/Abel-Ruiz"
2019,"Barcelona","La Liga","Nélson Semedo","POR","DF","24",1993,17.8,38,27,23,12,3,12,18,66.7,6,23,7,16,22,60,26,0,"https://fbref.com/en/players/d04b94db/Nelson-Semedo"
2019,"Barcelona","La Liga","Denis Suárez","ESP","MF,DF","24",1994,0.2,0,0,0,0,0,0,0,NA,0,1,0,1,0,0,0,0,"https://fbref.com/en/players/12c50af5/Denis-Suarez"
2019,"Barcelona","La Liga","Luis Suárez","URU","FW","31",1987,31.4,18,11,1,6,11,4,10,40,6,12,4,8,8,26,24,0,"https://fbref.com/en/players/a6154613/Luis-Suarez"
2019,"Barcelona","La Liga","Marc-André ter Stegen","GER","GK","26",1992,35,0,0,0,0,0,0,3,0,3,0,0,0,2,2,5,2,"https://fbref.com/en/players/6f51e382/Marc-Andre-ter-Stegen"
2019,"Barcelona","La Liga","Jean-Clair Todibo","FRA","DF","18",1999,1.7,7,2,4,3,0,5,6,83.3,1,1,0,1,3,10,8,0,"https://fbref.com/en/players/88f130ed/Jean-Clair-Todibo"
2019,"Barcelona","La Liga","Samuel Umtiti","FRA","DF","24",1993,13.2,8,5,3,4,1,4,6,66.7,2,10,8,2,18,26,28,2,"https://fbref.com/en/players/3eed9821/Samuel-Umtiti"
2019,"Barcelona","La Liga","Thomas Vermaelen","BEL","DF","32",1985,6.5,6,4,3,3,0,3,7,42.9,4,4,2,2,6,12,21,0,"https://fbref.com/en/players/d0d79694/Thomas-Vermaelen"
2019,"Barcelona","La Liga","Arturo Vidal","CHI","MF","31",1987,21.4,78,44,32,37,9,30,69,43.5,39,46,5,41,29,107,23,1,"https://fbref.com/en/players/67cdbc0e/Arturo-Vidal"
2019,"Barcelona","La Liga","Moussa Wagué","SEN","DF,FW","19",1998,2.5,6,5,1,4,1,3,7,42.9,4,1,0,1,4,10,3,0,"https://fbref.com/en/players/808df563/Moussa-Wague"
2019,"Bayern Munich","Bundesliga","David Alaba","AUT","DF","26",1992,28.1,34,21,13,13,8,17,26,65.4,9,24,3,21,31,65,40,0,"https://fbref.com/en/players/05439de2/David-Alaba"
2019,"Bayern Munich","Bundesliga","Thiago Alcántara","ESP","MF","27",1991,26.8,87,65,31,44,12,25,48,52.1,23,23,4,19,44,131,17,1,"https://fbref.com/en/players/77e84962/Thiago-Alcantara"
2019,"Bayern Munich","Bundesliga","Jérôme Boateng","GER","DF","29",1988,18.8,21,15,12,9,0,10,22,45.5,12,8,3,5,25,46,49,0,"https://fbref.com/en/players/2db2fd7b/Jerome-Boateng"
2019,"Bayern Munich","Bundesliga","Kingsley Coman","FRA","FW,MF","22",1996,15.3,11,6,4,4,3,6,19,31.6,13,20,0,20,5,16,3,0,"https://fbref.com/en/players/042e8a49/Kingsley-Coman"
2019,"Bayern Munich","Bundesliga","Alphonso Davies","CAN","MF,FW","17",2000,0.9,1,1,1,0,0,0,0,NA,0,2,0,2,2,3,1,0,"https://fbref.com/en/players/d781d855/Alphonso-Davies"
2019,"Bayern Munich","Bundesliga","Serge Gnabry","GER","FW,MF","23",1995,19.6,36,20,12,13,11,5,30,16.7,25,18,0,18,11,47,3,0,"https://fbref.com/en/players/88e357ef/Serge-Gnabry"
2019,"Bayern Munich","Bundesliga","Leon Goretzka","GER","MF","23",1995,22.5,41,22,7,27,7,14,38,36.8,24,25,4,21,26,67,14,1,"https://fbref.com/en/players/cc86b9a3/Leon-Goretzka"
2019,"Bayern Munich","Bundesliga","Mats Hummels","GER","DF","29",1988,19.7,26,17,19,6,1,9,24,37.5,15,20,8,12,34,60,50,1,"https://fbref.com/en/players/05d548d8/Mats-Hummels"
2019,"Bayern Munich","Bundesliga","Joshua Kimmich","GER","DF,MF","23",1995,34,46,26,17,22,7,25,54,46.3,29,35,9,26,34,80,41,3,"https://fbref.com/en/players/49296448/Joshua-Kimmich"
2019,"Bayern Munich","Bundesliga","Robert Lewandowski","POL","FW","29",1988,32.9,12,9,0,8,4,3,11,27.3,8,11,1,10,7,19,15,0,"https://fbref.com/en/players/8d78e732/Robert-Lewandowski"
2019,"Bayern Munich","Bundesliga","Javi Martínez","ESP","MF","29",1988,14.5,26,15,7,17,2,5,16,31.3,11,17,5,12,31,57,13,0,"https://fbref.com/en/players/7f97771d/Javi-Martinez"
2019,"Bayern Munich","Bundesliga","Thomas Müller","GER","MF,FW","28",1989,26.4,42,23,13,15,14,10,38,26.3,28,46,6,40,9,51,12,0,"https://fbref.com/en/players/3c6089ab/Thomas-Muller"
2019,"Bayern Munich","Bundesliga","Manuel Neuer","GER","GK","32",1986,25.6,1,1,1,0,0,0,1,0,1,1,0,1,0,1,8,3,"https://fbref.com/en/players/8778c910/Manuel-Neuer"
2019,"Bayern Munich","Bundesliga","Rafinha","BRA","DF","32",1985,10,15,7,6,6,3,6,14,42.9,8,8,3,5,19,34,11,0,"https://fbref.com/en/players/d003e213/Rafinha"
2019,"Bayern Munich","Bundesliga","Franck Ribéry","FRA","MF,FW","35",1983,13,15,7,7,6,2,4,10,40,6,9,0,9,7,22,1,0,"https://fbref.com/en/players/f61c7c4e/Franck-Ribery"
2019,"Bayern Munich","Bundesliga","Arjen Robben","NED","FW,MF","34",1984,6.3,3,1,0,3,0,0,1,0,1,6,1,5,3,6,0,0,"https://fbref.com/en/players/09586899/Arjen-Robben"
2019,"Bayern Munich","Bundesliga","James Rodríguez","COL","MF","27",1991,12.6,12,8,3,4,5,5,19,26.3,14,9,0,9,4,16,1,0,"https://fbref.com/en/players/715bf047/James-Rodriguez"
2019,"Bayern Munich","Bundesliga","Renato Sanches","POR","MF","20",1997,6.4,5,5,2,1,2,3,10,30,7,7,0,7,4,9,2,0,"https://fbref.com/en/players/032f894e/Renato-Sanches"
2019,"Bayern Munich","Bundesliga","Meritan Shabani","ALB","MF","19",1999,0,0,0,0,0,0,0,0,NA,0,0,0,0,0,0,0,0,"https://fbref.com/en/players/012c38ec/Meritan-Shabani"
2019,"Bayern Munich","Bundesliga","Niklas Süle","GER","DF","22",1995,29.5,28,23,17,10,1,18,25,72,7,23,13,10,40,68,83,0,"https://fbref.com/en/players/e33c06cf/Niklas-Sule"
2019,"Bayern Munich","Bundesliga","Corentin Tolisso","FRA","MF","23",1994,0.6,0,0,0,0,0,0,2,0,2,1,1,0,0,0,0,0,"https://fbref.com/en/players/652d4c37/Corentin-Tolisso"
2019,"Bayern Munich","Bundesliga","Sven Ulreich","GER","GK","29",1988,8.4,0,0,0,0,0,0,0,NA,0,0,0,0,0,0,2,1,"https://fbref.com/en/players/7d3e7da6/Sven-Ulreich"
2019,"Bayern Munich","Bundesliga","Sandro Wagner","GER","FW","30",1987,1.6,3,2,0,2,1,0,1,0,1,0,0,0,0,3,2,0,"https://fbref.com/en/players/61b0b44d/Sandro-Wagner"
2019,"Bayern Munich","Bundesliga","Jeong Woo-yeong","KOR","FW","18",1999,0.1,0,0,0,0,0,0,1,0,1,0,0,0,0,0,0,0,"https://fbref.com/en/players/6190474d/Jeong-Woo-yeong"
2019,"Betis","La Liga","Antonio Barragán","ESP","DF,FW","31",1987,10.4,14,8,9,4,1,2,12,16.7,10,15,4,11,5,19,30,2,"https://fbref.com/en/players/487d9b09/Antonio-Barragan"
2019,"Betis","La Liga","Marc Bartra","ESP","DF","27",1991,32.5,86,55,55,26,5,41,76,53.9,35,46,21,25,60,146,132,2,"https://fbref.com/en/players/b742cc0d/Marc-Bartra"
2019,"Betis","La Liga","Ryad Boudebouz","ALG","MF,FW","28",1990,6,8,4,4,1,3,4,10,40,6,5,1,4,5,13,2,0,"https://fbref.com/en/players/1001ae82/Ryad-Boudebouz"
2019,"Betis","La Liga","Sergio Canales","ESP","MF","27",1991,29.5,44,30,19,18,7,11,53,20.8,42,34,3,31,9,53,8,1,"https://fbref.com/en/players/a6de370d/Sergio-Canales"
2019,"Betis","La Liga","William Carvalho","POR","MF","26",1992,26.5,45,27,20,21,4,16,29,55.2,13,8,0,8,12,57,30,0,"https://fbref.com/en/players/dee86451/William-Carvalho"
2019,"Betis","La Liga","Emerson","BRA","FW,DF","19",1999,3.5,9,7,6,1,2,3,10,30,7,6,0,6,7,16,12,0,"https://fbref.com/en/players/df8b52a5/Emerson"
2019,"Betis","La Liga","Zouhair Feddal","MAR","DF","29",1989,18.9,38,23,31,6,1,16,28,57.1,12,19,8,11,31,69,94,2,"https://fbref.com/en/players/89151b16/Zouhair-Feddal"
2019,"Betis","La Liga","Junior Firpo","ESP","DF,FW","21",1996,21.5,38,25,16,14,8,10,24,41.7,14,27,2,25,23,61,48,0,"https://fbref.com/en/players/24f59bb2/Junior-Firpo"
2019,"Betis","La Liga","Javi García","ESP","DF,MF","31",1987,5.8,3,1,3,0,0,2,3,66.7,1,5,1,4,5,8,27,0,"https://fbref.com/en/players/167c1bb0/Javi-Garcia"
2019,"Betis","La Liga","Andrés Guardado","MEX","MF,DF","31",1986,25.9,24,15,9,12,3,11,47,23.4,36,27,1,26,28,52,28,1,"https://fbref.com/en/players/ef322658/Andres-Guardado"
2019,"Betis","La Liga","Francis Guerrero","ESP","DF,FW","22",1996,19.8,51,28,25,16,10,23,41,56.1,18,15,1,14,21,72,47,4,"https://fbref.com/en/players/59d53e8a/Francis-Guerrero"
2019,"Betis","La Liga","Takashi Inui","JPN","MF","30",1988,4.2,4,3,0,4,0,3,7,42.9,4,3,0,3,1,5,1,0,"https://fbref.com/en/players/61bd33d0/Takashi-Inui"
2019,"Betis","La Liga","Jesé","ESP","FW,MF","25",1993,8.7,7,4,3,3,1,2,8,25,6,8,0,8,1,8,1,0,"https://fbref.com/en/players/4a537185/Jese"
2019,"Betis","La Liga","Joaquín","ESP","FW,MF","37",1981,18.8,10,4,4,2,4,3,7,42.9,4,13,2,11,14,24,31,1,"https://fbref.com/en/players/4c5b14d2/Joaquin"
2019,"Betis","La Liga","Wilfrid Kaptoum","CMR","MF","22",1996,8.6,15,6,4,10,1,5,11,45.5,6,9,1,8,10,25,6,2,"https://fbref.com/en/players/d717630e/Wilfrid-Kaptoum"
2019,"Betis","La Liga","Diego Lainez","MEX","FW,MF","18",2000,3.9,4,4,0,3,1,1,1,100,0,2,0,2,1,5,2,0,"https://fbref.com/en/players/bf12926c/Diego-Lainez"
2019,"Betis","La Liga","Sergio León","ESP","FW,MF","29",1989,7.1,4,2,2,1,1,2,8,25,6,4,0,4,2,6,6,0,"https://fbref.com/en/players/0a0cc13c/Sergio-Leon"
2019,"Betis","La Liga","Giovani Lo Celso","ARG","MF,FW","22",1996,26.6,52,31,16,28,8,9,35,25.7,26,24,1,23,17,69,8,0,"https://fbref.com/en/players/d7553721/Giovani-Lo-Celso"
2019,"Betis","La Liga","Pau López","ESP","GK","23",1994,33,0,0,0,0,0,0,2,0,2,1,0,1,2,2,17,2,"https://fbref.com/en/players/20b9f052/Pau-Lopez"
2019,"Betis","La Liga","Aïssa Mandi","ALG","DF","26",1991,34,52,34,27,20,5,12,29,41.4,17,39,23,16,41,93,71,2,"https://fbref.com/en/players/fbd6378b/Aissa-Mandi"
2019,"Betis","La Liga","Loren Morón","ESP","FW","24",1993,21.7,18,12,4,11,3,6,27,22.2,21,24,1,23,6,24,18,0,"https://fbref.com/en/players/3aa4a3be/Loren-Moron"
2019,"Betis","La Liga","Joel Robles","ESP","GK","28",1990,5,1,0,1,0,0,1,1,100,0,0,0,0,0,1,5,1,"https://fbref.com/en/players/cda0b317/Joel-Robles"
2019,"Betis","La Liga","Antonio Sanabria","PAR","FW","22",1996,9,8,6,0,5,3,1,6,16.7,5,8,2,6,3,11,4,0,"https://fbref.com/en/players/0a447501/Antonio-Sanabria"
2019,"Betis","La Liga","Sidnei","BRA","DF","28",1989,19.4,48,29,33,12,3,18,34,52.9,16,21,8,13,41,89,57,0,"https://fbref.com/en/players/b14d0c5d/Sidnei"
2019,"Betis","La Liga","Cristian Tello","ESP","DF,FW","26",1991,17.5,32,20,18,9,5,17,35,48.6,18,19,0,19,16,48,17,1,"https://fbref.com/en/players/72a99e38/Cristian-Tello"
2019,"Bologna","Serie A","Arturo Calabresi","ITA","DF","22",1996,15.7,46,27,22,17,7,22,40,55,18,18,3,15,34,80,60,0,"https://fbref.com/en/players/34bb6fbd/Arturo-Calabresi"
2019,"Bologna","Serie A","Gabriele Corbo","ITA","DF","18",2000,0.1,0,0,0,0,0,0,0,NA,0,0,0,0,0,0,0,0,"https://fbref.com/en/players/091795f2/Gabriele-Corbo"
2019,"Bologna","Serie A","Sebastien De Maio","FRA","DF","31",1987,5.5,5,4,3,2,0,1,2,50,1,8,5,3,1,6,32,0,"https://fbref.com/en/players/952a03fe/Sebastien-De-Maio"
2019,"Bologna","Serie A","Mattia Destro","ITA","FW","27",1991,5.5,3,2,2,0,1,0,0,NA,0,4,0,4,0,3,6,0,"https://fbref.com/en/players/d7d32194/Mattia-Destro"
2019,"Bologna","Serie A","Mitchell Dijks","NED","DF","25",1993,22.5,30,18,19,7,4,13,36,36.1,23,18,1,17,23,53,49,0,"https://fbref.com/en/players/0a3065c8/Mitchell-Dijks"
2019,"Bologna","Serie A","Godfred Donsah","GHA","MF","22",1996,1.7,3,1,3,0,0,3,5,60,2,4,2,2,0,3,7,0,"https://fbref.com/en/players/384dd218/Godfred-Donsah"
2019,"Bologna","Serie A","Blerim Džemaili","SUI","MF","32",1986,19.4,44,27,22,19,3,19,58,32.8,39,22,1,21,17,61,12,1,"https://fbref.com/en/players/756959aa/Blerim-Dzemaili"
2019,"Bologna","Serie A","Simone Edera","ITA","FW","21",1997,2.2,4,4,3,0,1,1,3,33.3,2,5,1,4,0,4,1,0,"https://fbref.com/en/players/8697c095/Simone-Edera"
2019,"Bologna","Serie A","Diego Falcinelli","ITA","FW","27",1991,7.8,8,5,1,3,4,2,3,66.7,1,4,1,3,1,9,5,0,"https://fbref.com/en/players/a39b9ef6/Diego-Falcinelli"
2019,"Bologna","Serie A","Giancarlo González","CRC","DF","30",1988,8.3,13,7,12,1,0,5,9,55.6,4,15,11,4,12,25,42,0,"https://fbref.com/en/players/117beb8f/Giancarlo-Gonzalez"
2019,"Bologna","Serie A","Filip Helander","SWE","DF","25",1993,19,42,26,25,13,4,19,23,82.6,4,27,16,11,14,56,84,0,"https://fbref.com/en/players/27f0ddef/Filip-Helander"
2019,"Bologna","Serie A","Ladislav Krejčí","CZE","DF,MF","26",1992,11.8,16,12,6,9,1,7,12,58.3,5,8,2,6,6,22,18,0,"https://fbref.com/en/players/58027adc/Ladislav-Krejci"
2019,"Bologna","Serie A","Danilo Larangeira","BRA","DF","34",1984,34.2,40,26,29,11,0,20,30,66.7,10,52,39,13,37,77,182,3,"https://fbref.com/en/players/fed5f993/Danilo-Larangeira"
2019,"Bologna","Serie A","Lyanco","BRA","DF","21",1997,12.4,29,18,19,10,0,13,18,72.2,5,24,16,8,22,51,64,0,"https://fbref.com/en/players/b5bf1770/Lyanco"
2019,"Bologna","Serie A","Juan Manuel Valencia","COL","FW","20",1998,0.3,0,0,0,0,0,0,0,NA,0,0,0,0,1,1,0,0,"https://fbref.com/en/players/7f50c23b/Juan-Manuel-Valencia"
2019,"Bologna","Serie A","Federico Mattiello","ITA","DF,FW","23",1995,14.8,33,20,19,9,5,15,23,65.2,8,9,3,6,20,53,43,0,"https://fbref.com/en/players/fba81826/Federico-Mattiello"
2019,"Bologna","Serie A","Ibrahima Mbaye","SEN","DF","23",1994,22.3,48,32,30,16,2,19,32,59.4,13,21,12,9,19,67,66,1,"https://fbref.com/en/players/cfbf9881/Ibrahima-Mbaye"
2019,"Bologna","Serie A","Ádám Nagy","HUN","MF","23",1995,10.8,29,21,15,13,1,11,21,52.4,10,13,5,8,25,54,12,2,"https://fbref.com/en/players/788b31e2/Adam-Nagy"
2019,"Bologna","Serie A","Orji Okwonkwo","NGA","FW","20",1998,2.9,4,3,1,2,1,2,2,100,0,0,0,0,1,5,0,0,"https://fbref.com/en/players/905a4f61/Orji-Okwonkwo"
2019,"Bologna","Serie A","Riccardo Orsolini","ITA","FW,MF","21",1997,21.8,40,24,16,18,6,9,39,23.1,30,23,2,21,14,54,25,1,"https://fbref.com/en/players/e14ec482/Riccardo-Orsolini"
2019,"Bologna","Serie A","Rodrigo Palacio","ARG","FW","36",1982,25.9,24,13,8,12,4,4,34,11.8,30,35,0,35,5,29,13,0,"https://fbref.com/en/players/8d8178ac/Rodrigo-Palacio"
2019,"Bologna","Serie A","Nehuén Paz","ARG","DF","25",1993,1.3,2,1,2,0,0,1,2,50,1,3,1,2,0,2,2,0,"https://fbref.com/en/players/42b1a58a/Nehuen-Paz"
2019,"Bologna","Serie A","Andrea Poli","ITA","MF","28",1989,21.5,65,47,30,28,7,24,67,35.8,43,36,5,31,35,100,13,2,"https://fbref.com/en/players/b3fd7075/Andrea-Poli"
2019,"Bologna","Serie A","Erick Pulgar","CHI","MF","24",1994,26.2,65,36,35,23,7,22,73,30.1,51,35,5,30,50,115,54,1,"https://fbref.com/en/players/4611e028/Erick-Pulgar"
2019,"Bologna","Serie A","Nicola Sansone","ITA","FW","26",1991,12.7,29,17,9,14,6,9,27,33.3,18,13,1,12,9,38,4,0,"https://fbref.com/en/players/7eb97a8e/Nicola-Sansone"
2019,"Bologna","Serie A","Federico Santander","PAR","FW","27",1991,22.9,18,10,6,8,4,2,23,8.7,21,20,2,18,9,27,30,0,"https://fbref.com/en/players/df85d472/Federico-Santander"
2019,"Bologna","Serie A","Łukasz Skorupski","POL","GK","27",1991,38,0,0,0,0,0,0,0,NA,0,0,0,0,3,3,12,4,"https://fbref.com/en/players/ab4449d6/Lukasz-Skorupski"
2019,"Bologna","Serie A","Roberto Soriano","ITA","MF","27",1991,16.5,27,18,14,10,3,8,24,33.3,16,21,2,19,3,30,11,0,"https://fbref.com/en/players/9d4c45d6/Roberto-Soriano"
2019,"Bologna","Serie A","Mattias Svanberg","SWE","MF","19",1999,13.1,22,11,14,7,1,11,25,44,14,25,6,19,11,33,16,2,"https://fbref.com/en/players/92d83c27/Mattias-Svanberg"
2019,"Bordeaux","Ligue 1","Yacine Adli","FRA","MF","18",2000,2.4,7,2,2,3,2,3,9,33.3,6,3,0,3,2,9,0,0,"https://fbref.com/en/players/26777636/Yacine-Adli"
2019,"Bordeaux","Ligue 1","Toma Bašić","CRO","MF","21",1996,14.8,32,16,5,21,6,11,31,35.5,20,13,1,12,9,41,22,1,"https://fbref.com/en/players/80556f08/Toma-Basic"
2019,"Bordeaux","Ligue 1","Paul Baysse","FRA","DF","30",1988,0.8,1,0,1,0,0,0,1,0,1,1,1,0,1,2,6,0,"https://fbref.com/en/players/2515040a/Paul-Baysse"
2019,"Bordeaux","Ligue 1","Yassine Benrahou","FRA","MF,FW","19",1999,2,9,6,1,7,1,2,5,40,3,4,0,4,2,11,1,0,"https://fbref.com/en/players/fbf76716/Yassine-Benrahou"
2019,"Bordeaux","Ligue 1","Jimmy Briand","FRA","FW","32",1985,27.7,14,8,2,10,2,4,24,16.7,20,14,6,8,4,18,29,0,"https://fbref.com/en/players/f83c8d6c/Jimmy-Briand"
2019,"Bordeaux","Ligue 1","Till Cissokho","FRA","DF","18",2000,0.9,1,0,1,0,0,0,0,NA,0,0,0,0,2,3,3,0,"https://fbref.com/en/players/e8b5ad37/Till-Cissokho"
2019,"Bordeaux","Ligue 1","Andreas Cornelius","DEN","FW","25",1993,8.8,4,1,1,3,0,1,4,25,3,4,1,3,1,5,21,0,"https://fbref.com/en/players/c693347d/Andreas-Cornelius"
2019,"Bordeaux","Ligue 1","Benoît Costil","FRA","GK","31",1987,37,2,0,2,0,0,2,2,100,0,0,0,0,0,2,14,3,"https://fbref.com/en/players/2434f24a/Benoit-Costil"
2019,"Bordeaux","Ligue 1","Milan Gajić","SRB","DF","22",1996,1,2,1,1,0,1,1,1,100,0,0,0,0,1,3,7,0,"https://fbref.com/en/players/9f6325f9/Milan-Gajic"
2019,"Bordeaux","Ligue 1","Vukašin Jovanović","SRB","DF","22",1996,15.3,26,21,21,5,0,13,19,68.4,6,23,12,11,36,62,105,0,"https://fbref.com/en/players/0eb03d5b/Vukasin-Jovanovic"
2019,"Bordeaux","Ligue 1","Samuel Kalu","NGA","FW","20",1997,14.2,27,18,15,7,5,4,11,36.4,7,11,3,8,8,35,4,1,"https://fbref.com/en/players/b8d22478/Samuel-Kalu"
2019,"Bordeaux","Ligue 1","François Kamano","GUI","FW,MF","22",1996,28.5,29,18,6,17,6,11,30,36.7,19,27,0,27,17,46,6,1,"https://fbref.com/en/players/81d3318f/Francois-Kamano"
2019,"Bordeaux","Ligue 1","Yann Karamoh","FRA","FW","20",1998,13.6,7,3,1,4,2,1,13,7.7,12,9,0,9,6,13,3,0,"https://fbref.com/en/players/8b66d9cc/Yann-Karamoh"
2019,"Bordeaux","Ligue 1","Jules Koundé","FRA","DF","19",1998,37,48,31,37,11,0,27,41,65.9,14,44,23,21,50,98,193,7,"https://fbref.com/en/players/4d1666ff/Jules-Kounde"
2019,"Bordeaux","Ligue 1","Gaëtan Laborde","FRA","FW","24",1994,1,4,3,0,1,3,2,4,50,2,0,0,0,0,4,0,0,"https://fbref.com/en/players/7cdda3bf/Gaetan-Laborde"
2019,"Bordeaux","Ligue 1","Alexandre Lauray","FRA","DF","21",1997,2.9,11,6,9,2,0,6,8,75,2,2,0,2,4,15,10,0,"https://fbref.com/en/players/ae6941ec/Alexandre-Lauray"
2019,"Bordeaux","Ligue 1","Lukas Lerager","DEN","MF","25",1993,14.4,38,21,14,23,1,18,43,41.9,25,22,10,12,32,70,26,1,"https://fbref.com/en/players/1b82f8df/Lukas-Lerager"
2019,"Bordeaux","Ligue 1","Igor Lewczuk","POL","DF","33",1985,5,12,7,8,2,2,1,4,25,3,2,2,0,4,16,27,0,"https://fbref.com/en/players/6b9f2f3e/Igor-Lewczuk"
2019,"Bordeaux","Ligue 1","Albert Lottin","FRA","MF,FW","16",2001,0.2,1,1,0,1,0,0,1,0,1,1,0,1,0,1,0,0,"https://fbref.com/en/players/934a0957/Albert-Lottin"
2019,"Bordeaux","Ligue 1","Josh Maja","NGA","FW","19",1998,2.2,2,1,1,1,0,0,1,0,1,1,0,1,0,2,0,0,"https://fbref.com/en/players/bc0bfc64/Josh-Maja"
2019,"Bordeaux","Ligue 1","Otávio","BRA","MF","24",1994,31.9,127,74,59,64,4,49,109,45,60,45,11,34,43,170,54,1,"https://fbref.com/en/players/243f4a0b/Otavio"
2019,"Bordeaux","Ligue 1","Pablo","BRA","DF","27",1991,21.5,26,15,22,3,1,13,23,56.5,10,28,22,6,32,58,173,2,"https://fbref.com/en/players/29d8ad3f/Pablo"
2019,"Bordeaux","Ligue 1","Sergi Palencia","ESP","DF","22",1996,22.1,74,50,46,20,8,27,55,49.1,28,22,3,19,17,91,70,1,"https://fbref.com/en/players/19f8e480/Sergi-Palencia"
2019,"Bordeaux","Ligue 1","Jaroslav Plašil","CZE","MF","36",1982,16,34,26,11,20,3,18,44,40.9,26,21,5,16,19,53,28,1,"https://fbref.com/en/players/516dc25b/Jaroslav-Plasil"
2019,"Bordeaux","Ligue 1","Maxime Poundjé","FRA","DF","25",1992,28.2,48,35,34,12,2,31,62,50,31,24,5,19,29,77,79,0,"https://fbref.com/en/players/b92edde2/Maxime-Poundje"
2019,"Bordeaux","Ligue 1","Gaëtan Poussin","FRA","GK","19",1999,1,0,0,0,0,0,0,0,NA,0,0,0,0,0,0,0,0,"https://fbref.com/en/players/c252c705/Gaetan-Poussin"
2019,"Bordeaux","Ligue 1","Nicolas de Préville","FRA","FW,MF","27",1991,14.1,28,19,10,15,3,8,29,27.6,21,23,1,22,10,38,21,1,"https://fbref.com/en/players/b0547a87/Nicolas-de-Preville"
2019,"Bordeaux","Ligue 1","Youssouf Sabaly","SEN","DF","25",1993,21.2,46,32,32,12,2,25,46,54.3,21,19,2,17,26,72,42,0,"https://fbref.com/en/players/fbbb9269/Youssouf-Sabaly"
2019,"Bordeaux","Ligue 1","Younousse Sankharé","SEN","MF","28",1989,16.4,25,12,2,19,4,6,19,31.6,13,14,0,14,9,34,4,0,"https://fbref.com/en/players/c650629d/Younousse-Sankhare"
2019,"Bordeaux","Ligue 1","Aurélien Tchouaméni","FRA","MF","18",2000,7.8,24,12,10,14,0,7,18,38.9,11,11,5,6,21,45,14,0,"https://fbref.com/en/players/4f255115/Aurelien-Tchouameni"
2019,"Bordeaux","Ligue 1","Driss Trichard","FRA","DF","23",1995,1,2,2,2,0,0,1,1,100,0,1,0,1,1,3,4,0,"https://fbref.com/en/players/6fea4e00/Driss-Trichard"
2019,"Bordeaux","Ligue 1","Valentín Vada","ARG","MF","22",1996,0.4,2,1,0,2,0,1,1,100,0,0,0,0,0,2,0,0,"https://fbref.com/en/players/dcf7cf44/Valentin-Vada"
2019,"Bordeaux","Ligue 1","Zaydou Youssouf","FRA","MF,FW","19",1999,4.7,7,5,3,4,0,3,7,42.9,4,5,1,4,5,12,0,0,"https://fbref.com/en/players/e2f9bb5f/Zaydou-Youssouf"
2019,"Bournemouth","Premier League","Nathan Aké","NED","DF","23",1995,37.9,66,35,42,21,3,22,35,62.9,13,51,35,16,32,98,241,0,"https://fbref.com/en/players/eaeca114/Nathan-Ake"
2019,"Bournemouth","Premier League","Asmir Begović","BIH","GK","31",1987,24,0,0,0,0,0,0,3,0,3,1,0,1,1,1,15,7,"https://fbref.com/en/players/7b4de647/Asmir-Begovic"
2019,"Bournemouth","Premier League","Artur Boruc","POL","GK","38",1980,12,1,0,1,0,0,1,3,33.3,2,0,0,0,0,1,1,0,"https://fbref.com/en/players/34ccf6fa/Artur-Boruc"
2019,"Bournemouth","Premier League","David Brooks","WAL","MF,FW","21",1997,25.1,37,26,12,19,6,19,44,43.2,25,36,7,29,24,61,28,0,"https://fbref.com/en/players/dc4cae05/David-Brooks"
2019,"Bournemouth","Premier League","Nathaniel Clyne","ENG","DF","27",1991,12.7,33,18,16,14,3,11,23,47.8,12,13,3,10,16,49,33,1,"https://fbref.com/en/players/0442183b/Nathaniel-Clyne"
2019,"Bournemouth","Premier League","Lewis Cook","ENG","MF","21",1997,8,13,6,6,7,0,8,19,42.1,11,8,2,6,8,21,7,1,"https://fbref.com/en/players/2afc7272/Lewis-Cook"
2019,"Bournemouth","Premier League","Steve Cook","ENG","DF","27",1991,31,36,19,31,5,0,20,27,74.1,7,36,21,15,50,86,202,1,"https://fbref.com/en/players/3e5e4e63/Steve-Cook"
2019,"Bournemouth","Premier League","Charlie Daniels","ENG","DF","31",1986,17.6,25,15,18,6,1,13,22,59.1,9,14,4,10,20,45,56,2,"https://fbref.com/en/players/9d107085/Charlie-Daniels"
2019,"Bournemouth","Premier League","Jermain Defoe","ENG","FW","35",1982,0.3,0,0,0,0,0,0,0,NA,0,0,0,0,0,0,0,0,"https://fbref.com/en/players/f1e8372d/Jermain-Defoe"
2019,"Bournemouth","Premier League","Simon Francis","ENG","DF","33",1985,13.7,25,14,19,5,1,12,24,50,12,15,7,8,19,44,73,1,"https://fbref.com/en/players/1e0b6a73/Simon-Francis"
2019,"Bournemouth","Premier League","Ryan Fraser","SCO","MF,FW","24",1994,35.2,19,11,9,8,2,10,32,31.3,22,23,6,17,22,41,33,0,"https://fbref.com/en/players/d56543a0/Ryan-Fraser"
2019,"Bournemouth","Premier League","Dan Gosling","ENG","MF","28",1990,19.3,57,23,27,21,9,28,53,52.8,25,33,11,22,20,77,46,1,"https://fbref.com/en/players/7fec31a0/Dan-Gosling"
2019,"Bournemouth","Premier League","Emerson Hyndman","USA","MF","22",1996,0.4,6,2,6,0,0,2,3,66.7,1,0,0,0,1,7,0,0,"https://fbref.com/en/players/3be1a627/Emerson-Hyndman"
2019,"Bournemouth","Premier League","Jordon Ibe","ENG","MF,DF","22",1995,8.9,6,5,0,5,1,2,7,28.6,5,2,0,2,4,10,4,0,"https://fbref.com/en/players/9f736ed2/Jordon-Ibe"
2019,"Bournemouth","Premier League","Joshua King","NOR","FW,MF","26",1992,32.9,30,19,7,19,4,8,29,27.6,21,28,4,24,7,37,14,0,"https://fbref.com/en/players/43458538/Joshua-King"
2019,"Bournemouth","Premier League","Jefferson Lerma","COL","MF","23",1994,27.8,45,31,20,20,5,14,54,25.9,40,35,19,16,54,99,88,1,"https://fbref.com/en/players/9b5ce51a/Jefferson-Lerma"
2019,"Bournemouth","Premier League","Chris Mepham","WAL","DF","20",1997,9.4,9,3,9,0,0,7,11,63.6,4,12,5,7,14,23,57,2,"https://fbref.com/en/players/fed96827/Chris-Mepham"
2019,"Bournemouth","Premier League","Tyrone Mings","ENG","DF","25",1993,1.6,4,3,3,1,0,2,3,66.7,1,5,2,3,6,10,8,0,"https://fbref.com/en/players/8397a50c/Tyrone-Mings"
2019,"Bournemouth","Premier League","Lys Mousset","FRA","FW","22",1996,4.1,3,1,1,1,1,1,4,25,3,3,0,3,1,4,3,0,"https://fbref.com/en/players/d9cfca3d/Lys-Mousset"
2019,"Bournemouth","Premier League","Diego Rico","ESP","DF,MF","25",1993,6.8,14,9,8,2,4,4,12,33.3,8,13,2,11,14,28,20,0,"https://fbref.com/en/players/d9ba39fc/Diego-Rico"
2019,"Bournemouth","Premier League","Jack Simpson","ENG","DF","21",1996,4.5,9,5,8,1,0,6,9,66.7,3,5,4,1,9,18,25,2,"https://fbref.com/en/players/76fa5f80/Jack-Simpson"
2019,"Bournemouth","Premier League","Adam Smith","ENG","DF,MF","27",1991,23,46,32,26,14,6,19,41,46.3,22,26,7,19,31,77,68,1,"https://fbref.com/en/players/20b104bc/Adam-Smith"
2019,"Bournemouth","Premier League","Dominic Solanke","ENG","FW,MF","20",1997,3.9,8,3,1,4,3,1,8,12.5,7,4,1,3,2,10,9,0,"https://fbref.com/en/players/e77dc3b2/Dominic-Solanke"
2019,"Bournemouth","Premier League","Junior Stanislas","ENG","MF,FW","28",1989,11.5,12,6,5,4,3,3,7,42.9,4,8,1,7,2,14,15,0,"https://fbref.com/en/players/6992791d/Junior-Stanislas"
2019,"Bournemouth","Premier League","Andrew Surman","ENG","MF","31",1986,16,11,6,6,5,0,3,13,23.1,10,20,7,13,10,21,34,1,"https://fbref.com/en/players/7d41b619/Andrew-Surman"
2019,"Bournemouth","Premier League","Sam Surridge","ENG","MF,FW","20",1998,0.1,1,0,0,0,1,0,0,NA,0,0,0,0,0,1,0,0,"https://fbref.com/en/players/b017b770/Sam-Surridge"
2019,"Bournemouth","Premier League","Mark Travers","IRL","GK","19",1999,2,0,0,0,0,0,0,0,NA,0,0,0,0,0,0,2,0,"https://fbref.com/en/players/fe558029/Mark-Travers"
2019,"Bournemouth","Premier League","Callum Wilson","ENG","FW","26",1992,28.1,9,7,4,3,2,0,8,0,8,14,4,10,4,13,16,0,"https://fbref.com/en/players/c596fcb0/Callum-Wilson"
2019,"Brighton","Premier League","Florin Andone","ROU","FW","25",1993,9.8,10,2,3,4,3,1,6,16.7,5,9,1,8,3,13,12,0,"https://fbref.com/en/players/dc008610/Florin-Andone"
2019,"Brighton","Premier League","Leon Balogun","NGA","DF","30",1988,6.6,12,6,11,1,0,8,9,88.9,1,5,3,2,17,29,32,1,"https://fbref.com/en/players/78e68b4d/Leon-Balogun"
2019,"Brighton","Premier League","Bernardo","BRA","DF","23",1995,19.5,62,43,43,13,6,31,45,68.9,14,32,13,19,34,96,82,0,"https://fbref.com/en/players/17370b95/Bernardo"
2019,"Brighton","Premier League","Yves Bissouma","MLI","MF","21",1996,19.7,62,30,33,27,2,20,38,52.6,18,21,5,16,33,95,29,2,"https://fbref.com/en/players/6c203af0/Yves-Bissouma"
2019,"Brighton","Premier League","Gaëtan Bong","CMR","DF","30",1988,20.1,16,10,7,6,3,6,10,60,4,16,6,10,25,41,57,2,"https://fbref.com/en/players/cfd5e123/Gaetan-Bong"
2019,"Brighton","Premier League","Bruno","ESP","DF","37",1980,12.6,25,16,20,3,2,14,18,77.8,4,7,2,5,11,36,30,1,"https://fbref.com/en/players/78803d03/Bruno"
2019,"Brighton","Premier League","David Button","ENG","GK","29",1989,4,0,0,0,0,0,0,0,NA,0,0,0,0,0,0,2,0,"https://fbref.com/en/players/e608ed4c/David-Button"
2019,"Brighton","Premier League","Shane Duffy","IRL","DF","26",1992,34.3,35,20,23,7,5,14,25,56,11,57,47,10,36,71,244,3,"https://fbref.com/en/players/7314bba4/Shane-Duffy"
2019,"Brighton","Premier League","Lewis Dunk","ENG","DF","26",1991,35,42,26,31,10,1,17,39,43.6,22,49,38,11,46,88,196,5,"https://fbref.com/en/players/282f75f3/Lewis-Dunk"
2019,"Brighton","Premier League","Pascal Groß","GER","MF,FW","27",1991,20.7,27,12,12,12,3,11,36,30.6,25,20,8,12,13,40,23,0,"https://fbref.com/en/players/8aec0537/Pascal-Gross"
2019,"Brighton","Premier League","José Izquierdo","COL","MF,FW","26",1992,8.8,15,9,9,4,2,10,20,50,10,7,1,6,5,20,7,0,"https://fbref.com/en/players/ca2bc3df/Jose-Izquierdo"
2019,"Brighton","Premier League","Alireza Jahanbakhsh","IRN","FW,MF","24",1993,11.3,32,18,17,11,4,11,30,36.7,19,16,0,16,11,43,4,0,"https://fbref.com/en/players/08452314/Alireza-Jahanbakhsh"
2019,"Brighton","Premier League","Beram Kayal","ISR","MF","30",1988,10.4,28,17,16,11,1,5,21,23.8,16,17,10,7,15,43,25,0,"https://fbref.com/en/players/26679cdf/Beram-Kayal"
2019,"Brighton","Premier League","Anthony Knockaert","FRA","MF,FW","26",1991,20.4,33,21,12,15,6,13,30,43.3,17,13,0,13,29,62,11,0,"https://fbref.com/en/players/6c679c6d/Anthony-Knockaert"
2019,"Brighton","Premier League","Jürgen Locadia","NED","FW,MF","24",1993,13.7,15,10,5,8,2,3,7,42.9,4,8,0,8,9,24,13,0,"https://fbref.com/en/players/6cc47ae1/Jurgen-Locadia"
2019,"Brighton","Premier League","Solly March","ENG","FW,MF","24",1994,27.4,56,24,27,16,13,19,45,42.2,26,34,4,30,27,83,44,0,"https://fbref.com/en/players/bb5fbd2b/Solly-March"
2019,"Brighton","Premier League","Martín Montoya","ESP","DF","27",1991,24.1,58,35,29,21,8,32,55,58.2,23,30,10,20,48,106,76,1,"https://fbref.com/en/players/5cec2487/Martin-Montoya"
2019,"Brighton","Premier League","Glenn Murray","ENG","FW","34",1983,27.9,17,7,4,7,6,4,20,20,16,20,3,17,2,19,17,1,"https://fbref.com/en/players/f2f29dda/Glenn-Murray"
2019,"Brighton","Premier League","Davy Pröpper","NED","MF","26",1991,28.3,50,28,23,21,6,16,52,30.8,36,21,6,15,53,103,37,0,"https://fbref.com/en/players/fdd85f94/Davy-Propper"
2019,"Brighton","Premier League","Mathew Ryan","AUS","GK","26",1992,34,1,0,1,0,0,1,2,50,1,0,0,0,0,1,13,1,"https://fbref.com/en/players/4535e4bb/Mathew-Ryan"
2019,"Brighton","Premier League","Dale Stephens","ENG","MF","29",1989,27.6,83,57,37,41,5,28,74,37.8,46,33,13,20,46,129,47,0,"https://fbref.com/en/players/653ee42d/Dale-Stephens"
2019,"Burnley","Premier League","Phil Bardsley","SCO","DF","33",1985,18.6,32,19,15,14,3,12,21,57.1,9,25,12,13,31,63,68,1,"https://fbref.com/en/players/1ae30132/Phil-Bardsley"
2019,"Burnley","Premier League","Ashley Barnes","ENG","FW","28",1989,26.5,28,17,4,17,7,6,29,20.7,23,29,8,21,2,30,25,0,"https://fbref.com/en/players/2691c772/Ashley-Barnes"
2019,"Burnley","Premier League","Jóhann Berg Guðmundsson","ISL","MF","27",1990,19.5,27,11,14,10,3,16,34,47.1,18,25,4,21,33,60,34,0,"https://fbref.com/en/players/f72293fc/Johann-Berg-Gudmundsson"
2019,"Burnley","Premier League","Robbie Brady","IRL","MF","26",1992,8,15,7,5,5,5,6,17,35.3,11,7,1,6,7,22,18,1,"https://fbref.com/en/players/96bb8cc2/Robbie-Brady"
2019,"Burnley","Premier League","Jack Cork","ENG","MF","29",1989,36.8,51,27,12,34,5,18,46,39.1,28,39,16,23,29,80,82,2,"https://fbref.com/en/players/74e12f1e/Jack-Cork"
2019,"Burnley","Premier League","Peter Crouch","ENG","FW","37",1981,1,1,1,0,1,0,1,1,100,0,0,0,0,0,1,2,0,"https://fbref.com/en/players/73d9bdc7/Peter-Crouch"
2019,"Burnley","Premier League","Steven Defour","BEL","MF","30",1988,5,8,4,2,4,2,3,14,21.4,11,11,3,8,8,16,7,0,"https://fbref.com/en/players/73489527/Steven-Defour"
2019,"Burnley","Premier League","Ben Gibson","ENG","DF","25",1993,0.7,1,1,1,0,0,0,0,NA,0,1,1,0,0,1,2,0,"https://fbref.com/en/players/bcfb0142/Ben-Gibson"
2019,"Burnley","Premier League","Joe Hart","ENG","GK","31",1987,19,0,0,0,0,0,0,1,0,1,0,0,0,0,0,11,3,"https://fbref.com/en/players/cb4f24c6/Joe-Hart"
2019,"Burnley","Premier League","Tom Heaton","ENG","GK","32",1986,19,0,0,0,0,0,0,2,0,2,0,0,0,0,0,8,2,"https://fbref.com/en/players/a6de6361/Tom-Heaton"
2019,"Burnley","Premier League","Jeff Hendrick","IRL","MF,FW","26",1992,22.9,24,12,13,7,4,9,32,28.1,23,20,5,15,12,36,31,0,"https://fbref.com/en/players/989d5705/Jeff-Hendrick"
2019,"Burnley","Premier League","Aaron Lennon","ENG","MF","31",1987,13.5,26,16,11,12,3,6,14,42.9,8,24,0,24,10,36,18,0,"https://fbref.com/en/players/2ff964a0/Aaron-Lennon"
2019,"Burnley","Premier League","Kevin Long","IRL","DF","27",1990,5.7,18,10,13,5,0,7,17,41.2,10,7,5,2,7,25,35,1,"https://fbref.com/en/players/5a4280b1/Kevin-Long"
2019,"Burnley","Premier League","Matthew Lowton","ENG","DF","29",1989,19.4,56,35,21,31,4,32,60,53.3,28,29,7,22,30,86,80,1,"https://fbref.com/en/players/9a9c05db/Matthew-Lowton"
2019,"Burnley","Premier League","Dwight McNeil","ENG","MF","18",1999,17.7,36,22,16,17,3,13,44,29.5,31,30,3,27,13,49,35,0,"https://fbref.com/en/players/fc15fb84/Dwight-McNeil"
2019,"Burnley","Premier League","Ben Mee","ENG","DF","28",1989,38,55,24,38,17,0,35,44,79.5,9,59,50,9,48,103,235,4,"https://fbref.com/en/players/8df7a2fb/Ben-Mee"
2019,"Burnley","Premier League","James Tarkowski","ENG","DF","25",1992,34.3,71,36,52,18,1,29,50,58,21,72,56,16,42,113,240,2,"https://fbref.com/en/players/15ea812b/James-Tarkowski"
2019,"Burnley","Premier League","Charlie Taylor","ENG","DF","24",1993,36,55,26,37,15,3,24,50,48,26,74,35,39,40,95,120,0,"https://fbref.com/en/players/cc2d7ad5/Charlie-Taylor"
2019,"Burnley","Premier League","Sam Vokes","WAL","FW","28",1989,10.2,4,2,1,2,1,0,0,NA,0,2,1,1,0,4,17,0,"https://fbref.com/en/players/1d6ac165/Sam-Vokes"
2019,"Burnley","Premier League","Matěj Vydra","CZE","FW","26",1992,3.5,2,1,0,1,1,0,3,0,3,4,1,3,1,3,6,0,"https://fbref.com/en/players/0d4ceb32/Matej-Vydra"
2019,"Burnley","Premier League","Stephen Ward","IRL","DF","32",1985,2.5,4,2,1,2,1,1,4,25,3,3,1,2,4,8,14,0,"https://fbref.com/en/players/3831b9fe/Stephen-Ward"
2019,"Burnley","Premier League","Ashley Westwood","ENG","MF","28",1990,31.4,58,30,24,27,7,14,39,35.9,25,38,9,29,47,105,42,2,"https://fbref.com/en/players/495945ef/Ashley-Westwood"
2019,"Burnley","Premier League","Chris Wood","NZL","FW","26",1991,28.8,12,8,0,7,5,5,17,29.4,12,17,4,13,3,15,26,0,"https://fbref.com/en/players/4e9a0555/Chris-Wood"
2019,"Caen","Ligue 1","Yoël Armougom","FRA","DF","20",1998,20.6,31,21,20,9,2,15,29,51.7,14,9,3,6,21,52,66,0,"https://fbref.com/en/players/9dd5da03/Yoel-Armougom"
2019,"Caen","Ligue 1","Yacine Bammou","MAR","FW,MF","26",1991,10.3,14,7,7,4,3,3,8,37.5,5,14,3,11,9,23,17,0,"https://fbref.com/en/players/a1d04509/Yacine-Bammou"
2019,"Caen","Ligue 1","Paul Baysse","FRA","DF","30",1988,19.9,25,14,20,5,0,13,18,72.2,5,25,20,5,31,56,113,1,"https://fbref.com/en/players/2515040a/Paul-Baysse"
2019,"Caen","Ligue 1","Claudio Beauvue","GLP","FW,MF","30",1988,16.7,18,11,7,9,2,1,14,7.1,13,11,2,9,10,28,21,0,"https://fbref.com/en/players/8ca253a3/Claudio-Beauvue"
2019,"Caen","Ligue 1","Enzo Crivelli","FRA","FW","23",1995,25.1,20,14,10,8,2,8,13,61.5,5,5,0,5,4,24,28,1,"https://fbref.com/en/players/06f33dc8/Enzo-Crivelli"
2019,"Caen","Ligue 1","Jessy Deminguet","FRA","MF","20",1998,14.1,37,25,18,17,2,15,40,37.5,25,19,3,16,18,55,28,1,"https://fbref.com/en/players/a6138e4a/Jessy-Deminguet"
2019,"Caen","Ligue 1","Ismaël Diomandé","CIV","MF,DF","25",1992,14.4,28,15,15,12,1,11,20,55,9,17,7,10,10,38,37,0,"https://fbref.com/en/players/10650926/Ismael-Diomande"
2019,"Caen","Ligue 1","Alexander Djiku","GHA","DF","23",1994,30.6,48,37,33,13,2,23,43,53.5,20,56,31,25,83,131,183,3,"https://fbref.com/en/players/43e7a164/Alexander-Djiku"
2019,"Caen","Ligue 1","Fayçal Fajr","MAR","MF","29",1988,36,65,32,22,33,10,25,66,37.9,41,27,6,21,29,94,19,2,"https://fbref.com/en/players/79135368/Faycal-Fajr"
2019,"Caen","Ligue 1","Romain Genevois","HAI","DF","30",1987,4,10,6,9,1,0,6,11,54.5,5,3,0,3,8,18,13,0,"https://fbref.com/en/players/1040e783/Romain-Genevois"
2019,"Caen","Ligue 1","Jonathan Gradit","FRA","DF","25",1992,22.3,52,28,30,21,1,28,52,53.8,24,40,15,25,45,97,82,3,"https://fbref.com/en/players/06c48679/Jonathan-Gradit"
2019,"Caen","Ligue 1","Frederic Guilbert","FRA","DF","23",1994,32.4,98,67,59,29,10,41,83,49.4,42,49,21,28,78,176,121,2,"https://fbref.com/en/players/5d8d7454/Frederic-Guilbert"
2019,"Caen","Ligue 1","Emmanuel Imorou","BEN","DF","29",1988,12.4,18,13,10,7,1,11,17,64.7,6,14,4,10,28,46,49,1,"https://fbref.com/en/players/3e87d087/Emmanuel-Imorou"
2019,"Caen","Ligue 1","Evens Joseph","FRA","MF,FW","19",1999,3.8,5,2,1,2,2,1,3,33.3,2,3,0,3,2,7,1,0,"https://fbref.com/en/players/acde3581/Evens-Joseph"
2019,"Caen","Ligue 1","Saîf-Eddine Khaoui","TUN","MF,FW","23",1995,15,20,14,5,11,4,8,27,29.6,19,9,1,8,20,40,4,0,"https://fbref.com/en/players/796b1c41/Saif-Eddine-Khaoui"
2019,"Caen","Ligue 1","Adama Mbengue","SEN","DF","24",1993,8.2,48,32,34,12,2,19,26,73.1,7,15,4,11,7,55,22,0,"https://fbref.com/en/players/b931d9d1/Adama-Mbengue"
2019,"Caen","Ligue 1","Herman Moussaki","FRA","MF,FW","19",1999,2.3,3,3,2,1,0,1,4,25,3,2,1,1,0,3,3,0,"https://fbref.com/en/players/63a10528/Herman-Moussaki"
2019,"Caen","Ligue 1","Aly Ndom","FRA","MF","22",1996,0.5,0,0,0,0,0,0,0,NA,0,0,0,0,1,1,1,0,"https://fbref.com/en/players/df819670/Aly-Ndom"
2019,"Caen","Ligue 1","Casimir Ninga","CHA","FW,MF","25",1993,27.4,53,30,23,21,9,20,49,40.8,29,22,1,21,22,75,12,0,"https://fbref.com/en/players/91f2da4c/Casimir-Ninga"
2019,"Caen","Ligue 1","Prince Oniangué","CGO","MF","29",1988,26,59,33,22,34,3,24,57,42.1,33,30,10,20,29,88,42,0,"https://fbref.com/en/players/9e27e5de/Prince-Oniangue"
2019,"Caen","Ligue 1","Stef Peeters","BEL","MF","26",1992,4.5,15,8,8,4,3,4,11,36.4,7,1,0,1,6,21,1,0,"https://fbref.com/en/players/2f8f43f3/Stef-Peeters"
2019,"Caen","Ligue 1","Brice Samba","CGO","GK","24",1994,38,1,0,1,0,0,0,1,0,1,0,0,0,1,2,12,4,"https://fbref.com/en/players/60d90c55/Brice-Samba"
2019,"Caen","Ligue 1","Baissama Sankoh","GUI","MF,FW","26",1992,7.2,4,1,4,0,0,1,4,25,3,8,1,7,5,9,16,0,"https://fbref.com/en/players/a8b4a643/Baissama-Sankoh"
2019,"Caen","Ligue 1","Timo Stavitski","FIN","MF,FW","19",1999,0.2,0,0,0,0,0,0,1,0,1,0,0,0,0,0,0,0,"https://fbref.com/en/players/6fb7edd3/Timo-Stavitski"
2019,"Caen","Ligue 1","Malik Tchokounté","FRA","FW,MF","29",1988,16.4,21,13,6,12,3,5,10,50,5,11,0,11,6,27,26,0,"https://fbref.com/en/players/ed0c3318/Malik-Tchokounte"
2019,"Caen","Ligue 1","Younn Zahary","COM","DF","19",1998,8.2,16,9,7,6,3,8,14,57.1,6,13,8,5,16,32,35,0,"https://fbref.com/en/players/28129034/Younn-Zahary"
2019,"Cagliari","Serie A","Marco Andreolli","ITA","DF","32",1986,1.2,1,1,1,0,0,1,1,100,0,2,1,1,1,2,5,0,"https://fbref.com/en/players/13d820de/Marco-Andreolli"
2019,"Cagliari","Serie A","Nicolò Barella","ITA","MF","21",1997,34.5,99,65,38,41,20,30,82,36.6,52,61,2,59,38,137,27,0,"https://fbref.com/en/players/6928979a/Nicolo-Barella"
2019,"Cagliari","Serie A","Valter Birsa","SVN","MF,FW","31",1986,3.9,5,3,1,3,1,4,8,50,4,5,0,5,4,9,3,0,"https://fbref.com/en/players/455a2b79/Valter-Birsa"
2019,"Cagliari","Serie A","Filip Bradarić","CRO","MF","26",1992,16.6,26,21,11,12,3,10,20,50,10,13,3,10,39,65,50,0,"https://fbref.com/en/players/605873e1/Filip-Bradaric"
2019,"Cagliari","Serie A","Fabrizio Cacciatore","ITA","DF","31",1986,6.4,9,7,7,0,2,1,5,20,4,6,4,2,7,16,17,0,"https://fbref.com/en/players/00b0bb87/Fabrizio-Cacciatore"
2019,"Cagliari","Serie A","Lucas Castro","ARG","MF","29",1989,10,18,11,8,8,2,8,23,34.8,15,20,4,16,17,35,6,0,"https://fbref.com/en/players/56b2957b/Lucas-Castro"
2019,"Cagliari","Serie A","Luca Ceppitelli","ITA","DF","28",1989,22.8,40,24,28,11,1,13,22,59.1,9,34,24,10,20,60,111,2,"https://fbref.com/en/players/7d50454d/Luca-Ceppitelli"
2019,"Cagliari","Serie A","Alberto Cerri","ITA","FW","22",1996,7.4,3,2,2,1,0,0,7,0,7,7,1,6,2,5,4,0,"https://fbref.com/en/players/1079c685/Alberto-Cerri"
2019,"Cagliari","Serie A","Luca Cigarini","ITA","MF","32",1986,18.7,54,33,27,22,5,28,63,44.4,35,28,5,23,26,80,41,0,"https://fbref.com/en/players/ae64d449/Luca-Cigarini"
2019,"Cagliari","Serie A","Alessio Cragno","ITA","GK","24",1994,38,0,0,0,0,0,0,1,0,1,0,0,0,2,2,19,1,"https://fbref.com/en/players/f554e29b/Alessio-Cragno"
2019,"Cagliari","Serie A","Alessandro Deiola","ITA","MF","22",1995,5,7,3,1,6,0,3,13,23.1,10,14,0,14,6,13,8,0,"https://fbref.com/en/players/7f267d66/Alessandro-Deiola"
2019,"Cagliari","Serie A","Kiril Despodov","BUL","FW,MF","21",1996,1.2,0,0,0,0,0,0,1,0,1,1,0,1,0,0,0,0,"https://fbref.com/en/players/13c8e5f6/Kiril-Despodov"
2019,"Cagliari","Serie A","Daniele Dessena","ITA","MF","31",1987,3.9,2,2,0,2,0,1,3,33.3,2,3,1,2,3,5,5,0,"https://fbref.com/en/players/02b2937c/Daniele-Dessena"
2019,"Cagliari","Serie A","Riccardo Doratiotto","ITA","FW","19",1999,0.9,1,1,0,0,1,0,0,NA,0,0,0,0,0,1,0,0,"https://fbref.com/en/players/c1bcb2df/Riccardo-Doratiotto"
2019,"Cagliari","Serie A","Paolo Faragò","ITA","MF,DF","25",1993,18.9,46,29,20,16,10,13,43,30.2,30,28,2,26,15,61,38,0,"https://fbref.com/en/players/9085dd7c/Paolo-Farago"
2019,"Cagliari","Serie A","Diego Farias","BRA","FW","28",1990,7.8,13,9,3,7,3,2,11,18.2,9,7,1,6,1,14,5,0,"https://fbref.com/en/players/157d29b6/Diego-Farias"
2019,"Cagliari","Serie A","Artur Ioniță","MDA","MF","27",1990,33,67,38,23,31,13,16,57,28.1,41,40,5,35,27,94,30,0,"https://fbref.com/en/players/cedb3e36/Artur-Ionita"
2019,"Cagliari","Serie A","Ragnar Klavan","EST","DF","32",1985,13.7,9,8,5,3,1,5,11,45.5,6,19,13,6,10,19,68,1,"https://fbref.com/en/players/008a6e6d/Ragnar-Klavan"
2019,"Cagliari","Serie A","Charalambos Lykogiannis","GRE","DF","24",1993,9.2,14,8,8,3,3,6,11,54.5,5,18,3,15,19,33,33,0,"https://fbref.com/en/players/5efc5389/Charalambos-Lykogiannis"
2019,"Cagliari","Serie A","Simone Padoin","ITA","DF,MF","34",1984,21.3,34,25,12,18,4,14,33,42.4,19,18,5,13,14,48,54,0,"https://fbref.com/en/players/5eb72339/Simone-Padoin"
2019,"Cagliari","Serie A","Marko Pajač","CRO","DF","25",1993,1.1,1,1,0,0,1,0,0,NA,0,1,1,0,1,2,3,0,"https://fbref.com/en/players/5df4ef30/Marko-Pajac"
2019,"Cagliari","Serie A","Leonardo Pavoletti","ITA","FW","29",1988,30.4,32,21,6,17,9,6,16,37.5,10,12,3,9,7,39,26,0,"https://fbref.com/en/players/d37b0350/Leonardo-Pavoletti"
2019,"Cagliari","Serie A","João Pedro","ITA","FW,MF","26",1992,28.4,17,12,4,8,5,4,11,36.4,7,14,5,9,6,23,14,0,"https://fbref.com/en/players/81255c03/Joao-Pedro"
2019,"Cagliari","Serie A","Luca Pellegrini","ITA","DF","19",1999,10.4,28,19,16,11,1,14,25,56,11,13,3,10,18,46,22,0,"https://fbref.com/en/players/3b61c9ec/Luca-Pellegrini"
2019,"Cagliari","Serie A","Fabio Pisacane","ITA","DF","32",1986,25.2,33,17,22,8,3,18,31,58.1,13,36,23,13,23,56,108,0,"https://fbref.com/en/players/56400c01/Fabio-Pisacane"
2019,"Cagliari","Serie A","Filippo Romagna","ITA","DF","21",1997,16.4,14,9,10,4,0,4,8,50,4,20,12,8,19,33,68,0,"https://fbref.com/en/players/84594618/Filippo-Romagna"
2019,"Cagliari","Serie A","Marco Sau","ITA","FW,MF","30",1987,6.2,4,2,0,2,2,0,3,0,3,5,0,5,1,5,4,0,"https://fbref.com/en/players/1ad1f50d/Marco-Sau"
2019,"Cagliari","Serie A","Darijo Srna","CRO","DF","36",1982,23.2,24,16,6,13,5,9,14,64.3,5,24,5,19,18,42,66,0,"https://fbref.com/en/players/edd6c8e9/Darijo-Srna"
2019,"Cagliari","Serie A","Cyril Théréau","FRA","FW","35",1983,1.5,1,1,0,1,0,1,1,100,0,0,0,0,0,1,2,0,"https://fbref.com/en/players/4d3ab428/Cyril-Thereau"
2019,"Cagliari","Serie A","Francesco Verde","ITA","FW","19",1999,0.1,1,0,0,1,0,0,0,NA,0,0,0,0,0,1,0,0,"https://fbref.com/en/players/0497a545/Francesco-Verde"
2019,"Cardiff City","Premier League","Harry Arter","IRL","MF","28",1989,22.2,62,37,27,26,9,16,46,34.8,30,33,5,28,21,83,21,2,"https://fbref.com/en/players/2f4c5a52/Harry-Arter"
2019,"Cardiff City","Premier League","Leandro Bacuna","CUW","MF","26",1991,6.2,15,10,5,7,3,8,22,36.4,14,5,2,3,15,30,9,0,"https://fbref.com/en/players/9dc69d38/Leandro-Bacuna"
2019,"Cardiff City","Premier League","Sol Bamba","CIV","DF","33",1985,27.5,74,42,44,30,0,31,55,56.4,24,72,32,40,82,156,181,3,"https://fbref.com/en/players/5534217d/Sol-Bamba"
2019,"Cardiff City","Premier League","Joe Bennett","ENG","DF","28",1990,29.3,50,29,34,16,0,22,38,57.9,16,30,8,22,60,110,93,0,"https://fbref.com/en/players/dc936144/Joe-Bennett"
2019,"Cardiff City","Premier League","Víctor Camarasa","ESP","MF","24",1994,28.5,28,15,8,15,5,6,31,19.4,25,17,2,15,33,61,28,1,"https://fbref.com/en/players/b2d03887/Victor-Camarasa"
2019,"Cardiff City","Premier League","Greg Cunningham","IRL","DF","27",1991,7,18,7,11,4,3,9,16,56.3,7,9,3,6,17,35,16,1,"https://fbref.com/en/players/dc10b26c/Greg-Cunningham"
2019,"Cardiff City","Premier League","Loïc Damour","FRA","MF","27",1991,0.3,0,0,0,0,0,0,1,0,1,0,0,0,0,0,0,0,"https://fbref.com/en/players/074d8166/Loic-Damour"
2019,"Cardiff City","Premier League","Bruno Ecuele Manga","GAB","DF","30",1988,37.5,69,36,48,16,5,29,58,50,29,62,28,34,81,150,179,4,"https://fbref.com/en/players/72a0fb65/Bruno-Ecuele-Manga"
2019,"Cardiff City","Premier League","Neil Etheridge","PHI","GK","28",1990,38,1,1,1,0,0,1,2,50,1,0,0,0,7,8,19,1,"https://fbref.com/en/players/2642bf6c/Neil-Etheridge"
2019,"Cardiff City","Premier League","Aron Gunnarsson","ISL","MF","29",1989,25.2,51,29,23,25,3,23,84,27.4,61,40,12,28,38,89,55,1,"https://fbref.com/en/players/e2533c20/Aron-Gunnarsson"
2019,"Cardiff City","Premier League","Kadeem Harris","ENG","MF","25",1993,4.2,12,5,6,4,2,7,8,87.5,1,3,0,3,3,15,5,0,"https://fbref.com/en/players/24396398/Kadeem-Harris"
2019,"Cardiff City","Premier League","Rhys Healey","WAL","FW","23",1994,0.6,1,0,0,1,0,0,1,0,1,0,0,0,0,1,0,0,"https://fbref.com/en/players/07ace8c3/Rhys-Healey"
2019,"Cardiff City","Premier League","Junior Hoilett","CAN","MF,FW","28",1990,23.8,40,27,26,11,3,15,53,28.3,38,34,0,34,32,72,30,0,"https://fbref.com/en/players/33af5b9e/Junior-Hoilett"
2019,"Cardiff City","Premier League","Gary Madine","ENG","FW,MF","27",1990,0.4,1,1,0,1,0,0,0,NA,0,0,0,0,0,1,0,0,"https://fbref.com/en/players/e3e6502a/Gary-Madine"
2019,"Cardiff City","Premier League","Nathaniel Mendez-Laing","ENG","MF,FW","26",1992,10.9,34,25,18,12,4,12,26,46.2,14,17,1,16,13,47,20,0,"https://fbref.com/en/players/b4b2f632/Nathaniel-Mendez-Laing"
2019,"Cardiff City","Premier League","Sean Morrison","ENG","DF","27",1991,33.8,35,17,29,4,2,15,28,53.6,13,47,30,17,52,87,204,5,"https://fbref.com/en/players/09fec029/Sean-Morrison"
2019,"Cardiff City","Premier League","Josh Murphy","ENG","MF,FW","23",1995,20.2,26,17,15,7,4,9,29,31,20,30,0,30,11,37,17,0,"https://fbref.com/en/players/b30c7426/Josh-Murphy"
2019,"Cardiff City","Premier League","Oumar Niasse","SEN","FW","28",1990,10.3,12,3,1,5,6,4,8,50,4,7,0,7,2,14,7,0,"https://fbref.com/en/players/af721f98/Oumar-Niasse"
2019,"Cardiff City","Premier League","Callum Paterson","SCO","FW,MF","23",1994,22.2,21,14,7,7,7,5,26,19.2,21,23,2,21,8,29,29,0,"https://fbref.com/en/players/d2583bce/Callum-Paterson"
2019,"Cardiff City","Premier League","Lee Peltier","ENG","DF","31",1986,17.2,39,25,27,11,1,15,27,55.6,12,18,12,6,18,57,60,0,"https://fbref.com/en/players/af341b88/Lee-Peltier"
2019,"Cardiff City","Premier League","Joe Ralls","ENG","MF","24",1993,21.8,45,23,21,21,3,10,33,30.3,23,21,6,15,29,74,30,0,"https://fbref.com/en/players/3730fcbc/Joe-Ralls"
2019,"Cardiff City","Premier League","Bobby Reid","JAM","FW,MF","25",1993,15.8,16,9,6,7,3,3,8,37.5,5,13,0,13,3,19,12,0,"https://fbref.com/en/players/0f7533cd/Bobby-Reid"
2019,"Cardiff City","Premier League","Jazz Richards","WAL","DF,MF","27",1991,1.5,0,0,0,0,0,0,1,0,1,2,1,1,2,2,5,0,"https://fbref.com/en/players/afef14da/Jazz-Richards"
2019,"Cardiff City","Premier League","Danny Ward","ENG","FW","26",1991,4.9,2,1,0,1,1,0,3,0,3,3,1,2,0,2,9,0,"https://fbref.com/en/players/cfb29823/Danny-Ward"
2019,"Cardiff City","Premier League","Kenneth Zohore","DEN","FW","24",1994,8.4,3,2,0,3,0,1,3,33.3,2,4,2,2,2,5,5,0,"https://fbref.com/en/players/5e508d0d/Kenneth-Zohore"
2019,"Celta Vigo","La Liga","Júnior Alonso","PAR","DF,MF","25",1993,6,13,9,8,4,1,7,12,58.3,5,8,3,5,5,18,24,1,"https://fbref.com/en/players/b18a3023/Junior-Alonso"
2019,"Celta Vigo","La Liga","Sergio Álvarez","ESP","GK","31",1986,13,0,0,0,0,0,0,0,NA,0,0,0,0,0,0,4,0,"https://fbref.com/en/players/8875b8c9/Sergio-Alvarez"
2019,"Celta Vigo","La Liga","Emmanuel Apeh","NGA","FW,MF","21",1996,0.2,0,0,0,0,0,0,1,0,1,0,0,0,0,0,0,0,"https://fbref.com/en/players/a230ebcc/Emmanuel-Apeh"
2019,"Celta Vigo","La Liga","Néstor Araujo","MEX","DF","26",1991,29.8,42,22,32,9,1,18,22,81.8,4,32,21,11,35,77,153,1,"https://fbref.com/en/players/27a013f7/Nestor-Araujo"
2019,"Celta Vigo","La Liga","Iago Aspas","ESP","FW,MF","30",1987,25,16,11,4,8,4,4,20,20,16,14,0,14,16,32,5,0,"https://fbref.com/en/players/7dcf86f6/Iago-Aspas"
2019,"Celta Vigo","La Liga","Fran Beltrán","ESP","MF","19",1999,16.9,23,17,8,12,3,13,31,41.9,18,19,2,17,19,42,15,1,"https://fbref.com/en/players/ed5c5fa3/Fran-Beltran"
2019,"Celta Vigo","La Liga","Rubén Blanco","ESP","GK","23",1995,25,1,0,1,0,0,1,2,50,1,1,0,1,2,3,13,2,"https://fbref.com/en/players/967f34d3/Ruben-Blanco"
2019,"Celta Vigo","La Liga","Ryad Boudebouz","ALG","MF,FW","28",1990,8,14,4,4,6,4,3,8,37.5,5,9,1,8,3,17,9,0,"https://fbref.com/en/players/1001ae82/Ryad-Boudebouz"
2019,"Celta Vigo","La Liga","Sofiane Boufal","MAR","MF,FW","24",1993,23.2,35,21,18,11,6,15,47,31.9,32,24,0,24,10,45,12,0,"https://fbref.com/en/players/b0c71810/Sofiane-Boufal"
2019,"Celta Vigo","La Liga","Gustavo Cabral","ARG","DF","32",1985,21.1,37,26,28,7,2,17,27,63,10,31,11,20,33,70,102,1,"https://fbref.com/en/players/92b4a127/Gustavo-Cabral"
2019,"Celta Vigo","La Liga","David Costas","ESP","DF","23",1995,13,25,13,21,4,0,10,15,66.7,5,12,6,6,18,43,58,1,"https://fbref.com/en/players/545e2f01/David-Costas"
2019,"Celta Vigo","La Liga","Dennis Eckert","GER","FW","21",1997,2.4,3,2,0,1,2,0,2,0,2,1,0,1,2,5,3,0,"https://fbref.com/en/players/7f8fb807/Dennis-Eckert"
2019,"Celta Vigo","La Liga","Maxi Gómez","URU","FW","21",1996,32.9,6,4,1,4,1,1,12,8.3,11,3,0,3,2,8,43,0,"https://fbref.com/en/players/4c2e9442/Maxi-Gomez"
2019,"Celta Vigo","La Liga","Andrew Hjulsager","DEN","MF,FW","23",1995,4,16,10,11,2,3,2,18,11.1,16,4,0,4,2,18,1,0,"https://fbref.com/en/players/2ef16f06/Andrew-Hjulsager"
2019,"Celta Vigo","La Liga","Wesley Hoedt","NED","DF","24",1994,9.9,17,11,15,2,0,12,17,70.6,5,17,11,6,11,28,58,3,"https://fbref.com/en/players/875898c7/Wesley-Hoedt"
2019,"Celta Vigo","La Liga","Mathias Jensen","DEN","MF,FW","22",1996,2.6,4,2,2,2,0,2,9,22.2,7,2,0,2,4,8,1,0,"https://fbref.com/en/players/0f134faf/Mathias-Jensen"
2019,"Celta Vigo","La Liga","Jozabed","ESP","MF","27",1991,12.8,19,10,8,8,3,8,24,33.3,16,8,2,6,9,28,13,2,"https://fbref.com/en/players/9b337c7c/Jozabed"
2019,"Celta Vigo","La Liga","David Juncà","ESP","DF","24",1993,19.5,55,30,40,13,2,28,46,60.9,18,27,6,21,35,90,63,1,"https://fbref.com/en/players/de7d40d6/David-Junca"
2019,"Celta Vigo","La Liga","Stanislav Lobotka","SVK","MF","23",1994,27.7,30,19,10,17,3,9,32,28.1,23,15,1,14,26,56,18,1,"https://fbref.com/en/players/e1cbb531/Stanislav-Lobotka"
2019,"Celta Vigo","La Liga","Hugo Mallo","ESP","DF","27",1991,34.4,73,41,41,27,5,27,52,51.9,25,44,13,31,50,123,135,1,"https://fbref.com/en/players/cb574619/Hugo-Mallo"
2019,"Celta Vigo","La Liga","Róbert Mazáň","SVK","DF","24",1994,1,3,3,3,0,0,2,2,100,0,2,0,2,3,6,0,0,"https://fbref.com/en/players/30672832/Robert-Mazan"
2019,"Celta Vigo","La Liga","Brais Méndez","ESP","MF,FW","21",1997,26.1,61,31,23,29,9,14,53,26.4,39,32,3,29,24,85,24,0,"https://fbref.com/en/players/c9e39d91/Brais-Mendez"
2019,"Celta Vigo","La Liga","Emre Mor","TUR","FW,MF","21",1997,4.1,7,4,1,3,3,2,7,28.6,5,5,0,5,3,10,1,0,"https://fbref.com/en/players/0c3f7197/Emre-Mor"
2019,"Celta Vigo","La Liga","Lucas Olaza","URU","DF","24",1994,10,29,18,19,8,2,14,18,77.8,4,13,6,7,8,37,18,0,"https://fbref.com/en/players/4cee5954/Lucas-Olaza"
2019,"Celta Vigo","La Liga","Facundo Roncaglia","ARG","DF","31",1987,11.9,34,22,26,8,0,17,24,70.8,7,12,5,7,20,54,51,2,"https://fbref.com/en/players/51e3954c/Facundo-Roncaglia"
2019,"Celta Vigo","La Liga","Pione Sisto","DEN","FW,MF","23",1995,9.4,4,3,4,0,0,0,9,0,9,5,0,5,3,7,3,0,"https://fbref.com/en/players/fd9c4805/Pione-Sisto"
2019,"Celta Vigo","La Liga","Kevin Vázquez","ESP","DF","25",1993,2.4,6,5,5,0,1,4,7,57.1,3,8,3,5,2,8,9,0,"https://fbref.com/en/players/ee923664/Kevin-Vazquez"
2019,"Celta Vigo","La Liga","Okay Yokuşlu","TUR","MF","24",1994,24.4,61,39,31,28,2,28,45,62.2,17,32,11,21,37,98,53,2,"https://fbref.com/en/players/e49ce451/Okay-Yokuslu"
2019,"Chelsea","Premier League","Marcos Alonso","ESP","DF","27",1990,30.7,73,46,44,22,7,33,58,56.9,25,25,2,23,39,112,101,0,"https://fbref.com/en/players/f4290206/Marcos-Alonso"
2019,"Chelsea","Premier League","Kepa Arrizabalaga","ESP","GK","23",1994,36,1,1,1,0,0,1,2,50,1,1,0,1,0,1,4,2,"https://fbref.com/en/players/28d596a0/Kepa-Arrizabalaga"
2019,"Chelsea","Premier League","César Azpilicueta","ESP","DF","28",1989,37.8,105,60,52,40,13,38,67,56.7,29,63,16,47,43,148,91,3,"https://fbref.com/en/players/53cad200/Cesar-Azpilicueta"
2019,"Chelsea","Premier League","Ross Barkley","ENG","MF","24",1993,13.8,15,10,5,7,3,4,14,28.6,10,8,1,7,9,24,17,2,"https://fbref.com/en/players/3a24769f/Ross-Barkley"
2019,"Chelsea","Premier League","Willy Caballero","ARG","GK","36",1981,2,0,0,0,0,0,0,0,NA,0,0,0,0,0,0,1,0,"https://fbref.com/en/players/a179d516/Willy-Caballero"
2019,"Chelsea","Premier League","Gary Cahill","ENG","DF","32",1985,0.3,0,0,0,0,0,0,0,NA,0,0,0,0,0,0,1,0,"https://fbref.com/en/players/7914b9fe/Gary-Cahill"
2019,"Chelsea","Premier League","Andreas Christensen","DEN","DF","22",1996,6.9,10,4,2,6,2,2,5,40,3,4,2,2,4,14,29,0,"https://fbref.com/en/players/1cb49278/Andreas-Christensen"
2019,"Chelsea","Premier League","Cesc Fàbregas","ESP","MF","31",1987,2,6,4,4,2,0,1,5,20,4,2,1,1,1,7,0,0,"https://fbref.com/en/players/33508c78/Cesc-Fabregas"
2019,"Chelsea","Premier League","Olivier Giroud","FRA","FW","31",1986,9.4,3,2,0,1,2,1,4,25,3,6,1,5,3,6,7,0,"https://fbref.com/en/players/16ceb862/Olivier-Giroud"
2019,"Chelsea","Premier League","Eden Hazard","BEL","FW","27",1991,32.5,14,9,2,1,11,5,17,29.4,12,10,0,10,13,27,6,1,"https://fbref.com/en/players/a39bb753/Eden-Hazard"
2019,"Chelsea","Premier League","Gonzalo Higuaín","ARG","FW","30",1987,12.1,10,7,2,4,4,2,11,18.2,9,4,0,4,1,11,5,0,"https://fbref.com/en/players/8a08491a/Gonzalo-Higuain"
2019,"Chelsea","Premier League","Callum Hudson-Odoi","ENG","FW","17",2000,4.4,8,6,8,0,0,2,4,50,2,1,0,1,3,11,0,0,"https://fbref.com/en/players/15f3ec41/Callum-Hudson-Odoi"
2019,"Chelsea","Premier League","Jorginho","ITA","MF","26",1991,35.1,76,38,27,41,8,45,96,46.9,51,46,7,39,64,140,38,1,"https://fbref.com/en/players/45db685d/Jorginho"
2019,"Chelsea","Premier League","N'Golo Kanté","FRA","MF","27",1991,34.4,75,41,21,41,13,23,67,34.3,44,63,6,57,44,119,32,1,"https://fbref.com/en/players/b9fbae28/NGolo-Kante"
2019,"Chelsea","Premier League","Mateo Kovačić","CRO","MF","24",1994,19.3,45,29,23,19,3,20,46,43.5,26,19,2,17,8,53,18,1,"https://fbref.com/en/players/79c0821a/Mateo-Kovacic"
2019,"Chelsea","Premier League","Ruben Loftus-Cheek","ENG","MF,FW","22",1996,11.1,18,12,7,7,4,3,12,25,9,10,4,6,11,29,5,0,"https://fbref.com/en/players/e97fd090/Ruben-Loftus-Cheek"
2019,"Chelsea","Premier League","David Luiz","BRA","DF","31",1987,36,41,31,27,13,1,21,28,75,7,33,18,15,35,76,149,1,"https://fbref.com/en/players/c0e27d1a/David-Luiz"
2019,"Chelsea","Premier League","Álvaro Morata","ESP","FW","25",1992,10.5,8,5,0,5,3,1,7,14.3,6,6,1,5,0,8,6,0,"https://fbref.com/en/players/129af0db/Alvaro-Morata"
2019,"Chelsea","Premier League","Victor Moses","NGA","FW","27",1990,0.3,0,0,0,0,0,0,0,NA,0,1,0,1,0,0,0,0,"https://fbref.com/en/players/e726e11e/Victor-Moses"
2019,"Chelsea","Premier League","Emerson Palmieri","ITA","DF","23",1994,7.4,14,9,6,5,3,6,10,60,4,11,1,10,8,22,14,0,"https://fbref.com/en/players/e0bc6fdc/Emerson-Palmieri"
2019,"Chelsea","Premier League","Pedro","ESP","FW","31",1987,19.8,27,14,11,10,6,9,35,25.7,26,13,2,11,18,45,8,1,"https://fbref.com/en/players/3ca7254a/Pedro"
2019,"Chelsea","Premier League","Antonio Rüdiger","GER","DF","25",1993,31.9,34,16,27,6,1,15,27,55.6,12,15,8,7,32,66,96,1,"https://fbref.com/en/players/18b896d6/Antonio-Rudiger"
2019,"Chelsea","Premier League","Willian","BRA","FW","29",1988,23.3,35,21,11,15,9,9,25,36,16,16,1,15,14,49,12,2,"https://fbref.com/en/players/8b9ebd03/Willian"
2019,"Chelsea","Premier League","Davide Zappacosta","ITA","DF","26",1992,1.4,0,0,0,0,0,0,1,0,1,0,0,0,3,3,5,0,"https://fbref.com/en/players/7fe90ccd/Davide-Zappacosta"
2019,"Chievo","Serie A","Marco Andreolli","ITA","DF","32",1986,7.2,10,6,7,2,1,6,10,60,4,4,2,2,6,16,33,0,"https://fbref.com/en/players/13d820de/Marco-Andreolli"
2019,"Chievo","Serie A","Mauro Antonio Burruchaga","ARG","MF","20",1998,0.6,2,2,1,1,0,0,2,0,2,2,1,1,0,2,3,0,"https://fbref.com/en/players/0830a4f9/Mauro-Antonio-Burruchaga"
2019,"Chievo","Serie A","Mattia Bani","ITA","DF","24",1993,29,67,40,46,21,0,27,40,67.5,13,51,35,16,57,124,162,2,"https://fbref.com/en/players/0821331c/Mattia-Bani"
2019,"Chievo","Serie A","Federico Barba","ITA","DF","24",1993,27.6,30,14,21,9,0,8,21,38.1,13,29,15,14,65,95,129,0,"https://fbref.com/en/players/c010b898/Federico-Barba"
2019,"Chievo","Serie A","Valter Birsa","SVN","MF,FW","31",1986,12.2,14,9,4,7,3,4,17,23.5,13,9,1,8,6,20,13,0,"https://fbref.com/en/players/455a2b79/Valter-Birsa"
2019,"Chievo","Serie A","Fabrizio Cacciatore","ITA","DF","31",1986,5.5,8,4,6,2,0,4,9,44.4,5,8,2,6,5,13,20,0,"https://fbref.com/en/players/00b0bb87/Fabrizio-Cacciatore"
2019,"Chievo","Serie A","Boštjan Cesar","SVN","DF","36",1982,12,16,10,9,7,0,7,17,41.2,10,14,8,6,14,30,60,2,"https://fbref.com/en/players/c1d18f10/Bostjan-Cesar"
2019,"Chievo","Serie A","Fabio Depaoli","ITA","DF","21",1997,27.4,74,43,37,32,5,34,67,50.7,33,42,16,26,35,109,99,3,"https://fbref.com/en/players/d97f2e8d/Fabio-Depaoli"
2019,"Chievo","Serie A","Assane Dioussé","SEN","MF","20",1997,9.9,24,16,11,8,5,10,23,43.5,13,14,4,10,19,43,13,2,"https://fbref.com/en/players/7f622eef/Assane-Diousse"
2019,"Chievo","Serie A","Nicolas Frey","FRA","DF","34",1984,2.5,3,1,2,1,0,0,3,0,3,3,3,0,7,10,18,0,"https://fbref.com/en/players/6378443d/Nicolas-Frey"
2019,"Chievo","Serie A","Emanuele Giaccherini","ITA","MF,FW","33",1985,22.3,14,8,5,7,2,6,31,19.4,25,21,2,19,16,30,10,2,"https://fbref.com/en/players/1c50f354/Emanuele-Giaccherini"
2019,"Chievo","Serie A","Sergej Grubac","MNE","FW","18",2000,1.7,2,1,1,0,1,1,1,100,0,1,0,1,0,2,1,0,"https://fbref.com/en/players/a1bedc05/Sergej-Grubac"
2019,"Chievo","Serie A","Përparim Hetemaj","FIN","MF","31",1986,24,53,27,27,23,3,20,68,29.4,48,25,1,24,30,83,24,2,"https://fbref.com/en/players/90b70194/Perparim-Hetemaj"
2019,"Chievo","Serie A","Paweł Jaroszyński","POL","DF","23",1994,15,29,18,17,8,4,16,32,50,16,15,4,11,24,53,41,1,"https://fbref.com/en/players/958a601f/Pawel-Jaroszynski"
2019,"Chievo","Serie A","Musa Juwara","GAM","FW","16",2001,0.1,0,0,0,0,0,0,0,NA,0,0,0,0,1,1,0,0,"https://fbref.com/en/players/7737dee2/Musa-Juwara"
2019,"Chievo","Serie A","Ibrahim Karamoko","FRA","MF","17",2001,0.7,0,0,0,0,0,0,0,NA,0,1,0,1,0,0,1,0,"https://fbref.com/en/players/550985aa/Ibrahim-Karamoko"
2019,"Chievo","Serie A","Sofian Kiyine","MAR","MF,DF","20",1997,9.1,28,13,11,14,3,9,18,50,9,10,0,10,10,38,4,0,"https://fbref.com/en/players/ce1806be/Sofian-Kiyine"
2019,"Chievo","Serie A","Mehdi Léris","ALG","MF,DF","20",1998,17.9,53,33,19,24,10,24,54,44.4,30,34,1,33,28,81,24,1,"https://fbref.com/en/players/7d3cbc67/Mehdi-Leris"
2019,"Chievo","Serie A","Riccardo Meggiorini","ITA","FW","32",1985,17.2,17,13,5,9,3,1,10,10,9,20,2,18,8,25,26,0,"https://fbref.com/en/players/2ec0f902/Riccardo-Meggiorini"
2019,"Chievo","Serie A","Angelo Ndrecka","ALB","DF","16",2001,1,1,1,1,0,0,1,2,50,1,3,2,1,0,1,1,0,"https://fbref.com/en/players/fcd20025/Angelo-Ndrecka"
2019,"Chievo","Serie A","Joel Obi","NGA","MF","27",1991,7.3,22,15,9,11,2,7,17,41.2,10,12,1,11,14,36,15,0,"https://fbref.com/en/players/614c38fb/Joel-Obi"
2019,"Chievo","Serie A","Sergio Pellissier","ITA","FW","39",1979,10.6,4,3,1,1,2,3,4,75,1,8,1,7,2,6,8,0,"https://fbref.com/en/players/878ee034/Sergio-Pellissier"
2019,"Chievo","Serie A","Lucas Piazon","BRA","MF,FW","24",1994,0.9,2,0,1,1,0,0,2,0,2,1,0,1,1,3,0,0,"https://fbref.com/en/players/f201798c/Lucas-Piazon"
2019,"Chievo","Serie A","Manuel Pucciarelli","ITA","FW","27",1991,3.4,4,2,2,1,1,2,5,40,3,5,0,5,3,7,4,0,"https://fbref.com/en/players/a1c7b425/Manuel-Pucciarelli"
2019,"Chievo","Serie A","Ivan Radovanović","SRB","MF","29",1988,19,27,22,20,7,0,11,31,35.5,20,19,7,12,26,53,36,0,"https://fbref.com/en/players/023937a9/Ivan-Radovanovic"
2019,"Chievo","Serie A","Nicola Rigoni","ITA","MF","27",1990,21.7,43,25,22,15,6,22,51,43.1,29,20,5,15,23,66,45,1,"https://fbref.com/en/players/e327bd76/Nicola-Rigoni"
2019,"Chievo","Serie A","Luca Rossettini","ITA","DF","33",1985,20.3,26,17,18,8,0,15,20,75,5,23,15,8,35,61,114,0,"https://fbref.com/en/players/47a500ae/Luca-Rossettini"
2019,"Chievo","Serie A","Ezequiel Schelotto","ITA","DF","29",1989,1.6,3,0,3,0,0,2,3,66.7,1,1,0,1,2,5,8,0,"https://fbref.com/en/players/a6e316c1/Ezequiel-Schelotto"
2019,"Chievo","Serie A","Andrea Seculin","ITA","GK","28",1990,1,0,0,0,0,0,0,0,NA,0,0,0,0,0,0,1,0,"https://fbref.com/en/players/c4f573f4/Andrea-Seculin"
2019,"Chievo","Serie A","Adrian Šemper","CRO","GK","20",1998,6,0,0,0,0,0,0,0,NA,0,0,0,0,1,1,3,0,"https://fbref.com/en/players/f02dde20/Adrian-Semper"
2019,"Chievo","Serie A","Stefano Sorrentino","ITA","GK","39",1979,31,1,1,1,0,0,1,2,50,1,0,0,0,3,4,10,1,"https://fbref.com/en/players/048877f5/Stefano-Sorrentino"
2019,"Chievo","Serie A","Mariusz Stępiński","POL","FW","23",1995,27.5,18,13,1,11,6,1,17,5.9,16,10,2,8,5,23,20,0,"https://fbref.com/en/players/7b536033/Mariusz-Stepinski"
2019,"Chievo","Serie A","Strahinja Tanasijević","SRB","DF,MF","21",1997,0.2,0,0,0,0,0,0,0,NA,0,0,0,0,0,0,0,0,"https://fbref.com/en/players/618ab91f/Strahinja-Tanasijevic"
2019,"Chievo","Serie A","Nenad Tomović","SRB","DF","30",1987,8.2,9,7,5,4,0,7,10,70,3,5,1,4,13,22,34,0,"https://fbref.com/en/players/6aafdc27/Nenad-Tomovic"
2019,"Chievo","Serie A","Emanuel Vignato","ITA","MF,FW","17",2000,7.3,8,4,4,3,1,0,6,0,6,4,0,4,10,18,0,0,"https://fbref.com/en/players/ec5dae45/Emanuel-Vignato"
2019,"Chievo","Serie A","Filip Đorđević","SRB","FW","30",1987,7,11,6,3,6,2,3,12,25,9,7,1,6,2,13,8,1,"https://fbref.com/en/players/dfb933e0/Filip-Djordjevic"
2019,"Crystal Palace","Premier League","Patrick van Aanholt","NED","DF","27",1990,35.5,48,24,35,11,2,24,40,60,16,33,9,24,40,88,91,2,"https://fbref.com/en/players/5f09991f/Patrick-van-Aanholt"
2019,"Crystal Palace","Premier League","Jordan Ayew","GHA","FW","26",1991,13.1,38,23,12,19,7,6,20,30,14,16,0,16,7,45,6,0,"https://fbref.com/en/players/da052c14/Jordan-Ayew"
2019,"Crystal Palace","Premier League","Michy Batshuayi","BEL","FW","24",1993,8.3,2,1,1,1,0,1,2,50,1,8,3,5,3,5,0,0,"https://fbref.com/en/players/2973d8ff/Michy-Batshuayi"
2019,"Crystal Palace","Premier League","Christian Benteke","BEL","FW","27",1990,9,5,1,0,4,1,1,4,25,3,7,2,5,0,5,14,0,"https://fbref.com/en/players/ab070c55/Christian-Benteke"
2019,"Crystal Palace","Premier League","Scott Dann","ENG","DF","31",1987,7.4,6,2,5,1,0,3,7,42.9,4,16,12,4,5,11,46,0,"https://fbref.com/en/players/52105203/Scott-Dann"
2019,"Crystal Palace","Premier League","Luke Dreher","ENG","FW","19",1998,0,0,0,0,0,0,0,0,NA,0,0,0,0,0,0,0,0,"https://fbref.com/en/players/d1c509d9/Luke-Dreher"
2019,"Crystal Palace","Premier League","Vicente Guaita","ESP","GK","31",1987,19.5,0,0,0,0,0,0,0,NA,0,0,0,0,0,0,5,2,"https://fbref.com/en/players/ab13a5aa/Vicente-Guaita"
2019,"Crystal Palace","Premier League","Wayne Hennessey","WAL","GK","31",1987,17.5,0,0,0,0,0,0,2,0,2,0,0,0,0,0,5,1,"https://fbref.com/en/players/76eca7e2/Wayne-Hennessey"
2019,"Crystal Palace","Premier League","Martin Kelly","ENG","DF","28",1990,12.3,21,13,18,2,1,14,19,73.7,5,18,12,6,11,32,88,1,"https://fbref.com/en/players/d7492450/Martin-Kelly"
2019,"Crystal Palace","Premier League","Cheikhou Kouyaté","SEN","MF","28",1989,21.1,59,33,23,31,5,9,33,27.3,24,29,11,18,16,75,33,0,"https://fbref.com/en/players/8d3c902d/Cheikhou-Kouyate"
2019,"Crystal Palace","Premier League","James McArthur","SCO","MF","30",1987,34,84,51,38,32,14,30,78,38.5,48,64,22,42,39,123,55,0,"https://fbref.com/en/players/cee31595/James-McArthur"
2019,"Crystal Palace","Premier League","Max Meyer","GER","MF","22",1995,15.7,33,18,14,18,1,11,20,55,9,6,0,6,15,48,19,0,"https://fbref.com/en/players/eba42d2b/Max-Meyer"
2019,"Crystal Palace","Premier League","Luka Milivojević","SRB","MF","27",1991,38,90,69,36,47,7,39,91,42.9,52,47,15,32,72,162,68,3,"https://fbref.com/en/players/2ce2508a/Luka-Milivojevic"
2019,"Crystal Palace","Premier League","Jason Puncheon","ENG","MF","32",1986,0.1,1,1,1,0,0,0,0,NA,0,0,0,0,0,1,0,0,"https://fbref.com/en/players/fd3f57ce/Jason-Puncheon"
2019,"Crystal Palace","Premier League","Mamadou Sakho","FRA","DF","28",1990,26.8,25,16,22,3,0,11,18,61.1,7,26,16,10,41,66,136,2,"https://fbref.com/en/players/87935cf3/Mamadou-Sakho"
2019,"Crystal Palace","Premier League","Bakary Sako","MLI","FW","30",1988,0.3,2,1,2,0,0,1,1,100,0,0,0,0,0,2,0,0,"https://fbref.com/en/players/381d7d54/Bakary-Sako"
2019,"Crystal Palace","Premier League","Jeffrey Schlupp","GHA","MF,FW","25",1992,18.6,41,20,18,18,5,10,27,37,17,30,8,22,19,60,27,1,"https://fbref.com/en/players/3312f911/Jeffrey-Schlupp"
2019,"Crystal Palace","Premier League","Pape Souaré","SEN","DF","28",1990,0,0,0,0,0,0,0,0,NA,0,0,0,0,1,1,0,0,"https://fbref.com/en/players/46b5375e/Pape-Souare"
2019,"Crystal Palace","Premier League","Julián Speroni","ARG","GK","39",1979,1,0,0,0,0,0,0,0,NA,0,0,0,0,0,0,1,2,"https://fbref.com/en/players/8e65a5e5/Julian-Speroni"
2019,"Crystal Palace","Premier League","Alexander Sørloth","NOR","FW","22",1995,2.1,2,1,0,0,2,1,2,50,1,0,0,0,0,2,3,0,"https://fbref.com/en/players/e92cd3f7/Alexander-Sorloth"
2019,"Crystal Palace","Premier League","James Tomkins","ENG","DF","29",1989,28.4,34,20,27,7,0,15,28,53.6,13,23,10,13,34,68,184,3,"https://fbref.com/en/players/e7ca0439/James-Tomkins"
2019,"Crystal Palace","Premier League","Andros Townsend","ENG","FW,MF","27",1991,33.4,62,35,38,16,8,35,89,39.3,54,48,5,43,38,100,28,0,"https://fbref.com/en/players/b28bbd58/Andros-Townsend"
2019,"Crystal Palace","Premier League","Aaron Wan-Bissaka","ENG","DF","20",1997,34.8,129,90,90,33,6,55,65,84.6,10,49,16,33,84,213,161,0,"https://fbref.com/en/players/9e525177/Aaron-Wan-Bissaka"
2019,"Crystal Palace","Premier League","Joel Ward","ENG","DF","28",1989,6.1,12,7,7,4,1,3,10,30,7,2,0,2,10,22,35,0,"https://fbref.com/en/players/8a7ff278/Joel-Ward"
2019,"Crystal Palace","Premier League","Connor Wickham","ENG","FW,MF","25",1993,0.7,0,0,0,0,0,0,0,NA,0,0,0,0,0,0,2,0,"https://fbref.com/en/players/41cc19c2/Connor-Wickham"
2019,"Crystal Palace","Premier League","Wilfried Zaha","CIV","FW","25",1992,33.7,39,20,11,23,5,12,34,35.3,22,19,0,19,10,49,4,0,"https://fbref.com/en/players/b2bc3b1f/Wilfried-Zaha"
2019,"Dijon","Ligue 1","Mehdi Abeid","ALG","MF","25",1992,22.5,51,33,27,16,8,15,45,33.3,30,33,7,26,29,80,23,1,"https://fbref.com/en/players/a4c3f7af/Mehdi-Abeid"
2019,"Dijon","Ligue 1","Nayef Aguerd","MAR","DF","22",1996,11.7,17,12,8,9,0,8,19,42.1,11,20,11,9,14,31,59,1,"https://fbref.com/en/players/288e1e13/Nayef-Aguerd"
2019,"Dijon","Ligue 1","Rúnar Alex Rúnarsson","ISL","GK","23",1995,25,2,0,2,0,0,2,6,33.3,4,0,0,0,1,3,7,2,"https://fbref.com/en/players/8fa8f8d2/Runar-Alex-Runarsson"
2019,"Dijon","Ligue 1","Bobby Allain","FRA","GK","26",1991,13,0,0,0,0,0,0,1,0,1,1,0,1,0,0,16,1,"https://fbref.com/en/players/8870154f/Bobby-Allain"
2019,"Dijon","Ligue 1","Mickaël Alphonse","GLP","DF","29",1989,6.3,10,5,6,1,3,3,4,75,1,3,1,2,9,19,30,0,"https://fbref.com/en/players/0a63446f/Mickael-Alphonse"
2019,"Dijon","Ligue 1","Romain Amalfitano","FRA","MF,FW","28",1989,28,52,33,20,28,4,25,67,37.3,42,45,13,32,47,99,35,0,"https://fbref.com/en/players/d7bf3d19/Romain-Amalfitano"
2019,"Dijon","Ligue 1","Florent Balmont","FRA","MF","38",1980,12,29,16,16,10,3,9,36,25,27,13,2,11,6,35,8,0,"https://fbref.com/en/players/4e7bfc23/Florent-Balmont"
2019,"Dijon","Ligue 1","Arnold Bouka Moutou","CGO","DF,FW","29",1988,0.7,3,1,2,1,0,0,4,0,4,1,0,1,3,6,1,0,"https://fbref.com/en/players/f3085377/Arnold-Bouka-Moutou"
2019,"Dijon","Ligue 1","Fouad Chafik","MAR","DF","31",1986,20.5,44,31,29,12,3,23,36,63.9,13,17,3,14,25,69,71,0,"https://fbref.com/en/players/edd1466a/Fouad-Chafik"
2019,"Dijon","Ligue 1","Kwon Chang-hoon","KOR","FW,MF","24",1994,10.4,7,4,3,2,2,0,12,0,12,16,0,16,8,15,8,0,"https://fbref.com/en/players/7961f7aa/Kwon-Chang-hoon"
2019,"Dijon","Ligue 1","Laurent Ciman","BEL","DF","32",1985,8,11,6,9,2,0,7,16,43.8,9,13,9,4,7,18,37,0,"https://fbref.com/en/players/5113d9a7/Laurent-Ciman"
2019,"Dijon","Ligue 1","Senou Coulibaly","MLI","DF","23",1994,4.6,13,7,10,3,0,3,8,37.5,5,8,2,6,11,24,20,0,"https://fbref.com/en/players/67b7357e/Senou-Coulibaly"
2019,"Dijon","Ligue 1","Yoann Gourcuff","FRA","MF,FW","32",1986,1.5,0,0,0,0,0,0,2,0,2,1,1,0,0,0,1,0,"https://fbref.com/en/players/3acddfdd/Yoann-Gourcuff"
2019,"Dijon","Ligue 1","Oussama Haddadi","TUN","DF","26",1992,29.7,51,25,38,11,2,24,43,55.8,19,33,8,25,45,96,93,2,"https://fbref.com/en/players/ec400194/Oussama-Haddadi"
2019,"Dijon","Ligue 1","Benjamin Jeannot","FRA","FW,MF","26",1992,16,17,12,5,7,5,6,19,31.6,13,15,3,12,12,29,14,0,"https://fbref.com/en/players/2e52206e/Benjamin-Jeannot"
2019,"Dijon","Ligue 1","Sory Kaba","GUI","FW,MF","23",1995,2.6,1,1,1,0,0,1,3,33.3,2,2,0,2,0,1,1,0,"https://fbref.com/en/players/d29202c2/Sory-Kaba"
2019,"Dijon","Ligue 1","Jules Keita","GUI","FW,MF","20",1998,5.1,10,4,0,3,7,5,12,41.7,7,2,0,2,2,12,1,0,"https://fbref.com/en/players/8c955557/Jules-Keita"
2019,"Dijon","Ligue 1","Wesley Lautoa","NCL","DF,MF","30",1987,33.6,81,55,46,31,4,34,75,45.3,41,37,14,23,87,168,110,1,"https://fbref.com/en/players/6e5b5a45/Wesley-Lautoa"
2019,"Dijon","Ligue 1","Enzo Loiodice","FRA","MF","17",2000,9.4,25,14,8,15,2,10,21,47.6,11,7,0,7,11,36,7,0,"https://fbref.com/en/players/6bca20fe/Enzo-Loiodice"
2019,"Dijon","Ligue 1","Jordan Marié","FRA","MF","26",1991,20,52,28,15,31,6,21,58,36.2,37,28,5,23,40,92,32,0,"https://fbref.com/en/players/0d2158d5/Jordan-Marie"
2019,"Dijon","Ligue 1","Valentin Rosier","FRA","DF,MF","21",1996,16.2,44,25,22,19,3,16,31,51.6,15,25,4,21,32,76,45,1,"https://fbref.com/en/players/9b6d9b53/Valentin-Rosier"
2019,"Dijon","Ligue 1","Wesley Saïd","FRA","FW,MF","23",1995,25,25,18,6,11,8,5,20,25,15,9,0,9,9,34,9,0,"https://fbref.com/en/players/90fcf472/Wesley-Said"
2019,"Dijon","Ligue 1","Frédéric Sammaritano","FRA","FW,MF","32",1986,6,11,5,5,5,1,5,13,38.5,8,8,1,7,8,19,2,1,"https://fbref.com/en/players/8802c1d5/Frederic-Sammaritano"
2019,"Dijon","Ligue 1","Naïm Sliti","TUN","MF,FW","26",1992,25.4,56,33,24,19,13,15,46,32.6,31,18,0,18,11,67,9,0,"https://fbref.com/en/players/2e0367a6/Naim-Sliti"
2019,"Dijon","Ligue 1","Júlio Tavares","CPV","FW","29",1988,31.2,15,9,1,7,7,3,9,33.3,6,17,3,14,13,28,51,0,"https://fbref.com/en/players/d520120b/Julio-Tavares"
2019,"Dijon","Ligue 1","Cédric Yamberé","CTA","DF","27",1990,31.2,47,31,36,11,0,21,39,53.8,18,45,32,13,52,99,136,4,"https://fbref.com/en/players/1c344204/Cedric-Yambere"
2019,"Dortmund","Bundesliga","Manuel Akanji","SUI","DF","23",1995,24.5,29,19,14,13,2,14,25,56,11,22,13,9,27,56,92,2,"https://fbref.com/en/players/89ac64a6/Manuel-Akanji"
2019,"Dortmund","Bundesliga","Paco Alcácer","ESP","FW","24",1993,13.5,3,1,2,0,1,0,6,0,6,5,0,5,6,9,7,0,"https://fbref.com/en/players/a7a9d95a/Paco-Alcacer"
2019,"Dortmund","Bundesliga","Jacob Bruun Larsen","DEN","FW","19",1998,14.1,15,9,8,2,5,7,17,41.2,10,15,1,14,13,28,12,0,"https://fbref.com/en/players/4e204552/Jacob-Bruun-Larsen"
2019,"Dortmund","Bundesliga","Roman Bürki","SUI","GK","27",1990,32,1,0,1,0,0,1,2,50,1,1,0,1,2,3,8,4,"https://fbref.com/en/players/9d12e142/Roman-Burki"
2019,"Dortmund","Bundesliga","Mahmoud Dahoud","GER","MF","22",1996,7.7,16,10,4,10,2,3,15,20,12,10,0,10,17,33,8,0,"https://fbref.com/en/players/db4ed67b/Mahmoud-Dahoud"
2019,"Dortmund","Bundesliga","Thomas Delaney","DEN","MF","26",1991,25.4,69,54,28,39,2,19,30,63.3,11,30,9,21,58,127,43,0,"https://fbref.com/en/players/fe641c1a/Thomas-Delaney"
2019,"Dortmund","Bundesliga","Abdou Diallo","SEN","DF","22",1996,26.4,36,20,20,13,3,11,15,73.3,4,28,15,13,26,62,91,1,"https://fbref.com/en/players/fc62f087/Abdou-Diallo"
2019,"Dortmund","Bundesliga","Mario Götze","GER","FW,MF","26",1992,18.6,26,19,6,11,9,4,25,16,21,10,0,10,8,34,4,1,"https://fbref.com/en/players/9efa1d25/Mario-Gotze"
2019,"Dortmund","Bundesliga","Raphaël Guerreiro","POR","FW,DF","24",1993,17,25,12,11,7,7,12,23,52.2,11,7,1,6,18,43,12,1,"https://fbref.com/en/players/048a1cbc/Raphael-Guerreiro"
2019,"Dortmund","Bundesliga","Achraf Hakimi","MAR","DF","19",1998,19.3,34,19,25,8,1,17,36,47.2,19,27,4,23,29,63,45,2,"https://fbref.com/en/players/e42d61c7/Achraf-Hakimi"
2019,"Dortmund","Bundesliga","Marwin Hitz","SUI","GK","30",1987,2,0,0,0,0,0,0,0,NA,0,0,0,0,0,0,0,1,"https://fbref.com/en/players/2e7ff968/Marwin-Hitz"
2019,"Dortmund","Bundesliga","Shinji Kagawa","JPN","MF","29",1989,1.1,0,0,0,0,0,0,0,NA,0,0,0,0,0,0,0,0,"https://fbref.com/en/players/5afafbfe/Shinji-Kagawa"
2019,"Dortmund","Bundesliga","Maximilian Philipp","GER","FW,MF","24",1994,8.4,7,5,3,4,0,2,9,22.2,7,10,0,10,3,10,6,0,"https://fbref.com/en/players/061e8e23/Maximilian-Philipp"
2019,"Dortmund","Bundesliga","Łukasz Piszczek","POL","DF","33",1985,19.5,57,36,34,15,8,18,33,54.5,15,26,3,23,39,96,69,0,"https://fbref.com/en/players/fe2db476/Lukasz-Piszczek"
2019,"Dortmund","Bundesliga","Christian Pulisic","USA","FW","19",1998,10.4,10,6,2,6,2,2,6,33.3,4,12,2,10,6,16,10,0,"https://fbref.com/en/players/1bf33a9a/Christian-Pulisic"
2019,"Dortmund","Bundesliga","Marco Reus","GER","MF,FW","29",1989,25.7,33,22,11,16,6,6,31,19.4,25,28,1,27,8,41,32,0,"https://fbref.com/en/players/36a3ff67/Marco-Reus"
2019,"Dortmund","Bundesliga","Jadon Sancho","ENG","FW,MF","18",2000,27.3,19,10,7,6,6,10,31,32.3,21,21,1,20,14,33,12,1,"https://fbref.com/en/players/dbf053da/Jadon-Sancho"
2019,"Dortmund","Bundesliga","Marcel Schmelzer","GER","DF","30",1988,6.3,10,5,7,2,1,5,9,55.6,4,7,1,6,9,19,14,0,"https://fbref.com/en/players/89565ac5/Marcel-Schmelzer"
2019,"Dortmund","Bundesliga","Ömer Toprak","TUR","DF","29",1989,2.6,1,1,0,1,0,0,1,0,1,1,1,0,0,1,7,0,"https://fbref.com/en/players/c5fd13e9/Omer-Toprak"
2019,"Dortmund","Bundesliga","Julian Weigl","GER","DF,MF","22",1995,16.2,32,18,19,12,1,24,41,58.5,17,18,10,8,16,48,56,2,"https://fbref.com/en/players/346d51d9/Julian-Weigl"
2019,"Dortmund","Bundesliga","Axel Witsel","BEL","MF","29",1989,31.9,47,33,19,24,4,17,28,60.7,11,33,6,27,47,94,49,0,"https://fbref.com/en/players/5dfc6ad5/Axel-Witsel"
2019,"Dortmund","Bundesliga","Marius Wolf","GER","DF,FW","23",1995,9.2,14,10,11,3,0,5,13,38.5,8,6,0,6,13,27,12,0,"https://fbref.com/en/players/fa661778/Marius-Wolf"
2019,"Dortmund","Bundesliga","Dan-Axel Zagadou","FRA","DF","19",1999,14.1,13,10,10,2,1,4,6,66.7,2,17,11,6,25,38,70,2,"https://fbref.com/en/players/a4effc55/Dan-Axel-Zagadou"
2019,"Düsseldorf","Bundesliga","Kaan Ayhan","TUR","DF","23",1994,27.2,53,29,38,15,0,23,47,48.9,24,34,16,18,59,112,118,3,"https://fbref.com/en/players/2200181e/Kaan-Ayhan"
2019,"Düsseldorf","Bundesliga","Aymen Barkok","MAR","MF","20",1998,5.7,13,6,4,9,0,4,19,21.1,15,8,1,7,4,17,3,0,"https://fbref.com/en/players/a2a85828/Aymen-Barkok"
2019,"Düsseldorf","Bundesliga","Adam Bodzek","GER","MF,DF","32",1985,17.7,44,27,27,16,1,17,43,39.5,26,15,6,9,26,70,39,0,"https://fbref.com/en/players/bb8a42fa/Adam-Bodzek"
2019,"Düsseldorf","Bundesliga","Robin Bormuth","GER","DF","22",1995,6.8,7,4,7,0,0,5,10,50,5,6,4,2,10,17,49,1,"https://fbref.com/en/players/d728acae/Robin-Bormuth"
2019,"Düsseldorf","Bundesliga","Jaroslav Drobný","CZE","GK","38",1979,2,0,0,0,0,0,0,0,NA,0,0,0,0,0,0,1,0,"https://fbref.com/en/players/e4a30d8c/Jaroslav-Drobny"
2019,"Düsseldorf","Bundesliga","Marvin Ducksch","GER","FW","24",1994,9.1,3,1,0,2,1,1,5,20,4,4,0,4,4,7,11,0,"https://fbref.com/en/players/638a4d71/Marvin-Ducksch"
2019,"Düsseldorf","Bundesliga","Oliver Fink","GER","MF","36",1982,11.7,38,22,17,17,4,12,38,31.6,26,20,3,17,13,51,19,0,"https://fbref.com/en/players/316162b6/Oliver-Fink"
2019,"Düsseldorf","Bundesliga","Niko Gießelmann","GER","DF","26",1991,28.8,57,37,38,14,5,26,59,44.1,33,25,6,19,36,93,85,1,"https://fbref.com/en/players/7242b495/Niko-Giesselmann"
2019,"Düsseldorf","Bundesliga","Rouwen Hennings","GER","FW","30",1987,20.4,14,10,1,8,5,2,13,15.4,11,16,1,15,4,18,20,0,"https://fbref.com/en/players/17611373/Rouwen-Hennings"
2019,"Düsseldorf","Bundesliga","André Hoffmann","GER","DF,MF","25",1993,11.7,22,14,12,10,0,9,25,36,16,17,12,5,21,43,44,0,"https://fbref.com/en/players/34b306a1/Andre-Hoffmann"
2019,"Düsseldorf","Bundesliga","Marcin Kamiński","POL","DF","26",1992,27,18,13,14,3,1,7,11,63.6,4,21,11,10,39,57,103,2,"https://fbref.com/en/players/463503e2/Marcin-Kaminski"
2019,"Düsseldorf","Bundesliga","Kenan Karaman","TUR","FW,MF","24",1994,10.2,13,9,3,10,0,7,12,58.3,5,5,1,4,2,15,8,0,"https://fbref.com/en/players/8f0f2230/Kenan-Karaman"
2019,"Düsseldorf","Bundesliga","Dawid Kownacki","POL","MF,FW","21",1997,6.4,13,6,9,3,1,7,16,43.8,9,8,0,8,2,15,8,0,"https://fbref.com/en/players/be5e1c4c/Dawid-Kownacki"
2019,"Düsseldorf","Bundesliga","Davor Lovren","CRO","MF","19",1998,0.5,1,1,0,0,1,0,0,NA,0,1,0,1,0,1,0,0,"https://fbref.com/en/players/58007d77/Davor-Lovren"
2019,"Düsseldorf","Bundesliga","Dodi Lukebakio","BEL","FW,MF","20",1997,21.9,25,17,11,6,8,8,15,53.3,7,13,0,13,9,34,19,0,"https://fbref.com/en/players/0c61c77c/Dodi-Lukebakio"
2019,"Düsseldorf","Bundesliga","Alfredo Morales","USA","MF","28",1990,17,32,18,16,15,1,6,24,25,18,18,9,9,24,56,31,0,"https://fbref.com/en/players/ff45add5/Alfredo-Morales"
2019,"Düsseldorf","Bundesliga","Benito Raman","BEL","MF,FW","23",1994,18.7,35,20,14,16,5,11,53,20.8,42,30,2,28,15,50,8,0,"https://fbref.com/en/players/867501bf/Benito-Raman"
2019,"Düsseldorf","Bundesliga","Michael Rensing","GER","GK","34",1984,32,2,1,2,0,0,1,5,20,4,1,0,1,2,4,13,2,"https://fbref.com/en/players/c476b0c0/Michael-Rensing"
2019,"Düsseldorf","Bundesliga","Marcel Sobottka","GER","MF","24",1994,10.5,30,20,12,18,0,10,19,52.6,9,13,5,8,24,54,17,0,"https://fbref.com/en/players/664590fa/Marcel-Sobottka"
2019,"Düsseldorf","Bundesliga","Kevin Stöger","AUT","MF","24",1993,23.5,63,35,28,27,8,30,67,44.8,37,32,5,27,31,94,19,1,"https://fbref.com/en/players/e5649a78/Kevin-Stoger"
2019,"Düsseldorf","Bundesliga","Markus Suttner","AUT","DF,MF","31",1987,5.4,10,7,5,4,1,4,8,50,4,8,3,5,8,18,10,0,"https://fbref.com/en/players/7391c2d9/Markus-Suttner"
2019,"Düsseldorf","Bundesliga","Takashi Usami","JPN","MF,FW","26",1992,9.8,18,12,7,11,0,9,26,34.6,17,15,2,13,8,26,13,1,"https://fbref.com/en/players/2bed2986/Takashi-Usami"
2019,"Düsseldorf","Bundesliga","Jean Zimmer","GER","DF,FW","24",1993,15.9,17,11,11,5,1,6,16,37.5,10,13,2,11,11,28,32,1,"https://fbref.com/en/players/912e63b5/Jean-Zimmer"
2019,"Düsseldorf","Bundesliga","Matthias Zimmermann","GER","DF,MF","26",1992,33.9,97,64,69,24,4,45,90,50,45,51,18,33,67,164,90,2,"https://fbref.com/en/players/e199d5b0/Matthias-Zimmermann"
2019,"Eibar","La Liga","Sergio Álvarez","ESP","DF,MF","26",1992,11.9,34,25,12,20,2,13,23,56.5,10,9,4,5,17,51,43,0,"https://fbref.com/en/players/88d91621/Sergio-Alvarez"
2019,"Eibar","La Liga","José Ángel","ESP","DF","28",1989,33.6,66,46,36,23,7,31,56,55.4,25,24,5,19,41,107,113,1,"https://fbref.com/en/players/3024e383/Jose-Angel"
2019,"Eibar","La Liga","Anaitz Arbilla","ESP","DF","31",1987,21.7,31,24,25,5,1,17,27,63,10,12,5,7,46,77,92,2,"https://fbref.com/en/players/850c0a0d/Anaitz-Arbilla"
2019,"Eibar","La Liga","Bebé","CPV","MF","28",1990,0.7,0,0,0,0,0,0,0,NA,0,1,0,1,1,1,0,0,"https://fbref.com/en/players/d8712bf9/Bebe"
2019,"Eibar","La Liga","Pedro Bigas","ESP","DF","27",1990,6.5,4,3,2,0,2,1,5,20,4,6,2,4,8,12,22,0,"https://fbref.com/en/players/697295b1/Pedro-Bigas"
2019,"Eibar","La Liga","Pablo de Blasis","ARG","DF,MF","30",1988,16.9,32,19,17,8,7,12,32,37.5,20,18,0,18,13,45,20,0,"https://fbref.com/en/players/9ab48bde/Pablo-de-Blasis"
2019,"Eibar","La Liga","Jordi Calavera","ESP","DF","22",1995,0,0,0,0,0,0,0,0,NA,0,0,0,0,0,0,0,0,"https://fbref.com/en/players/bdef8cdb/Jordi-Calavera"
2019,"Eibar","La Liga","Marc Cardona","ESP","FW,MF","23",1995,6.7,7,5,2,1,4,2,6,33.3,4,7,0,7,1,8,3,0,"https://fbref.com/en/players/b92b456a/Marc-Cardona"
2019,"Eibar","La Liga","Charles","BRA","FW","34",1984,19.3,7,5,1,3,3,2,13,15.4,11,14,1,13,4,11,14,0,"https://fbref.com/en/players/c4b8bcf4/Charles"
2019,"Eibar","La Liga","Marc Cucurella","ESP","MF,FW","20",1998,26.2,49,37,13,21,15,10,23,43.5,13,36,3,33,20,69,24,0,"https://fbref.com/en/players/1daec722/Marc-Cucurella"
2019,"Eibar","La Liga","Papakouli Diop","SEN","MF","32",1986,26.1,66,40,14,44,8,14,34,41.2,20,21,1,20,37,103,27,0,"https://fbref.com/en/players/7329018e/Papakouli-Diop"
2019,"Eibar","La Liga","Marko Dmitrović","SRB","GK","26",1992,24,0,0,0,0,0,0,0,NA,0,0,0,0,2,2,11,3,"https://fbref.com/en/players/ac295d9e/Marko-Dmitrovic"
2019,"Eibar","La Liga","Sergi Enrich","ESP","FW","28",1990,28.7,27,17,3,11,13,7,30,23.3,23,11,1,10,6,33,14,0,"https://fbref.com/en/players/bb4b1242/Sergi-Enrich"
2019,"Eibar","La Liga","Gonzalo Escalante","ARG","MF","25",1993,19.9,49,28,11,35,3,19,46,41.3,27,37,2,35,21,70,21,0,"https://fbref.com/en/players/3f79a1c8/Gonzalo-Escalante"
2019,"Eibar","La Liga","Pablo Hervías","ESP","MF","25",1993,2,1,1,0,1,0,0,4,0,4,2,0,2,0,1,0,0,"https://fbref.com/en/players/ba5a9545/Pablo-Hervias"
2019,"Eibar","La Liga","Joan Jordán","ESP","MF","24",1994,31.9,63,40,16,38,9,28,80,35,52,38,4,34,32,95,18,1,"https://fbref.com/en/players/2a0c8ba4/Joan-Jordan"
2019,"Eibar","La Liga","Kike","ESP","FW","28",1989,14.4,7,4,1,2,4,1,5,20,4,18,0,18,4,11,6,0,"https://fbref.com/en/players/e897d8ba/Kike"
2019,"Eibar","La Liga","Pedro León","ESP","MF,FW","31",1986,4.7,7,4,2,2,3,4,7,57.1,3,10,0,10,4,11,2,0,"https://fbref.com/en/players/d66b9872/Pedro-Leon"
2019,"Eibar","La Liga","Miguel Marí","ESP","MF","21",1997,0.8,0,0,0,0,0,0,2,0,2,0,0,0,1,1,2,0,"https://fbref.com/en/players/d70a3661/Miguel-Mari"
2019,"Eibar","La Liga","Pere Milla","ESP","MF,FW","25",1992,3.8,7,6,1,5,1,0,5,0,5,4,1,3,2,9,1,0,"https://fbref.com/en/players/335039a2/Pere-Milla"
2019,"Eibar","La Liga","Paulo Oliveira","POR","DF","26",1992,24.9,49,39,33,16,0,28,44,63.6,16,25,10,15,36,85,116,0,"https://fbref.com/en/players/a8fbae1d/Paulo-Oliveira"
2019,"Eibar","La Liga","Fabián Orellana","CHI","MF,FW","32",1986,30.4,44,21,14,16,14,9,42,21.4,33,17,0,17,19,63,4,0,"https://fbref.com/en/players/c90977db/Fabian-Orellana"
2019,"Eibar","La Liga","Rubén Peña","ESP","DF","27",1991,29.7,63,46,24,27,12,24,53,45.3,29,37,9,28,35,98,57,0,"https://fbref.com/en/players/1f079188/Ruben-Pena"
2019,"Eibar","La Liga","Iván Ramis","ESP","DF","33",1984,18.6,23,13,10,11,2,17,23,73.9,6,10,5,5,18,41,65,2,"https://fbref.com/en/players/d2be40f2/Ivan-Ramis"
2019,"Eibar","La Liga","Asier Riesgo","ESP","GK","34",1983,14,1,1,1,0,0,1,3,33.3,2,0,0,0,0,1,8,1,"https://fbref.com/en/players/581c5276/Asier-Riesgo"
2019,"Eint Frankfurt","Bundesliga","David Abraham","ARG","DF","32",1986,15.8,22,14,13,8,1,11,25,44,14,23,12,11,24,46,64,0,"https://fbref.com/en/players/565bf0da/David-Abraham"
2019,"Eint Frankfurt","Bundesliga","Allan","BRA","MF","21",1997,2,4,4,2,2,0,0,4,0,4,4,2,2,0,4,1,0,"https://fbref.com/en/players/b15e93aa/Allan"
2019,"Eint Frankfurt","Bundesliga","Danny Blum","GER","MF","27",1991,0,0,0,0,0,0,0,0,NA,0,0,0,0,0,0,5,0,"https://fbref.com/en/players/eb61713c/Danny-Blum"
2019,"Eint Frankfurt","Bundesliga","Timothy Chandler","USA","DF","28",1990,0.2,0,0,0,0,0,0,0,NA,0,0,0,0,0,0,0,0,"https://fbref.com/en/players/b3b7f5a6/Timothy-Chandler"
2019,"Eint Frankfurt","Bundesliga","Danny da Costa","GER","DF,FW","25",1993,33.7,61,35,29,25,7,18,42,42.9,24,51,9,42,32,93,67,0,"https://fbref.com/en/players/5ddb8f9f/Danny-da-Costa"
2019,"Eint Frankfurt","Bundesliga","Marco Fabián","MEX","FW","29",1989,0.7,3,2,2,1,0,1,1,100,0,0,0,0,3,6,0,0,"https://fbref.com/en/players/e665a2db/Marco-Fabian"
2019,"Eint Frankfurt","Bundesliga","Simon Falette","GUI","DF","26",1992,6.7,9,6,7,1,1,2,6,33.3,4,11,5,6,14,23,32,0,"https://fbref.com/en/players/b82880c6/Simon-Falette"
2019,"Eint Frankfurt","Bundesliga","Gelson Fernandes","SUI","MF","31",1986,24.7,74,48,33,38,3,23,65,35.4,42,45,9,36,53,127,16,0,"https://fbref.com/en/players/8e58987d/Gelson-Fernandes"
2019,"Eint Frankfurt","Bundesliga","Mijat Gaćinović","SRB","MF","23",1995,18.1,31,20,7,13,11,11,42,26.2,31,26,1,25,24,55,10,0,"https://fbref.com/en/players/16daec92/Mijat-Gacinovic"
2019,"Eint Frankfurt","Bundesliga","Jonathan de Guzmán","NED","MF","30",1987,17.4,34,24,11,20,3,13,28,46.4,15,18,2,16,11,45,16,0,"https://fbref.com/en/players/1bcca8b8/Jonathan-de-Guzman"
2019,"Eint Frankfurt","Bundesliga","Sébastien Haller","CIV","FW","24",1994,24.2,24,11,7,10,7,8,21,38.1,13,21,1,20,15,39,23,0,"https://fbref.com/en/players/ba115a40/Sebastien-Haller"
2019,"Eint Frankfurt","Bundesliga","Makoto Hasebe","JPN","DF,MF","34",1984,28,52,34,35,17,0,25,42,59.5,17,43,22,21,40,92,101,3,"https://fbref.com/en/players/9ab16552/Makoto-Hasebe"
2019,"Eint Frankfurt","Bundesliga","Martin Hinteregger","AUT","DF","25",1992,12.7,34,26,19,12,3,13,28,46.4,15,20,7,13,13,47,51,0,"https://fbref.com/en/players/080440a4/Martin-Hinteregger"
2019,"Eint Frankfurt","Bundesliga","Branimir Hrgota","SWE","FW","25",1993,0.1,0,0,0,0,0,0,0,NA,0,0,0,0,0,0,0,0,"https://fbref.com/en/players/710fbdd1/Branimir-Hrgota"
2019,"Eint Frankfurt","Bundesliga","Luka Jović","SRB","FW,MF","20",1997,24.9,10,5,1,8,1,1,12,8.3,11,8,0,8,3,13,30,0,"https://fbref.com/en/players/4d8cd038/Luka-Jovic"
2019,"Eint Frankfurt","Bundesliga","Filip Kostić","SRB","DF,FW","25",1992,32.8,64,42,35,22,7,23,65,35.4,42,80,6,74,23,87,50,0,"https://fbref.com/en/players/b1cd37e6/Filip-Kostic"
2019,"Eint Frankfurt","Bundesliga","Nicolai Müller","GER","FW,MF","30",1987,2.4,4,2,3,1,0,1,2,50,1,4,1,3,0,4,0,0,"https://fbref.com/en/players/5e1df051/Nicolai-Muller"
2019,"Eint Frankfurt","Bundesliga","Obite N'Dicka","FRA","DF","18",1999,25.6,43,28,31,10,2,31,52,59.6,21,29,11,18,29,72,123,0,"https://fbref.com/en/players/441197b8/Obite-NDicka"
2019,"Eint Frankfurt","Bundesliga","Gonçalo Paciência","POR","FW","23",1994,4.3,3,2,0,2,1,1,2,50,1,8,1,7,0,3,1,0,"https://fbref.com/en/players/962e54cb/Goncalo-Paciencia"
2019,"Eint Frankfurt","Bundesliga","Ante Rebić","CRO","FW,MF","24",1993,22,22,9,5,12,5,5,12,41.7,7,18,1,17,8,30,3,0,"https://fbref.com/en/players/536cebe5/Ante-Rebic"
2019,"Eint Frankfurt","Bundesliga","Sebastian Rode","GER","MF","27",1990,10.3,31,19,17,9,5,16,35,45.7,19,17,0,17,19,50,14,0,"https://fbref.com/en/players/e12b0b5b/Sebastian-Rode"
2019,"Eint Frankfurt","Bundesliga","Marco Russ","GER","DF","32",1985,4.2,7,2,5,2,0,4,6,66.7,2,2,2,0,7,14,8,0,"https://fbref.com/en/players/e26c4233/Marco-Russ"
2019,"Eint Frankfurt","Bundesliga","Frederik Rønnow","DEN","GK","25",1992,1.4,0,0,0,0,0,0,0,NA,0,0,0,0,0,0,1,0,"https://fbref.com/en/players/a70b8345/Frederik-Ronnow"
2019,"Eint Frankfurt","Bundesliga","Carlos Salcedo","MEX","DF","24",1993,5.1,7,3,4,3,0,4,7,57.1,3,7,3,4,9,16,22,0,"https://fbref.com/en/players/64c07ae1/Carlos-Salcedo"
2019,"Eint Frankfurt","Bundesliga","Marc Stendera","GER","MF","22",1995,1.2,6,1,2,4,0,2,4,50,2,4,1,3,0,6,0,0,"https://fbref.com/en/players/500cd987/Marc-Stendera"
2019,"Eint Frankfurt","Bundesliga","Taleb Tawatha","ISR","FW,DF","26",1992,1.4,1,1,1,0,0,1,2,50,1,0,0,0,0,1,1,0,"https://fbref.com/en/players/bbb496b5/Taleb-Tawatha"
2019,"Eint Frankfurt","Bundesliga","Lucas Torró","ESP","MF","24",1994,6.2,14,7,5,7,2,5,11,45.5,6,12,1,11,14,28,13,0,"https://fbref.com/en/players/0e4fef6e/Lucas-Torro"
2019,"Eint Frankfurt","Bundesliga","Almamy Touré","MLI","DF,MF","22",1996,5.8,18,11,7,11,0,5,8,62.5,3,4,1,3,9,27,25,0,"https://fbref.com/en/players/c8c60119/Almamy-Toure"
2019,"Eint Frankfurt","Bundesliga","Kevin Trapp","GER","GK","28",1990,32.6,0,0,0,0,0,0,2,0,2,0,0,0,0,0,17,1,"https://fbref.com/en/players/ce17b5eb/Kevin-Trapp"
2019,"Eint Frankfurt","Bundesliga","Jetro Willems","NED","MF,DF","24",1994,8.1,20,15,10,8,2,9,15,60,6,10,4,6,10,30,14,0,"https://fbref.com/en/players/9050ddc4/Jetro-Willems"
2019,"Empoli","Serie A","Afriyie Acquah","GHA","MF","26",1992,16.8,27,9,9,12,6,4,11,36.4,7,11,1,10,12,39,16,0,"https://fbref.com/en/players/d7403bd5/Afriyie-Acquah"
2019,"Empoli","Serie A","Luca Antonelli","ITA","DF","31",1987,8.4,13,11,4,5,4,7,17,41.2,10,19,4,15,16,29,25,1,"https://fbref.com/en/players/40f0ed6c/Luca-Antonelli"
2019,"Empoli","Serie A","Ismaël Bennacer","ALG","MF","20",1997,32.9,94,57,43,41,10,32,75,42.7,43,38,9,29,57,151,34,0,"https://fbref.com/en/players/db092d3b/Ismael-Bennacer"
2019,"Empoli","Serie A","Matteo Brighi","ITA","MF","37",1981,2.6,11,4,2,9,0,2,9,22.2,7,2,0,2,3,14,4,0,"https://fbref.com/en/players/d417b306/Matteo-Brighi"
2019,"Empoli","Serie A","Leonardo Capezzi","ITA","MF","23",1995,8.6,14,9,6,8,0,7,13,53.8,6,14,4,10,10,24,13,0,"https://fbref.com/en/players/07ea0ef2/Leonardo-Capezzi"
2019,"Empoli","Serie A","Francesco Caputo","ITA","FW","30",1987,38,13,9,2,4,7,3,10,30,7,11,1,10,2,15,11,0,"https://fbref.com/en/players/5bd72174/Francesco-Caputo"
2019,"Empoli","Serie A","Cristian Dell'Orco","ITA","DF","24",1994,11.5,18,11,11,5,2,4,11,36.4,7,13,7,6,17,35,44,0,"https://fbref.com/en/players/b0243215/Cristian-DellOrco"
2019,"Empoli","Serie A","Giovanni Di Lorenzo","ITA","DF,FW","24",1993,37,66,43,38,23,5,24,44,54.5,20,34,13,21,36,102,93,3,"https://fbref.com/en/players/230a2fac/Giovanni-Di-Lorenzo"
2019,"Empoli","Serie A","Bartłomiej Drągowski","POL","GK","20",1997,14,0,0,0,0,0,0,1,0,1,0,0,0,0,0,7,1,"https://fbref.com/en/players/085e71a7/Bartlomiej-Dragowski"
2019,"Empoli","Serie A","Diego Farias","BRA","FW","28",1990,13.3,11,4,2,8,1,3,10,30,7,7,1,6,0,11,4,0,"https://fbref.com/en/players/157d29b6/Diego-Farias"
2019,"Empoli","Serie A","Hamed Junior Traorè","CIV","MF","18",2000,25.1,67,38,26,32,9,27,72,37.5,45,29,4,25,30,97,17,0,"https://fbref.com/en/players/570bb4b9/Hamed-Junior-Traore"
2019,"Empoli","Serie A","Rade Krunić","BIH","MF","24",1993,30.8,38,23,21,14,3,14,41,34.1,27,35,12,23,24,62,32,0,"https://fbref.com/en/players/817c6964/Rade-Krunic"
2019,"Empoli","Serie A","Antonino La Gumina","ITA","FW,MF","22",1996,12.1,5,4,1,2,2,2,6,33.3,4,8,2,6,6,11,5,0,"https://fbref.com/en/players/822a7761/Antonino-La-Gumina"
2019,"Empoli","Serie A","Domenico Maietta","ITA","DF","35",1982,19,33,15,22,10,1,16,36,44.4,20,19,14,5,24,57,78,2,"https://fbref.com/en/players/3d936ba9/Domenico-Maietta"
2019,"Empoli","Serie A","Levan Mchedlidze","GEO","FW","28",1990,2.3,1,1,0,0,1,0,1,0,1,2,0,2,0,1,5,0,"https://fbref.com/en/players/54ab361e/Levan-Mchedlidze"
2019,"Empoli","Serie A","Samuel Mráz","SVK","FW","21",1997,1.9,0,0,0,0,0,0,0,NA,0,2,0,2,0,0,2,0,"https://fbref.com/en/players/be6c1ccc/Samuel-Mraz"
2019,"Empoli","Serie A","Dimitris Nikolaou","GRE","DF","19",1998,3.9,5,3,3,2,0,1,2,50,1,2,2,0,2,7,14,0,"https://fbref.com/en/players/cf961d8d/Dimitris-Nikolaou"
2019,"Empoli","Serie A","Dimitri Oberlin","SUI","FW","20",1997,1.5,1,1,0,0,1,0,3,0,3,1,0,1,0,1,1,0,"https://fbref.com/en/players/af45e954/Dimitri-Oberlin"
2019,"Empoli","Serie A","Marko Pajač","CRO","FW,DF","25",1993,8.2,7,7,2,3,2,5,11,45.5,6,3,0,3,7,14,18,0,"https://fbref.com/en/players/5df4ef30/Marko-Pajac"
2019,"Empoli","Serie A","Manuel Pasqual","ITA","DF","36",1982,14.9,26,19,12,11,3,17,45,37.8,28,7,0,7,11,37,31,0,"https://fbref.com/en/players/548902cc/Manuel-Pasqual"
2019,"Empoli","Serie A","Ivan Provedel","ITA","GK","24",1994,16,0,0,0,0,0,0,1,0,1,0,0,0,0,0,4,0,"https://fbref.com/en/players/277da414/Ivan-Provedel"
2019,"Empoli","Serie A","Jacob Rasmussen","DEN","DF,MF","21",1997,11.3,18,12,10,6,2,5,14,35.7,9,18,13,5,12,30,55,1,"https://fbref.com/en/players/283699b4/Jacob-Rasmussen"
2019,"Empoli","Serie A","Alejandro Rodríguez","ESP","MF","27",1991,0.3,0,0,0,0,0,0,0,NA,0,0,0,0,0,0,1,0,"https://fbref.com/en/players/7602ddf6/Alejandro-Rodriguez"
2019,"Empoli","Serie A","Matías Silvestre","ARG","DF","33",1984,34,31,17,22,5,4,17,26,65.4,9,29,24,5,21,52,165,0,"https://fbref.com/en/players/b6ca47a2/Matias-Silvestre"
2019,"Empoli","Serie A","Pietro Terracciano","ITA","GK","28",1990,8,0,0,0,0,0,0,0,NA,0,0,0,0,1,1,4,0,"https://fbref.com/en/players/e1b0a70d/Pietro-Terracciano"
2019,"Empoli","Serie A","Salih Uçan","TUR","MF","24",1994,2.9,10,4,3,5,2,3,10,30,7,4,0,4,6,16,2,0,"https://fbref.com/en/players/fe154b26/Salih-Ucan"
2019,"Empoli","Serie A","Joel Untersee","SUI","DF","24",1994,1.4,3,2,1,2,0,2,3,66.7,1,2,1,1,1,4,5,1,"https://fbref.com/en/players/3300c14c/Joel-Untersee"
2019,"Empoli","Serie A","Freddie Veseli","ALB","DF","25",1992,28.2,34,21,16,15,3,19,27,70.4,8,28,17,11,30,64,99,1,"https://fbref.com/en/players/d541e703/Freddie-Veseli"
2019,"Empoli","Serie A","Miha Zajc","SVN","MF,FW","24",1994,13,6,4,1,1,4,2,11,18.2,9,15,4,11,5,11,8,0,"https://fbref.com/en/players/83e4643e/Miha-Zajc"
2019,"Espanyol","La Liga","Léo Baptistão","BRA","FW,MF","25",1992,13.7,22,14,11,5,6,8,27,29.6,19,17,0,17,8,30,14,0,"https://fbref.com/en/players/35f6db55/Leo-Baptistao"
2019,"Espanyol","La Liga","Sergi Darder","ESP","MF","24",1993,30.1,60,35,23,32,5,25,69,36.2,44,18,3,15,22,82,30,0,"https://fbref.com/en/players/070a3904/Sergi-Darder"
2019,"Espanyol","La Liga","Óscar Duarte","CRC","DF,MF","29",1989,7.3,12,5,7,5,0,4,7,57.1,3,7,7,0,13,25,34,0,"https://fbref.com/en/players/aa0ac32d/Oscar-Duarte"
2019,"Espanyol","La Liga","Facundo Ferreyra","ARG","FW","27",1991,2.3,5,2,0,4,1,1,3,33.3,2,3,0,3,0,5,5,0,"https://fbref.com/en/players/b39a793e/Facundo-Ferreyra"
2019,"Espanyol","La Liga","Sergio García","ESP","FW,MF","35",1983,16.5,18,10,4,11,3,3,16,18.8,13,6,1,5,10,28,4,0,"https://fbref.com/en/players/2bee98fd/Sergio-Garcia"
2019,"Espanyol","La Liga","Esteban Granero","ESP","MF","31",1987,22.4,50,32,26,18,6,17,50,34,33,42,8,34,26,76,34,2,"https://fbref.com/en/players/1b17ed86/Esteban-Granero"
2019,"Espanyol","La Liga","Mario Hermoso","ESP","DF","23",1995,31.2,38,24,29,7,2,21,39,53.8,18,34,25,9,37,75,175,2,"https://fbref.com/en/players/555f3a0b/Mario-Hermoso"
2019,"Espanyol","La Liga","Borja Iglesias","ESP","FW","25",1993,34.2,23,14,7,8,8,5,24,20.8,19,14,6,8,7,30,41,0,"https://fbref.com/en/players/75645f0e/Borja-Iglesias"
2019,"Espanyol","La Liga","Wu Lei","CHN","FW,MF","26",1991,11.8,13,6,5,6,2,5,16,31.3,11,9,0,9,7,20,7,0,"https://fbref.com/en/players/e3fabb0a/Wu-Lei"
2019,"Espanyol","La Liga","Alejandro López","ESP","MF","21",1997,1.2,3,1,1,2,0,2,3,66.7,1,0,0,0,3,6,1,0,"https://fbref.com/en/players/f1887f53/Alejandro-Lopez"
2019,"Espanyol","La Liga","David López","ESP","DF","28",1989,20.2,27,18,15,10,2,10,22,45.5,12,18,12,6,28,55,65,2,"https://fbref.com/en/players/f03f284b/David-Lopez"
2019,"Espanyol","La Liga","Diego López","ESP","GK","36",1981,38,0,0,0,0,0,0,0,NA,0,0,0,0,2,2,9,3,"https://fbref.com/en/players/73683fa9/Diego-Lopez"
2019,"Espanyol","La Liga","Javi López","ESP","DF","32",1986,21.6,63,40,37,22,4,28,60,46.7,32,27,5,22,40,103,90,0,"https://fbref.com/en/players/ffad706e/Javi-Lopez"
2019,"Espanyol","La Liga","Lluis López","ESP","DF","21",1997,5.8,5,3,4,1,0,3,6,50,3,6,2,4,7,12,21,0,"https://fbref.com/en/players/a685f013/Lluis-Lopez"
2019,"Espanyol","La Liga","Óscar Melendo","ESP","MF,FW","20",1997,22.2,17,8,7,6,4,10,26,38.5,16,17,1,16,13,30,9,0,"https://fbref.com/en/players/379652be/Oscar-Melendo"
2019,"Espanyol","La Liga","Naldo","BRA","DF","29",1988,15.1,18,10,9,5,4,6,10,60,4,19,13,6,26,44,112,1,"https://fbref.com/en/players/a2609621/Naldo"
2019,"Espanyol","La Liga","Pedrosa","ESP","DF","20",1998,8.5,14,9,11,2,1,7,14,50,7,10,4,6,8,22,27,0,"https://fbref.com/en/players/112521d1/Pedrosa"
2019,"Espanyol","La Liga","Hernán Pérez","PAR","FW,MF","29",1989,8.8,13,10,8,3,2,6,27,22.2,21,14,3,11,5,18,13,0,"https://fbref.com/en/players/e1cea3f7/Hernan-Perez"
2019,"Espanyol","La Liga","Pablo Piatti","ARG","FW,MF","29",1989,8.3,21,15,8,10,3,8,16,50,8,15,0,15,2,23,8,0,"https://fbref.com/en/players/48e89655/Pablo-Piatti"
2019,"Espanyol","La Liga","Javi Puado","ESP","FW,MF","20",1998,4,2,1,0,2,0,0,7,0,7,5,1,4,6,8,4,0,"https://fbref.com/en/players/2683eda7/Javi-Puado"
2019,"Espanyol","La Liga","Marc Roca","ESP","MF","21",1996,34.6,71,45,36,26,9,28,70,40,42,43,21,22,36,107,60,3,"https://fbref.com/en/players/da27e268/Marc-Roca"
2019,"Espanyol","La Liga","Roberto Rosales","VEN","DF","29",1988,19.4,48,31,22,16,10,21,44,47.7,23,19,7,12,22,70,68,0,"https://fbref.com/en/players/81069528/Roberto-Rosales"
2019,"Espanyol","La Liga","Víctor Sánchez","ESP","MF","30",1987,14.1,45,30,21,17,7,14,67,20.9,53,17,2,15,25,70,25,0,"https://fbref.com/en/players/ad4d0985/Victor-Sanchez"
2019,"Espanyol","La Liga","Alfa Semedo","GNB","MF","20",1997,0.5,0,0,0,0,0,0,3,0,3,1,1,0,2,2,0,0,"https://fbref.com/en/players/07750704/Alfa-Semedo"
2019,"Espanyol","La Liga","Dídac Vilà","ESP","DF","29",1989,26.2,67,31,33,26,8,31,58,53.4,27,41,12,29,53,120,94,1,"https://fbref.com/en/players/bad38a94/Didac-Vila"
2019,"Everton","Premier League","Leighton Baines","ENG","DF","33",1984,4.2,8,6,4,3,1,4,6,66.7,2,2,0,2,2,10,8,0,"https://fbref.com/en/players/b18095b6/Leighton-Baines"
2019,"Everton","Premier League","Bernard","BRA","FW,MF","25",1992,23.5,49,30,19,22,8,15,55,27.3,40,37,2,35,27,76,14,1,"https://fbref.com/en/players/ab4b3e35/Bernard"
2019,"Everton","Premier League","Dominic Calvert-Lewin","ENG","FW","21",1997,19.8,13,7,3,3,7,7,15,46.7,8,16,3,13,7,20,19,0,"https://fbref.com/en/players/59e6e5bf/Dominic-Calvert-Lewin"
2019,"Everton","Premier League","Séamus Coleman","IRL","DF","29",1988,28.4,44,25,23,18,3,19,30,63.3,11,14,5,9,26,70,86,0,"https://fbref.com/en/players/0420d84f/Seamus-Coleman"
2019,"Everton","Premier League","Tom Davies","ENG","MF","20",1998,10.9,27,17,9,17,1,7,23,30.4,16,15,1,14,16,43,9,1,"https://fbref.com/en/players/9228b07c/Tom-Davies"
2019,"Everton","Premier League","Lucas Digne","FRA","DF","25",1993,32.9,71,46,45,18,8,28,45,62.2,17,43,9,34,60,131,116,0,"https://fbref.com/en/players/1b84dbe1/Lucas-Digne"
2019,"Everton","Premier League","Idrissa Gana Gueye","SEN","MF","28",1989,31.4,142,89,70,63,9,38,76,50,38,52,8,44,74,216,48,1,"https://fbref.com/en/players/72c812f3/Idrissa-Gana-Gueye"
2019,"Everton","Premier League","André Gomes","POR","MF","25",1993,22,39,23,12,24,3,13,59,22,46,27,4,23,20,59,18,0,"https://fbref.com/en/players/1961b2aa/Andre-Gomes"
2019,"Everton","Premier League","Mason Holgate","ENG","DF","21",1996,4.5,5,4,4,1,0,1,1,100,0,3,2,1,3,8,32,0,"https://fbref.com/en/players/d0042ab9/Mason-Holgate"
2019,"Everton","Premier League","Phil Jagielka","ENG","DF","35",1982,3.7,7,5,3,4,0,1,4,25,3,1,0,1,2,9,14,0,"https://fbref.com/en/players/3233eefd/Phil-Jagielka"
2019,"Everton","Premier League","Michael Keane","ENG","DF","25",1993,33,41,25,22,16,3,19,32,59.4,13,30,22,8,43,84,185,4,"https://fbref.com/en/players/c5b7c315/Michael-Keane"
2019,"Everton","Premier League","Jonjoe Kenny","ENG","DF","21",1997,8.8,21,16,16,4,1,10,18,55.6,8,13,2,11,17,38,36,1,"https://fbref.com/en/players/099e666f/Jonjoe-Kenny"
2019,"Everton","Premier League","Ademola Lookman","NGA","FW,MF","20",1997,6.9,15,7,7,5,3,4,6,66.7,2,10,0,10,7,22,2,0,"https://fbref.com/en/players/7c104bb7/Ademola-Lookman"
2019,"Everton","Premier League","James McCarthy","IRL","MF","27",1990,0.2,2,1,1,1,0,0,0,NA,0,0,0,0,1,3,0,0,"https://fbref.com/en/players/64b08de7/James-McCarthy"
2019,"Everton","Premier League","Yerry Mina","COL","DF","23",1994,9.9,14,7,8,6,0,6,9,66.7,3,11,5,6,8,22,54,3,"https://fbref.com/en/players/6d5701f2/Yerry-Mina"
2019,"Everton","Premier League","Oumar Niasse","SEN","FW","28",1990,0.7,0,0,0,0,0,0,1,0,1,0,0,0,0,0,0,0,"https://fbref.com/en/players/af721f98/Oumar-Niasse"
2019,"Everton","Premier League","Jordan Pickford","ENG","GK","24",1994,38,0,0,0,0,0,0,0,NA,0,0,0,0,0,0,20,8,"https://fbref.com/en/players/4806ec67/Jordan-Pickford"
2019,"Everton","Premier League","Richarlison","BRA","FW,MF","21",1997,29.6,49,34,19,20,10,8,24,33.3,16,30,2,28,16,65,39,0,"https://fbref.com/en/players/fa031b34/Richarlison"
2019,"Everton","Premier League","Morgan Schneiderlin","FRA","MF","28",1989,9.3,24,16,11,11,2,6,14,42.9,8,16,3,13,15,39,16,0,"https://fbref.com/en/players/51b41c5c/Morgan-Schneiderlin"
2019,"Everton","Premier League","Gylfi Sigurðsson","ISL","MF","28",1989,34.6,56,36,20,25,11,16,47,34,31,38,4,34,28,84,24,0,"https://fbref.com/en/players/76dd1480/Gylfi-Sigurdsson"
2019,"Everton","Premier League","Cenk Tosun","TUR","FW","27",1991,11.8,13,9,3,6,4,4,13,30.8,9,12,0,12,5,18,3,0,"https://fbref.com/en/players/9a104dee/Cenk-Tosun"
2019,"Everton","Premier League","Theo Walcott","ENG","FW,MF","29",1989,23.5,27,17,11,9,7,10,22,45.5,12,17,1,16,22,49,8,0,"https://fbref.com/en/players/1ecb65be/Theo-Walcott"
2019,"Everton","Premier League","Kurt Zouma","FRA","DF","23",1994,29,32,21,16,14,2,4,11,36.4,7,27,12,15,54,86,126,2,"https://fbref.com/en/players/ce4246f5/Kurt-Zouma"
2019,"Fiorentina","Serie A","Marco Benassi","ITA","MF","23",1994,25.4,30,19,8,15,7,14,41,34.1,27,16,3,13,9,39,27,1,"https://fbref.com/en/players/0000acda/Marco-Benassi"
2019,"Fiorentina","Serie A","Cristiano Biraghi","ITA","DF","25",1992,35.5,52,33,31,17,4,18,38,47.4,20,40,17,23,44,96,113,0,"https://fbref.com/en/players/9e1577aa/Cristiano-Biraghi"
2019,"Fiorentina","Serie A","Federico Ceccherini","ITA","DF","26",1992,11,13,10,8,3,2,5,9,55.6,4,12,8,4,21,34,40,0,"https://fbref.com/en/players/d9624b51/Federico-Ceccherini"
2019,"Fiorentina","Serie A","Federico Chiesa","ITA","FW","20",1997,33.7,46,27,8,17,21,10,40,25,30,24,1,23,10,56,12,0,"https://fbref.com/en/players/b0f7e36c/Federico-Chiesa"
2019,"Fiorentina","Serie A","Bryan Dabo","BFA","MF,DF","26",1992,9.2,10,6,1,8,1,1,6,16.7,5,11,6,5,10,20,21,0,"https://fbref.com/en/players/c53083ad/Bryan-Dabo"
2019,"Fiorentina","Serie A","Bartłomiej Drągowski","POL","GK","20",1997,2.5,0,0,0,0,0,0,0,NA,0,0,0,0,0,0,2,0,"https://fbref.com/en/players/085e71a7/Bartlomiej-Dragowski"
2019,"Fiorentina","Serie A","Valentin Eysseric","FRA","FW,MF","26",1992,4,6,5,3,2,1,2,4,50,2,6,1,5,4,10,1,0,"https://fbref.com/en/players/ae82fa48/Valentin-Eysseric"
2019,"Fiorentina","Serie A","Edimilson Fernandes","SUI","MF","22",1996,21.9,36,24,17,16,3,14,36,38.9,22,31,6,25,26,62,31,0,"https://fbref.com/en/players/3bb625ac/Edimilson-Fernandes"
2019,"Fiorentina","Serie A","Gerson","BRA","MF,FW","21",1997,27,42,26,22,15,5,12,38,31.6,26,46,9,37,16,58,32,0,"https://fbref.com/en/players/8827bf46/Gerson"
2019,"Fiorentina","Serie A","Dávid Hancko","SVK","DF","20",1997,3.1,7,6,4,3,0,6,9,66.7,3,3,1,2,3,10,12,0,"https://fbref.com/en/players/4fac8f81/David-Hancko"
2019,"Fiorentina","Serie A","Vitor Hugo","BRA","DF","27",1991,27.4,64,42,38,25,1,17,27,63,10,28,13,15,74,138,141,2,"https://fbref.com/en/players/f2c1300a/Vitor-Hugo"
2019,"Fiorentina","Serie A","Alban Lafont","FRA","GK","19",1999,33.5,0,0,0,0,0,0,0,NA,0,0,0,0,1,1,16,4,"https://fbref.com/en/players/4e7db402/Alban-Lafont"
2019,"Fiorentina","Serie A","Vincent Laurini","FRA","DF","29",1989,10.2,13,5,6,5,2,6,10,60,4,11,5,6,13,26,30,0,"https://fbref.com/en/players/3535098b/Vincent-Laurini"
2019,"Fiorentina","Serie A","Nicky Medja","SUI","FW,MF","18",2000,0.5,1,0,0,0,1,1,2,50,1,0,0,0,0,1,0,0,"https://fbref.com/en/players/714ffae7/Nicky-Medja"
2019,"Fiorentina","Serie A","Nikola Milenković","SRB","DF","20",1997,33.4,59,40,36,21,2,17,33,51.5,16,39,21,18,48,107,143,0,"https://fbref.com/en/players/bee704fc/Nikola-Milenkovic"
2019,"Fiorentina","Serie A","Kevin Mirallas","BEL","FW,MF","30",1987,14.4,17,7,8,4,5,6,15,40,9,17,0,17,4,21,10,0,"https://fbref.com/en/players/aa51343f/Kevin-Mirallas"
2019,"Fiorentina","Serie A","Cristóbal Montiel","ESP","FW","18",2000,0.1,0,0,0,0,0,0,0,NA,0,0,0,0,0,0,0,0,"https://fbref.com/en/players/dd52d069/Cristobal-Montiel"
2019,"Fiorentina","Serie A","Luis Muriel","COL","FW","27",1991,16,19,11,4,13,2,6,18,33.3,12,10,0,10,3,22,1,0,"https://fbref.com/en/players/eb2fe5b6/Luis-Muriel"
2019,"Fiorentina","Serie A","Christian Nørgaard","DEN","MF","24",1994,3.6,4,2,1,2,1,2,5,40,3,2,0,2,10,14,16,0,"https://fbref.com/en/players/df0a4c90/Christian-Norgaard"
2019,"Fiorentina","Serie A","Germán Pezzella","ARG","DF","27",1991,31.7,56,36,42,13,1,31,51,60.8,20,42,30,12,60,116,159,1,"https://fbref.com/en/players/8c725b43/German-Pezzella"
2019,"Fiorentina","Serie A","Marko Pjaca","CRO","FW,MF","23",1995,8.3,9,4,3,4,2,2,6,33.3,4,2,0,2,7,16,6,0,"https://fbref.com/en/players/2c38b327/Marko-Pjaca"
2019,"Fiorentina","Serie A","Giovanni Simeone","ARG","FW","23",1995,27.3,43,27,10,23,10,7,29,24.1,22,26,2,24,4,47,14,0,"https://fbref.com/en/players/343c0d52/Giovanni-Simeone"
2019,"Fiorentina","Serie A","Riccardo Sottil","ITA","FW,MF","19",1999,0.2,1,1,0,1,0,1,1,100,0,0,0,0,0,1,0,0,"https://fbref.com/en/players/94816803/Riccardo-Sottil"
2019,"Fiorentina","Serie A","Pietro Terracciano","ITA","GK","28",1990,2,0,0,0,0,0,0,0,NA,0,0,0,0,0,0,1,1,"https://fbref.com/en/players/e1b0a70d/Pietro-Terracciano"
2019,"Fiorentina","Serie A","Cyril Théréau","FRA","FW,MF","35",1983,0.3,0,0,0,0,0,0,0,NA,0,0,0,0,0,0,1,0,"https://fbref.com/en/players/4d3ab428/Cyril-Thereau"
2019,"Fiorentina","Serie A","Jordan Veretout","FRA","MF","25",1993,32.7,64,40,22,31,11,21,52,40.4,31,33,7,26,46,110,54,2,"https://fbref.com/en/players/4a56052c/Jordan-Veretout"
2019,"Fiorentina","Serie A","Dušan Vlahović","SRB","FW","18",2000,1.8,0,0,0,0,0,0,0,NA,0,2,0,2,0,0,4,0,"https://fbref.com/en/players/79443529/Dusan-Vlahovic"
2019,"Freiburg","Bundesliga","Amir Abrashi","ALB","MF","28",1990,8.8,20,11,7,10,3,6,19,31.6,13,11,3,8,14,34,15,0,"https://fbref.com/en/players/1c08a3c8/Amir-Abrashi"
2019,"Freiburg","Bundesliga","Christoph Daferner","GER","FW","20",1998,0.3,1,0,1,0,0,0,0,NA,0,0,0,0,1,2,0,0,"https://fbref.com/en/players/e5be34dd/Christoph-Daferner"
2019,"Freiburg","Bundesliga","Mark Flekken","NED","GK","25",1993,1,0,0,0,0,0,0,0,NA,0,0,0,0,0,0,0,0,"https://fbref.com/en/players/a92ab7be/Mark-Flekken"
2019,"Freiburg","Bundesliga","Mike Frantz","GER","MF,FW","31",1986,24.6,34,26,15,15,4,6,20,30,14,24,4,20,21,55,32,0,"https://fbref.com/en/players/482b70ad/Mike-Frantz"
2019,"Freiburg","Bundesliga","Jérôme Gondorf","GER","MF,FW","30",1988,14.4,33,18,12,19,2,14,28,50,14,29,5,24,19,52,23,1,"https://fbref.com/en/players/49ffe0f2/Jerome-Gondorf"
2019,"Freiburg","Bundesliga","Vincenzo Grifo","ITA","MF,FW","25",1993,15.9,26,14,11,8,7,14,27,51.9,13,10,1,9,2,28,10,0,"https://fbref.com/en/players/54e4866f/Vincenzo-Grifo"
2019,"Freiburg","Bundesliga","Manuel Gulde","GER","DF","27",1991,19,24,16,18,5,1,12,16,75,4,25,13,12,26,50,90,0,"https://fbref.com/en/players/25ab9c9c/Manuel-Gulde"
2019,"Freiburg","Bundesliga","Christian Günter","GER","DF,MF","25",1993,32,38,26,16,16,6,20,43,46.5,23,31,7,24,14,52,55,0,"https://fbref.com/en/players/8593f88c/Christian-Gunter"
2019,"Freiburg","Bundesliga","Janik Haberer","GER","MF,FW","24",1994,26,71,47,37,24,10,30,75,40,45,31,4,27,36,107,49,0,"https://fbref.com/en/players/70dcf94d/Janik-Haberer"
2019,"Freiburg","Bundesliga","Dominique Heintz","GER","DF","24",1993,33.9,41,21,34,6,1,18,32,56.3,14,45,22,23,45,86,214,0,"https://fbref.com/en/players/699fb8db/Dominique-Heintz"
2019,"Freiburg","Bundesliga","Nicolas Höfler","GER","MF","28",1990,17.9,45,22,19,22,4,14,36,38.9,22,21,4,17,32,77,41,0,"https://fbref.com/en/players/5d8e331f/Nicolas-Hofler"
2019,"Freiburg","Bundesliga","Lucas Höler","GER","FW","24",1994,11.2,18,13,6,9,3,4,18,22.2,14,10,1,9,3,21,15,2,"https://fbref.com/en/players/ca618d23/Lucas-Holer"
2019,"Freiburg","Bundesliga","Patrick Kammerbauer","GER","FW","21",1997,0,0,0,0,0,0,0,0,NA,0,0,0,0,1,1,1,0,"https://fbref.com/en/players/8bdcb6fd/Patrick-Kammerbauer"
2019,"Freiburg","Bundesliga","Tim Kleindienst","GER","FW","22",1995,2.2,4,3,1,2,1,1,3,33.3,2,3,0,3,0,4,7,0,"https://fbref.com/en/players/258a6f4d/Tim-Kleindienst"
2019,"Freiburg","Bundesliga","Robin Koch","GER","MF,DF","22",1996,21.1,25,14,17,7,1,7,24,29.2,17,31,18,13,32,57,77,4,"https://fbref.com/en/players/ea6bc03a/Robin-Koch"
2019,"Freiburg","Bundesliga","Lukas Kübler","GER","DF,MF","25",1992,13.2,35,22,23,12,0,16,26,61.5,10,15,5,10,30,65,50,1,"https://fbref.com/en/players/2a29eb9b/Lukas-Kubler"
2019,"Freiburg","Bundesliga","Philipp Lienhart","AUT","DF","22",1996,6.8,6,6,4,2,0,3,6,50,3,9,7,2,11,17,42,0,"https://fbref.com/en/players/302527b2/Philipp-Lienhart"
2019,"Freiburg","Bundesliga","Florian Niederlechner","GER","FW,MF","27",1990,10.8,7,5,1,4,2,0,5,0,5,12,4,8,6,13,10,0,"https://fbref.com/en/players/d6862409/Florian-Niederlechner"
2019,"Freiburg","Bundesliga","Chima Okoroji","NGA","DF,MF","21",1997,1.2,3,0,1,1,1,1,1,100,0,0,0,0,1,4,1,0,"https://fbref.com/en/players/d453346c/Chima-Okoroji"
2019,"Freiburg","Bundesliga","Nils Petersen","GER","FW","29",1988,21.4,29,21,10,16,3,4,24,16.7,20,28,2,26,13,42,34,0,"https://fbref.com/en/players/f93e6e94/Nils-Petersen"
2019,"Freiburg","Bundesliga","Yoric Ravet","FRA","FW,MF","28",1989,0.8,2,1,1,0,1,1,2,50,1,2,1,1,0,2,1,0,"https://fbref.com/en/players/4d74201d/Yoric-Ravet"
2019,"Freiburg","Bundesliga","Roland Sallai","HUN","MF","21",1997,5.9,12,7,5,5,2,5,13,38.5,8,3,0,3,3,15,8,0,"https://fbref.com/en/players/bf075f6b/Roland-Sallai"
2019,"Freiburg","Bundesliga","Keven Schlotterbeck","GER","DF","21",1997,8.6,22,16,19,2,1,8,12,66.7,4,17,11,6,13,35,26,0,"https://fbref.com/en/players/f6bdc830/Keven-Schlotterbeck"
2019,"Freiburg","Bundesliga","Nico Schlotterbeck","GER","DF","18",1999,2.5,6,6,6,0,0,2,2,100,0,3,1,2,5,11,10,0,"https://fbref.com/en/players/34e12499/Nico-Schlotterbeck"
2019,"Freiburg","Bundesliga","Alexander Schwolow","GER","GK","26",1992,33,0,0,0,0,0,0,1,0,1,0,0,0,0,0,13,2,"https://fbref.com/en/players/0d55d942/Alexander-Schwolow"
2019,"Freiburg","Bundesliga","Pascal Stenzel","GER","DF,MF","22",1996,16.1,42,26,26,14,2,24,43,55.8,19,16,3,13,30,72,48,1,"https://fbref.com/en/players/99f7e9aa/Pascal-Stenzel"
2019,"Freiburg","Bundesliga","Marco Terrazzino","GER","MF,FW","27",1991,5.7,6,3,4,2,0,1,7,14.3,6,5,2,3,3,9,2,0,"https://fbref.com/en/players/7e689867/Marco-Terrazzino"
2019,"Freiburg","Bundesliga","Luca Waldschmidt","GER","FW,MF","22",1996,19.1,20,13,7,10,3,2,20,10,18,20,3,17,13,33,8,1,"https://fbref.com/en/players/e5a35ae9/Luca-Waldschmidt"
2019,"Frosinone","Serie A","Joaquín Ardaiz","URU","FW","19",1999,0.2,0,0,0,0,0,0,0,NA,0,0,0,0,0,0,0,0,"https://fbref.com/en/players/eb823875/Joaquin-Ardaiz"
2019,"Frosinone","Serie A","Lorenzo Ariaudo","ITA","DF","29",1989,18.7,20,14,15,4,1,6,10,60,4,31,20,11,14,34,103,0,"https://fbref.com/en/players/68b78c2a/Lorenzo-Ariaudo"
2019,"Frosinone","Serie A","Francesco Bardi","ITA","GK","26",1992,3,0,0,0,0,0,0,0,NA,0,0,0,0,0,0,2,0,"https://fbref.com/en/players/0acda699/Francesco-Bardi"
2019,"Frosinone","Serie A","Andrea Beghetto","ITA","DF","23",1994,24.7,26,14,13,10,3,15,25,60,10,20,4,16,17,43,59,0,"https://fbref.com/en/players/438dfc6a/Andrea-Beghetto"
2019,"Frosinone","Serie A","Nicolò Brighenti","ITA","DF","28",1989,11,27,17,9,15,3,6,14,42.9,8,17,8,9,31,58,37,0,"https://fbref.com/en/players/54c356b0/Nicolo-Brighenti"
2019,"Frosinone","Serie A","Joel Campbell","CRC","FW,MF","26",1992,9.9,15,10,5,8,2,3,17,17.6,14,2,0,2,3,18,2,1,"https://fbref.com/en/players/895ff3ca/Joel-Campbell"
2019,"Frosinone","Serie A","Marco Capuano","ITA","DF","26",1991,25.6,53,33,37,15,1,26,46,56.5,20,44,31,13,34,87,101,2,"https://fbref.com/en/players/616aea37/Marco-Capuano"
2019,"Frosinone","Serie A","Francesco Cassata","ITA","MF","21",1997,12.5,20,11,12,4,4,9,23,39.1,14,8,1,7,6,26,15,1,"https://fbref.com/en/players/96960855/Francesco-Cassata"
2019,"Frosinone","Serie A","Raman Chibsah","GHA","MF","25",1993,29.1,46,27,25,19,2,16,54,29.6,38,45,10,35,32,78,28,1,"https://fbref.com/en/players/aa5a409a/Raman-Chibsah"
2019,"Frosinone","Serie A","Camillo Ciano","ITA","FW,MF","28",1990,27.3,33,15,12,10,11,8,50,16,42,28,4,24,8,41,16,0,"https://fbref.com/en/players/2114abf9/Camillo-Ciano"
2019,"Frosinone","Serie A","Daniel Ciofani","ITA","FW","33",1985,18,8,6,2,5,1,3,7,42.9,4,4,0,4,3,11,9,0,"https://fbref.com/en/players/b09a3ecc/Daniel-Ciofani"
2019,"Frosinone","Serie A","Lorenzo Crisetig","ITA","MF","25",1993,5.6,14,11,4,8,2,6,15,40,9,8,3,5,12,26,12,0,"https://fbref.com/en/players/f54dfca8/Lorenzo-Crisetig"
2019,"Frosinone","Serie A","Federico Dionisi","ITA","FW,MF","31",1987,2.3,3,1,0,2,1,0,2,0,2,0,0,0,0,3,0,0,"https://fbref.com/en/players/a74d2999/Federico-Dionisi"
2019,"Frosinone","Serie A","Paolo Ghiglione","ITA","DF","21",1997,5.7,8,4,6,1,1,6,14,42.9,8,2,0,2,4,12,22,0,"https://fbref.com/en/players/71dc23da/Paolo-Ghiglione"
2019,"Frosinone","Serie A","Edoardo Goldaniga","ITA","DF","24",1993,29,43,28,34,7,2,19,32,59.4,13,29,16,13,57,100,119,0,"https://fbref.com/en/players/4b029b31/Edoardo-Goldaniga"
2019,"Frosinone","Serie A","Mirko Gori","ITA","MF","25",1993,3.7,16,13,7,9,0,5,16,31.3,11,2,0,2,4,20,9,0,"https://fbref.com/en/players/7d86864c/Mirko-Gori"
2019,"Frosinone","Serie A","Emil Hallfreðsson","ISL","MF","34",1984,4.4,10,6,5,4,1,0,9,0,9,4,1,3,2,12,3,0,"https://fbref.com/en/players/86015b20/Emil-Hallfredsson"
2019,"Frosinone","Serie A","Luka Krajnc","SVN","DF","23",1994,8.8,10,8,6,3,1,5,6,83.3,1,11,3,8,11,21,42,0,"https://fbref.com/en/players/2b71b88a/Luka-Krajnc"
2019,"Frosinone","Serie A","Raffaele Maiello","ITA","MF","27",1991,22.7,42,27,30,8,4,16,27,59.3,11,23,10,13,30,72,41,0,"https://fbref.com/en/players/02febfdc/Raffaele-Maiello"
2019,"Frosinone","Serie A","Luca Matarese","ITA","FW","20",1998,0.2,0,0,0,0,0,0,0,NA,0,0,0,0,0,0,0,0,"https://fbref.com/en/players/a6fc1a22/Luca-Matarese"
2019,"Frosinone","Serie A","Cristian Molinaro","ITA","DF,MF","35",1983,12.9,15,10,7,7,1,3,9,33.3,6,11,4,7,15,30,43,0,"https://fbref.com/en/players/1c8c5aed/Cristian-Molinaro"
2019,"Frosinone","Serie A","Luca Paganini","ITA","DF,MF","25",1993,12.5,25,13,8,13,4,8,23,34.8,15,19,4,15,19,44,17,1,"https://fbref.com/en/players/e5b98a70/Luca-Paganini"
2019,"Frosinone","Serie A","Stipe Perica","CRO","FW","23",1995,5.3,5,3,2,2,1,1,3,33.3,2,3,1,2,0,5,4,0,"https://fbref.com/en/players/269b4638/Stipe-Perica"
2019,"Frosinone","Serie A","Andrea Pinamonti","ITA","FW","19",1999,18.1,14,6,6,5,3,4,20,20,16,16,3,13,5,19,17,0,"https://fbref.com/en/players/08aa9cd1/Andrea-Pinamonti"
2019,"Frosinone","Serie A","Bartosz Salamon","POL","DF","27",1991,19.2,17,10,12,5,0,6,14,42.9,8,27,19,8,27,44,143,1,"https://fbref.com/en/players/9b30df1e/Bartosz-Salamon"
2019,"Frosinone","Serie A","Paolo Sammarco","ITA","MF","35",1983,6.1,16,7,7,6,3,6,9,66.7,3,5,0,5,3,19,1,2,"https://fbref.com/en/players/3c1e4e84/Paolo-Sammarco"
2019,"Frosinone","Serie A","Danilo Soddimo","ITA","MF,FW","30",1987,2.8,11,9,3,6,2,3,6,50,3,2,1,1,7,18,3,0,"https://fbref.com/en/players/098139eb/Danilo-Soddimo"
2019,"Frosinone","Serie A","Marco Sportiello","ITA","GK","26",1992,35,1,0,1,0,0,1,1,100,0,1,0,1,0,1,8,2,"https://fbref.com/en/players/ac4003af/Marco-Sportiello"
2019,"Frosinone","Serie A","Marcello Trotta","ITA","FW","25",1992,4.4,7,6,2,4,1,1,3,33.3,2,2,1,1,3,10,3,0,"https://fbref.com/en/players/acdad0aa/Marcello-Trotta"
2019,"Frosinone","Serie A","Luca Valzania","ITA","MF","22",1996,10,21,12,7,10,4,13,33,39.4,20,18,0,18,16,37,8,1,"https://fbref.com/en/players/2b28ba9f/Luca-Valzania"
2019,"Frosinone","Serie A","Federico Viviani","ITA","MF","26",1992,3.7,6,5,2,3,1,3,8,37.5,5,6,3,3,8,14,2,0,"https://fbref.com/en/players/2258c078/Federico-Viviani"
2019,"Frosinone","Serie A","Rai Vloet","NED","MF","23",1995,1.4,4,2,1,2,1,0,3,0,3,4,0,4,0,4,1,0,"https://fbref.com/en/players/b32e8c5f/Rai-Vloet"
2019,"Frosinone","Serie A","Francesco Zampano","ITA","DF,MF","24",1993,23.4,35,25,23,9,3,15,31,48.4,16,24,4,20,13,48,48,0,"https://fbref.com/en/players/8e45910b/Francesco-Zampano"
2019,"Fulham","Premier League","Floyd Ayité","TOG","FW,MF","29",1988,5.3,4,4,2,1,1,2,6,33.3,4,8,1,7,7,11,5,0,"https://fbref.com/en/players/fd5888a0/Floyd-Ayite"
2019,"Fulham","Premier League","Ryan Babel","NED","FW,MF","31",1986,13.9,8,4,1,5,2,3,9,33.3,6,12,0,12,6,14,13,1,"https://fbref.com/en/players/6438d426/Ryan-Babel"
2019,"Fulham","Premier League","Marcus Bettinelli","ENG","GK","26",1992,7,0,0,0,0,0,0,0,NA,0,0,0,0,0,0,5,0,"https://fbref.com/en/players/0d85a4e8/Marcus-Bettinelli"
2019,"Fulham","Premier League","Joe Bryan","ENG","DF,MF","24",1993,26.1,61,41,35,21,5,24,42,57.1,18,34,12,22,31,92,82,1,"https://fbref.com/en/players/af69e7f0/Joe-Bryan"
2019,"Fulham","Premier League","Tom Cairney","SCO","MF,FW","27",1991,24.4,37,21,9,22,6,12,16,75,4,21,5,16,10,47,13,1,"https://fbref.com/en/players/a8748947/Tom-Cairney"
2019,"Fulham","Premier League","Calum Chambers","ENG","MF,DF","23",1995,28.8,64,36,32,27,5,16,48,33.3,32,37,12,25,69,133,113,4,"https://fbref.com/en/players/dc6f5bdd/Calum-Chambers"
2019,"Fulham","Premier League","Cyrus Christie","IRL","DF,MF","25",1992,21.6,43,23,26,13,4,18,41,43.9,23,25,11,14,29,72,96,1,"https://fbref.com/en/players/7eb67dad/Cyrus-Christie"
2019,"Fulham","Premier League","Ibrahima Cissé","GUI","MF","24",1994,1,0,0,0,0,0,0,1,0,1,0,0,0,3,3,4,0,"https://fbref.com/en/players/be4fede9/Ibrahima-Cisse"
2019,"Fulham","Premier League","Harvey Elliott","ENG","MF","15",2003,0.2,0,0,0,0,0,0,0,NA,0,1,0,1,0,0,0,0,"https://fbref.com/en/players/c8387671/Harvey-Elliott"
2019,"Fulham","Premier League","Fabricio","ESP","GK","30",1987,2,1,1,1,0,0,0,0,NA,0,0,0,0,0,1,3,2,"https://fbref.com/en/players/af245161/Fabricio"
2019,"Fulham","Premier League","Timothy Fosu-Mensah","NED","DF","20",1998,8.8,18,7,12,6,0,8,13,61.5,5,11,5,6,12,30,30,1,"https://fbref.com/en/players/a9142dc3/Timothy-Fosu-Mensah"
2019,"Fulham","Premier League","Stefan Johansen","NOR","MF","27",1991,4.6,11,3,4,7,0,5,8,62.5,3,5,0,5,3,14,6,0,"https://fbref.com/en/players/a48da055/Stefan-Johansen"
2019,"Fulham","Premier League","Aboubakar Kamara","MTN","FW","23",1995,7.7,8,4,1,5,2,3,7,42.9,4,6,0,6,1,9,6,0,"https://fbref.com/en/players/4047c976/Aboubakar-Kamara"
2019,"Fulham","Premier League","Neeskens Kebano","COD","FW,MF","26",1992,1.2,3,1,2,1,0,1,1,100,0,3,0,3,0,3,3,0,"https://fbref.com/en/players/18b999f4/Neeskens-Kebano"
2019,"Fulham","Premier League","Maxime Le Marchand","FRA","DF","28",1989,25,56,36,45,11,0,23,47,48.9,24,30,16,14,54,110,129,2,"https://fbref.com/en/players/321a71a7/Maxime-Le-Marchand"
2019,"Fulham","Premier League","Lazar Marković","SRB","MF","24",1994,0.5,0,0,0,0,0,0,0,NA,0,0,0,0,0,0,2,0,"https://fbref.com/en/players/723ba189/Lazar-Markovic"
2019,"Fulham","Premier League","Alfie Mawson","ENG","DF","24",1994,12.6,11,7,7,4,0,6,10,60,4,20,17,3,19,30,64,1,"https://fbref.com/en/players/d368feb8/Alfie-Mawson"
2019,"Fulham","Premier League","Kevin McDonald","SCO","MF","29",1988,9.3,15,11,6,8,1,5,13,38.5,8,8,2,6,9,24,22,0,"https://fbref.com/en/players/71a08f97/Kevin-McDonald"
2019,"Fulham","Premier League","Aleksandar Mitrović","SRB","FW","23",1994,36.4,19,9,3,13,3,5,15,33.3,10,22,8,14,6,25,53,0,"https://fbref.com/en/players/3925dbd6/Aleksandar-Mitrovic"
2019,"Fulham","Premier League","Håvard Nordtveit","NOR","DF","28",1990,4,9,4,8,1,0,4,5,80,1,3,3,0,8,17,15,1,"https://fbref.com/en/players/6cafd68d/Havard-Nordtveit"
2019,"Fulham","Premier League","Denis Odoi","GHA","DF","30",1988,28.8,48,34,29,16,3,21,33,63.6,12,45,24,21,42,90,153,0,"https://fbref.com/en/players/f7750aa0/Denis-Odoi"
2019,"Fulham","Premier League","Tim Ream","USA","DF","30",1987,22.7,23,14,16,7,0,14,28,50,14,19,10,9,25,48,80,2,"https://fbref.com/en/players/28b40c9c/Tim-Ream"
2019,"Fulham","Premier League","Sergio Rico","ESP","GK","24",1993,29,1,1,1,0,0,1,1,100,0,0,0,0,1,2,13,5,"https://fbref.com/en/players/5f0241b2/Sergio-Rico"
2019,"Fulham","Premier League","André Schürrle","GER","FW,MF","27",1990,18.2,30,19,14,10,6,12,42,28.6,30,16,1,15,8,38,17,1,"https://fbref.com/en/players/ecbb3fdf/Andre-Schurrle"
2019,"Fulham","Premier League","Jean Seri","CIV","MF","27",1991,24.9,41,28,20,20,1,13,45,28.9,32,40,9,31,32,73,17,4,"https://fbref.com/en/players/10efd0e1/Jean-Seri"
2019,"Fulham","Premier League","Ryan Sessegnon","ENG","FW,DF","18",2000,25.6,22,14,8,8,6,6,22,27.3,16,25,2,23,19,41,49,1,"https://fbref.com/en/players/6aa3e78b/Ryan-Sessegnon"
2019,"Fulham","Premier League","Luciano Vietto","ARG","FW,MF","24",1993,11,15,11,5,5,5,4,19,21.1,15,9,0,9,6,21,5,0,"https://fbref.com/en/players/2513a588/Luciano-Vietto"
2019,"Fulham","Premier League","Andre-Frank Zambo Anguissa","CMR","MF","22",1995,16.9,48,29,23,20,5,18,52,34.6,34,25,6,19,34,82,32,0,"https://fbref.com/en/players/6bb2c084/Andre-Frank-Zambo-Anguissa"
2019,"Genoa","Serie A","Daniel Bessa","ITA","MF","25",1993,27.1,60,35,28,23,9,11,39,28.2,28,30,4,26,19,79,16,1,"https://fbref.com/en/players/88895312/Daniel-Bessa"
2019,"Genoa","Serie A","Davide Biraschi","ITA","DF","24",1994,31.6,58,38,37,19,2,25,42,59.5,17,32,13,19,64,122,107,1,"https://fbref.com/en/players/64cd167d/Davide-Biraschi"
2019,"Genoa","Serie A","Domenico Criscito","ITA","DF","31",1986,34.1,111,75,64,36,11,57,83,68.7,26,40,11,29,70,181,142,0,"https://fbref.com/en/players/35dd6d80/Domenico-Criscito"
2019,"Genoa","Serie A","Nicola Dalmonte","ITA","FW,MF","20",1997,0.5,2,2,0,2,0,0,0,NA,0,0,0,0,0,2,0,0,"https://fbref.com/en/players/59a3efba/Nicola-Dalmonte"
2019,"Genoa","Serie A","Andrea Favilli","ITA","FW,DF","21",1997,1.9,1,1,0,0,1,0,1,0,1,1,0,1,0,1,1,0,"https://fbref.com/en/players/44510fde/Andrea-Favilli"
2019,"Genoa","Serie A","Koray Günter","GER","DF","23",1994,9.3,18,13,13,3,2,9,16,56.3,7,9,7,2,18,36,34,0,"https://fbref.com/en/players/f1f1f238/Koray-Gunter"
2019,"Genoa","Serie A","Oscar Hiljemark","SWE","MF","26",1992,13.3,16,9,8,7,1,5,16,31.3,11,13,3,10,13,29,14,0,"https://fbref.com/en/players/98e958af/Oscar-Hiljemark"
2019,"Genoa","Serie A","Jandrei","BRA","GK","25",1993,1,0,0,0,0,0,0,1,0,1,0,0,0,0,0,0,0,"https://fbref.com/en/players/85ea4399/Jandrei"
2019,"Genoa","Serie A","Christian Kouamé","CIV","FW","20",1997,34.1,31,22,8,16,7,2,13,15.4,11,23,3,20,25,56,28,0,"https://fbref.com/en/players/58e933d2/Christian-Kouame"
2019,"Genoa","Serie A","Gianluca Lapadula","PER","FW","28",1990,4.5,2,1,2,0,0,1,5,20,4,2,0,2,1,3,2,0,"https://fbref.com/en/players/2ead2809/Gianluca-Lapadula"
2019,"Genoa","Serie A","Darko Lazović","SRB","DF,FW","27",1990,28.2,28,17,13,8,7,14,31,45.2,17,21,6,15,20,48,33,0,"https://fbref.com/en/players/5128bde4/Darko-Lazovic"
2019,"Genoa","Serie A","Lukas Lerager","DEN","MF","25",1993,12.5,34,18,12,20,2,13,42,31,29,11,1,10,18,52,12,0,"https://fbref.com/en/players/1b82f8df/Lukas-Lerager"
2019,"Genoa","Serie A","Federico Marchetti","ITA","GK","35",1983,4,0,0,0,0,0,0,0,NA,0,0,0,0,0,0,1,0,"https://fbref.com/en/players/f794b426/Federico-Marchetti"
2019,"Genoa","Serie A","Luca Mazzitelli","ITA","MF","22",1995,3.6,5,2,3,1,1,2,3,66.7,1,4,1,3,6,11,7,0,"https://fbref.com/en/players/dc61b402/Luca-Mazzitelli"
2019,"Genoa","Serie A","Iuri Medeiros","POR","MF,FW","24",1994,1.2,2,2,0,1,1,1,2,50,1,2,0,2,0,2,1,0,"https://fbref.com/en/players/97e2aa67/Iuri-Medeiros"
2019,"Genoa","Serie A","Stephane Omeonga","BEL","MF","22",1996,0.6,1,1,1,0,0,0,1,0,1,1,0,1,0,1,2,0,"https://fbref.com/en/players/72c803a0/Stephane-Omeonga"
2019,"Genoa","Serie A","Goran Pandev","MKD","FW,MF","35",1983,12.5,14,10,0,10,4,2,8,25,6,7,0,7,1,15,3,0,"https://fbref.com/en/players/d711d04f/Goran-Pandev"
2019,"Genoa","Serie A","Pedro Pereira","POR","DF,FW","20",1998,15.4,20,14,15,2,3,11,19,57.9,8,10,5,5,14,34,55,1,"https://fbref.com/en/players/c77be0cf/Pedro-Pereira"
2019,"Genoa","Serie A","Giuseppe Pezzella","ITA","DF,MF","20",1997,1.2,2,1,1,1,0,0,0,NA,0,1,0,1,1,3,4,0,"https://fbref.com/en/players/149c5f5d/Giuseppe-Pezzella"
2019,"Genoa","Serie A","Krzysztof Piątek","POL","FW","23",1995,17.7,9,4,2,5,2,1,15,6.7,14,18,3,15,3,12,19,0,"https://fbref.com/en/players/17f3620a/Krzysztof-Piatek"
2019,"Genoa","Serie A","Ivan Radovanović","SRB","MF","29",1988,14.2,20,12,11,8,1,8,17,47.1,9,12,4,8,13,33,20,1,"https://fbref.com/en/players/023937a9/Ivan-Radovanovic"
2019,"Genoa","Serie A","Ionuț Radu","ROU","GK","21",1997,33,0,0,0,0,0,0,1,0,1,0,0,0,1,1,11,4,"https://fbref.com/en/players/67f649be/Ionut-Radu"
2019,"Genoa","Serie A","Esteban Rolón","ARG","MF","23",1995,11.6,46,29,14,20,12,20,44,45.5,24,18,2,16,16,62,12,0,"https://fbref.com/en/players/10e25802/Esteban-Rolon"
2019,"Genoa","Serie A","Cristian Romero","ARG","DF","20",1998,26,61,35,38,18,5,27,40,67.5,13,49,27,22,37,98,128,1,"https://fbref.com/en/players/a3d94a58/Cristian-Romero"
2019,"Genoa","Serie A","Rômulo","ITA","MF,FW","31",1987,15,26,18,9,10,7,7,17,41.2,10,16,3,13,18,44,20,0,"https://fbref.com/en/players/07abb358/Romulo"
2019,"Genoa","Serie A","Antonio Sanabria","PAR","FW","22",1996,8.5,6,3,1,1,4,0,1,0,1,8,0,8,4,10,3,0,"https://fbref.com/en/players/0a447501/Antonio-Sanabria"
2019,"Genoa","Serie A","Sandro","BRA","MF","29",1989,7.9,27,17,12,11,4,9,17,52.9,8,9,4,5,20,47,25,0,"https://fbref.com/en/players/c1c2c925/Sandro"
2019,"Genoa","Serie A","Nicolás Spolli","ARG","DF","35",1983,6,7,6,3,4,0,0,2,0,2,8,6,2,7,14,39,1,"https://fbref.com/en/players/9a560ebe/Nicolas-Spolli"
2019,"Genoa","Serie A","Stefano Sturaro","ITA","MF,FW","25",1993,2.4,4,3,0,3,1,2,9,22.2,7,3,1,2,3,7,2,0,"https://fbref.com/en/players/2334478a/Stefano-Sturaro"
2019,"Genoa","Serie A","Miguel Veloso","POR","MF","32",1986,14,31,20,14,13,4,9,26,34.6,17,12,1,11,13,44,21,0,"https://fbref.com/en/players/ab1ca213/Miguel-Veloso"
2019,"Genoa","Serie A","Ervin Zukanović","BIH","DF","31",1987,21.8,28,16,20,7,1,17,30,56.7,13,17,9,8,19,47,96,0,"https://fbref.com/en/players/1253a12e/Ervin-Zukanovic"
2019,"Getafe","La Liga","Iván Alejo","ESP","MF","23",1995,1.6,2,0,0,2,0,0,4,0,4,2,0,2,0,2,3,0,"https://fbref.com/en/players/3d7e48ce/Ivan-Alejo"
2019,"Getafe","La Liga","Amath","SEN","MF","22",1996,11.1,20,13,7,11,2,6,27,22.2,21,17,0,17,10,30,12,0,"https://fbref.com/en/players/f3b1d9a2/Amath"
2019,"Getafe","La Liga","Vitorino Antunes","POR","DF,MF","31",1987,24.2,41,26,22,17,2,27,45,60,18,33,7,26,43,84,75,1,"https://fbref.com/en/players/3e4f735d/Vitorino-Antunes"
2019,"Getafe","La Liga","Mauro Arambarri","URU","MF","22",1995,29.7,59,33,18,37,4,23,76,30.3,53,44,9,35,30,89,36,0,"https://fbref.com/en/players/58afe001/Mauro-Arambarri"
2019,"Getafe","La Liga","Markel Bergara","ESP","MF","32",1986,0.6,2,2,0,1,1,2,3,66.7,1,3,0,3,1,3,2,0,"https://fbref.com/en/players/04a65a8f/Markel-Bergara"
2019,"Getafe","La Liga","Leandro Cabrera","URU","DF","27",1991,31,47,26,28,17,2,24,41,58.5,17,29,16,13,52,99,216,2,"https://fbref.com/en/players/69cbc8b6/Leandro-Cabrera"
2019,"Getafe","La Liga","Leandro Chichizola","ARG","GK","28",1990,1,0,0,0,0,0,0,0,NA,0,0,0,0,0,0,1,0,"https://fbref.com/en/players/8d957256/Leandro-Chichizola"
2019,"Getafe","La Liga","Sebastián Cristóforo","URU","MF","24",1993,5,15,8,4,8,3,5,14,35.7,9,13,0,13,8,23,5,0,"https://fbref.com/en/players/3c05c659/Sebastian-Cristoforo"
2019,"Getafe","La Liga","Djené","TOG","DF","26",1991,33.1,54,34,43,11,0,26,43,60.5,17,27,11,16,74,128,154,3,"https://fbref.com/en/players/a4971d84/Djene"
2019,"Getafe","La Liga","Hugo Duro","ESP","MF,FW","18",1999,4.6,6,4,1,2,3,3,6,50,3,6,1,5,3,9,4,0,"https://fbref.com/en/players/37e103f8/Hugo-Duro"
2019,"Getafe","La Liga","Mathieu Flamini","FRA","MF","34",1984,5,9,4,4,4,1,4,7,57.1,3,3,1,2,5,14,4,0,"https://fbref.com/en/players/148d4105/Mathieu-Flamini"
2019,"Getafe","La Liga","Dimitri Foulquier","FRA","MF,DF","25",1993,20,29,12,10,14,5,11,22,50,11,23,2,21,20,49,38,0,"https://fbref.com/en/players/45e17712/Dimitri-Foulquier"
2019,"Getafe","La Liga","Bruno González","ESP","DF","28",1990,18.9,23,10,14,8,1,9,18,50,9,13,6,7,22,45,110,0,"https://fbref.com/en/players/f11fe861/Bruno-Gonzalez"
2019,"Getafe","La Liga","Sergi Guardiola","ESP","MF,FW","27",1991,0.3,1,1,0,1,0,0,0,NA,0,0,0,0,0,1,0,0,"https://fbref.com/en/players/32974271/Sergi-Guardiola"
2019,"Getafe","La Liga","Robert Ibáñez","ESP","MF","25",1993,0.8,2,2,1,1,0,0,1,0,1,3,0,3,0,2,0,0,"https://fbref.com/en/players/c7429db3/Robert-Ibanez"
2019,"Getafe","La Liga","Nemanja Maksimović","SRB","MF","23",1995,35.7,77,45,21,51,5,21,61,34.4,40,60,15,45,71,148,33,0,"https://fbref.com/en/players/00b28772/Nemanja-Maksimovic"
2019,"Getafe","La Liga","Jaime Mata","ESP","FW,MF","29",1988,27,30,21,8,14,8,7,26,26.9,19,14,0,14,17,47,27,0,"https://fbref.com/en/players/02319ad7/Jaime-Mata"
2019,"Getafe","La Liga","Ignasi Miquel","ESP","DF","25",1992,3.5,1,0,0,1,0,1,2,50,1,4,4,0,5,6,25,0,"https://fbref.com/en/players/174f09a6/Ignasi-Miquel"
2019,"Getafe","La Liga","Jorge Molina","ESP","FW","36",1982,29.4,12,9,1,4,7,2,15,13.3,13,22,0,22,7,19,26,1,"https://fbref.com/en/players/43f71e77/Jorge-Molina"
2019,"Getafe","La Liga","Mathías Olivera","URU","DF,MF","20",1997,11.2,24,17,11,8,5,10,18,55.6,8,25,2,23,10,34,22,0,"https://fbref.com/en/players/41c12f75/Mathias-Olivera"
2019,"Getafe","La Liga","Francisco Portillo","ESP","MF","28",1990,22.2,26,16,6,15,5,9,29,31,20,14,0,14,17,43,9,0,"https://fbref.com/en/players/8e010ff4/Francisco-Portillo"
2019,"Getafe","La Liga","Ángel Rodríguez","ESP","FW","31",1987,20.2,16,7,1,6,9,6,26,23.1,20,15,1,14,8,24,8,0,"https://fbref.com/en/players/8cfc2f69/Angel-Rodriguez"
2019,"Getafe","La Liga","Samuel Sáiz","ESP","MF","27",1991,3.4,4,3,0,3,1,2,5,40,3,1,0,1,0,4,2,0,"https://fbref.com/en/players/13e0eb29/Samuel-Saiz"
2019,"Getafe","La Liga","Gaku Shibasaki","JPN","MF,FW","26",1992,4.3,7,3,2,4,1,3,6,50,3,2,0,2,3,10,4,0,"https://fbref.com/en/players/d2ac648c/Gaku-Shibasaki"
2019,"Getafe","La Liga","David Soria","ESP","GK","25",1993,37,1,0,1,0,0,1,2,50,1,2,0,2,1,2,15,6,"https://fbref.com/en/players/8f8c6934/David-Soria"
2019,"Getafe","La Liga","Damián Suárez","URU","DF","30",1988,36,96,62,43,41,12,53,120,44.2,67,47,6,41,46,142,57,2,"https://fbref.com/en/players/ba5004e1/Damian-Suarez"
2019,"Girona","La Liga","Aday","ESP","DF,MF","30",1987,7.2,9,8,2,5,2,6,7,85.7,1,1,0,1,7,16,17,1,"https://fbref.com/en/players/5890cef1/Aday"
2019,"Girona","La Liga","Pedro Alcalá","ESP","DF","29",1989,20.8,32,23,23,9,0,15,23,65.2,8,21,18,3,36,68,120,0,"https://fbref.com/en/players/ba71d071/Pedro-Alcala"
2019,"Girona","La Liga","Yassine Bounou","MAR","GK","27",1991,31.8,0,0,0,0,0,0,2,0,2,0,0,0,1,1,7,2,"https://fbref.com/en/players/f6798fc3/Yassine-Bounou"
2019,"Girona","La Liga","Seydou Doumbia","CIV","FW","30",1987,6,5,1,1,2,2,0,2,0,2,2,0,2,3,8,1,0,"https://fbref.com/en/players/c49afee6/Seydou-Doumbia"
2019,"Girona","La Liga","Bernardo Espinosa","COL","DF","29",1989,30.3,20,14,16,4,0,8,17,47.1,9,46,31,15,40,60,197,5,"https://fbref.com/en/players/4242011c/Bernardo-Espinosa"
2019,"Girona","La Liga","Aleix García","ESP","MF","21",1997,18.5,37,19,17,20,0,13,36,36.1,23,21,6,15,21,58,18,0,"https://fbref.com/en/players/a10361d2/Aleix-Garcia"
2019,"Girona","La Liga","Borja García","ESP","MF,FW","27",1990,29.2,39,27,17,15,7,22,44,50,22,23,2,21,38,77,17,0,"https://fbref.com/en/players/e7f4603c/Borja-Garcia"
2019,"Girona","La Liga","Raúl García","ESP","DF","29",1989,9.4,21,12,11,7,3,11,16,68.8,5,14,4,10,11,32,35,1,"https://fbref.com/en/players/1a317a1b/Raul-Garcia"
2019,"Girona","La Liga","Álex Granell","ESP","MF,DF","29",1988,26.6,64,28,30,31,3,34,83,41,49,34,5,29,35,99,36,1,"https://fbref.com/en/players/a25250f8/Alex-Granell"
2019,"Girona","La Liga","Gorka Iraizoz","ESP","GK","37",1981,6.2,1,0,1,0,0,1,1,100,0,0,0,0,1,2,7,0,"https://fbref.com/en/players/26f2473f/Gorka-Iraizoz"
2019,"Girona","La Liga","Juanpe","ESP","DF","27",1991,30.7,48,25,32,15,1,24,45,53.3,21,31,15,16,57,105,138,0,"https://fbref.com/en/players/1633fc8a/Juanpe"
2019,"Girona","La Liga","Anthony Lozano","HON","FW,MF","25",1993,8.1,6,5,3,3,0,0,6,0,6,7,1,6,0,6,6,0,"https://fbref.com/en/players/38699c72/Anthony-Lozano"
2019,"Girona","La Liga","Douglas Luiz","BRA","MF","20",1998,16.6,34,19,13,20,1,9,38,23.7,29,19,7,12,21,55,26,0,"https://fbref.com/en/players/6f7d826d/Douglas-Luiz"
2019,"Girona","La Liga","Johan Mojica","COL","FW,MF","25",1992,0.2,1,1,1,0,0,0,0,NA,0,0,0,0,0,1,0,0,"https://fbref.com/en/players/608f2092/Johan-Mojica"
2019,"Girona","La Liga","Marc Muniesa","ESP","DF,MF","26",1992,15.6,49,34,27,17,5,15,28,53.6,13,18,6,12,37,86,49,1,"https://fbref.com/en/players/4db76f57/Marc-Muniesa"
2019,"Girona","La Liga","Carles Planas","ESP","DF","27",1991,4.7,12,6,7,5,0,4,11,36.4,7,2,0,2,4,16,15,0,"https://fbref.com/en/players/72b92c4e/Carles-Planas"
2019,"Girona","La Liga","Pere Pons","ESP","MF","25",1993,31,83,46,34,38,11,30,82,36.6,52,48,12,36,35,118,39,0,"https://fbref.com/en/players/29b61deb/Pere-Pons"
2019,"Girona","La Liga","Pedro Porro","ESP","DF","18",1999,24.6,51,31,28,16,7,32,80,40,48,36,2,34,39,90,60,1,"https://fbref.com/en/players/27d0a506/Pedro-Porro"
2019,"Girona","La Liga","Portu","ESP","FW,MF","26",1992,31.3,33,24,8,15,10,12,43,27.9,31,16,1,15,8,41,5,0,"https://fbref.com/en/players/1bda5842/Portu"
2019,"Girona","La Liga","Jonás Ramalho","ESP","DF","25",1993,18,13,6,12,1,0,8,14,57.1,6,24,11,13,16,29,80,1,"https://fbref.com/en/players/be3a0121/Jonas-Ramalho"
2019,"Girona","La Liga","Patrick Roberts","ENG","MF,FW","21",1997,6.7,7,6,5,2,0,3,15,20,12,5,0,5,3,10,2,1,"https://fbref.com/en/players/59d93937/Patrick-Roberts"
2019,"Girona","La Liga","Paik Seung-ho","KOR","FW,MF","21",1997,0.7,0,0,0,0,0,0,1,0,1,1,0,1,3,3,1,0,"https://fbref.com/en/players/1e1bea09/Paik-Seung-ho"
2019,"Girona","La Liga","Kévin Soni","CMR","FW,DF","20",1998,0.9,3,2,0,2,1,2,4,50,2,3,0,3,1,4,0,0,"https://fbref.com/en/players/6435143e/Kevin-Soni"
2019,"Girona","La Liga","Cristhian Stuani","URU","FW","31",1986,30.3,23,13,7,13,3,5,20,25,15,13,1,12,4,27,39,0,"https://fbref.com/en/players/220c11f1/Cristhian-Stuani"
2019,"Girona","La Liga","David Timor","ESP","MF","28",1989,1.8,2,2,1,1,0,0,1,0,1,1,1,0,3,5,3,0,"https://fbref.com/en/players/174651c8/David-Timor"
2019,"Girona","La Liga","Valery","ESP","DF,FW","18",1999,9.9,20,15,13,6,1,10,17,58.8,7,15,1,14,8,28,10,0,"https://fbref.com/en/players/4acd733a/Valery"
2019,"Guingamp","Ligue 1","Nicolas Benezet","FRA","MF,FW","27",1991,18.5,32,19,14,15,3,5,19,26.3,14,12,0,12,19,51,4,0,"https://fbref.com/en/players/30395d3b/Nicolas-Benezet"
2019,"Guingamp","Ligue 1","Ludovic Blas","FRA","MF,FW","20",1997,26.4,62,38,22,32,8,20,43,46.5,23,44,7,37,26,88,14,0,"https://fbref.com/en/players/6191093d/Ludovic-Blas"
2019,"Guingamp","Ligue 1","Marc-Aurèle Caillard","FRA","GK","24",1994,21,0,0,0,0,0,0,2,0,2,0,0,0,2,2,8,3,"https://fbref.com/en/players/5ee6e943/Marc-Aurele-Caillard"
2019,"Guingamp","Ligue 1","Louis Carnot","FRA","MF","17",2001,0.1,0,0,0,0,0,0,0,NA,0,0,0,0,0,0,0,0,"https://fbref.com/en/players/2384dbed/Louis-Carnot"
2019,"Guingamp","Ligue 1","Marcus Coco","FRA","FW,MF","22",1996,20.4,39,23,20,10,9,16,33,48.5,17,24,0,24,23,62,14,0,"https://fbref.com/en/players/3010aefb/Marcus-Coco"
2019,"Guingamp","Ligue 1","Lucas Deaux","FRA","MF","29",1988,13.2,41,28,21,18,2,20,41,48.8,21,10,0,10,11,52,7,0,"https://fbref.com/en/players/44f8c299/Lucas-Deaux"
2019,"Guingamp","Ligue 1","Étienne Didot","FRA","MF","35",1983,23.4,41,29,12,27,2,17,44,38.6,27,37,10,27,37,78,35,0,"https://fbref.com/en/players/d2aa8ac0/Etienne-Didot"
2019,"Guingamp","Ligue 1","Papy Djilobodji","SEN","DF","29",1988,1.9,1,1,1,0,0,0,0,NA,0,4,2,2,0,1,11,0,"https://fbref.com/en/players/083525e5/Papy-Djilobodji"
2019,"Guingamp","Ligue 1","Félix Eboa Eboa","CMR","DF","21",1997,27,47,33,26,20,1,16,22,72.7,6,37,24,13,39,86,136,2,"https://fbref.com/en/players/167d5018/Felix-Eboa-Eboa"
2019,"Guingamp","Ligue 1","Guessouma Fofana","MTN","MF","25",1992,5.3,14,9,2,10,2,4,10,40,6,3,0,3,6,20,8,0,"https://fbref.com/en/players/9dafff2a/Guessouma-Fofana"
2019,"Guingamp","Ligue 1","Didier Ibrahim Ndong","GAB","MF","24",1994,8.3,16,11,3,13,0,5,13,38.5,8,15,3,12,15,31,6,1,"https://fbref.com/en/players/885b7aa7/Didier-Ibrahim-Ndong"
2019,"Guingamp","Ligue 1","Jordan Ikoko","COD","DF","24",1994,19,37,24,22,14,1,16,28,57.1,12,18,5,13,24,61,30,0,"https://fbref.com/en/players/8ff4872e/Jordan-Ikoko"
2019,"Guingamp","Ligue 1","Karl-Johan Johnsson","SWE","GK","28",1990,17,0,0,0,0,0,0,1,0,1,0,0,0,0,0,4,1,"https://fbref.com/en/players/a56bd2ee/Karl-Johan-Johnsson"
2019,"Guingamp","Ligue 1","Nathaël Julan","FRA","FW,MF","22",1996,4.8,1,0,0,0,1,0,3,0,3,6,1,5,0,1,2,0,"https://fbref.com/en/players/39901146/Nathael-Julan"
2019,"Guingamp","Ligue 1","Christophe Kerbrat","FRA","DF","31",1986,23.3,40,24,28,12,0,24,38,63.2,14,19,10,9,50,90,140,5,"https://fbref.com/en/players/0515a4cb/Christophe-Kerbrat"
2019,"Guingamp","Ligue 1","Djégui Koita","FRA","DF","18",1999,1.9,8,6,8,0,0,3,4,75,1,5,3,2,0,8,9,0,"https://fbref.com/en/players/b1adaefa/Djegui-Koita"
2019,"Guingamp","Ligue 1","Johan Larsson","SWE","DF","28",1990,1,1,1,0,1,0,1,2,50,1,0,0,0,1,2,1,1,"https://fbref.com/en/players/fe006f82/Johan-Larsson"
2019,"Guingamp","Ligue 1","Alexandre Mendy","GNB","FW","24",1994,8.5,5,3,0,4,1,3,8,37.5,5,3,0,3,1,6,6,0,"https://fbref.com/en/players/e067808c/Alexandre-Mendy"
2019,"Guingamp","Ligue 1","Mehdi Merghem","FRA","FW,MF","21",1997,8,25,18,15,7,3,11,21,52.4,10,14,1,13,9,34,6,0,"https://fbref.com/en/players/49000148/Mehdi-Merghem"
2019,"Guingamp","Ligue 1","Yeni Ngbakoto","COD","MF,FW","26",1992,6.3,9,4,4,3,2,4,8,50,4,7,0,7,4,13,2,0,"https://fbref.com/en/players/813aae2f/Yeni-Ngbakoto"
2019,"Guingamp","Ligue 1","Matthias Phaeton","GLP","FW,MF","18",2000,0.6,1,1,0,1,0,0,0,NA,0,0,0,0,0,1,0,0,"https://fbref.com/en/players/42c8ede1/Matthias-Phaeton"
2019,"Guingamp","Ligue 1","Lebogang Phiri","RSA","MF","23",1994,21.4,60,38,16,41,3,24,43,55.8,19,26,3,23,29,89,19,0,"https://fbref.com/en/players/b6dac747/Lebogang-Phiri"
2019,"Guingamp","Ligue 1","Pedro Rebocho","POR","DF","23",1995,36,61,35,31,22,8,29,54,53.7,25,48,13,35,40,101,92,1,"https://fbref.com/en/players/276cce2e/Pedro-Rebocho"
2019,"Guingamp","Ligue 1","Ronny Rodelin","FRA","MF,FW","28",1989,8.8,13,5,2,7,4,3,8,37.5,5,8,1,7,8,21,13,0,"https://fbref.com/en/players/1f8c7aa9/Ronny-Rodelin"
2019,"Guingamp","Ligue 1","Nolan Roux","FRA","FW","30",1988,17.1,11,9,0,6,5,4,14,28.6,10,6,2,4,4,15,21,0,"https://fbref.com/en/players/3071a619/Nolan-Roux"
2019,"Guingamp","Ligue 1","Yannis Salibur","FRA","MF","27",1991,0.2,0,0,0,0,0,0,0,NA,0,0,0,0,0,0,0,0,"https://fbref.com/en/players/bb4a42be/Yannis-Salibur"
2019,"Guingamp","Ligue 1","Jérémy Sorbon","FRA","DF","34",1983,29.4,33,20,23,10,0,14,22,63.6,8,33,23,10,34,67,105,2,"https://fbref.com/en/players/7768df30/Jeremy-Sorbon"
2019,"Guingamp","Ligue 1","Franck Tabanou","FRA","DF","29",1989,2,4,3,4,0,0,1,2,50,1,0,0,0,6,10,15,0,"https://fbref.com/en/players/15e1afd5/Franck-Tabanou"
2019,"Guingamp","Ligue 1","Marcus Thuram","FRA","FW,MF","20",1997,28.6,45,28,23,15,7,20,43,46.5,23,24,1,23,10,55,14,0,"https://fbref.com/en/players/6f8cd6d0/Marcus-Thuram"
2019,"Guingamp","Ligue 1","Cheick Traoré","MLI","DF","23",1995,16.8,37,21,23,11,3,15,25,60,10,13,3,10,23,60,46,1,"https://fbref.com/en/players/bfcef334/Cheick-Traore"
2019,"Hannover 96","Bundesliga","Kevin Akpoguma","NGA","DF","23",1995,3.5,10,6,5,5,0,6,7,85.7,1,7,2,5,10,20,7,2,"https://fbref.com/en/players/6ec6fde0/Kevin-Akpoguma"
2019,"Hannover 96","Bundesliga","Miiko Albornoz","CHI","DF,MF","27",1990,18.4,46,26,31,10,5,21,45,46.7,24,23,3,20,16,62,37,1,"https://fbref.com/en/players/d459281d/Miiko-Albornoz"
2019,"Hannover 96","Bundesliga","Waldemar Anton","GER","DF","22",1996,34,49,32,33,14,2,22,50,44,28,56,33,23,69,118,169,3,"https://fbref.com/en/players/5e66fa06/Waldemar-Anton"
2019,"Hannover 96","Bundesliga","Takuma Asano","JPN","MF,FW","23",1994,7.8,5,3,1,1,3,1,6,16.7,5,9,0,9,2,7,2,0,"https://fbref.com/en/players/13ddc856/Takuma-Asano"
2019,"Hannover 96","Bundesliga","Marvin Bakalorz","GER","MF","28",1989,16.3,18,11,7,9,2,6,36,16.7,30,29,4,25,28,46,47,0,"https://fbref.com/en/players/04c11885/Marvin-Bakalorz"
2019,"Hannover 96","Bundesliga","Noah Joel Sarenren Bazee","NGA","FW,MF","21",1996,1.7,0,0,0,0,0,0,0,NA,0,1,0,1,0,0,3,0,"https://fbref.com/en/players/fbbc8e15/Noah-Joel-Sarenren-Bazee"
2019,"Hannover 96","Bundesliga","Ihlas Bebou","TOG","MF,FW","24",1994,11.8,15,9,4,10,1,4,9,44.4,5,18,2,16,9,24,9,0,"https://fbref.com/en/players/a53b661f/Ihlas-Bebou"
2019,"Hannover 96","Bundesliga","Uffe Bech","DEN","FW","25",1993,0.2,0,0,0,0,0,0,1,0,1,0,0,0,0,0,0,0,"https://fbref.com/en/players/f7097e8a/Uffe-Bech"
2019,"Hannover 96","Bundesliga","Tim Dierßen","GER","MF","22",1996,0.2,0,0,0,0,0,0,0,NA,0,1,0,1,0,0,0,0,"https://fbref.com/en/players/96f8ab0c/Tim-Dierssen"
2019,"Hannover 96","Bundesliga","Josip Elez","CRO","DF","24",1994,7.2,8,3,5,3,0,2,11,18.2,9,13,4,9,6,14,27,0,"https://fbref.com/en/players/eafac393/Josip-Elez"
2019,"Hannover 96","Bundesliga","Michael Esser","GER","GK","30",1987,32,3,2,3,0,0,2,5,40,3,1,0,1,1,4,15,0,"https://fbref.com/en/players/83e0eeb4/Michael-Esser"
2019,"Hannover 96","Bundesliga","Felipe","BRA","DF","31",1987,12.2,23,15,21,2,0,9,17,52.9,8,17,9,8,35,58,71,0,"https://fbref.com/en/players/de164de6/Felipe"
2019,"Hannover 96","Bundesliga","Iver Fossum","NOR","MF","22",1996,5.1,9,5,1,7,1,4,8,50,4,8,2,6,7,16,10,0,"https://fbref.com/en/players/ce218223/Iver-Fossum"
2019,"Hannover 96","Bundesliga","Niclas Füllkrug","GER","FW","25",1993,12.4,3,0,0,1,2,1,5,20,4,10,4,6,1,4,17,0,"https://fbref.com/en/players/4f16405e/Niclas-Fullkrug"
2019,"Hannover 96","Bundesliga","Benjamin Hadžić","BIH","FW,MF","19",1999,0.3,0,0,0,0,0,0,1,0,1,0,0,0,0,0,0,0,"https://fbref.com/en/players/f765bb88/Benjamin-Hadzic"
2019,"Hannover 96","Bundesliga","Genki Haraguchi","JPN","MF,DF","27",1991,23.7,44,26,21,20,3,17,66,25.8,49,34,5,29,21,65,33,0,"https://fbref.com/en/players/f24ea523/Genki-Haraguchi"
2019,"Hannover 96","Bundesliga","Jonathas","BRA","FW","29",1989,6.7,7,4,3,4,0,3,10,30,7,9,1,8,3,10,4,0,"https://fbref.com/en/players/531807b3/Jonathas"
2019,"Hannover 96","Bundesliga","Julian Korb","GER","DF","26",1992,11.2,26,17,16,9,1,10,29,34.5,19,27,4,23,23,49,34,1,"https://fbref.com/en/players/3dffff26/Julian-Korb"
2019,"Hannover 96","Bundesliga","Linton Maina","GER","FW,MF","19",1999,15.7,28,14,13,10,5,12,23,52.2,11,20,0,20,14,42,4,0,"https://fbref.com/en/players/e5d85da8/Linton-Maina"
2019,"Hannover 96","Bundesliga","Nicolai Müller","GER","MF,FW","30",1987,10,18,9,7,7,4,8,27,29.6,19,9,1,8,1,19,7,0,"https://fbref.com/en/players/5e1df051/Nicolai-Muller"
2019,"Hannover 96","Bundesliga","Florent Muslija","KVX","MF,FW","20",1998,7.5,16,10,8,6,2,8,12,66.7,4,4,0,4,3,19,4,0,"https://fbref.com/en/players/ae961785/Florent-Muslija"
2019,"Hannover 96","Bundesliga","Matthias Ostrzolek","GER","DF","28",1990,16.3,32,18,24,8,0,20,33,60.6,13,20,5,15,26,58,44,2,"https://fbref.com/en/players/1cd87320/Matthias-Ostrzolek"
2019,"Hannover 96","Bundesliga","Edgar Prib","GER","MF","28",1989,2.2,10,9,3,5,2,2,4,50,2,4,0,4,2,12,1,0,"https://fbref.com/en/players/420ff5a3/Edgar-Prib"
2019,"Hannover 96","Bundesliga","Samuel Şahin-Radlinger","AUT","GK","25",1992,1,0,0,0,0,0,0,0,NA,0,1,0,1,0,0,2,0,"https://fbref.com/en/players/e385200c/Samuel-Sahin-Radlinger"
2019,"Hannover 96","Bundesliga","Pirmin Schwegler","SUI","MF","31",1987,23.1,63,34,30,29,4,34,60,56.7,26,21,5,16,41,104,54,0,"https://fbref.com/en/players/5528407e/Pirmin-Schwegler"
2019,"Hannover 96","Bundesliga","Oliver Sorg","GER","DF","28",1990,17.6,42,28,26,16,0,20,43,46.5,23,16,9,7,46,88,47,0,"https://fbref.com/en/players/541cdd20/Oliver-Sorg"
2019,"Hannover 96","Bundesliga","Sebastian Soto","USA","MF,FW","18",2000,0.3,0,0,0,0,0,0,0,NA,0,0,0,0,0,0,0,0,"https://fbref.com/en/players/00c3d4dc/Sebastian-Soto"
2019,"Hannover 96","Bundesliga","Philipp Tschauner","GER","GK","32",1985,1,0,0,0,0,0,0,0,NA,0,0,0,0,0,0,0,0,"https://fbref.com/en/players/73e2f6eb/Philipp-Tschauner"
2019,"Hannover 96","Bundesliga","Walace","BRA","MF","23",1995,22.2,52,22,17,28,7,27,61,44.3,34,30,4,26,45,97,36,1,"https://fbref.com/en/players/26db8853/Walace"
2019,"Hannover 96","Bundesliga","Hendrik Weydandt","GER","FW","23",1995,19.1,18,12,7,8,3,3,24,12.5,21,14,4,10,5,23,44,0,"https://fbref.com/en/players/773968e4/Hendrik-Weydandt"
2019,"Hannover 96","Bundesliga","Kevin Wimmer","AUT","DF","25",1992,18.7,25,17,17,6,2,15,27,55.6,12,30,23,7,41,66,63,0,"https://fbref.com/en/players/faf55ce4/Kevin-Wimmer"
2019,"Hannover 96","Bundesliga","Bobby Wood","USA","FW,MF","25",1992,13.1,13,10,2,10,1,5,8,62.5,3,2,0,2,4,17,6,0,"https://fbref.com/en/players/9853983f/Bobby-Wood"
2019,"Hertha BSC","Bundesliga","Florian Baak","GER","MF","19",1999,0,0,0,0,0,0,0,0,NA,0,0,0,0,0,0,0,0,"https://fbref.com/en/players/150d5992/Florian-Baak"
2019,"Hertha BSC","Bundesliga","Per Ciljan Skjelbred","NOR","MF","31",1987,11.1,26,18,13,12,1,5,22,22.7,17,10,1,9,20,46,14,0,"https://fbref.com/en/players/ecab64a0/Per-Ciljan-Skjelbred"
2019,"Hertha BSC","Bundesliga","Palkó Dárdai","HUN","FW,MF","19",1999,1.3,1,1,1,0,0,0,0,NA,0,1,0,1,0,1,0,0,"https://fbref.com/en/players/db7161ed/Palko-Dardai"
2019,"Hertha BSC","Bundesliga","Vladimír Darida","CZE","MF","27",1990,4.2,8,5,3,4,1,2,3,66.7,1,5,0,5,8,16,5,0,"https://fbref.com/en/players/3eb0f2df/Vladimir-Darida"
2019,"Hertha BSC","Bundesliga","Javairô Dilrosun","NED","FW,MF","20",1998,10,14,10,7,5,2,3,7,42.9,4,18,2,16,7,21,9,0,"https://fbref.com/en/players/34a0f5ff/Javairo-Dilrosun"
2019,"Hertha BSC","Bundesliga","Ondrej Duda","SVK","MF","23",1994,28.5,54,33,13,35,6,15,55,27.3,40,36,4,32,15,69,17,1,"https://fbref.com/en/players/79ca3e23/Ondrej-Duda"
2019,"Hertha BSC","Bundesliga","Marko Grujić","SRB","MF","22",1996,19.8,45,33,17,20,8,13,38,34.2,25,29,6,23,29,74,51,1,"https://fbref.com/en/players/8b8e759d/Marko-Grujic"
2019,"Hertha BSC","Bundesliga","Vedad Ibišević","BIH","FW","33",1984,20.1,12,8,2,5,5,0,10,0,10,10,4,6,3,15,20,0,"https://fbref.com/en/players/c3fd9887/Vedad-Ibisevic"
2019,"Hertha BSC","Bundesliga","Rune Jarstein","NOR","GK","33",1984,30.5,0,0,0,0,0,0,0,NA,0,0,0,0,1,1,8,1,"https://fbref.com/en/players/27d2618c/Rune-Jarstein"
2019,"Hertha BSC","Bundesliga","Dennis Jastrzembski","POL","FW,DF","18",2000,0.7,0,0,0,0,0,0,3,0,3,0,0,0,1,1,0,0,"https://fbref.com/en/players/6bba916f/Dennis-Jastrzembski"
2019,"Hertha BSC","Bundesliga","Salomon Kalou","CIV","FW,MF","32",1985,25.7,21,12,5,11,5,6,24,25,18,23,1,22,6,27,25,0,"https://fbref.com/en/players/2042d931/Salomon-Kalou"
2019,"Hertha BSC","Bundesliga","Lukas Klünter","GER","DF","22",1996,6.6,11,8,6,5,0,4,5,80,1,6,2,4,12,23,20,0,"https://fbref.com/en/players/92948149/Lukas-Klunter"
2019,"Hertha BSC","Bundesliga","Pascal Köpke","GER","FW,MF","22",1995,0.8,1,0,1,0,0,1,2,50,1,0,0,0,0,1,0,0,"https://fbref.com/en/players/3861d9cc/Pascal-Kopke"
2019,"Hertha BSC","Bundesliga","Thomas Kraft","GER","GK","30",1988,3.5,0,0,0,0,0,0,0,NA,0,0,0,0,0,0,1,1,"https://fbref.com/en/players/bb25c778/Thomas-Kraft"
2019,"Hertha BSC","Bundesliga","Valentino Lazaro","AUT","DF,FW","22",1996,30.5,46,31,23,17,6,21,53,39.6,32,52,12,40,44,90,65,0,"https://fbref.com/en/players/016ff750/Valentino-Lazaro"
2019,"Hertha BSC","Bundesliga","Mathew Leckie","AUS","FW,MF","27",1991,10.5,20,13,5,10,5,7,16,43.8,9,10,1,9,13,33,16,0,"https://fbref.com/en/players/b93b7882/Mathew-Leckie"
2019,"Hertha BSC","Bundesliga","Derrick Luckassen","NED","DF","23",1995,2.8,4,2,4,0,0,1,3,33.3,2,1,0,1,0,4,13,0,"https://fbref.com/en/players/30a09cb5/Derrick-Luckassen"
2019,"Hertha BSC","Bundesliga","Fabian Lustenberger","SUI","DF,MF","30",1988,24.1,45,30,23,21,1,15,33,45.5,18,39,18,21,39,84,108,2,"https://fbref.com/en/players/a63a995f/Fabian-Lustenberger"
2019,"Hertha BSC","Bundesliga","Arne Maier","GER","MF","19",1999,22.9,31,16,12,19,0,6,25,24,19,32,9,23,28,59,35,0,"https://fbref.com/en/players/ab700320/Arne-Maier"
2019,"Hertha BSC","Bundesliga","Maximilian Mittelstädt","GER","DF,MF","21",1997,20,61,37,33,23,5,23,49,46.9,26,32,4,28,46,107,64,0,"https://fbref.com/en/players/88d4144a/Maximilian-Mittelstadt"
2019,"Hertha BSC","Bundesliga","Peter Pekarík","SVK","DF","31",1986,2.4,2,1,1,1,0,1,3,33.3,2,2,1,1,1,3,5,0,"https://fbref.com/en/players/c18d22f5/Peter-Pekarik"
2019,"Hertha BSC","Bundesliga","Marvin Plattenhardt","GER","DF","26",1992,21.4,27,21,12,10,5,14,21,66.7,7,18,3,15,7,34,56,0,"https://fbref.com/en/players/f7aa75bd/Marvin-Plattenhardt"
2019,"Hertha BSC","Bundesliga","Karim Rekik","NED","DF","23",1994,23,36,22,23,12,1,12,18,66.7,6,24,16,8,34,70,88,0,"https://fbref.com/en/players/3376a776/Karim-Rekik"
2019,"Hertha BSC","Bundesliga","Davie Selke","GER","FW","23",1995,19.3,5,2,1,4,0,2,9,22.2,7,11,0,11,1,6,7,0,"https://fbref.com/en/players/1238a3f9/Davie-Selke"
2019,"Hertha BSC","Bundesliga","Niklas Stark","GER","DF","23",1995,20.8,34,19,23,11,0,9,24,37.5,15,45,26,19,37,71,141,1,"https://fbref.com/en/players/aad48be9/Niklas-Stark"
2019,"Hertha BSC","Bundesliga","Jordan Torunarigha","GER","DF","20",1997,12.9,34,30,23,10,1,18,28,64.3,10,19,7,12,29,63,55,0,"https://fbref.com/en/players/f86cabbd/Jordan-Torunarigha"
2019,"Hoffenheim","Bundesliga","Kevin Akpoguma","NGA","DF","23",1995,5.5,23,15,13,10,0,11,21,52.4,10,18,5,13,12,35,20,2,"https://fbref.com/en/players/6ec6fde0/Kevin-Akpoguma"
2019,"Hoffenheim","Bundesliga","Alfons Amade","GER","MF","18",1999,0.1,1,1,0,1,0,1,2,50,1,0,0,0,1,2,0,0,"https://fbref.com/en/players/d73a07e2/Alfons-Amade"
2019,"Hoffenheim","Bundesliga","Nadiem Amiri","GER","MF","21",1996,8.4,14,9,8,4,2,3,13,23.1,10,11,0,11,7,21,4,0,"https://fbref.com/en/players/555d5edd/Nadiem-Amiri"
2019,"Hoffenheim","Bundesliga","Oliver Baumann","GER","GK","28",1990,33,0,0,0,0,0,0,0,NA,0,0,0,0,2,2,11,5,"https://fbref.com/en/players/47064058/Oliver-Baumann"
2019,"Hoffenheim","Bundesliga","Christoph Baumgartner","AUT","MF","18",1999,0.9,1,0,0,0,1,1,3,33.3,2,2,0,2,0,1,0,0,"https://fbref.com/en/players/437f2b00/Christoph-Baumgartner"
2019,"Hoffenheim","Bundesliga","Ishak Belfodil","ALG","FW,MF","26",1992,20.7,13,10,5,6,2,4,16,25,12,6,0,6,3,16,14,0,"https://fbref.com/en/players/ff182fdc/Ishak-Belfodil"
2019,"Hoffenheim","Bundesliga","Ermin Bičakčić","BIH","DF","28",1990,19.9,32,19,18,11,3,13,22,59.1,9,36,15,21,56,88,79,1,"https://fbref.com/en/players/7aac47fe/Ermin-Bicakcic"
2019,"Hoffenheim","Bundesliga","Leonardo Bittencourt","GER","MF","24",1993,11.9,37,26,9,22,6,8,32,25,24,22,1,21,13,50,7,0,"https://fbref.com/en/players/dc62fbee/Leonardo-Bittencourt"
2019,"Hoffenheim","Bundesliga","Joshua Brenet","NED","DF","24",1994,10.1,20,13,12,5,3,7,13,53.8,6,16,1,15,8,28,19,0,"https://fbref.com/en/players/2b5527c4/Joshua-Brenet"
2019,"Hoffenheim","Bundesliga","Kerem Demirbay","GER","MF","25",1993,22.4,57,35,20,27,10,11,51,21.6,40,34,10,24,22,79,25,0,"https://fbref.com/en/players/54b4dc4e/Kerem-Demirbay"
2019,"Hoffenheim","Bundesliga","Dennis Geiger","GER","MF","20",1998,2.7,2,1,1,1,0,1,6,16.7,5,1,0,1,3,5,1,0,"https://fbref.com/en/players/37f606f0/Dennis-Geiger"
2019,"Hoffenheim","Bundesliga","Vincenzo Grifo","ITA","MF,FW","25",1993,3.7,6,3,2,3,1,0,5,0,5,2,1,1,2,8,5,0,"https://fbref.com/en/players/54e4866f/Vincenzo-Grifo"
2019,"Hoffenheim","Bundesliga","Florian Grillitsch","AUT","MF","22",1995,26.6,77,49,30,38,9,36,80,45,44,34,8,26,72,149,56,1,"https://fbref.com/en/players/ffbbc83b/Florian-Grillitsch"
2019,"Hoffenheim","Bundesliga","Justin Hoogma","NED","DF,MF","20",1998,1.2,4,2,2,1,1,2,2,100,0,3,1,2,2,6,1,0,"https://fbref.com/en/players/816192f0/Justin-Hoogma"
2019,"Hoffenheim","Bundesliga","Benjamin Hübner","GER","DF","29",1989,9,29,18,18,9,2,14,18,77.8,4,16,7,9,21,50,35,0,"https://fbref.com/en/players/99de6b6f/Benjamin-Hubner"
2019,"Hoffenheim","Bundesliga","Joelinton","BRA","FW,MF","21",1996,23.7,35,22,9,20,6,10,30,33.3,20,36,3,33,14,49,8,0,"https://fbref.com/en/players/c17bfb65/Joelinton"
2019,"Hoffenheim","Bundesliga","Pavel Kadeřábek","CZE","DF","26",1992,27.9,30,19,12,13,5,11,24,45.8,13,37,10,27,34,64,71,1,"https://fbref.com/en/players/79c90e45/Pavel-Kaderabek"
2019,"Hoffenheim","Bundesliga","Gregor Kobel","SUI","GK","20",1997,1,0,0,0,0,0,0,0,NA,0,0,0,0,0,0,0,0,"https://fbref.com/en/players/cd59b9df/Gregor-Kobel"
2019,"Hoffenheim","Bundesliga","Andrej Kramarić","CRO","MF,FW","27",1991,26.6,9,4,1,5,3,4,26,15.4,22,15,3,12,8,17,13,0,"https://fbref.com/en/players/603cb947/Andrej-Kramaric"
2019,"Hoffenheim","Bundesliga","Reiss Nelson","ENG","MF,FW","18",1999,7.1,17,10,8,4,5,2,13,15.4,11,12,1,11,5,22,2,0,"https://fbref.com/en/players/c5bdb6e3/Reiss-Nelson"
2019,"Hoffenheim","Bundesliga","Håvard Nordtveit","NOR","MF,DF","28",1990,5.2,8,5,2,4,2,3,7,42.9,4,8,5,3,4,12,14,0,"https://fbref.com/en/players/6cafd68d/Havard-Nordtveit"
2019,"Hoffenheim","Bundesliga","Kasim Nuhu","GHA","DF","23",1995,10,19,11,14,3,2,10,23,43.5,13,11,5,6,23,42,44,0,"https://fbref.com/en/players/93a50d2c/Kasim-Nuhu"
2019,"Hoffenheim","Bundesliga","David Otto","GER","MF,FW","19",1999,0.3,2,1,1,1,0,0,1,0,1,0,0,0,0,2,0,0,"https://fbref.com/en/players/676ff98c/David-Otto"
2019,"Hoffenheim","Bundesliga","Stefan Posch","AUT","DF","21",1997,15.6,45,32,28,15,2,17,28,60.7,11,26,11,15,21,66,58,0,"https://fbref.com/en/players/7f609bfc/Stefan-Posch"
2019,"Hoffenheim","Bundesliga","Lukas Rupp","GER","MF,DF","27",1991,0.3,1,1,0,0,1,0,0,NA,0,0,0,0,0,1,0,0,"https://fbref.com/en/players/3faa1780/Lukas-Rupp"
2019,"Hoffenheim","Bundesliga","Nico Schulz","GER","DF","25",1993,28.2,34,20,19,12,3,15,36,41.7,21,32,4,28,24,58,36,0,"https://fbref.com/en/players/fa274d97/Nico-Schulz"
2019,"Hoffenheim","Bundesliga","Ádám Szalai","HUN","FW","30",1987,18.1,19,13,3,12,4,4,11,36.4,7,8,1,7,4,23,8,0,"https://fbref.com/en/players/53e07d0b/Adam-Szalai"
2019,"Hoffenheim","Bundesliga","Kevin Vogt","GER","DF","26",1991,26.6,24,15,20,4,0,12,32,37.5,20,28,11,17,33,57,103,3,"https://fbref.com/en/players/1d8e9add/Kevin-Vogt"
2019,"Hoffenheim","Bundesliga","Steven Zuber","SUI","MF,FW","26",1991,6.3,12,9,5,6,1,6,13,46.2,7,5,1,4,5,17,4,0,"https://fbref.com/en/players/b6a6e0a7/Steven-Zuber"
2019,"Huddersfield","Premier League","Juninho Bacuna","CUW","MF,DF","20",1997,15.7,46,29,22,19,5,22,54,40.7,32,21,1,20,24,70,12,1,"https://fbref.com/en/players/aaf1bf05/Juninho-Bacuna"
2019,"Huddersfield","Premier League","Philip Billing","DEN","MF","22",1996,24.3,73,44,26,39,8,19,42,45.2,23,57,16,41,53,126,43,0,"https://fbref.com/en/players/d328a254/Philip-Billing"
2019,"Huddersfield","Premier League","Joel Coleman","ENG","GK","22",1995,1,0,0,0,0,0,0,0,NA,0,0,0,0,0,0,0,0,"https://fbref.com/en/players/b73e459a/Joel-Coleman"
2019,"Huddersfield","Premier League","Matty Daly","ENG","MF","17",2001,0.8,0,0,0,0,0,0,0,NA,0,0,0,0,0,0,0,0,"https://fbref.com/en/players/03e48abb/Matty-Daly"
2019,"Huddersfield","Premier League","Laurent Depoitre","BEL","FW","29",1988,11.9,6,4,2,3,1,0,3,0,3,9,0,9,2,8,8,0,"https://fbref.com/en/players/aa5859cb/Laurent-Depoitre"
2019,"Huddersfield","Premier League","Adama Diakhaby","FRA","FW,MF","22",1996,6.1,6,3,4,1,1,3,11,27.3,8,7,0,7,1,7,2,0,"https://fbref.com/en/players/65585e3a/Adama-Diakhaby"
2019,"Huddersfield","Premier League","Demeaco Duhaney","ENG","DF","19",1998,0.5,1,0,1,0,0,1,3,33.3,2,2,0,2,1,2,1,0,"https://fbref.com/en/players/5ef608f7/Demeaco-Duhaney"
2019,"Huddersfield","Premier League","Erik Durm","GER","DF","26",1992,22.8,35,22,24,8,3,14,33,42.4,19,26,6,20,41,76,42,0,"https://fbref.com/en/players/cf623c78/Erik-Durm"
2019,"Huddersfield","Premier League","Jon Gorenc Stanković","SVN","MF,DF","22",1996,7.9,26,18,18,7,1,14,26,53.8,12,16,9,7,9,35,20,1,"https://fbref.com/en/players/9c74fa25/Jon-Gorenc-Stankovic"
2019,"Huddersfield","Premier League","Karlan Grant","ENG","FW","20",1997,9.7,5,2,1,2,2,1,3,33.3,2,8,0,8,2,7,1,1,"https://fbref.com/en/players/87f7500e/Karlan-Grant"
2019,"Huddersfield","Premier League","Florent Hadergjonaj","KVX","DF,MF","24",1994,20.5,30,17,10,18,2,13,37,35.1,24,21,7,14,21,51,37,1,"https://fbref.com/en/players/9aa186b2/Florent-Hadergjonaj"
2019,"Huddersfield","Premier League","Ben Hamer","ENG","GK","30",1987,6.1,0,0,0,0,0,0,3,0,3,0,0,0,1,1,3,2,"https://fbref.com/en/players/d822a850/Ben-Hamer"
2019,"Huddersfield","Premier League","Jonathan Hogg","ENG","MF","29",1988,26.3,78,41,18,51,9,27,69,39.1,42,46,7,39,73,151,19,1,"https://fbref.com/en/players/9306d5ea/Jonathan-Hogg"
2019,"Huddersfield","Premier League","Mathias Jørgensen","DEN","DF","28",1990,23.9,49,31,27,21,1,27,46,58.7,19,29,14,15,69,118,83,0,"https://fbref.com/en/players/0db5d2c8/Mathias-Jorgensen"
2019,"Huddersfield","Premier League","Elias Kachunga","COD","FW,MF","26",1992,13.1,22,9,8,12,2,9,25,36,16,16,1,15,4,26,10,0,"https://fbref.com/en/players/5bddccc9/Elias-Kachunga"
2019,"Huddersfield","Premier League","Terence Kongolo","NED","DF","24",1994,30.2,74,46,44,26,4,27,47,57.4,20,42,16,26,65,139,106,1,"https://fbref.com/en/players/1f9a3a04/Terence-Kongolo"
2019,"Huddersfield","Premier League","Rajiv van La Parra","NED","FW,MF","27",1991,4.5,8,5,1,7,0,1,6,16.7,5,0,0,0,4,12,3,1,"https://fbref.com/en/players/1931bde9/Rajiv-van-La-Parra"
2019,"Huddersfield","Premier League","Jonas Lössl","DEN","GK","29",1989,30.9,0,0,0,0,0,0,1,0,1,1,0,1,2,2,12,2,"https://fbref.com/en/players/939bc634/Jonas-Lossl"
2019,"Huddersfield","Premier League","Chris Löwe","GER","DF,MF","29",1989,22.9,34,18,17,15,2,12,33,36.4,21,21,3,18,23,57,56,0,"https://fbref.com/en/players/c6896eab/Chris-Lowe"
2019,"Huddersfield","Premier League","Isaac Mbenza","BEL","FW,MF","22",1996,11,10,9,5,5,0,2,4,50,2,4,0,4,5,15,4,0,"https://fbref.com/en/players/aa1a8c7e/Isaac-Mbenza"
2019,"Huddersfield","Premier League","Aaron Mooy","AUS","MF,FW","27",1990,25.9,62,42,19,27,16,21,52,40.4,31,43,7,36,14,76,22,0,"https://fbref.com/en/players/47b7e3af/Aaron-Mooy"
2019,"Huddersfield","Premier League","Steve Mounié","BEN","FW","23",1994,19.8,9,6,3,4,2,2,12,16.7,10,10,1,9,5,14,15,0,"https://fbref.com/en/players/19ba6c6d/Steve-Mounie"
2019,"Huddersfield","Premier League","Alex Pritchard","ENG","MF,FW","25",1993,23.1,36,24,10,18,8,10,35,28.6,25,26,2,24,17,53,9,0,"https://fbref.com/en/players/ff9fcd4d/Alex-Pritchard"
2019,"Huddersfield","Premier League","Jason Puncheon","ENG","MF","32",1986,4.2,7,4,1,5,1,1,7,14.3,6,3,1,2,3,10,8,0,"https://fbref.com/en/players/fd3f57ce/Jason-Puncheon"
2019,"Huddersfield","Premier League","Collin Quaner","GER","FW","27",1991,0.4,0,0,0,0,0,0,1,0,1,0,0,0,0,0,0,0,"https://fbref.com/en/players/19b8b0b9/Collin-Quaner"
2019,"Huddersfield","Premier League","Aaron Rowe","ENG","FW","17",2000,0.8,1,0,1,0,0,0,0,NA,0,0,0,0,1,2,1,0,"https://fbref.com/en/players/4b6bcb0d/Aaron-Rowe"
2019,"Huddersfield","Premier League","Abdelhamid Sabiri","MAR","FW","21",1996,0.5,2,1,1,1,0,0,0,NA,0,1,0,1,1,3,0,0,"https://fbref.com/en/players/4830e0af/Abdelhamid-Sabiri"
2019,"Huddersfield","Premier League","Christopher Schindler","GER","DF","28",1990,36.2,61,36,46,14,1,27,47,57.4,20,69,34,35,70,131,138,4,"https://fbref.com/en/players/8ae9869d/Christopher-Schindler"
2019,"Huddersfield","Premier League","Tommy Smith","ENG","DF","26",1992,12.7,26,13,14,11,1,10,25,40,15,12,4,8,18,44,25,0,"https://fbref.com/en/players/e9208654/Tommy-Smith"
2019,"Huddersfield","Premier League","Ramadan Sobhi","EGY","FW,MF","21",1997,0.9,1,1,0,1,0,0,0,NA,0,2,0,2,1,2,0,0,"https://fbref.com/en/players/98be0d02/Ramadan-Sobhi"
2019,"Huddersfield","Premier League","Danny Williams","USA","MF","29",1989,1.1,0,0,0,0,0,0,0,NA,0,4,1,3,1,1,2,0,"https://fbref.com/en/players/ec9a28ce/Danny-Williams"
2019,"Huesca","La Liga","Juan Aguilera","ESP","MF","32",1985,3.8,2,2,0,1,1,1,4,25,3,4,2,2,4,6,2,0,"https://fbref.com/en/players/18dc8533/Juan-Aguilera"
2019,"Huesca","La Liga","Carlos Akapo","EQG","DF","25",1993,11.4,28,15,18,8,2,19,33,57.6,14,12,2,10,23,51,36,0,"https://fbref.com/en/players/f2a68b97/Carlos-Akapo"
2019,"Huesca","La Liga","Ezequiel Ávila","ARG","FW,MF","24",1994,22.2,18,10,7,7,4,4,26,15.4,22,21,2,19,13,31,22,0,"https://fbref.com/en/players/253a06b9/Ezequiel-Avila"
2019,"Huesca","La Liga","Rajko Brežančić","SRB","DF","28",1989,0.7,1,0,0,0,1,0,0,NA,0,0,0,0,0,1,0,0,"https://fbref.com/en/players/1519a888/Rajko-Brezancic"
2019,"Huesca","La Liga","Juanjo Camacho","ESP","MF,DF","37",1980,0.4,1,1,1,0,0,1,1,100,0,0,0,0,0,1,1,0,"https://fbref.com/en/players/1a1609ab/Juanjo-Camacho"
2019,"Huesca","La Liga","Cucho","COL","FW","19",1999,23.9,22,13,6,10,6,6,18,33.3,12,23,2,21,9,31,21,0,"https://fbref.com/en/players/71b47ab9/Cucho"
2019,"Huesca","La Liga","Adrián Diéguez","ESP","DF","22",1996,8.3,16,10,11,4,1,9,16,56.3,7,9,4,5,12,28,46,1,"https://fbref.com/en/players/70438d35/Adrian-Dieguez"
2019,"Huesca","La Liga","Xabier Etxeita","ESP","DF","30",1987,29.7,47,23,32,12,3,26,47,55.3,21,38,25,13,39,86,163,3,"https://fbref.com/en/players/4a895384/Xabier-Etxeita"
2019,"Huesca","La Liga","David Ferreiro","ESP","MF,FW","30",1988,25.3,36,22,13,19,4,11,64,17.2,53,27,1,26,24,60,14,2,"https://fbref.com/en/players/8970907e/David-Ferreiro"
2019,"Huesca","La Liga","Javi Galán","ESP","DF,FW","23",1994,16,61,39,36,23,2,34,59,57.6,25,22,1,21,19,80,52,1,"https://fbref.com/en/players/a4b00319/Javi-Galan"
2019,"Huesca","La Liga","Álex Gallar","ESP","MF,FW","26",1992,11.2,15,9,6,5,4,8,19,42.1,11,9,1,8,9,24,5,0,"https://fbref.com/en/players/36d5469c/Alex-Gallar"
2019,"Huesca","La Liga","Enric Gallego","ESP","FW","31",1986,17.1,21,15,3,13,5,3,19,15.8,16,17,2,15,8,29,32,0,"https://fbref.com/en/players/82e9b89d/Enric-Gallego"
2019,"Huesca","La Liga","Moi Gómez","ESP","MF","24",1994,33.9,42,28,15,25,2,11,46,23.9,35,27,3,24,28,70,27,0,"https://fbref.com/en/players/5a626448/Moi-Gomez"
2019,"Huesca","La Liga","Serdar Gürler","TUR","MF,FW","26",1991,5.4,5,5,3,2,0,3,11,27.3,8,8,0,8,1,6,2,0,"https://fbref.com/en/players/8d2ad5c0/Serdar-Gurler"
2019,"Huesca","La Liga","Yangel Herrera","VEN","MF,DF","20",1998,12.8,48,24,18,25,5,23,43,53.5,20,13,1,12,14,62,32,0,"https://fbref.com/en/players/e778654a/Yangel-Herrera"
2019,"Huesca","La Liga","Pablo Insua","ESP","DF","24",1993,8.6,23,10,14,9,0,8,15,53.3,7,2,0,2,12,35,40,0,"https://fbref.com/en/players/4b5e7e90/Pablo-Insua"
2019,"Huesca","La Liga","Aleksandar Jovanović","SRB","GK","25",1992,12,0,0,0,0,0,0,0,NA,0,0,0,0,1,1,3,0,"https://fbref.com/en/players/129dd8e7/Aleksandar-Jovanovic"
2019,"Huesca","La Liga","Juanpi","VEN","MF,FW","24",1994,7.4,16,6,9,5,2,4,12,33.3,8,15,0,15,6,22,3,0,"https://fbref.com/en/players/d79afcfc/Juanpi"
2019,"Huesca","La Liga","Samuele Longo","ITA","FW","26",1992,6.2,4,3,2,2,0,0,6,0,6,4,0,4,1,5,7,0,"https://fbref.com/en/players/1163de29/Samuele-Longo"
2019,"Huesca","La Liga","Luisinho","POR","DF","33",1985,5.6,14,10,9,5,0,10,17,58.8,7,6,1,5,16,30,17,0,"https://fbref.com/en/players/a7f00c8c/Luisinho"
2019,"Huesca","La Liga","Martín Mantovani","ARG","DF","34",1984,7.8,15,9,12,3,0,6,11,54.5,5,4,3,1,22,37,48,0,"https://fbref.com/en/players/4ffb647d/Martin-Mantovani"
2019,"Huesca","La Liga","Gonzalo Melero","ESP","MF","24",1994,14.9,26,23,5,19,2,11,48,22.9,37,14,4,10,2,28,23,0,"https://fbref.com/en/players/3902e91b/Gonzalo-Melero"
2019,"Huesca","La Liga","Jorge Miramón","ESP","DF","29",1989,27.7,73,55,49,17,7,34,53,64.2,19,34,11,23,44,117,65,1,"https://fbref.com/en/players/7f4c7c9f/Jorge-Miramon"
2019,"Huesca","La Liga","Damián Musto","ARG","MF,DF","31",1987,18.7,52,34,22,27,3,16,33,48.5,17,30,11,19,34,86,54,1,"https://fbref.com/en/players/74e0a984/Damian-Musto"
2019,"Huesca","La Liga","Jorge Pulido","ESP","DF","27",1991,30.9,63,42,40,19,4,32,51,62.7,19,39,18,21,50,113,158,0,"https://fbref.com/en/players/978cd030/Jorge-Pulido"
2019,"Huesca","La Liga","Cristian Rivera","ESP","MF","21",1997,18.8,38,25,18,19,1,11,25,44,14,21,4,17,31,69,31,0,"https://fbref.com/en/players/8ef81d2d/Cristian-Rivera"
2019,"Huesca","La Liga","Roberto Santamaría","ESP","GK","33",1985,20,0,0,0,0,0,0,0,NA,0,0,0,0,1,1,12,1,"https://fbref.com/en/players/bca21ef3/Roberto-Santamaria"
2019,"Huesca","La Liga","Lluís Sastre","ESP","MF","32",1986,1.3,5,3,0,5,0,0,1,0,1,0,0,0,1,6,0,0,"https://fbref.com/en/players/5f186f5c/Lluis-Sastre"
2019,"Huesca","La Liga","Rúben Semedo","POR","DF","24",1994,9.4,20,16,14,6,0,12,16,75,4,15,9,6,16,36,35,2,"https://fbref.com/en/players/c904f3d5/Ruben-Semedo"
2019,"Huesca","La Liga","Axel Werner","ARG","GK","22",1996,6,0,0,0,0,0,0,0,NA,0,0,0,0,0,0,2,0,"https://fbref.com/en/players/c0b1a6da/Axel-Werner"
2019,"Inter","Serie A","Kwadwo Asamoah","GHA","DF","29",1988,29.7,44,26,22,14,8,29,51,56.9,22,21,4,17,40,84,46,1,"https://fbref.com/en/players/089550f5/Kwadwo-Asamoah"
2019,"Inter","Serie A","Keita Baldé","SEN","FW","23",1995,9.9,10,6,4,2,4,2,9,22.2,7,8,0,8,3,13,1,0,"https://fbref.com/en/players/509a4ccb/Keita-Balde"
2019,"Inter","Serie A","Marcelo Brozović","CRO","MF","25",1992,29.4,101,70,47,40,14,31,86,36,55,45,8,37,44,145,32,3,"https://fbref.com/en/players/33b8d077/Marcelo-Brozovic"
2019,"Inter","Serie A","Antonio Candreva","ITA","FW,MF","31",1987,5.6,1,1,0,1,0,1,8,12.5,7,0,0,0,4,5,9,0,"https://fbref.com/en/players/356c9002/Antonio-Candreva"
2019,"Inter","Serie A","Danilo D'Ambrosio","ITA","DF","29",1988,28.7,69,40,34,27,8,24,57,42.1,33,25,8,17,27,96,39,0,"https://fbref.com/en/players/44eb9093/Danilo-DAmbrosio"
2019,"Inter","Serie A","Roberto Gagliardini","ITA","MF","24",1994,12.1,23,14,13,8,2,10,27,37,17,21,3,18,16,39,19,0,"https://fbref.com/en/players/ce30bfc8/Roberto-Gagliardini"
2019,"Inter","Serie A","Samir Handanović","SVN","GK","34",1984,38,1,0,1,0,0,1,1,100,0,0,0,0,0,1,12,1,"https://fbref.com/en/players/74419746/Samir-Handanovic"
2019,"Inter","Serie A","Dalbert Henrique","BRA","DF","24",1993,8.6,33,24,18,14,1,12,21,57.1,9,9,3,6,8,41,20,0,"https://fbref.com/en/players/f45f9427/Dalbert-Henrique"
2019,"Inter","Serie A","Mauro Icardi","ARG","FW","25",1993,25.2,9,8,2,2,5,1,6,16.7,5,4,1,3,3,12,20,1,"https://fbref.com/en/players/43b78598/Mauro-Icardi"
2019,"Inter","Serie A","Yann Karamoh","FRA","FW,MF","20",1998,0.1,0,0,0,0,0,0,0,NA,0,0,0,0,0,0,0,0,"https://fbref.com/en/players/8b66d9cc/Yann-Karamoh"
2019,"Inter","Serie A","João Mário","POR","MF,FW","25",1993,12,28,16,9,15,4,9,31,29,22,14,0,14,6,34,4,1,"https://fbref.com/en/players/f0021247/Joao-Mario"
2019,"Inter","Serie A","Lautaro Martínez","ARG","FW,MF","20",1997,14.9,6,5,0,2,4,2,6,33.3,4,16,0,16,3,9,7,0,"https://fbref.com/en/players/f7036e1c/Lautaro-Martinez"
2019,"Inter","Serie A","Miranda","BRA","DF","33",1984,12.9,11,7,7,4,0,4,8,50,4,11,7,4,14,25,48,2,"https://fbref.com/en/players/314f2124/Miranda"
2019,"Inter","Serie A","Radja Nainggolan","BEL","MF","30",1988,21.9,35,26,7,20,8,10,24,41.7,14,17,2,15,8,43,5,0,"https://fbref.com/en/players/1f9328da/Radja-Nainggolan"
2019,"Inter","Serie A","Ivan Perišić","CRO","FW","29",1989,30,34,26,7,20,7,16,51,31.4,35,40,4,36,23,57,55,0,"https://fbref.com/en/players/6fe90922/Ivan-Perisic"
2019,"Inter","Serie A","Matteo Politano","ITA","FW","24",1993,28.3,18,7,9,4,5,8,30,26.7,22,18,0,18,14,32,10,1,"https://fbref.com/en/players/5e861944/Matteo-Politano"
2019,"Inter","Serie A","Andrea Ranocchia","ITA","DF,FW","30",1988,0.7,2,2,1,1,0,0,1,0,1,1,0,1,0,2,3,0,"https://fbref.com/en/players/539230cf/Andrea-Ranocchia"
2019,"Inter","Serie A","Milan Škriniar","SVK","DF","23",1995,35,64,37,46,17,1,38,60,63.3,22,48,29,19,27,91,138,0,"https://fbref.com/en/players/30f5ffa9/Milan-Skriniar"
2019,"Inter","Serie A","Cédric Soares","POR","DF","26",1991,2.9,8,6,2,4,2,4,7,57.1,3,4,1,3,2,10,3,0,"https://fbref.com/en/players/839c14e1/Cedric-Soares"
2019,"Inter","Serie A","Borja Valero","ESP","MF","33",1985,13.7,22,19,9,10,3,8,30,26.7,22,11,1,10,16,38,27,2,"https://fbref.com/en/players/0e21fc3c/Borja-Valero"
2019,"Inter","Serie A","Matías Vecino","URU","MF","26",1991,22.4,50,39,18,23,9,26,53,49.1,27,38,9,29,17,67,22,0,"https://fbref.com/en/players/44ac04e9/Matias-Vecino"
2019,"Inter","Serie A","Stefan de Vrij","NED","DF","26",1992,28,25,16,14,10,1,8,15,53.3,7,32,23,9,25,50,95,1,"https://fbref.com/en/players/d0d8dd44/Stefan-de-Vrij"
2019,"Inter","Serie A","Šime Vrsaljko","CRO","DF","26",1992,8.1,20,14,8,6,6,9,14,64.3,5,5,1,4,11,31,27,1,"https://fbref.com/en/players/46a8347f/Sime-Vrsaljko"
2019,"Juventus","Serie A","Andrea Barzagli","ITA","DF","37",1981,2.9,1,1,0,1,0,1,2,50,1,2,2,0,4,5,10,0,"https://fbref.com/en/players/7c0000fd/Andrea-Barzagli"
2019,"Juventus","Serie A","Medhi Benatia","MAR","DF","31",1987,5,7,6,6,1,0,3,5,60,2,10,5,5,16,23,18,0,"https://fbref.com/en/players/3b15ef2d/Medhi-Benatia"
2019,"Juventus","Serie A","Rodrigo Bentancur","URU","MF","21",1997,22.3,53,34,22,29,2,18,39,46.2,21,20,8,12,43,96,42,1,"https://fbref.com/en/players/3b8674e6/Rodrigo-Bentancur"
2019,"Juventus","Serie A","Federico Bernardeschi","ITA","MF,FW","24",1994,16.4,14,8,5,6,3,7,18,38.9,11,9,0,9,6,20,10,0,"https://fbref.com/en/players/ee93c1a9/Federico-Bernardeschi"
2019,"Juventus","Serie A","Leonardo Bonucci","ITA","DF","31",1987,27.5,18,9,11,6,1,10,13,76.9,3,32,21,11,38,56,88,3,"https://fbref.com/en/players/52ec54d0/Leonardo-Bonucci"
2019,"Juventus","Serie A","Martín Cáceres","URU","DF","31",1987,7,7,3,6,0,1,4,4,100,0,6,3,3,4,11,14,0,"https://fbref.com/en/players/e94d79e3/Martin-Caceres"
2019,"Juventus","Serie A","Emre Can","GER","MF","24",1994,20.1,64,38,28,27,9,24,40,60,16,43,13,30,28,92,36,2,"https://fbref.com/en/players/a65ce836/Emre-Can"
2019,"Juventus","Serie A","João Cancelo","POR","DF","24",1994,21.9,43,28,18,18,7,27,49,55.1,22,14,4,10,15,58,48,0,"https://fbref.com/en/players/bd6351cd/Joao-Cancelo"
2019,"Juventus","Serie A","Giorgio Chiellini","ITA","DF","33",1984,22.1,24,13,20,2,2,5,8,62.5,3,22,15,7,30,54,96,1,"https://fbref.com/en/players/e85fb9b8/Giorgio-Chiellini"
2019,"Juventus","Serie A","Douglas Costa","BRA","FW,MF","27",1990,6.9,10,8,2,8,0,4,9,44.4,5,8,0,8,4,14,2,0,"https://fbref.com/en/players/4fa7cb9b/Douglas-Costa"
2019,"Juventus","Serie A","Juan Cuadrado","COL","MF,DF","30",1988,13.6,20,15,6,9,5,5,23,21.7,18,14,3,11,18,38,11,0,"https://fbref.com/en/players/0ab1f153/Juan-Cuadrado"
2019,"Juventus","Serie A","Mattia De Sciglio","ITA","DF","25",1992,19.4,40,28,24,14,2,17,28,60.7,11,18,6,12,26,66,58,1,"https://fbref.com/en/players/ae4e2852/Mattia-De-Sciglio"
2019,"Juventus","Serie A","Paulo Dybala","ARG","FW,MF","24",1993,23.7,17,8,3,9,5,7,23,30.4,16,20,2,18,14,31,1,0,"https://fbref.com/en/players/e0921a4f/Paulo-Dybala"
2019,"Juventus","Serie A","Paolo Gozzi Iweru","ITA","DF","17",2001,1,3,2,2,1,0,0,0,NA,0,0,0,0,3,6,3,0,"https://fbref.com/en/players/94230890/Paolo-Gozzi-Iweru"
2019,"Juventus","Serie A","Grigoris Kastanos","CYP","MF","20",1998,0.7,3,1,3,0,0,0,0,NA,0,3,1,2,0,3,0,0,"https://fbref.com/en/players/2a82aa85/Grigoris-Kastanos"
2019,"Juventus","Serie A","Moise Kean","ITA","FW","18",2000,6,0,0,0,0,0,0,1,0,1,1,0,1,2,2,1,0,"https://fbref.com/en/players/3d50bcdb/Moise-Kean"
2019,"Juventus","Serie A","Sami Khedira","GER","MF","31",1987,7.8,10,9,6,2,2,5,9,55.6,4,8,3,5,5,15,6,0,"https://fbref.com/en/players/38ac43d3/Sami-Khedira"
2019,"Juventus","Serie A","Mario Mandžukić","CRO","FW","32",1986,22.4,34,25,13,15,6,9,18,50,9,17,5,12,13,47,22,0,"https://fbref.com/en/players/afa0d4e0/Mario-Mandzukic"
2019,"Juventus","Serie A","Blaise Matuidi","FRA","MF","31",1987,26.9,59,33,25,21,13,20,36,55.6,16,33,8,25,26,85,21,1,"https://fbref.com/en/players/c0cddebe/Blaise-Matuidi"
2019,"Juventus","Serie A","Stephy Mavididi","ENG","FW","20",1998,0.2,0,0,0,0,0,0,0,NA,0,1,0,1,0,0,0,0,"https://fbref.com/en/players/30144daa/Stephy-Mavididi"
2019,"Juventus","Serie A","Hans Nicolussi Caviglia","ITA","MF","18",2000,0.6,2,1,0,2,0,0,2,0,2,2,1,1,0,2,0,0,"https://fbref.com/en/players/b136c945/Hans-Nicolussi-Caviglia"
2019,"Juventus","Serie A","Mattia Perin","ITA","GK","25",1992,9,0,0,0,0,0,0,0,NA,0,0,0,0,0,0,3,2,"https://fbref.com/en/players/4c62d0c8/Mattia-Perin"
2019,"Juventus","Serie A","Carlo Pinsoglio","ITA","GK","28",1990,1,0,0,0,0,0,0,0,NA,0,0,0,0,0,0,0,0,"https://fbref.com/en/players/f6a06749/Carlo-Pinsoglio"
2019,"Juventus","Serie A","Miralem Pjanić","BIH","MF","28",1990,25.3,41,20,15,18,8,16,59,27.1,43,34,6,28,36,77,19,2,"https://fbref.com/en/players/ad6df2d5/Miralem-Pjanic"
2019,"Juventus","Serie A","Manolo Portanova","ITA","MF","18",2000,0.4,1,1,0,1,0,0,1,0,1,2,0,2,1,2,2,0,"https://fbref.com/en/players/c8c0dccd/Manolo-Portanova"
2019,"Juventus","Serie A","Cristiano Ronaldo","POR","FW","33",1985,29.9,10,7,5,4,1,1,11,9.1,10,7,2,5,6,16,32,0,"https://fbref.com/en/players/dea698d9/Cristiano-Ronaldo"
2019,"Juventus","Serie A","Daniele Rugani","ITA","DF","24",1994,15,8,5,5,3,0,2,5,40,3,19,14,5,16,24,51,1,"https://fbref.com/en/players/14b8fcdf/Daniele-Rugani"
2019,"Juventus","Serie A","Alex Sandro","BRA","DF","27",1991,26.5,68,45,28,33,7,21,36,58.3,15,32,8,24,38,106,71,0,"https://fbref.com/en/players/0d82903c/Alex-Sandro"
2019,"Juventus","Serie A","Matheus Pereira da Silva","BRA","MF","20",1998,1,3,2,0,2,1,2,4,50,2,1,0,1,0,3,1,0,"https://fbref.com/en/players/bef22bc4/Matheus-Pereira-da-Silva"
2019,"Juventus","Serie A","Leonardo Spinazzola","ITA","DF","25",1993,6.7,9,4,4,2,3,4,8,50,4,5,0,5,3,12,7,0,"https://fbref.com/en/players/3626daea/Leonardo-Spinazzola"
2019,"Juventus","Serie A","Wojciech Szczęsny","POL","GK","28",1990,28,2,1,2,0,0,1,1,100,0,0,0,0,1,3,8,2,"https://fbref.com/en/players/01b8a2b2/Wojciech-Szczesny"
2019,"Lazio","Serie A","Francesco Acerbi","ITA","DF","30",1988,36.8,40,30,22,13,5,12,16,75,4,50,32,18,61,101,169,1,"https://fbref.com/en/players/b96b595c/Francesco-Acerbi"
2019,"Lazio","Serie A","Luis Alberto","ESP","MF,FW","25",1992,22.1,53,22,15,29,9,21,55,38.2,34,23,3,20,10,63,10,0,"https://fbref.com/en/players/5294a83f/Luis-Alberto"
2019,"Lazio","Serie A","Nicolò Armini","ITA","DF","17",2001,0.4,1,1,0,1,0,1,2,50,1,1,0,1,0,1,0,0,"https://fbref.com/en/players/2f7407fa/Nicolo-Armini"
2019,"Lazio","Serie A","Milan Badelj","CRO","MF","29",1989,12.7,33,20,10,19,4,16,37,43.2,21,27,9,18,33,66,20,1,"https://fbref.com/en/players/e8c930bb/Milan-Badelj"
2019,"Lazio","Serie A","Bastos","ANG","DF","27",1991,12.7,22,17,16,4,2,17,27,63,10,16,8,8,7,29,49,1,"https://fbref.com/en/players/c01c66d9/Bastos"
2019,"Lazio","Serie A","Valon Berisha","KVX","MF,FW","25",1993,2.2,8,5,1,6,1,4,6,66.7,2,6,0,6,4,12,3,0,"https://fbref.com/en/players/d5575935/Valon-Berisha"
2019,"Lazio","Serie A","Martín Cáceres","URU","DF","31",1987,3.4,4,2,3,1,0,4,6,66.7,2,4,0,4,0,4,12,1,"https://fbref.com/en/players/e94d79e3/Martin-Caceres"
2019,"Lazio","Serie A","Felipe Caicedo","ECU","FW","29",1988,15.2,16,12,4,6,6,1,8,12.5,7,9,2,7,5,21,5,0,"https://fbref.com/en/players/93b891d1/Felipe-Caicedo"
2019,"Lazio","Serie A","Luan Capanni","BRA","FW","18",2000,0.1,1,1,0,0,1,0,0,NA,0,0,0,0,0,1,0,0,"https://fbref.com/en/players/28237d7e/Luan-Capanni"
2019,"Lazio","Serie A","Danilo Cataldi","ITA","MF,FW","23",1994,6.4,12,7,4,5,3,2,9,22.2,7,3,0,3,7,19,6,0,"https://fbref.com/en/players/ba3d3bea/Danilo-Cataldi"
2019,"Lazio","Serie A","Joaquín Correa","ARG","FW,MF","23",1994,21.4,21,13,6,12,3,5,18,27.8,13,14,3,11,2,23,7,0,"https://fbref.com/en/players/45b9b619/Joaquin-Correa"
2019,"Lazio","Serie A","Riza Durmisi","DEN","DF","24",1994,3.6,4,4,2,0,2,2,3,66.7,1,0,0,0,1,5,9,0,"https://fbref.com/en/players/e5cd9da6/Riza-Durmisi"
2019,"Lazio","Serie A","Luiz Felipe","ITA","DF","21",1997,14.3,27,18,20,7,0,13,20,65,7,27,15,12,26,53,57,1,"https://fbref.com/en/players/15d0c248/Luiz-Felipe"
2019,"Lazio","Serie A","Guido Guerrieri","ITA","GK","22",1996,1,0,0,0,0,0,0,0,NA,0,0,0,0,0,0,2,0,"https://fbref.com/en/players/77e401c7/Guido-Guerrieri"
2019,"Lazio","Serie A","Ciro Immobile","ITA","FW","28",1990,31.8,12,6,4,3,5,4,9,44.4,5,18,1,17,1,13,8,0,"https://fbref.com/en/players/4431aed2/Ciro-Immobile"
2019,"Lazio","Serie A","Bruno Jordão","POR","MF,DF","19",1998,1,4,3,2,1,1,1,3,33.3,2,1,0,1,0,4,2,0,"https://fbref.com/en/players/41ff002d/Bruno-Jordao"
2019,"Lazio","Serie A","Lucas Leiva","BRA","MF","31",1987,22.1,91,54,40,46,5,38,79,48.1,41,27,11,16,52,143,43,3,"https://fbref.com/en/players/4c78b5ed/Lucas-Leiva"
2019,"Lazio","Serie A","Jordan Lukaku","BEL","DF,MF","24",1994,1.9,4,3,2,1,1,3,5,60,2,3,0,3,5,9,2,0,"https://fbref.com/en/players/0cd0e21b/Jordan-Lukaku"
2019,"Lazio","Serie A","Senad Lulić","BIH","DF,FW","32",1986,32.5,71,43,37,27,7,32,76,42.1,44,27,3,24,49,120,58,1,"https://fbref.com/en/players/7fd58fe3/Senad-Lulic"
2019,"Lazio","Serie A","Adam Marušić","MNE","DF","25",1992,23.5,32,15,14,14,4,16,25,64,9,25,4,21,24,56,36,0,"https://fbref.com/en/players/d4535821/Adam-Marusic"
2019,"Lazio","Serie A","Sergej Milinković-Savić","SRB","MF","23",1995,26.6,44,28,17,21,6,23,60,38.3,37,28,4,24,27,71,48,0,"https://fbref.com/en/players/4e6dbac4/Sergej-Milinkovic-Savic"
2019,"Lazio","Serie A","Alessandro Murgia","ITA","MF","21",1996,0.1,0,0,0,0,0,0,0,NA,0,0,0,0,0,0,0,0,"https://fbref.com/en/players/fb2c533b/Alessandro-Murgia"
2019,"Lazio","Serie A","Pedro Neto","POR","FW,DF","18",2000,0.5,0,0,0,0,0,0,0,NA,0,1,0,1,0,0,0,0,"https://fbref.com/en/players/7ba2eaa9/Pedro-Neto"
2019,"Lazio","Serie A","Marco Parolo","ITA","MF","33",1985,28.5,68,45,24,37,7,18,56,32.1,38,48,11,37,28,96,56,0,"https://fbref.com/en/players/ed5886d2/Marco-Parolo"
2019,"Lazio","Serie A","Patric","ESP","DF","25",1993,12.1,19,11,8,8,3,8,15,53.3,7,14,7,7,12,31,29,1,"https://fbref.com/en/players/f7223718/Patric"
2019,"Lazio","Serie A","Silvio Proto","BEL","GK","35",1983,2,0,0,0,0,0,0,1,0,1,0,0,0,0,0,1,0,"https://fbref.com/en/players/c8a88acd/Silvio-Proto"
2019,"Lazio","Serie A","Ștefan Radu","ROU","DF","31",1986,24.9,43,27,24,15,4,25,38,65.8,13,20,14,6,42,85,85,1,"https://fbref.com/en/players/53de807a/Stefan-Radu"
2019,"Lazio","Serie A","Rômulo","ITA","DF","31",1987,8.6,10,5,8,2,0,5,7,71.4,2,10,2,8,5,15,13,0,"https://fbref.com/en/players/07abb358/Romulo"
2019,"Lazio","Serie A","Thomas Strakosha","ALB","GK","23",1995,35,1,1,1,0,0,1,1,100,0,0,0,0,1,2,8,1,"https://fbref.com/en/players/339fe0e8/Thomas-Strakosha"
2019,"Lazio","Serie A","Wallace","BRA","DF","23",1994,13.7,17,13,11,6,0,8,17,47.1,9,13,7,6,30,47,60,2,"https://fbref.com/en/players/d61b3354/Wallace"
2019,"Leganés","La Liga","Alexander","ARG","FW","29",1988,0.1,1,0,1,0,0,1,1,100,0,0,0,0,0,1,0,0,"https://fbref.com/en/players/3e1858af/Alexander"
2019,"Leganés","La Liga","José Arnaiz","ESP","MF,FW","23",1995,1.3,1,1,1,0,0,0,3,0,3,0,0,0,2,3,1,0,"https://fbref.com/en/players/46e07328/Jose-Arnaiz"
2019,"Leganés","La Liga","Martin Braithwaite","DEN","FW","27",1991,15.6,5,3,0,0,5,0,4,0,4,9,0,9,3,8,4,0,"https://fbref.com/en/players/fd771f95/Martin-Braithwaite"
2019,"Leganés","La Liga","Unai Bustinza","ESP","DF","26",1992,22.5,41,31,25,14,2,17,33,51.5,16,31,13,18,53,94,110,2,"https://fbref.com/en/players/f3112790/Unai-Bustinza"
2019,"Leganés","La Liga","Guido Carrillo","ARG","FW","27",1991,22.1,25,14,4,12,9,6,19,31.6,13,12,1,11,8,33,25,0,"https://fbref.com/en/players/8f898ba8/Guido-Carrillo"
2019,"Leganés","La Liga","Iván Cuéllar","ESP","GK","34",1984,33.9,0,0,0,0,0,0,1,0,1,0,0,0,2,2,10,0,"https://fbref.com/en/players/75751c99/Ivan-Cuellar"
2019,"Leganés","La Liga","Youssef En-Nesyri","MAR","FW","21",1997,23.4,16,8,6,5,5,4,24,16.7,20,18,3,15,6,22,23,0,"https://fbref.com/en/players/04e17fd5/Youssef-En-Nesyri"
2019,"Leganés","La Liga","Javier Eraso","ESP","MF,FW","28",1990,7,6,3,3,2,1,0,6,0,6,3,1,2,7,13,4,0,"https://fbref.com/en/players/aec0fb6f/Javier-Eraso"
2019,"Leganés","La Liga","Raúl García","ESP","DF","29",1989,4.2,8,6,4,4,0,6,8,75,2,5,2,3,6,14,28,1,"https://fbref.com/en/players/1a317a1b/Raul-Garcia"
2019,"Leganés","La Liga","Gerard Gumbau","ESP","MF","23",1994,13.3,22,16,9,13,0,6,25,24,19,15,2,13,13,35,13,0,"https://fbref.com/en/players/ac454a4f/Gerard-Gumbau"
2019,"Leganés","La Liga","Juanfran","ESP","DF,FW","29",1988,16.2,20,12,13,5,2,9,16,56.3,7,9,4,5,19,39,37,0,"https://fbref.com/en/players/9ba48d64/Juanfran"
2019,"Leganés","La Liga","Vasyl Kravets","UKR","DF,FW","20",1997,5.3,16,11,8,6,2,6,13,46.2,7,5,1,4,4,20,10,1,"https://fbref.com/en/players/29e48848/Vasyl-Kravets"
2019,"Leganés","La Liga","Andriy Lunin","UKR","GK","19",1999,4.1,0,0,0,0,0,0,0,NA,0,0,0,0,0,0,0,0,"https://fbref.com/en/players/3061e1ec/Andriy-Lunin"
2019,"Leganés","La Liga","Sabin Merino","ESP","FW,MF","26",1992,3.3,1,1,0,0,1,1,1,100,0,1,0,1,0,1,4,0,"https://fbref.com/en/players/1d5f96d9/Sabin-Merino"
2019,"Leganés","La Liga","Ezequiel Muñoz","ARG","DF","27",1990,2.3,3,2,1,2,0,0,0,NA,0,3,1,2,1,4,10,0,"https://fbref.com/en/players/e4b8c5b6/Ezequiel-Munoz"
2019,"Leganés","La Liga","Allan Nyom","CMR","DF,FW","30",1988,19,32,24,20,10,2,12,17,70.6,5,7,2,5,20,52,35,0,"https://fbref.com/en/players/97572117/Allan-Nyom"
2019,"Leganés","La Liga","Dani Ojeda","ESP","MF,DF","23",1994,2.1,3,2,2,0,1,1,3,33.3,2,2,0,2,2,5,2,0,"https://fbref.com/en/players/375a669e/Dani-Ojeda"
2019,"Leganés","La Liga","Kenneth Omeruo","NGA","DF","24",1993,27,49,27,41,8,0,20,29,69,9,23,11,12,37,86,159,3,"https://fbref.com/en/players/0f0aa5b4/Kenneth-Omeruo"
2019,"Leganés","La Liga","Rubén Pérez","ESP","MF","29",1989,27.5,71,42,27,40,4,32,80,40,48,35,8,27,40,111,34,1,"https://fbref.com/en/players/3c7bc9bd/Ruben-Perez"
2019,"Leganés","La Liga","Recio","ESP","MF","27",1991,14.3,30,21,14,13,3,6,24,25,18,14,2,12,14,44,14,0,"https://fbref.com/en/players/54073b28/Recio"
2019,"Leganés","La Liga","Diego Reyes","MEX","DF","25",1992,3.6,7,4,4,3,0,3,4,75,1,4,4,0,7,14,17,1,"https://fbref.com/en/players/d4f46475/Diego-Reyes"
2019,"Leganés","La Liga","Óscar Rodríguez Arnaiz","ESP","MF","20",1998,27.8,46,25,26,15,5,16,58,27.6,42,12,2,10,16,62,16,0,"https://fbref.com/en/players/19709006/Oscar-Rodriguez-Arnaiz"
2019,"Leganés","La Liga","Diego Rolán","URU","MF,FW","25",1993,2.4,6,4,3,3,0,2,9,22.2,7,2,0,2,3,9,3,0,"https://fbref.com/en/players/d1491e00/Diego-Rolan"
2019,"Leganés","La Liga","Michael Santos","URU","FW,MF","25",1993,6.2,12,5,1,7,4,2,7,28.6,5,7,1,6,1,13,1,0,"https://fbref.com/en/players/3cb6f224/Michael-Santos"
2019,"Leganés","La Liga","Jonathan Silva","ARG","DF,FW","24",1994,30,51,38,30,17,4,23,52,44.2,29,23,2,21,29,80,86,0,"https://fbref.com/en/players/f2308b33/Jonathan-Silva"
2019,"Leganés","La Liga","Dimitris Siovas","GRE","DF","29",1988,32.9,57,32,38,18,1,27,47,57.4,20,32,15,17,65,122,155,1,"https://fbref.com/en/players/92d38e6c/Dimitris-Siovas"
2019,"Leganés","La Liga","Rodrigo Tarín","ESP","DF","22",1996,15.9,22,14,15,5,2,7,10,70,3,11,5,6,31,53,79,0,"https://fbref.com/en/players/a03c82b2/Rodrigo-Tarin"
2019,"Leganés","La Liga","Mikel Vesga","ESP","MF","25",1993,23,50,32,27,15,8,20,82,24.4,62,42,4,38,39,89,26,0,"https://fbref.com/en/players/b0fce72c/Mikel-Vesga"
2019,"Leganés","La Liga","Nabil El Zhar","MAR","MF,FW","31",1986,10.7,8,4,2,4,2,0,5,0,5,4,0,4,4,12,1,0,"https://fbref.com/en/players/37f96552/Nabil-El-Zhar"
2019,"Leicester City","Premier League","Marc Albrighton","ENG","FW,MF","28",1989,18.1,35,22,18,14,3,13,31,41.9,18,26,3,23,23,58,30,0,"https://fbref.com/en/players/b827d5b3/Marc-Albrighton"
2019,"Leicester City","Premier League","Daniel Amartey","GHA","DF","23",1994,7.1,18,12,11,6,1,10,15,66.7,5,6,4,2,17,35,28,1,"https://fbref.com/en/players/1a4ef233/Daniel-Amartey"
2019,"Leicester City","Premier League","Harvey Barnes","ENG","MF,FW","20",1997,11.2,10,6,5,4,1,4,6,66.7,2,7,1,6,3,13,7,0,"https://fbref.com/en/players/3ea50f67/Harvey-Barnes"
2019,"Leicester City","Premier League","Ben Chilwell","ENG","DF","21",1996,36,55,29,34,18,3,24,55,43.6,31,37,7,30,38,93,156,0,"https://fbref.com/en/players/d2424d1b/Ben-Chilwell"
2019,"Leicester City","Premier League","Hamza Choudhury","ENG","MF","20",1997,6.6,24,10,13,10,1,9,15,60,6,12,3,9,15,39,13,0,"https://fbref.com/en/players/7d2d3329/Hamza-Choudhury"
2019,"Leicester City","Premier League","Fousseni Diabaté","MLI","FW","22",1995,0.6,2,0,2,0,0,0,1,0,1,2,0,2,0,2,0,0,"https://fbref.com/en/players/d07e3b41/Fousseni-Diabate"
2019,"Leicester City","Premier League","Jonny Evans","NIR","DF","30",1988,22.2,24,13,20,4,0,13,18,72.2,5,28,10,18,33,57,152,3,"https://fbref.com/en/players/f8fcd2a5/Jonny-Evans"
2019,"Leicester City","Premier League","Christian Fuchs","AUT","DF","32",1986,2.3,4,3,0,4,0,1,2,50,1,0,0,0,4,8,8,0,"https://fbref.com/en/players/a67a09fb/Christian-Fuchs"
2019,"Leicester City","Premier League","Rachid Ghezzal","ALG","FW,MF","26",1992,8.3,14,5,3,7,4,3,18,16.7,15,10,1,9,7,21,4,1,"https://fbref.com/en/players/dc3a9a0d/Rachid-Ghezzal"
2019,"Leicester City","Premier League","Demarai Gray","ENG","FW,MF","22",1996,22.1,25,12,7,14,4,6,16,37.5,10,19,0,19,9,34,15,0,"https://fbref.com/en/players/4468ec10/Demarai-Gray"
2019,"Leicester City","Premier League","Vicente Iborra","ESP","MF","30",1988,2.5,4,1,1,3,0,0,7,0,7,1,0,1,8,12,4,1,"https://fbref.com/en/players/ad1ffcfd/Vicente-Iborra"
2019,"Leicester City","Premier League","Kelechi Iheanacho","NGA","FW,MF","21",1996,10.5,6,5,4,1,1,1,5,20,4,5,0,5,2,8,3,0,"https://fbref.com/en/players/c92e1a31/Kelechi-Iheanacho"
2019,"Leicester City","Premier League","James Maddison","ENG","MF,FW","21",1996,31.5,48,32,20,25,3,14,58,24.1,44,20,4,16,12,60,10,1,"https://fbref.com/en/players/ee38d9c5/James-Maddison"
2019,"Leicester City","Premier League","Harry Maguire","ENG","DF","25",1993,28.8,31,17,21,9,1,11,17,64.7,6,32,18,14,36,67,155,4,"https://fbref.com/en/players/d8931174/Harry-Maguire"
2019,"Leicester City","Premier League","Nampalys Mendy","SEN","MF","26",1992,23.2,33,18,16,16,1,6,22,27.3,16,24,8,16,26,59,26,2,"https://fbref.com/en/players/1598599e/Nampalys-Mendy"
2019,"Leicester City","Premier League","Wes Morgan","JAM","DF","34",1984,21.4,27,15,14,12,1,6,7,85.7,1,24,10,14,32,59,109,1,"https://fbref.com/en/players/80c31c97/Wes-Morgan"
2019,"Leicester City","Premier League","Wilfred Ndidi","NGA","MF","21",1996,36.6,142,98,66,67,9,46,95,48.4,49,64,9,55,83,225,85,2,"https://fbref.com/en/players/6b47c5db/Wilfred-Ndidi"
2019,"Leicester City","Premier League","Shinji Okazaki","JPN","MF,FW","32",1986,3.2,5,5,2,3,0,0,1,0,1,7,1,6,2,7,1,0,"https://fbref.com/en/players/68796d61/Shinji-Okazaki"
2019,"Leicester City","Premier League","Ricardo Pereira","POR","DF,FW","24",1993,34.7,118,66,66,40,12,54,112,48.2,58,60,6,54,60,178,130,1,"https://fbref.com/en/players/75a72a99/Ricardo-Pereira"
2019,"Leicester City","Premier League","Kasper Schmeichel","DEN","GK","31",1986,38,1,1,1,0,0,1,1,100,0,0,0,0,3,4,14,3,"https://fbref.com/en/players/53af52f3/Kasper-Schmeichel"
2019,"Leicester City","Premier League","Adrien Silva","POR","MF","29",1989,1,2,2,0,1,1,0,2,0,2,1,0,1,1,3,1,0,"https://fbref.com/en/players/d6f88a1d/Adrien-Silva"
2019,"Leicester City","Premier League","Danny Simpson","ENG","DF","31",1987,3.2,11,3,8,3,0,3,5,60,2,7,3,4,6,17,20,0,"https://fbref.com/en/players/3201b03d/Danny-Simpson"
2019,"Leicester City","Premier League","Çağlar Söyüncü","TUR","DF","22",1996,4.1,5,2,4,1,0,3,6,50,3,8,5,3,7,12,22,3,"https://fbref.com/en/players/21166ff4/Caglar-Soyuncu"
2019,"Leicester City","Premier League","Youri Tielemans","BEL","MF","21",1997,12.1,17,8,5,9,3,5,17,29.4,12,13,2,11,5,22,13,1,"https://fbref.com/en/players/56f7a928/Youri-Tielemans"
2019,"Leicester City","Premier League","Jamie Vardy","ENG","FW","31",1987,30.3,14,8,3,6,5,4,17,23.5,13,16,1,15,6,20,28,0,"https://fbref.com/en/players/45963054/Jamie-Vardy"
2019,"Levante","La Liga","Enis Bardhi","MKD","MF","23",1995,31.5,70,43,30,34,6,28,87,32.2,59,35,3,32,31,101,36,1,"https://fbref.com/en/players/cac2537b/Enis-Bardhi"
2019,"Levante","La Liga","Emmanuel Boateng","GHA","FW","22",1996,7.8,4,3,0,0,4,0,3,0,3,5,0,5,1,5,7,0,"https://fbref.com/en/players/2e23c66b/Emmanuel-Boateng"
2019,"Levante","La Liga","Erick Cabaco","URU","DF","23",1995,18.1,22,13,19,3,0,12,29,41.4,17,29,14,15,29,51,69,0,"https://fbref.com/en/players/e7ab4179/Erick-Cabaco"
2019,"Levante","La Liga","José Campaña","ESP","MF","25",1993,35.7,65,45,31,29,5,27,86,31.4,59,51,7,44,48,113,46,1,"https://fbref.com/en/players/61220da2/Jose-Campana"
2019,"Levante","La Liga","Chema","ESP","DF","26",1992,13.9,27,19,16,9,2,13,19,68.4,6,19,11,8,19,46,83,0,"https://fbref.com/en/players/7f203b54/Chema"
2019,"Levante","La Liga","Coke","ESP","DF","31",1987,20.2,44,27,24,17,3,26,56,46.4,30,18,8,10,40,84,54,1,"https://fbref.com/en/players/6d8f8441/Coke"
2019,"Levante","La Liga","Cheick Doukouré","CIV","MF","25",1992,3.5,13,7,3,7,3,4,15,26.7,11,10,2,8,3,16,3,1,"https://fbref.com/en/players/e208bcc8/Cheick-Doukoure"
2019,"Levante","La Liga","Raphael Dwamena","GHA","FW","22",1995,2.5,0,0,0,0,0,0,0,NA,0,2,1,1,0,0,2,0,"https://fbref.com/en/players/525f9bf4/Raphael-Dwamena"
2019,"Levante","La Liga","Aitor Fernández","ESP","GK","27",1991,16,1,0,1,0,0,1,1,100,0,0,0,0,1,2,10,1,"https://fbref.com/en/players/a01c3d54/Aitor-Fernandez"
2019,"Levante","La Liga","Jason","ESP","DF,FW","24",1994,25.9,44,25,22,11,11,20,71,28.2,51,25,4,21,46,90,27,0,"https://fbref.com/en/players/9038c2a1/Jason"
2019,"Levante","La Liga","Pedro López Muñoz","ESP","DF","34",1983,5.2,5,3,5,0,0,3,7,42.9,4,8,3,5,8,13,7,0,"https://fbref.com/en/players/a60823a4/Pedro-Lopez-Munoz"
2019,"Levante","La Liga","José Luis Morales","ESP","FW,MF","31",1987,35.5,21,15,6,10,5,8,49,16.3,41,22,1,21,12,33,17,0,"https://fbref.com/en/players/4a478107/Jose-Luis-Morales"
2019,"Levante","La Liga","Antonio Luna","ESP","DF,FW","27",1991,14,14,10,6,7,1,6,23,26.1,17,22,7,15,15,29,48,1,"https://fbref.com/en/players/ed239245/Antonio-Luna"
2019,"Levante","La Liga","Fran Manzanara","ESP","DF,MF","21",1996,1.7,7,5,3,3,1,4,4,100,0,3,2,1,1,8,7,0,"https://fbref.com/en/players/bbfaeda4/Fran-Manzanara"
2019,"Levante","La Liga","Roger Martí","ESP","FW","27",1991,21,8,6,1,4,3,1,19,5.3,18,14,1,13,4,12,9,0,"https://fbref.com/en/players/0ae4e09a/Roger-Marti"
2019,"Levante","La Liga","Borja Mayoral","ESP","FW","21",1997,18,9,4,1,6,2,5,16,31.3,11,10,1,9,5,14,5,0,"https://fbref.com/en/players/64e8ed6d/Borja-Mayoral"
2019,"Levante","La Liga","Oier Olazábal","ESP","GK","28",1989,21,1,1,1,0,0,1,2,50,1,1,0,1,1,2,15,2,"https://fbref.com/en/players/b5bdf144/Oier-Olazabal"
2019,"Levante","La Liga","Sergio Postigo","ESP","DF","29",1988,16.1,25,15,22,3,0,15,19,78.9,4,21,12,9,20,45,77,0,"https://fbref.com/en/players/474ecac8/Sergio-Postigo"
2019,"Levante","La Liga","Sanjin Prcić","BIH","MF","24",1993,5.9,18,13,7,9,2,5,11,45.5,6,11,7,4,11,29,11,1,"https://fbref.com/en/players/51c30111/Sanjin-Prcic"
2019,"Levante","La Liga","Rober","ESP","DF","23",1995,31.7,41,29,33,6,2,24,48,50,24,52,36,16,51,92,129,2,"https://fbref.com/en/players/c00097d2/Rober"
2019,"Levante","La Liga","Rubén Rochina","ESP","MF","27",1991,20,51,33,26,16,9,23,81,28.4,58,29,0,29,21,72,19,1,"https://fbref.com/en/players/ecd8c01e/Ruben-Rochina"
2019,"Levante","La Liga","Moses Simon","NGA","DF,MF","23",1995,8.7,14,8,10,2,2,5,9,55.6,4,10,1,9,12,26,14,0,"https://fbref.com/en/players/5f3eaaf5/Moses-Simon"
2019,"Levante","La Liga","Toño","ESP","DF,FW","28",1989,19.6,17,13,12,3,2,10,21,47.6,11,20,5,15,14,31,42,0,"https://fbref.com/en/players/d4ef9ac5/Tono"
2019,"Levante","La Liga","Koke Vegas","ESP","GK","22",1995,1,0,0,0,0,0,0,0,NA,0,0,0,0,0,0,0,0,"https://fbref.com/en/players/bfb15d99/Koke-Vegas"
2019,"Levante","La Liga","Rúben Vezo","POR","DF","24",1994,14.9,26,17,17,8,1,14,22,63.6,8,23,20,3,19,45,88,0,"https://fbref.com/en/players/c67cd65c/Ruben-Vezo"
2019,"Levante","La Liga","Nikola Vukčević","MNE","MF","26",1991,7.4,25,18,12,9,4,9,24,37.5,15,15,5,10,10,35,17,0,"https://fbref.com/en/players/4442fbcd/Nikola-Vukcevic"
2019,"Leverkusen","Bundesliga","Lucas Alario","ARG","FW,MF","25",1992,14.1,15,8,5,6,4,4,14,28.6,10,9,0,9,1,16,16,0,"https://fbref.com/en/players/834d0be5/Lucas-Alario"
2019,"Leverkusen","Bundesliga","Charles Aránguiz","CHI","MF","29",1989,21,48,30,21,22,5,21,66,31.8,45,31,2,29,25,73,27,1,"https://fbref.com/en/players/56413b1f/Charles-Aranguiz"
2019,"Leverkusen","Bundesliga","Leon Bailey","JAM","FW","20",1997,21.3,15,11,9,2,4,6,20,30,14,20,0,20,14,29,11,0,"https://fbref.com/en/players/3a233281/Leon-Bailey"
2019,"Leverkusen","Bundesliga","Julian Baumgartlinger","AUT","MF","30",1988,17.3,52,30,24,20,8,20,45,44.4,25,18,6,12,26,78,21,1,"https://fbref.com/en/players/69374ff5/Julian-Baumgartlinger"
2019,"Leverkusen","Bundesliga","Karim Bellarabi","GER","FW","28",1990,11.7,13,6,7,4,2,3,19,15.8,16,13,0,13,10,23,8,0,"https://fbref.com/en/players/bee0bab1/Karim-Bellarabi"
2019,"Leverkusen","Bundesliga","Lars Bender","GER","MF,DF","29",1989,15.1,43,29,20,20,3,18,35,51.4,17,26,4,22,21,64,26,0,"https://fbref.com/en/players/c50281a0/Lars-Bender"
2019,"Leverkusen","Bundesliga","Sven Bender","GER","DF","29",1989,22.1,40,25,25,15,0,18,30,60,12,31,14,17,52,92,98,0,"https://fbref.com/en/players/070ec0b1/Sven-Bender"
2019,"Leverkusen","Bundesliga","Julian Brandt","GER","MF,FW","22",1996,29.6,27,16,13,10,4,7,43,16.3,36,27,1,26,17,44,12,1,"https://fbref.com/en/players/a167537f/Julian-Brandt"
2019,"Leverkusen","Bundesliga","Aleksandar Dragović","AUT","DF","27",1991,14.8,18,12,14,4,0,9,14,64.3,5,15,8,7,25,43,66,0,"https://fbref.com/en/players/6fd8a334/Aleksandar-Dragovic"
2019,"Leverkusen","Bundesliga","Kai Havertz","GER","MF,FW","19",1999,32.2,26,17,10,11,5,8,32,25,24,31,4,27,16,42,29,0,"https://fbref.com/en/players/fed7cb61/Kai-Havertz"
2019,"Leverkusen","Bundesliga","Benjamin Henrichs","GER","DF","21",1997,0.7,0,0,0,0,0,0,0,NA,0,2,0,2,3,3,0,0,"https://fbref.com/en/players/0a89e877/Benjamin-Henrichs"
2019,"Leverkusen","Bundesliga","Lukáš Hrádecký","FIN","GK","28",1989,32,0,0,0,0,0,0,1,0,1,0,0,0,1,1,9,1,"https://fbref.com/en/players/ad3389d5/Lukas-Hradecky"
2019,"Leverkusen","Bundesliga","Tin Jedvaj","CRO","DF","22",1995,12.5,23,15,9,8,6,10,19,52.6,9,28,2,26,22,45,52,0,"https://fbref.com/en/players/f820504e/Tin-Jedvaj"
2019,"Leverkusen","Bundesliga","Isaac Kiese Thelin","SWE","FW,MF","26",1992,2,2,1,0,2,0,1,2,50,1,1,0,1,0,2,4,0,"https://fbref.com/en/players/b956af7d/Isaac-Kiese-Thelin"
2019,"Leverkusen","Bundesliga","Dominik Kohr","GER","MF","24",1994,10.8,42,29,21,21,0,14,35,40,21,25,12,13,15,57,17,1,"https://fbref.com/en/players/0fbecd11/Dominik-Kohr"
2019,"Leverkusen","Bundesliga","Ramazan Özcan","AUT","GK","34",1984,2,0,0,0,0,0,0,0,NA,0,0,0,0,1,1,2,0,"https://fbref.com/en/players/a165a577/Ramazan-Ozcan"
2019,"Leverkusen","Bundesliga","Paulinho","BRA","FW,MF","18",2000,2,4,4,2,2,0,1,2,50,1,3,0,3,2,6,0,1,"https://fbref.com/en/players/53070b63/Paulinho"
2019,"Leverkusen","Bundesliga","Jonathan Tah","GER","DF","22",1996,32.6,44,30,30,10,4,17,32,53.1,15,39,26,13,45,89,142,1,"https://fbref.com/en/players/bd142efb/Jonathan-Tah"
2019,"Leverkusen","Bundesliga","Kevin Volland","GER","FW","26",1992,31.3,33,20,7,14,12,13,27,48.1,14,17,1,16,6,39,33,0,"https://fbref.com/en/players/64f69877/Kevin-Volland"
2019,"Leverkusen","Bundesliga","Mitchell Weiser","GER","DF","24",1994,23.5,63,37,34,22,7,26,50,52,24,31,3,28,27,90,48,0,"https://fbref.com/en/players/30c220c3/Mitchell-Weiser"
2019,"Leverkusen","Bundesliga","Wendell","BRA","DF","25",1993,25.3,75,48,47,24,4,34,57,59.6,23,49,13,36,29,104,66,0,"https://fbref.com/en/players/f9acca3a/Wendell"
2019,"Lille","Ligue 1","Luiz Araújo","BRA","FW,MF","22",1996,8.7,23,17,8,9,6,9,24,37.5,15,6,1,5,3,26,4,0,"https://fbref.com/en/players/fa18c72e/Luiz-Araujo"
2019,"Lille","Ligue 1","Fodé Ballo-Touré","SEN","DF","21",1997,17.7,47,35,26,19,2,21,32,65.6,11,25,7,18,27,74,42,2,"https://fbref.com/en/players/f449640d/Fode-Ballo-Toure"
2019,"Lille","Ligue 1","Jonathan Bamba","FRA","FW,MF","22",1996,33.4,29,19,7,17,5,13,39,33.3,26,24,1,23,41,70,18,0,"https://fbref.com/en/players/b2bd0f6c/Jonathan-Bamba"
2019,"Lille","Ligue 1","Yassine Benzia","ALG","MF","23",1994,1.8,1,1,0,1,0,1,1,100,0,0,0,0,1,2,1,0,"https://fbref.com/en/players/6fbde63a/Yassine-Benzia"
2019,"Lille","Ligue 1","Zeki Çelik","TUR","DF","21",1997,33,90,59,40,39,11,36,89,40.4,53,34,5,29,34,124,89,1,"https://fbref.com/en/players/31a62dc7/Zeki-Celik"
2019,"Lille","Ligue 1","Kouadio-Yves Dabila","CIV","DF","21",1997,8.7,11,6,10,1,0,5,6,83.3,1,13,9,4,6,17,44,0,"https://fbref.com/en/players/3067cbef/Kouadio-Yves-Dabila"
2019,"Lille","Ligue 1","Gabriel Dos Santos","BRA","DF","20",1997,11.8,18,11,13,4,1,4,7,57.1,3,14,6,8,19,37,60,2,"https://fbref.com/en/players/67ac5bb8/Gabriel-Dos-Santos"
2019,"Lille","Ligue 1","José Fonte","POR","DF","34",1983,34.6,27,15,15,9,3,17,24,70.8,7,33,26,7,37,64,153,1,"https://fbref.com/en/players/90f87966/Jose-Fonte"
2019,"Lille","Ligue 1","Rui Fonte","POR","FW,MF","28",1990,7,25,12,4,16,5,6,11,54.5,5,4,0,4,2,27,8,0,"https://fbref.com/en/players/6ff8ef56/Rui-Fonte"
2019,"Lille","Ligue 1","Edgar Ié","POR","DF","24",1994,2.7,5,4,3,2,0,3,5,60,2,2,1,1,7,12,17,0,"https://fbref.com/en/players/3767b3b7/Edgar-Ie"
2019,"Lille","Ligue 1","Jonathan Ikone","FRA","MF,FW","20",1998,31.1,25,14,7,12,6,8,30,26.7,22,24,2,22,6,31,4,0,"https://fbref.com/en/players/42eaa028/Jonathan-Ikone"
2019,"Lille","Ligue 1","Youssouf Koné","MLI","DF","23",1995,19,67,38,45,19,3,41,65,63.1,24,31,3,28,39,106,52,1,"https://fbref.com/en/players/e6eadfb8/Youssouf-Kone"
2019,"Lille","Ligue 1","Rafael Leão","POR","FW","19",1999,14.3,5,2,0,4,1,2,15,13.3,13,13,4,9,4,9,12,0,"https://fbref.com/en/players/20730eae/Rafael-Leao"
2019,"Lille","Ligue 1","Thiago Maia","BRA","MF","21",1997,11.3,32,19,17,13,2,13,33,39.4,20,14,5,9,23,55,23,0,"https://fbref.com/en/players/91e58f66/Thiago-Maia"
2019,"Lille","Ligue 1","Mike Maignan","FRA","GK","23",1995,38,0,0,0,0,0,0,0,NA,0,1,0,1,0,0,12,1,"https://fbref.com/en/players/fcb38f57/Mike-Maignan"
2019,"Lille","Ligue 1","Reinildo Mandava","MOZ","DF","24",1994,1.1,3,2,1,2,0,2,3,66.7,1,1,0,1,1,4,0,0,"https://fbref.com/en/players/c20bdcd7/Reinildo-Mandava"
2019,"Lille","Ligue 1","Thiago Mendes","BRA","MF","26",1992,34.2,85,47,42,41,2,39,71,54.9,32,44,11,33,68,153,49,0,"https://fbref.com/en/players/c6e5d20f/Thiago-Mendes"
2019,"Lille","Ligue 1","Lebo Mothiba","RSA","FW","22",1996,2.8,1,1,0,1,0,0,0,NA,0,0,0,0,0,1,8,0,"https://fbref.com/en/players/3eaf8817/Lebo-Mothiba"
2019,"Lille","Ligue 1","Nicolas Pépé","CIV","FW,MF","23",1995,36.9,27,10,6,15,6,8,35,22.9,27,33,0,33,13,40,11,1,"https://fbref.com/en/players/57e3f0c7/Nicolas-Pepe"
2019,"Lille","Ligue 1","Jérémy Pied","FRA","DF","29",1989,5.2,12,8,5,6,1,3,9,33.3,6,8,1,7,5,17,13,0,"https://fbref.com/en/players/a634b9d2/Jeremy-Pied"
2019,"Lille","Ligue 1","Loïc Rémy","FRA","FW","31",1987,13.4,2,1,0,2,0,0,3,0,3,3,1,2,2,4,17,1,"https://fbref.com/en/players/5c2da10f/Loic-Remy"
2019,"Lille","Ligue 1","Adama Soumaoro","FRA","DF","26",1992,19.1,14,11,12,2,0,4,6,66.7,2,21,18,3,21,35,92,1,"https://fbref.com/en/players/7b075c75/Adama-Soumaoro"
2019,"Lille","Ligue 1","Boubakary Soumaré","FRA","MF","19",1999,6.3,20,15,9,11,0,10,18,55.6,8,9,3,6,7,27,5,0,"https://fbref.com/en/players/ae59b359/Boubakary-Soumare"
2019,"Lille","Ligue 1","Xeka","POR","MF","23",1994,25.1,59,31,25,27,7,18,57,31.6,39,20,2,18,21,80,30,4,"https://fbref.com/en/players/f3600c02/Xeka"
2019,"Lille","Ligue 1","Arton Zekaj","KVX","FW","18",2000,0,0,0,0,0,0,0,0,NA,0,0,0,0,0,0,0,0,"https://fbref.com/en/players/0bd57eb0/Arton-Zekaj"
2019,"Liverpool","Premier League","Trent Alexander-Arnold","ENG","DF","19",1998,27.4,61,39,31,22,8,36,68,52.9,32,19,3,16,35,96,68,0,"https://fbref.com/en/players/cd1acf9d/Trent-Alexander-Arnold"
2019,"Liverpool","Premier League","Alisson","BRA","GK","25",1992,38,2,1,2,0,0,2,2,100,0,0,0,0,1,3,14,6,"https://fbref.com/en/players/7a2e46a8/Alisson"
2019,"Liverpool","Premier League","Rafael Camacho","POR","DF","18",2000,0,1,0,1,0,0,1,1,100,0,0,0,0,0,1,0,0,"https://fbref.com/en/players/91b43c98/Rafael-Camacho"
2019,"Liverpool","Premier League","Nathaniel Clyne","ENG","DF","27",1991,1.2,4,3,2,2,0,2,4,50,2,1,0,1,2,6,1,0,"https://fbref.com/en/players/0442183b/Nathaniel-Clyne"
2019,"Liverpool","Premier League","Fabinho","BRA","MF","24",1993,22.4,59,31,17,38,4,24,59,40.7,35,34,6,28,28,87,27,2,"https://fbref.com/en/players/7f3b388c/Fabinho"
2019,"Liverpool","Premier League","Roberto Firmino","BRA","FW,MF","26",1991,29,30,20,5,16,9,7,34,20.6,27,35,1,34,6,36,16,0,"https://fbref.com/en/players/4c370d81/Roberto-Firmino"
2019,"Liverpool","Premier League","Joe Gomez","ENG","DF","21",1997,11.8,18,11,10,7,1,9,15,60,6,10,5,5,14,32,42,0,"https://fbref.com/en/players/7a11550b/Joe-Gomez"
2019,"Liverpool","Premier League","Jordan Henderson","ENG","MF","28",1990,22.1,46,36,20,22,4,16,39,41,23,27,3,24,30,76,17,0,"https://fbref.com/en/players/935e6b8f/Jordan-Henderson"
2019,"Liverpool","Premier League","Naby Keïta","GUI","MF,FW","23",1995,15.4,37,15,13,19,5,14,42,33.3,28,29,4,25,12,49,16,1,"https://fbref.com/en/players/f25c8e3a/Naby-Keita"
2019,"Liverpool","Premier League","Adam Lallana","ENG","MF,FW","30",1988,5.2,16,9,6,7,3,5,12,41.7,7,10,1,9,5,21,4,0,"https://fbref.com/en/players/99813635/Adam-Lallana"
2019,"Liverpool","Premier League","Dejan Lovren","CRO","DF","29",1989,11,15,9,10,5,0,7,15,46.7,8,11,7,4,11,26,51,2,"https://fbref.com/en/players/1a2935f6/Dejan-Lovren"
2019,"Liverpool","Premier League","Sadio Mané","SEN","FW","26",1992,34.2,35,29,12,17,6,14,43,32.6,29,28,4,24,15,50,10,1,"https://fbref.com/en/players/c691bfe2/Sadio-Mane"
2019,"Liverpool","Premier League","Joël Matip","CMR","DF","26",1991,17.1,39,26,23,12,4,13,24,54.2,11,12,7,5,32,71,78,0,"https://fbref.com/en/players/b217ef29/Joel-Matip"
2019,"Liverpool","Premier League","James Milner","ENG","MF,DF","32",1986,19.9,43,23,14,24,5,15,41,36.6,26,40,5,35,18,61,30,0,"https://fbref.com/en/players/2f90f6b8/James-Milner"
2019,"Liverpool","Premier League","Alberto Moreno","ESP","DF","26",1992,1.7,3,2,1,2,0,1,3,33.3,2,1,0,1,2,5,0,0,"https://fbref.com/en/players/11b9265b/Alberto-Moreno"
2019,"Liverpool","Premier League","Divock Origi","BEL","FW","23",1995,4.1,6,1,2,3,1,1,4,25,3,2,0,2,0,6,2,0,"https://fbref.com/en/players/43a166b4/Divock-Origi"
2019,"Liverpool","Premier League","Alex Oxlade-Chamberlain","ENG","MF","24",1993,0.2,1,1,0,1,0,1,1,100,0,0,0,0,1,2,0,0,"https://fbref.com/en/players/38c7feef/Alex-Oxlade-Chamberlain"
2019,"Liverpool","Premier League","Andrew Robertson","SCO","DF","24",1994,35.7,80,49,41,31,8,39,70,55.7,31,33,6,27,29,109,57,3,"https://fbref.com/en/players/2e4f5f03/Andrew-Robertson"
2019,"Liverpool","Premier League","Mohamed Salah","EGY","FW","26",1992,36.1,21,9,3,11,7,5,16,31.3,11,9,0,9,5,26,6,0,"https://fbref.com/en/players/e342ad68/Mohamed-Salah"
2019,"Liverpool","Premier League","Xherdan Shaqiri","SUI","FW,MF","26",1991,11.8,14,4,3,9,2,9,19,47.4,10,6,1,5,6,20,6,0,"https://fbref.com/en/players/6421ec64/Xherdan-Shaqiri"
2019,"Liverpool","Premier League","Daniel Sturridge","ENG","FW,MF","28",1989,5.7,3,3,1,1,1,2,3,66.7,1,4,0,4,1,4,0,0,"https://fbref.com/en/players/1b7ec703/Daniel-Sturridge"
2019,"Liverpool","Premier League","Virgil van Dijk","NED","DF","27",1991,37.6,38,28,26,11,1,14,14,100,0,29,18,11,40,78,201,1,"https://fbref.com/en/players/e06683ca/Virgil-van-Dijk"
2019,"Liverpool","Premier League","Georginio Wijnaldum","NED","MF","27",1990,30.3,41,28,14,20,7,14,27,51.9,13,21,7,14,21,62,24,0,"https://fbref.com/en/players/eb58eef0/Georginio-Wijnaldum"
2019,"Lyon","Ligue 1","Houssem Aouar","FRA","MF","20",1998,34,63,38,28,25,10,17,61,27.9,44,33,6,27,32,95,25,3,"https://fbref.com/en/players/a5db0bec/Houssem-Aouar"
2019,"Lyon","Ligue 1","Pape Cheikh Diop","SEN","MF","20",1997,5,1,0,0,1,0,0,5,0,5,6,2,4,2,3,2,1,"https://fbref.com/en/players/873ce3a2/Pape-Cheikh-Diop"
2019,"Lyon","Ligue 1","Maxwel Cornet","CIV","FW","21",1996,14.2,14,11,4,7,3,1,11,9.1,10,10,0,10,5,19,8,0,"https://fbref.com/en/players/beb391dd/Maxwel-Cornet"
2019,"Lyon","Ligue 1","Moussa Dembélé","FRA","FW","22",1996,22.4,12,4,0,8,4,4,14,28.6,10,15,2,13,2,14,13,0,"https://fbref.com/en/players/e7986081/Moussa-Dembele"
2019,"Lyon","Ligue 1","Jason Denayer","BEL","DF","23",1995,30.6,33,21,22,11,0,16,24,66.7,8,36,32,4,26,59,122,1,"https://fbref.com/en/players/47af88b8/Jason-Denayer"
2019,"Lyon","Ligue 1","Leo Dubois","FRA","DF","23",1994,22.7,51,22,25,21,5,20,35,57.1,15,30,10,20,22,73,61,1,"https://fbref.com/en/players/ff0ab48c/Leo-Dubois"
2019,"Lyon","Ligue 1","Nabil Fekir","FRA","MF","25",1993,22.1,51,31,16,19,16,13,38,34.2,25,42,0,42,7,58,3,0,"https://fbref.com/en/players/bece776f/Nabil-Fekir"
2019,"Lyon","Ligue 1","Yassin Fekir","FRA","FW","21",1997,0.1,0,0,0,0,0,0,1,0,1,0,0,0,0,0,0,0,"https://fbref.com/en/players/6644712a/Yassin-Fekir"
2019,"Lyon","Ligue 1","Jordan Ferri","FRA","MF","26",1992,1.3,5,3,3,1,1,1,4,25,3,4,2,2,1,6,3,0,"https://fbref.com/en/players/375622c5/Jordan-Ferri"
2019,"Lyon","Ligue 1","Mathieu Gorgelin","FRA","GK","27",1990,4,0,0,0,0,0,0,0,NA,0,0,0,0,0,0,3,0,"https://fbref.com/en/players/4d3e9033/Mathieu-Gorgelin"
2019,"Lyon","Ligue 1","Anthony Lopes","POR","GK","27",1990,34,1,0,1,0,0,1,3,33.3,2,3,0,3,2,3,16,3,"https://fbref.com/en/players/f00de885/Anthony-Lopes"
2019,"Lyon","Ligue 1","Fernando Marçal","BRA","DF","29",1989,9.8,25,16,17,7,1,12,15,80,3,9,3,6,30,55,42,0,"https://fbref.com/en/players/9ae9eaea/Fernando-Marcal"
2019,"Lyon","Ligue 1","Marcelo","BRA","DF","31",1987,32,48,33,29,17,2,19,24,79.2,5,30,22,8,62,110,152,2,"https://fbref.com/en/players/e3d0b0c4/Marcelo"
2019,"Lyon","Ligue 1","Mariano","DOM","FW","24",1993,1.6,0,0,0,0,0,0,0,NA,0,0,0,0,1,1,0,0,"https://fbref.com/en/players/5c4dc0ff/Mariano"
2019,"Lyon","Ligue 1","Memphis","NED","FW,MF","24",1994,30.4,12,9,0,7,5,5,21,23.8,16,16,2,14,9,21,1,0,"https://fbref.com/en/players/8f696594/Memphis"
2019,"Lyon","Ligue 1","Ferland Mendy","FRA","DF","23",1995,28.1,44,28,25,14,5,14,17,82.4,3,22,5,17,34,78,53,2,"https://fbref.com/en/players/3cefcaef/Ferland-Mendy"
2019,"Lyon","Ligue 1","Jérémy Morel","MAD","DF","34",1984,11.8,16,10,11,5,0,9,13,69.2,4,18,14,4,18,34,45,1,"https://fbref.com/en/players/e97150c0/Jeremy-Morel"
2019,"Lyon","Ligue 1","Tanguy Ndombele","FRA","MF","21",1996,29.9,66,43,21,35,10,22,54,40.7,32,29,9,20,30,96,13,3,"https://fbref.com/en/players/5cdddffa/Tanguy-Ndombele"
2019,"Lyon","Ligue 1","Lenny Pintor","FRA","FW","17",2000,0,0,0,0,0,0,0,0,NA,0,0,0,0,0,0,0,0,"https://fbref.com/en/players/6453830e/Lenny-Pintor"
2019,"Lyon","Ligue 1","Rafael","BRA","DF","28",1990,11.4,31,19,14,12,5,17,24,70.8,7,19,2,17,15,46,30,2,"https://fbref.com/en/players/9a1f2e1c/Rafael"
2019,"Lyon","Ligue 1","Oumar Solet","FRA","DF","18",2000,0.7,1,0,1,0,0,1,1,100,0,1,0,1,0,1,0,0,"https://fbref.com/en/players/0670ee51/Oumar-Solet"
2019,"Lyon","Ligue 1","Martin Terrier","FRA","FW","21",1997,16.5,23,13,5,13,5,9,23,39.1,14,17,2,15,6,29,14,0,"https://fbref.com/en/players/5148dcc5/Martin-Terrier"
2019,"Lyon","Ligue 1","Kenny Tete","NED","DF","22",1995,11.6,30,23,11,16,3,13,19,68.4,6,13,5,8,18,48,29,0,"https://fbref.com/en/players/77d7c96f/Kenny-Tete"
2019,"Lyon","Ligue 1","Lucas Tousart","FRA","MF","21",1997,19.2,74,38,33,34,7,25,59,42.4,34,30,13,17,26,100,27,0,"https://fbref.com/en/players/71ec39ef/Lucas-Tousart"
2019,"Lyon","Ligue 1","Bertrand Traoré","BFA","FW","22",1995,23.5,36,22,19,13,4,12,26,46.2,14,23,5,18,15,51,18,0,"https://fbref.com/en/players/c47541e0/Bertrand-Traore"
2019,"M'Gladbach","Bundesliga","László Bénes","SVK","MF,FW","20",1997,0.3,3,1,3,0,0,3,3,100,0,1,0,1,0,3,0,0,"https://fbref.com/en/players/fe888e39/Laszlo-Benes"
2019,"M'Gladbach","Bundesliga","Louis Beyer","GER","DF","18",2000,8,32,18,21,10,1,17,24,70.8,7,12,6,6,11,43,32,0,"https://fbref.com/en/players/9af1f9ff/Louis-Beyer"
2019,"M'Gladbach","Bundesliga","Mickaël Cuisance","FRA","MF","18",1999,3.1,11,6,6,3,2,3,8,37.5,5,3,0,3,5,16,4,0,"https://fbref.com/en/players/5722eced/Mickael-Cuisance"
2019,"M'Gladbach","Bundesliga","Josip Drmić","SUI","FW","25",1992,2.5,2,0,0,2,0,1,2,50,1,1,0,1,1,3,0,0,"https://fbref.com/en/players/15ea94de/Josip-Drmic"
2019,"M'Gladbach","Bundesliga","Nico Elvedi","SUI","DF","21",1996,29.1,41,19,34,7,0,23,33,69.7,10,30,13,17,47,88,135,6,"https://fbref.com/en/players/48035304/Nico-Elvedi"
2019,"M'Gladbach","Bundesliga","Matthias Ginter","GER","DF","24",1994,26.4,24,14,16,7,1,9,17,52.9,8,31,19,12,17,41,98,1,"https://fbref.com/en/players/f521b80a/Matthias-Ginter"
2019,"M'Gladbach","Bundesliga","Thorgan Hazard","BEL","FW,MF","25",1993,31.9,50,33,22,20,8,17,48,35.4,31,35,2,33,27,77,12,0,"https://fbref.com/en/players/50871bcc/Thorgan-Hazard"
2019,"M'Gladbach","Bundesliga","Patrick Herrmann","GER","FW,DF","27",1991,12,20,14,8,7,5,6,17,35.3,11,6,3,3,6,26,12,0,"https://fbref.com/en/players/dfb6490a/Patrick-Herrmann"
2019,"M'Gladbach","Bundesliga","Jonas Hofmann","GER","MF","26",1992,21.2,37,18,11,19,7,9,37,24.3,28,33,2,31,16,53,14,1,"https://fbref.com/en/players/2903a856/Jonas-Hofmann"
2019,"M'Gladbach","Bundesliga","Tony Jantschke","GER","DF","28",1990,10.4,15,10,9,5,1,6,8,75,2,10,7,3,27,42,51,1,"https://fbref.com/en/players/34b54da7/Tony-Jantschke"
2019,"M'Gladbach","Bundesliga","Fabian Johnson","USA","DF,FW","30",1987,11.2,13,5,2,8,3,6,8,75,2,8,3,5,10,23,16,0,"https://fbref.com/en/players/76e5da9d/Fabian-Johnson"
2019,"M'Gladbach","Bundesliga","Christoph Kramer","GER","MF","27",1991,12.6,41,22,17,23,1,15,40,37.5,25,19,4,15,21,62,23,0,"https://fbref.com/en/players/496aeede/Christoph-Kramer"
2019,"M'Gladbach","Bundesliga","Michael Lang","SUI","DF","27",1991,13.9,14,9,7,6,1,6,16,37.5,10,14,3,11,16,30,42,1,"https://fbref.com/en/players/864db10a/Michael-Lang"
2019,"M'Gladbach","Bundesliga","Florian Neuhaus","GER","MF","21",1997,22.9,22,15,9,9,4,10,36,27.8,26,20,1,19,10,32,23,0,"https://fbref.com/en/players/36a59ba4/Florian-Neuhaus"
2019,"M'Gladbach","Bundesliga","Alassane Pléa","FRA","FW","25",1993,27.8,14,10,7,4,3,5,22,22.7,17,17,2,15,3,17,15,2,"https://fbref.com/en/players/bc6bd723/Alassane-Plea"
2019,"M'Gladbach","Bundesliga","Raffael","BRA","FW","33",1985,6,8,4,2,4,2,2,7,28.6,5,5,0,5,1,9,0,0,"https://fbref.com/en/players/791af558/Raffael"
2019,"M'Gladbach","Bundesliga","Yann Sommer","SUI","GK","29",1988,34,2,2,2,0,0,2,2,100,0,1,0,1,1,3,12,5,"https://fbref.com/en/players/420c18a1/Yann-Sommer"
2019,"M'Gladbach","Bundesliga","Lars Stindl","GER","FW,MF","29",1988,16.8,21,14,8,11,2,3,15,20,12,22,2,20,14,35,13,0,"https://fbref.com/en/players/7cd6badb/Lars-Stindl"
2019,"M'Gladbach","Bundesliga","Tobias Strobl","GER","MF,DF","28",1990,25.5,31,17,17,13,1,9,29,31,20,36,14,22,29,60,35,1,"https://fbref.com/en/players/17780d2b/Tobias-Strobl"
2019,"M'Gladbach","Bundesliga","Ibrahima Traoré","GUI","FW,MF","30",1988,6.1,12,6,8,2,2,3,11,27.3,8,3,1,2,3,15,1,0,"https://fbref.com/en/players/096a77c4/Ibrahima-Traore"
2019,"M'Gladbach","Bundesliga","Oscar Wendt","SWE","DF","32",1985,30.3,45,34,34,8,3,31,53,58.5,22,37,11,26,19,64,90,0,"https://fbref.com/en/players/b69261a0/Oscar-Wendt"
2019,"M'Gladbach","Bundesliga","Denis Zakaria","SUI","MF","21",1996,21.8,40,21,15,24,1,12,30,40,18,38,9,29,26,66,20,0,"https://fbref.com/en/players/384d58d9/Denis-Zakaria"
2019,"Mainz 05","Bundesliga","Issah Abbas","GHA","FW","19",1998,0.1,0,0,0,0,0,0,0,NA,0,0,0,0,0,0,0,0,"https://fbref.com/en/players/2590ddf7/Issah-Abbas"
2019,"Mainz 05","Bundesliga","Ridle Baku","GER","MF","20",1998,10.4,18,9,6,9,3,2,7,28.6,5,13,1,12,8,26,9,0,"https://fbref.com/en/players/442b56fa/Ridle-Baku"
2019,"Mainz 05","Bundesliga","Leandro Barreiro Martins","LUX","MF","18",2000,1,4,4,2,0,2,1,2,50,1,0,0,0,2,6,1,0,"https://fbref.com/en/players/00242b75/Leandro-Barreiro-Martins"
2019,"Mainz 05","Bundesliga","Stefan Bell","GER","DF","26",1991,25,31,20,18,13,0,15,34,44.1,19,31,11,20,54,85,122,1,"https://fbref.com/en/players/857a5abe/Stefan-Bell"
2019,"Mainz 05","Bundesliga","Pablo de Blasis","ARG","FW","30",1988,1,2,0,0,1,1,2,3,66.7,1,0,0,0,1,3,0,0,"https://fbref.com/en/players/9ab48bde/Pablo-de-Blasis"
2019,"Mainz 05","Bundesliga","Jean-Paul Boëtius","NED","MF","24",1994,23.6,51,32,21,25,5,16,44,36.4,28,59,2,57,37,88,13,0,"https://fbref.com/en/players/635f2732/Jean-Paul-Boetius"
2019,"Mainz 05","Bundesliga","Daniel Brosinski","GER","DF","30",1988,24.5,27,16,16,10,1,18,33,54.5,15,30,9,21,26,53,58,0,"https://fbref.com/en/players/a7813ac4/Daniel-Brosinski"
2019,"Mainz 05","Bundesliga","Niko Bungert","GER","DF","31",1986,3.2,7,5,5,2,0,5,5,100,0,7,6,1,4,11,16,0,"https://fbref.com/en/players/0e0ab524/Niko-Bungert"
2019,"Mainz 05","Bundesliga","Jonathan Burkardt","GER","FW,MF","18",2000,2.9,4,4,2,1,1,1,2,50,1,2,0,2,3,7,5,0,"https://fbref.com/en/players/05f99a4a/Jonathan-Burkardt"
2019,"Mainz 05","Bundesliga","Gaëtan Bussmann","FRA","DF","27",1991,1,2,1,2,0,0,2,5,40,3,0,0,0,1,3,2,0,"https://fbref.com/en/players/278f6efc/Gaetan-Bussmann"
2019,"Mainz 05","Bundesliga","Giulio Donati","ITA","DF","28",1990,6.9,9,7,6,3,0,8,10,80,2,5,3,2,16,25,24,0,"https://fbref.com/en/players/22051fbe/Giulio-Donati"
2019,"Mainz 05","Bundesliga","Jean-Philippe Gbamin","CIV","MF","22",1995,29.7,51,31,29,15,7,23,51,45.1,28,39,5,34,30,81,32,1,"https://fbref.com/en/players/6bd603db/Jean-Philippe-Gbamin"
2019,"Mainz 05","Bundesliga","Ahmet Gürleyen","GER","DF","19",1999,0.1,0,0,0,0,0,0,0,NA,0,0,0,0,0,0,1,0,"https://fbref.com/en/players/c58a9db7/Ahmet-Gurleyen"
2019,"Mainz 05","Bundesliga","Alexander Hack","GER","DF","24",1993,11.3,29,13,20,9,0,19,28,67.9,9,26,15,11,41,70,59,2,"https://fbref.com/en/players/a5ec3ede/Alexander-Hack"
2019,"Mainz 05","Bundesliga","Gerrit Holtmann","PHI","FW,MF","23",1995,1.6,2,0,1,0,1,1,2,50,1,3,2,1,4,6,1,0,"https://fbref.com/en/players/2979c05a/Gerrit-Holtmann"
2019,"Mainz 05","Bundesliga","Pierre Kunde","CMR","MF","23",1995,21.2,48,29,20,26,2,16,27,59.3,11,34,14,20,24,72,49,1,"https://fbref.com/en/players/9ceb7642/Pierre-Kunde"
2019,"Mainz 05","Bundesliga","Danny Latza","GER","MF","28",1989,20.7,41,22,16,23,2,20,61,32.8,41,49,10,39,20,61,31,0,"https://fbref.com/en/players/33b554b7/Danny-Latza"
2019,"Mainz 05","Bundesliga","Aarón Martín","ESP","DF","21",1997,32,55,30,29,21,5,20,38,52.6,18,38,11,27,38,93,75,1,"https://fbref.com/en/players/2f3e911a/Aaron-Martin"
2019,"Mainz 05","Bundesliga","Jean-Philippe Mateta","FRA","FW","21",1997,27.6,13,9,4,4,5,1,10,10,9,15,2,13,3,16,22,0,"https://fbref.com/en/players/50e6dc35/Jean-Philippe-Mateta"
2019,"Mainz 05","Bundesliga","Alexandru Maxim","ROU","MF,FW","28",1990,6.4,16,10,6,9,1,10,19,52.6,9,12,0,12,5,21,7,0,"https://fbref.com/en/players/61fc9685/Alexandru-Maxim"
2019,"Mainz 05","Bundesliga","Florian Müller","GER","GK","20",1997,24,1,1,1,0,0,1,2,50,1,0,0,0,3,4,8,5,"https://fbref.com/en/players/cbac6ec9/Florian-Muller"
2019,"Mainz 05","Bundesliga","Phillipp Mwene","AUT","DF,MF","24",1994,3,7,2,3,4,0,5,6,83.3,1,6,0,6,6,13,10,0,"https://fbref.com/en/players/2ff76adc/Phillipp-Mwene"
2019,"Mainz 05","Bundesliga","Moussa Niakhate","FRA","DF","22",1996,31,49,30,35,12,2,20,33,60.6,13,42,24,18,44,93,143,1,"https://fbref.com/en/players/00242715/Moussa-Niakhate"
2019,"Mainz 05","Bundesliga","Karim Onisiwo","AUT","FW,MF","26",1992,12.9,23,15,6,12,5,4,12,33.3,8,14,3,11,9,32,13,0,"https://fbref.com/en/players/f26834c7/Karim-Onisiwo"
2019,"Mainz 05","Bundesliga","Levin Öztunalı","GER","MF,FW","22",1996,10.2,17,7,5,9,3,4,18,22.2,14,14,2,12,7,24,10,0,"https://fbref.com/en/players/66385c46/Levin-Oztunali"
2019,"Mainz 05","Bundesliga","Robin Quaison","SWE","FW,MF","24",1993,24.4,19,12,3,10,6,5,12,41.7,7,9,1,8,7,26,4,0,"https://fbref.com/en/players/74c7c2db/Robin-Quaison"
2019,"Mainz 05","Bundesliga","Anthony Ujah","NGA","FW","27",1990,8.2,2,0,0,1,1,1,2,50,1,7,2,5,1,3,10,0,"https://fbref.com/en/players/99be8fb5/Anthony-Ujah"
2019,"Mainz 05","Bundesliga","Robin Zentner","GER","GK","23",1994,10,0,0,0,0,0,0,1,0,1,0,0,0,1,1,3,0,"https://fbref.com/en/players/5c4bf6ba/Robin-Zentner"
2019,"Manchester City","Premier League","Sergio Agüero","ARG","FW","30",1988,27.3,17,9,1,10,6,5,9,55.6,4,15,1,14,9,26,3,0,"https://fbref.com/en/players/4d034881/Sergio-Aguero"
2019,"Manchester City","Premier League","Danilo","BRA","DF","27",1991,9,20,16,6,12,2,12,17,70.6,5,5,0,5,15,35,22,1,"https://fbref.com/en/players/94b2001f/Danilo"
2019,"Manchester City","Premier League","Kevin De Bruyne","BEL","MF","27",1991,10.8,22,15,6,12,4,7,21,33.3,14,13,1,12,3,25,2,1,"https://fbref.com/en/players/e46012d4/Kevin-De-Bruyne"
2019,"Manchester City","Premier League","Fabian Delph","ENG","DF","28",1989,8.1,23,14,11,7,5,12,23,52.2,11,3,0,3,13,36,19,1,"https://fbref.com/en/players/111c3236/Fabian-Delph"
2019,"Manchester City","Premier League","Ederson","BRA","GK","24",1993,38,3,3,2,1,0,3,3,100,0,0,0,0,1,4,12,2,"https://fbref.com/en/players/3bb7b8b4/Ederson"
2019,"Manchester City","Premier League","Fernandinho","BRA","MF","33",1985,26.4,57,43,19,30,8,26,47,55.3,21,28,4,24,41,98,70,0,"https://fbref.com/en/players/101da2b5/Fernandinho"
2019,"Manchester City","Premier League","Phil Foden","ENG","MF","18",2000,3.7,7,6,1,3,3,2,9,22.2,7,1,0,1,4,11,1,0,"https://fbref.com/en/players/ed1e53f3/Phil-Foden"
2019,"Manchester City","Premier League","İlkay Gündoğan","GER","MF","27",1990,23.7,19,12,4,12,3,6,31,19.4,25,12,3,9,28,47,19,1,"https://fbref.com/en/players/819b3158/Ilkay-Gundogan"
2019,"Manchester City","Premier League","Gabriel Jesus","BRA","FW","21",1997,11.5,10,3,5,2,3,0,5,0,5,16,2,14,3,13,4,0,"https://fbref.com/en/players/b66315ae/Gabriel-Jesus"
2019,"Manchester City","Premier League","Vincent Kompany","BEL","DF","32",1986,13.6,16,10,11,3,2,8,9,88.9,1,11,8,3,16,32,55,0,"https://fbref.com/en/players/d2bff301/Vincent-Kompany"
2019,"Manchester City","Premier League","Aymeric Laporte","ESP","DF","24",1994,34,42,20,27,14,1,22,34,64.7,12,16,9,7,39,81,98,2,"https://fbref.com/en/players/119b9a8e/Aymeric-Laporte"
2019,"Manchester City","Premier League","Riyad Mahrez","ALG","FW,MF","27",1991,14.9,14,7,3,7,4,6,18,33.3,12,18,1,17,9,23,3,1,"https://fbref.com/en/players/892d5bb1/Riyad-Mahrez"
2019,"Manchester City","Premier League","Benjamin Mendy","FRA","DF","24",1994,10,16,10,10,5,1,9,17,52.9,8,13,4,9,10,26,18,0,"https://fbref.com/en/players/5271c8f1/Benjamin-Mendy"
2019,"Manchester City","Premier League","Nicolás Otamendi","ARG","DF","30",1988,13.7,24,14,17,6,1,5,9,55.6,4,6,4,2,29,53,56,1,"https://fbref.com/en/players/0d267745/Nicolas-Otamendi"
2019,"Manchester City","Premier League","Leroy Sané","GER","FW","22",1996,20.7,24,15,8,7,9,2,23,8.7,21,21,2,19,8,32,2,0,"https://fbref.com/en/players/2b114be3/Leroy-Sane"
2019,"Manchester City","Premier League","Bernardo Silva","POR","MF,FW","23",1994,31.7,52,39,18,21,13,16,67,23.9,51,47,3,44,25,77,26,1,"https://fbref.com/en/players/3eb22ec9/Bernardo-Silva"
2019,"Manchester City","Premier League","David Silva","ESP","MF","32",1986,26.7,30,18,12,11,7,1,20,5,19,18,1,17,22,52,15,0,"https://fbref.com/en/players/e2716bd0/David-Silva"
2019,"Manchester City","Premier League","Raheem Sterling","ENG","FW","23",1994,30.8,32,16,11,12,9,9,25,36,16,28,3,25,17,49,4,0,"https://fbref.com/en/players/b400bde0/Raheem-Sterling"
2019,"Manchester City","Premier League","John Stones","ENG","DF","24",1994,19.6,16,11,9,5,2,4,9,44.4,5,15,9,6,14,30,64,1,"https://fbref.com/en/players/5eecec3d/John-Stones"
2019,"Manchester City","Premier League","Kyle Walker","ENG","DF","28",1990,30.9,40,26,20,20,0,24,38,63.2,14,19,5,14,36,76,58,2,"https://fbref.com/en/players/86dd77d1/Kyle-Walker"
2019,"Manchester City","Premier League","Oleksandr Zinchenko","UKR","DF","21",1996,12.8,34,20,13,15,6,14,33,42.4,19,14,3,11,20,54,19,1,"https://fbref.com/en/players/51cf8561/Oleksandr-Zinchenko"
2019,"Manchester Utd","Premier League","Eric Bailly","CIV","DF","24",1994,7.1,15,9,14,1,0,8,10,80,2,9,4,5,13,28,39,1,"https://fbref.com/en/players/a1232f4e/Eric-Bailly"
2019,"Manchester Utd","Premier League","Tahith Chong","NED","FW","18",1999,0.4,0,0,0,0,0,0,0,NA,0,1,0,1,0,0,1,0,"https://fbref.com/en/players/2696b6a9/Tahith-Chong"
2019,"Manchester Utd","Premier League","Diogo Dalot","POR","DF,FW","19",1999,11.3,24,12,8,14,2,14,19,73.7,5,15,2,13,10,34,35,1,"https://fbref.com/en/players/d9565625/Diogo-Dalot"
2019,"Manchester Utd","Premier League","Matteo Darmian","ITA","DF","28",1989,4.9,14,8,10,4,0,4,11,36.4,7,9,0,9,7,21,20,0,"https://fbref.com/en/players/96e0490d/Matteo-Darmian"
2019,"Manchester Utd","Premier League","Marouane Fellaini","BEL","MF","30",1987,8.4,21,13,11,9,1,9,17,52.9,8,9,5,4,4,25,34,1,"https://fbref.com/en/players/87575fd9/Marouane-Fellaini"
2019,"Manchester Utd","Premier League","Fred","BRA","MF","25",1993,11.6,29,17,12,16,1,15,33,45.5,18,26,2,24,16,45,14,2,"https://fbref.com/en/players/b853e0ad/Fred"
2019,"Manchester Utd","Premier League","James Garner","ENG","MF","17",2001,0,0,0,0,0,0,0,0,NA,0,0,0,0,0,0,0,0,"https://fbref.com/en/players/4e015693/James-Garner"
2019,"Manchester Utd","Premier League","David de Gea","ESP","GK","27",1990,38,0,0,0,0,0,0,2,0,2,1,0,1,0,0,11,4,"https://fbref.com/en/players/7ba6d84e/David-de-Gea"
2019,"Manchester Utd","Premier League","Angel Gomes","ENG","MF,FW","17",2000,0.3,1,0,0,0,1,0,0,NA,0,0,0,0,0,1,0,0,"https://fbref.com/en/players/645a3363/Angel-Gomes"
2019,"Manchester Utd","Premier League","Mason Greenwood","ENG","FW","16",2001,1.3,3,3,2,0,1,2,3,66.7,1,2,0,2,0,3,1,0,"https://fbref.com/en/players/58eee997/Mason-Greenwood"
2019,"Manchester Utd","Premier League","Ander Herrera","ESP","MF","28",1989,15.6,54,28,24,22,8,21,61,34.4,40,38,6,32,37,91,25,1,"https://fbref.com/en/players/436a9dd0/Ander-Herrera"
2019,"Manchester Utd","Premier League","Phil Jones","ENG","DF","26",1992,14,19,13,12,7,0,8,13,61.5,5,16,11,5,23,42,67,3,"https://fbref.com/en/players/def899bd/Phil-Jones"
2019,"Manchester Utd","Premier League","Victor Lindelöf","SWE","DF","24",1994,28.9,40,27,28,12,0,13,23,56.5,10,21,12,9,24,64,121,3,"https://fbref.com/en/players/f5deef4c/Victor-Lindelof"
2019,"Manchester Utd","Premier League","Jesse Lingard","ENG","FW,MF","25",1992,18.5,29,18,8,11,10,7,28,25,21,18,2,16,10,39,9,1,"https://fbref.com/en/players/810e3c74/Jesse-Lingard"
2019,"Manchester Utd","Premier League","Romelu Lukaku","BEL","FW","25",1993,23.7,8,4,0,6,2,2,10,20,8,12,1,11,2,10,19,0,"https://fbref.com/en/players/5eae500a/Romelu-Lukaku"
2019,"Manchester Utd","Premier League","Anthony Martial","FRA","FW","22",1995,18,9,7,2,5,2,1,11,9.1,10,12,0,12,3,12,8,0,"https://fbref.com/en/players/8b788c01/Anthony-Martial"
2019,"Manchester Utd","Premier League","Juan Mata","ESP","FW,MF","30",1988,14.3,9,4,7,1,1,6,21,28.6,15,8,1,7,6,15,6,0,"https://fbref.com/en/players/29733c72/Juan-Mata"
2019,"Manchester Utd","Premier League","Nemanja Matić","SRB","MF","29",1988,27.1,50,30,27,19,4,30,59,50.8,29,39,18,21,31,81,53,4,"https://fbref.com/en/players/eb7822d7/Nemanja-Matic"
2019,"Manchester Utd","Premier League","Scott McTominay","SCO","MF,DF","21",1996,9.6,10,9,3,6,1,4,10,40,6,9,4,5,15,25,16,0,"https://fbref.com/en/players/d93c2511/Scott-McTominay"
2019,"Manchester Utd","Premier League","Andreas Pereira","BRA","MF","22",1996,6.7,8,6,5,2,1,4,15,26.7,11,9,2,7,11,19,8,1,"https://fbref.com/en/players/6639e500/Andreas-Pereira"
2019,"Manchester Utd","Premier League","Paul Pogba","FRA","MF","25",1993,33.4,47,30,21,21,5,17,43,39.5,26,30,9,21,18,65,39,0,"https://fbref.com/en/players/867239d3/Paul-Pogba"
2019,"Manchester Utd","Premier League","Marcus Rashford","ENG","FW","20",1997,25.9,24,12,4,12,8,7,29,24.1,22,27,0,27,3,27,24,0,"https://fbref.com/en/players/a1d5bd30/Marcus-Rashford"
2019,"Manchester Utd","Premier League","Marcos Rojo","ARG","DF","28",1990,2.4,5,3,3,2,0,1,6,16.7,5,3,2,1,6,11,9,1,"https://fbref.com/en/players/e0991c04/Marcos-Rojo"
2019,"Manchester Utd","Premier League","Alexis Sánchez","CHI","FW,MF","29",1988,9.8,17,10,5,9,3,5,13,38.5,8,7,0,7,9,26,2,0,"https://fbref.com/en/players/2c0f8e9e/Alexis-Sanchez"
2019,"Manchester Utd","Premier League","Luke Shaw","ENG","DF","23",1995,28.8,55,29,17,31,7,28,47,59.6,19,42,12,30,21,76,93,2,"https://fbref.com/en/players/9c94165b/Luke-Shaw"
2019,"Manchester Utd","Premier League","Chris Smalling","ENG","DF","28",1989,23.6,30,17,21,9,0,11,17,64.7,6,37,25,12,26,56,109,1,"https://fbref.com/en/players/b6964eb6/Chris-Smalling"
2019,"Manchester Utd","Premier League","Antonio Valencia","ECU","DF","32",1985,5.2,8,6,2,4,2,3,4,75,1,9,0,9,5,13,10,0,"https://fbref.com/en/players/08aa17d0/Antonio-Valencia"
2019,"Manchester Utd","Premier League","Ashley Young","ENG","DF","33",1985,28.5,52,32,34,16,2,20,39,51.3,19,36,10,26,55,107,74,0,"https://fbref.com/en/players/be927d03/Ashley-Young"
2019,"Marseille","Ligue 1","Jordan Amavi","FRA","DF","24",1994,24.2,74,50,34,26,14,35,56,62.5,21,24,8,16,46,120,93,4,"https://fbref.com/en/players/22721b88/Jordan-Amavi"
2019,"Marseille","Ligue 1","Mario Balotelli","ITA","FW","27",1990,10.4,5,3,1,3,1,2,7,28.6,5,8,2,6,3,8,6,0,"https://fbref.com/en/players/8ff07990/Mario-Balotelli"
2019,"Marseille","Ligue 1","Duje Ćaleta-Car","CRO","DF","21",1996,17.2,22,16,14,8,0,14,18,77.8,4,15,9,6,20,42,86,2,"https://fbref.com/en/players/94f8d10c/Duje-Caleta-Car"
2019,"Marseille","Ligue 1","Valère Germain","FRA","FW","28",1990,24.1,38,25,8,22,8,8,33,24.2,25,20,5,15,6,44,30,0,"https://fbref.com/en/players/ea0ff634/Valere-Germain"
2019,"Marseille","Ligue 1","Luiz Gustavo","BRA","MF,DF","31",1987,27.1,72,43,49,18,5,30,66,45.5,36,26,12,14,34,106,61,0,"https://fbref.com/en/players/82671804/Luiz-Gustavo"
2019,"Marseille","Ligue 1","Tomáš Hubočan","SVK","DF","32",1985,0.8,3,2,3,0,0,3,4,75,1,0,0,0,2,5,5,0,"https://fbref.com/en/players/97b87472/Tomas-Hubocan"
2019,"Marseille","Ligue 1","Boubacar Kamara","FRA","DF","18",1999,26.8,67,39,38,24,5,32,49,65.3,17,24,13,11,45,112,95,2,"https://fbref.com/en/players/cc77354e/Boubacar-Kamara"
2019,"Marseille","Ligue 1","Maxime Lopez","FRA","MF","20",1997,24.2,46,24,17,23,6,19,53,35.8,34,10,2,8,20,66,8,0,"https://fbref.com/en/players/20094685/Maxime-Lopez"
2019,"Marseille","Ligue 1","Steve Mandanda","FRA","GK","33",1985,30.4,0,0,0,0,0,0,3,0,3,0,0,0,1,1,7,4,"https://fbref.com/en/players/1d2d5cc8/Steve-Mandanda"
2019,"Marseille","Ligue 1","Kostas Mitroglou","GRE","FW","30",1988,6.4,0,0,0,0,0,0,3,0,3,0,0,0,0,0,5,0,"https://fbref.com/en/players/c6ac6579/Kostas-Mitroglou"
2019,"Marseille","Ligue 1","Clinton N'Jie","CMR","FW","24",1993,4,7,4,2,3,2,3,3,100,0,2,0,2,2,9,0,0,"https://fbref.com/en/players/77f278a0/Clinton-NJie"
2019,"Marseille","Ligue 1","Lucas Ocampos","ARG","FW,MF","24",1994,30.1,80,54,37,33,10,34,80,42.5,46,40,5,35,29,109,30,0,"https://fbref.com/en/players/a08b974a/Lucas-Ocampos"
2019,"Marseille","Ligue 1","Dimitri Payet","FRA","MF,FW","31",1987,21.2,11,9,2,8,1,5,22,22.7,17,14,0,14,8,19,8,0,"https://fbref.com/en/players/58ae47b2/Dimitri-Payet"
2019,"Marseille","Ligue 1","Yohann Pelé","FRA","GK","35",1982,7.6,0,0,0,0,0,0,2,0,2,0,0,0,0,0,1,1,"https://fbref.com/en/players/76806215/Yohann-Pele"
2019,"Marseille","Ligue 1","Nemanja Radonjić","SRB","FW,MF","22",1996,7.6,8,5,1,5,2,5,16,31.3,11,3,0,3,5,13,4,0,"https://fbref.com/en/players/0630eb63/Nemanja-Radonjic"
2019,"Marseille","Ligue 1","Adil Rami","FRA","DF","32",1985,15.7,14,9,12,2,0,8,12,66.7,4,14,14,0,18,32,52,3,"https://fbref.com/en/players/8dbff17c/Adil-Rami"
2019,"Marseille","Ligue 1","Christopher Rocchia","FRA","DF","20",1998,0,0,0,0,0,0,0,0,NA,0,0,0,0,0,0,1,0,"https://fbref.com/en/players/aa21406e/Christopher-Rocchia"
2019,"Marseille","Ligue 1","Rolando","POR","DF","32",1985,8.9,18,7,15,3,0,8,10,80,2,8,6,2,11,29,25,0,"https://fbref.com/en/players/0eeafda5/Rolando"
2019,"Marseille","Ligue 1","Hiroki Sakai","JPN","DF","28",1990,26.4,59,41,30,23,6,29,54,53.7,25,25,10,15,37,96,77,0,"https://fbref.com/en/players/d63e2912/Hiroki-Sakai"
2019,"Marseille","Ligue 1","Morgan Sanson","FRA","MF","23",1994,26.7,70,47,27,35,8,21,77,27.3,56,40,1,39,42,112,8,1,"https://fbref.com/en/players/6e7f1353/Morgan-Sanson"
2019,"Marseille","Ligue 1","Bouna Sarr","SEN","DF,MF","26",1992,24.9,67,48,27,27,13,26,42,61.9,16,28,3,25,39,106,56,1,"https://fbref.com/en/players/1a4b9094/Bouna-Sarr"
2019,"Marseille","Ligue 1","Grégory Sertic","FRA","MF","28",1989,1.2,2,0,1,1,0,0,1,0,1,2,1,1,1,3,2,0,"https://fbref.com/en/players/c4527123/Gregory-Sertic"
2019,"Marseille","Ligue 1","Kevin Strootman","NED","MF","28",1990,21.6,76,40,21,47,8,20,52,38.5,32,24,6,18,24,100,26,0,"https://fbref.com/en/players/ef2e5e1a/Kevin-Strootman"
2019,"Marseille","Ligue 1","Florian Thauvin","FRA","FW,MF","25",1993,29,42,23,10,21,11,16,35,45.7,19,19,1,18,8,50,4,0,"https://fbref.com/en/players/2b9fdeea/Florian-Thauvin"
2019,"Milan","Serie A","Ignazio Abate","ITA","DF","31",1986,14.5,34,19,16,13,5,14,22,63.6,8,19,6,13,18,52,50,0,"https://fbref.com/en/players/1c529186/Ignazio-Abate"
2019,"Milan","Serie A","Tiemoué Bakayoko","FRA","MF","23",1994,25.6,69,43,22,40,7,26,62,41.9,36,34,5,29,50,119,42,2,"https://fbref.com/en/players/59bf127b/Tiemoue-Bakayoko"
2019,"Milan","Serie A","Lucas Biglia","ARG","MF","32",1986,12.4,60,33,31,25,4,20,45,44.4,25,19,3,16,22,82,21,1,"https://fbref.com/en/players/5710a281/Lucas-Biglia"
2019,"Milan","Serie A","Giacomo Bonaventura","ITA","MF","28",1989,7.2,6,2,2,4,0,2,7,28.6,5,3,0,3,7,13,8,0,"https://fbref.com/en/players/d995ed27/Giacomo-Bonaventura"
2019,"Milan","Serie A","Fabio Borini","ITA","FW,DF","27",1991,11.7,14,10,7,7,0,3,9,33.3,6,17,0,17,12,26,28,0,"https://fbref.com/en/players/ef5b337e/Fabio-Borini"
2019,"Milan","Serie A","Davide Calabria","ITA","DF","21",1996,21.7,79,51,58,16,5,37,67,55.2,30,33,1,32,32,111,78,1,"https://fbref.com/en/players/2146785a/Davide-Calabria"
2019,"Milan","Serie A","Hakan Çalhanoğlu","TUR","MF,FW","24",1994,32,52,31,27,16,9,23,46,50,23,27,5,22,28,80,19,0,"https://fbref.com/en/players/cd0fa27b/Hakan-Calhanoglu"
2019,"Milan","Serie A","Samu Castillejo","ESP","FW,MF","23",1995,11.4,15,10,10,2,3,4,25,16,21,16,0,16,8,23,11,0,"https://fbref.com/en/players/130a7a3f/Samu-Castillejo"
2019,"Milan","Serie A","Andrea Conti","ITA","DF","24",1994,5.6,9,5,3,4,2,2,9,22.2,7,4,0,4,15,24,12,1,"https://fbref.com/en/players/8fef5412/Andrea-Conti"
2019,"Milan","Serie A","Patrick Cutrone","ITA","FW","20",1998,16.2,9,5,0,3,6,2,16,12.5,14,13,2,11,7,16,13,0,"https://fbref.com/en/players/a4fe8cda/Patrick-Cutrone"
2019,"Milan","Serie A","Gianluigi Donnarumma","ITA","GK","19",1999,34.3,1,1,1,0,0,1,2,50,1,0,0,0,1,2,13,3,"https://fbref.com/en/players/08f5afaa/Gianluigi-Donnarumma"
2019,"Milan","Serie A","Gonzalo Higuaín","ARG","FW","30",1987,14.2,8,6,1,5,2,5,13,38.5,8,3,0,3,0,8,11,1,"https://fbref.com/en/players/8a08491a/Gonzalo-Higuain"
2019,"Milan","Serie A","Franck Kessié","CIV","MF","21",1996,33.5,42,27,16,20,6,18,38,47.4,20,35,10,25,27,69,53,2,"https://fbref.com/en/players/05e19d6a/Franck-Kessie"
2019,"Milan","Serie A","Diego Laxalt","URU","DF,MF","25",1993,7.2,26,13,14,7,5,13,22,59.1,9,23,3,20,8,34,12,0,"https://fbref.com/en/players/f26e3c59/Diego-Laxalt"
2019,"Milan","Serie A","José Mauri","ITA","MF","22",1996,2.3,8,4,2,6,0,2,6,33.3,4,0,0,0,5,13,0,0,"https://fbref.com/en/players/644faf10/Jose-Mauri"
2019,"Milan","Serie A","Mateo Musacchio","ARG","DF","27",1990,29,41,22,30,8,3,19,27,70.4,8,26,19,7,29,70,114,0,"https://fbref.com/en/players/91899ca8/Mateo-Musacchio"
2019,"Milan","Serie A","Lucas Paquetá","BRA","MF","20",1997,9.4,18,9,9,8,1,7,24,29.2,17,12,0,12,4,22,11,2,"https://fbref.com/en/players/9b6f7fd5/Lucas-Paqueta"
2019,"Milan","Serie A","Krzysztof Piątek","POL","FW","23",1995,15.3,8,6,2,1,5,3,10,30,7,7,2,5,1,9,15,0,"https://fbref.com/en/players/17f3620a/Krzysztof-Piatek"
2019,"Milan","Serie A","Pepe Reina","ESP","GK","35",1982,3.7,0,0,0,0,0,0,0,NA,0,0,0,0,0,0,1,0,"https://fbref.com/en/players/e358587b/Pepe-Reina"
2019,"Milan","Serie A","Ricardo Rodríguez","SUI","DF","25",1992,33.9,57,32,34,21,2,32,39,82.1,7,25,5,20,38,95,98,0,"https://fbref.com/en/players/7f78ad23/Ricardo-Rodriguez"
2019,"Milan","Serie A","Alessio Romagnoli","ITA","DF","23",1995,31.6,34,19,26,6,2,16,19,84.2,3,48,32,16,37,71,173,1,"https://fbref.com/en/players/3ead85f9/Alessio-Romagnoli"
2019,"Milan","Serie A","Suso","ESP","FW,MF","24",1993,33.5,28,18,10,14,4,10,41,24.4,31,26,1,25,16,44,3,0,"https://fbref.com/en/players/4e219ad2/Suso"
2019,"Milan","Serie A","Cristián Zapata","COL","DF","31",1986,11.4,23,16,15,7,1,9,10,90,1,18,15,3,8,31,59,0,"https://fbref.com/en/players/b1deecf8/Cristian-Zapata"
2019,"Monaco","Ligue 1","Jean-Eudes Aholou","CIV","MF","24",1994,11.9,20,11,6,11,3,8,16,50,8,7,0,7,17,37,12,0,"https://fbref.com/en/players/48b28bfd/Jean-Eudes-Aholou"
2019,"Monaco","Ligue 1","Youssef Aït Bennasser","MAR","MF","22",1996,11.9,33,16,14,18,1,13,29,44.8,16,15,5,10,15,48,19,0,"https://fbref.com/en/players/c46fa34c/Youssef-Ait-Bennasser"
2019,"Monaco","Ligue 1","Benoît Badiashile","FRA","DF","17",2001,19.6,25,18,18,7,0,17,25,68,8,12,5,7,21,46,79,2,"https://fbref.com/en/players/06df8256/Benoit-Badiashile"
2019,"Monaco","Ligue 1","Fodé Ballo-Touré","SEN","DF","21",1997,17.7,46,31,26,16,4,20,40,50,20,20,2,18,28,74,38,2,"https://fbref.com/en/players/f449640d/Fode-Ballo-Toure"
2019,"Monaco","Ligue 1","Antonio Barreca","ITA","DF","23",1995,6.6,11,8,8,3,0,7,11,63.6,4,3,2,1,7,18,18,0,"https://fbref.com/en/players/6a189491/Antonio-Barreca"
2019,"Monaco","Ligue 1","Diego Benaglio","SUI","GK","34",1983,22.9,1,0,1,0,0,1,1,100,0,0,0,0,0,1,16,0,"https://fbref.com/en/players/b7e7937d/Diego-Benaglio"
2019,"Monaco","Ligue 1","Giulian Biancone","FRA","DF","18",2000,1,4,3,4,0,0,1,3,33.3,2,0,0,0,3,7,2,0,"https://fbref.com/en/players/de40e38c/Giulian-Biancone"
2019,"Monaco","Ligue 1","Nacer Chadli","BEL","MF,DF","28",1989,7.7,11,5,4,4,3,3,8,37.5,5,7,1,6,3,14,7,0,"https://fbref.com/en/players/5b54bf3b/Nacer-Chadli"
2019,"Monaco","Ligue 1","Sofiane Diop","FRA","MF,FW","18",2000,8.2,12,7,3,6,3,1,15,6.7,14,6,0,6,8,20,6,0,"https://fbref.com/en/players/19053e31/Sofiane-Diop"
2019,"Monaco","Ligue 1","Cesc Fàbregas","ESP","MF","31",1987,10.7,14,10,5,5,4,8,28,28.6,20,12,3,9,9,23,5,1,"https://fbref.com/en/players/33508c78/Cesc-Fabregas"
2019,"Monaco","Ligue 1","Romain Faivre","FRA","MF","20",1998,1,1,0,0,1,0,0,1,0,1,0,0,0,1,2,1,1,"https://fbref.com/en/players/745ca0a3/Romain-Faivre"
2019,"Monaco","Ligue 1","Radamel Falcao","COL","FW","32",1986,28.4,34,15,6,16,12,8,27,29.6,19,11,6,5,3,37,23,2,"https://fbref.com/en/players/66116290/Radamel-Falcao"
2019,"Monaco","Ligue 1","Willem Geubbels","FRA","MF","16",2001,0.1,0,0,0,0,0,0,0,NA,0,0,0,0,0,0,0,0,"https://fbref.com/en/players/9836e892/Willem-Geubbels"
2019,"Monaco","Ligue 1","Kamil Glik","POL","DF","30",1988,33,32,23,26,5,1,16,32,50,16,25,17,8,61,93,200,1,"https://fbref.com/en/players/c6056d58/Kamil-Glik"
2019,"Monaco","Ligue 1","Aleksandr Golovin","RUS","MF,FW","22",1996,25.4,36,17,3,20,13,10,44,22.7,34,34,3,31,22,58,12,0,"https://fbref.com/en/players/3708e9fa/Aleksandr-Golovin"
2019,"Monaco","Ligue 1","Samuel Grandsir","FRA","FW,MF","21",1996,5.2,12,7,4,5,3,2,10,20,8,11,0,11,1,13,5,1,"https://fbref.com/en/players/d2448564/Samuel-Grandsir"
2019,"Monaco","Ligue 1","Benjamin Henrichs","GER","DF,MF","21",1997,20.3,58,39,32,22,4,16,38,42.1,22,18,0,18,35,93,45,0,"https://fbref.com/en/players/0a89e877/Benjamin-Henrichs"
2019,"Monaco","Ligue 1","Wilson Isidor","FRA","FW","17",2000,0.5,0,0,0,0,0,0,0,NA,0,1,1,0,0,0,1,0,"https://fbref.com/en/players/a671316d/Wilson-Isidor"
2019,"Monaco","Ligue 1","Jemerson","BRA","DF,MF","25",1992,24.7,54,38,34,19,1,29,46,63,17,29,17,12,25,79,121,1,"https://fbref.com/en/players/7cab69b5/Jemerson"
2019,"Monaco","Ligue 1","Stevan Jovetić","MNE","MF,FW","28",1989,4.4,2,1,1,1,0,1,3,33.3,2,1,0,1,1,3,3,0,"https://fbref.com/en/players/f36c432f/Stevan-Jovetic"
2019,"Monaco","Ligue 1","Rony Lopes","POR","FW,MF","22",1995,20.5,33,22,10,17,6,9,22,40.9,13,17,1,16,8,41,10,0,"https://fbref.com/en/players/7c2965bb/Rony-Lopes"
2019,"Monaco","Ligue 1","Gelson Martins","POR","FW,MF","23",1995,15.4,20,12,8,7,5,13,32,40.6,19,9,1,8,8,28,7,0,"https://fbref.com/en/players/3ef0fa48/Gelson-Martins"
2019,"Monaco","Ligue 1","Han-Noah Massengo","FRA","MF","17",2001,0.7,2,2,2,0,0,2,5,40,3,0,0,0,2,4,1,0,"https://fbref.com/en/players/eba1e557/Han-Noah-Massengo"
2019,"Monaco","Ligue 1","Jordi Mboula","ESP","FW,MF","19",1999,3.1,3,0,0,1,2,3,6,50,3,1,0,1,1,4,5,0,"https://fbref.com/en/players/4887118d/Jordi-Mboula"
2019,"Monaco","Ligue 1","Kévin N'Doram","FRA","DF,MF","22",1996,2.2,5,4,1,4,0,3,5,60,2,1,1,0,5,10,8,1,"https://fbref.com/en/players/e50623a0/Kevin-NDoram"
2019,"Monaco","Ligue 1","Georges-Kévin N'Koudou","CMR","FW","23",1995,0.3,2,1,0,0,2,1,1,100,0,2,0,2,0,2,0,0,"https://fbref.com/en/players/76c131da/Georges-Kevin-NKoudou"
2019,"Monaco","Ligue 1","Naldo","BRA","DF","35",1982,3.3,5,3,4,1,0,2,4,50,2,5,2,3,5,10,23,0,"https://fbref.com/en/players/03bd0bf4/Naldo"
2019,"Monaco","Ligue 1","Pelé","GNB","MF","26",1991,5.2,8,7,3,5,0,2,6,33.3,4,2,1,1,3,11,10,0,"https://fbref.com/en/players/743fdcd3/Pele"
2019,"Monaco","Ligue 1","Pietro Pellegri","ITA","FW,MF","17",2001,0.9,1,1,0,0,1,0,0,NA,0,0,0,0,0,1,0,0,"https://fbref.com/en/players/a44d3a3c/Pietro-Pellegri"
2019,"Monaco","Ligue 1","Ronaël Pierre-Gabriel","FRA","DF","20",1998,3.9,13,8,10,2,1,9,10,90,1,3,1,2,3,16,18,0,"https://fbref.com/en/players/64ba07c0/Ronael-Pierre-Gabriel"
2019,"Monaco","Ligue 1","Andrea Raggi","ITA","DF","34",1984,5.5,7,5,7,0,0,6,6,100,0,1,0,1,7,14,21,0,"https://fbref.com/en/players/bd4f5f94/Andrea-Raggi"
2019,"Monaco","Ligue 1","Julien Serrano","FRA","MF,DF","20",1998,1.3,5,4,3,2,0,3,6,50,3,1,0,1,3,8,3,0,"https://fbref.com/en/players/7fb301af/Julien-Serrano"
2019,"Monaco","Ligue 1","Djibril Sidibé","FRA","DF,MF","26",1992,23.1,50,34,27,12,11,26,48,54.2,22,25,9,16,30,80,51,0,"https://fbref.com/en/players/4c5b714f/Djibril-Sidibe"
2019,"Monaco","Ligue 1","Adrien Silva","POR","MF","29",1989,13.2,50,31,19,26,5,30,62,48.4,32,15,2,13,16,66,23,0,"https://fbref.com/en/players/d6f88a1d/Adrien-Silva"
2019,"Monaco","Ligue 1","Danijel Subašić","CRO","GK","33",1984,12.6,0,0,0,0,0,0,1,0,1,0,0,0,0,0,6,2,"https://fbref.com/en/players/f6db3bd5/Danijel-Subasic"
2019,"Monaco","Ligue 1","Seydou Sy","SEN","GK","22",1995,2.5,0,0,0,0,0,0,0,NA,0,0,0,0,0,0,0,1,"https://fbref.com/en/players/8417953b/Seydou-Sy"
2019,"Monaco","Ligue 1","Moussa Sylla","FRA","FW,MF","18",1999,8.5,6,4,4,1,1,2,6,33.3,4,5,2,3,2,8,5,0,"https://fbref.com/en/players/d8b97bb3/Moussa-Sylla"
2019,"Monaco","Ligue 1","Youri Tielemans","BEL","MF","21",1997,18.7,45,24,17,23,5,24,47,51.1,23,20,3,17,18,63,22,0,"https://fbref.com/en/players/56f7a928/Youri-Tielemans"
2019,"Monaco","Ligue 1","Almamy Touré","MLI","DF","22",1996,3.8,13,6,6,7,0,3,10,30,7,3,1,2,11,24,12,0,"https://fbref.com/en/players/c8c60119/Almamy-Toure"
2019,"Monaco","Ligue 1","Adama Traoré","MLI","MF","23",1995,2.7,2,1,1,0,1,1,4,25,3,4,0,4,3,5,1,0,"https://fbref.com/en/players/1a6f2a66/Adama-Traore"
2019,"Monaco","Ligue 1","William Vainqueur","FRA","MF","29",1988,0.9,6,3,4,2,0,1,1,100,0,1,0,1,0,6,0,0,"https://fbref.com/en/players/92cd4bef/William-Vainqueur"
2019,"Monaco","Ligue 1","Carlos Vinícius","BRA","FW,MF","23",1995,5.8,4,1,1,2,1,0,1,0,1,7,0,7,1,5,2,0,"https://fbref.com/en/players/8b529245/Carlos-Vinicius"
2019,"Montpellier","Ligue 1","Ruben Aguilar","FRA","DF","25",1993,28.1,88,51,40,33,15,39,69,56.5,30,23,3,20,37,125,50,1,"https://fbref.com/en/players/3dd738a1/Ruben-Aguilar"
2019,"Montpellier","Ligue 1","Yanis Ammour","FRA","MF","19",1999,0,0,0,0,0,0,0,0,NA,0,0,0,0,0,0,0,0,"https://fbref.com/en/players/aeed036d/Yanis-Ammour"
2019,"Montpellier","Ligue 1","Dimitry Bertaud","FRA","GK","20",1998,1,0,0,0,0,0,0,0,NA,0,0,0,0,0,0,0,0,"https://fbref.com/en/players/380a15e2/Dimitry-Bertaud"
2019,"Montpellier","Ligue 1","Bilal Boutobba","FRA","FW,MF","19",1998,0.4,0,0,0,0,0,0,2,0,2,0,0,0,0,0,0,0,"https://fbref.com/en/players/e8a65bc8/Bilal-Boutobba"
2019,"Montpellier","Ligue 1","Souleymane Camara","SEN","FW,MF","35",1982,1.5,0,0,0,0,0,0,2,0,2,0,0,0,0,0,3,0,"https://fbref.com/en/players/c58270f8/Souleymane-Camara"
2019,"Montpellier","Ligue 1","Daniel Congré","FRA","DF","33",1985,36.6,75,45,46,26,3,38,65,58.5,27,35,15,20,67,142,106,1,"https://fbref.com/en/players/3f5b4635/Daniel-Congre"
2019,"Montpellier","Ligue 1","Nicolas Cozza","FRA","DF","19",1999,10.9,19,15,14,5,0,4,10,40,6,13,10,3,23,42,37,1,"https://fbref.com/en/players/8f325097/Nicolas-Cozza"
2019,"Montpellier","Ligue 1","Andy Delort","ALG","FW","26",1991,34.6,34,20,7,20,7,8,34,23.5,26,28,7,21,4,38,7,0,"https://fbref.com/en/players/d33c706e/Andy-Delort"
2019,"Montpellier","Ligue 1","Keagan Dolly","RSA","FW","25",1993,1,1,1,0,1,0,0,3,0,3,0,0,0,0,1,0,0,"https://fbref.com/en/players/ccb1c3af/Keagan-Dolly"
2019,"Montpellier","Ligue 1","Vitorino Hilton","BRA","DF","40",1977,35.9,33,13,28,5,0,12,30,40,18,31,15,16,66,99,198,2,"https://fbref.com/en/players/c4bbea9f/Vitorino-Hilton"
2019,"Montpellier","Ligue 1","Gaëtan Laborde","FRA","FW,MF","24",1994,32.2,36,15,6,15,15,11,27,40.7,16,18,2,16,6,42,27,0,"https://fbref.com/en/players/7cdda3bf/Gaetan-Laborde"
2019,"Montpellier","Ligue 1","Paul Lasne","FRA","MF,DF","29",1989,19.9,53,33,32,16,5,24,43,55.8,19,22,2,20,22,75,23,1,"https://fbref.com/en/players/542cc80f/Paul-Lasne"
2019,"Montpellier","Ligue 1","Damien Le Tallec","FRA","MF","28",1990,31.2,95,58,42,43,10,33,89,37.1,56,35,8,27,59,154,50,0,"https://fbref.com/en/players/8f4d116f/Damien-Le-Tallec"
2019,"Montpellier","Ligue 1","Benjamin Lecomte","FRA","GK","27",1991,37,1,0,1,0,0,1,3,33.3,2,0,0,0,5,6,24,3,"https://fbref.com/en/players/2fa2a875/Benjamin-Lecomte"
2019,"Montpellier","Ligue 1","Pedro Mendes","POR","DF","27",1990,29.6,71,42,56,13,2,31,47,66,16,42,22,20,48,119,73,1,"https://fbref.com/en/players/6690ef25/Pedro-Mendes"
2019,"Montpellier","Ligue 1","Florent Mollet","FRA","MF","26",1991,28.5,36,20,8,20,8,13,51,25.5,38,32,1,31,23,59,7,0,"https://fbref.com/en/players/7e82a78f/Florent-Mollet"
2019,"Montpellier","Ligue 1","Ambroise Oyongo","CMR","DF","27",1991,23.7,44,21,23,16,5,20,38,52.6,18,26,6,20,38,82,60,0,"https://fbref.com/en/players/e3e05edf/Ambroise-Oyongo"
2019,"Montpellier","Ligue 1","Facundo Píriz","URU","MF,FW","28",1990,1.3,9,6,3,4,2,4,9,44.4,5,2,1,1,0,9,2,0,"https://fbref.com/en/players/fca455cc/Facundo-Piriz"
2019,"Montpellier","Ligue 1","Morgan Poaty","CGO","MF","21",1997,1,1,1,1,0,0,0,0,NA,0,1,0,1,0,1,2,0,"https://fbref.com/en/players/7add56e1/Morgan-Poaty"
2019,"Montpellier","Ligue 1","Mihailo Ristić","SRB","DF,MF","22",1995,3.6,14,9,8,5,1,6,10,60,4,11,3,8,9,23,6,0,"https://fbref.com/en/players/ea0aa7e0/Mihailo-Ristic"
2019,"Montpellier","Ligue 1","Junior Sambia","FRA","MF,FW","21",1996,10.3,15,7,7,7,1,6,15,40,9,14,2,12,5,20,3,0,"https://fbref.com/en/players/24eb7ed6/Junior-Sambia"
2019,"Montpellier","Ligue 1","Giovanni Sio","CIV","FW","29",1989,0.7,0,0,0,0,0,0,0,NA,0,0,0,0,0,0,0,0,"https://fbref.com/en/players/0fe7f7bc/Giovanni-Sio"
2019,"Montpellier","Ligue 1","Ellyes Skhiri","TUN","MF","23",1995,34.3,105,58,31,64,10,43,91,47.3,48,60,7,53,60,165,41,0,"https://fbref.com/en/players/c2211709/Ellyes-Skhiri"
2019,"Montpellier","Ligue 1","Petar Škuletić","SRB","FW","28",1990,6.7,9,5,4,2,3,1,15,6.7,14,7,1,6,3,12,14,1,"https://fbref.com/en/players/d9a66c60/Petar-Skuletic"
2019,"Montpellier","Ligue 1","Mathías Suárez","URU","DF","22",1996,6.1,20,11,7,10,3,10,23,43.5,13,11,0,11,9,29,18,0,"https://fbref.com/en/players/0c291a1a/Mathias-Suarez"
2019,"Nantes","Ligue 1","Alexis Alegue","FRA","FW","21",1996,0.1,1,0,0,1,0,0,0,NA,0,0,0,0,0,1,0,0,"https://fbref.com/en/players/0f4c0bad/Alexis-Alegue"
2019,"Nantes","Ligue 1","Thomas Basila","FRA","DF","19",1999,1,2,1,1,1,0,0,0,NA,0,2,1,1,0,2,8,0,"https://fbref.com/en/players/65391fa7/Thomas-Basila"
2019,"Nantes","Ligue 1","Gabriel Boschilia","BRA","FW,MF","22",1996,14.7,33,23,11,9,13,8,33,24.2,25,14,2,12,8,41,7,0,"https://fbref.com/en/players/e90af77c/Gabriel-Boschilia"
2019,"Nantes","Ligue 1","Diego Carlos","BRA","DF","25",1993,35,58,34,43,14,1,26,33,78.8,7,44,31,13,50,108,186,1,"https://fbref.com/en/players/b4a014b1/Diego-Carlos"
2019,"Nantes","Ligue 1","Kalifa Coulibaly","MLI","FW","26",1991,19.5,15,7,1,10,4,4,11,36.4,7,8,1,7,4,19,22,0,"https://fbref.com/en/players/9980269a/Kalifa-Coulibaly"
2019,"Nantes","Ligue 1","Abdoulaye Dabo","FRA","FW","17",2001,1.3,3,1,1,0,2,0,0,NA,0,0,0,0,0,3,0,0,"https://fbref.com/en/players/797f6070/Abdoulaye-Dabo"
2019,"Nantes","Ligue 1","Koffi Djidji","CIV","DF","25",1992,1,1,1,1,0,0,0,0,NA,0,1,1,0,1,2,3,0,"https://fbref.com/en/players/933d3b51/Koffi-Djidji"
2019,"Nantes","Ligue 1","Maxime Dupé","FRA","GK","25",1993,10.4,0,0,0,0,0,0,0,NA,0,0,0,0,0,0,3,1,"https://fbref.com/en/players/0e12089d/Maxime-Dupe"
2019,"Nantes","Ligue 1","Lucas Evangelista","BRA","FW,MF","23",1995,8,30,17,11,12,7,14,25,56,11,10,0,10,9,39,6,0,"https://fbref.com/en/players/5f4ce4b6/Lucas-Evangelista"
2019,"Nantes","Ligue 1","Valentin Eysseric","FRA","MF,FW","26",1992,2.3,1,1,0,1,0,0,2,0,2,2,0,2,0,1,0,0,"https://fbref.com/en/players/ae82fa48/Valentin-Eysseric"
2019,"Nantes","Ligue 1","Fábio","BRA","DF,FW","28",1990,14.2,53,34,25,27,1,26,53,49.1,27,18,4,14,18,71,27,0,"https://fbref.com/en/players/bc7b4580/Fabio"
2019,"Nantes","Ligue 1","Andrei Girotto","BRA","MF","26",1992,16.4,57,40,18,36,3,20,44,45.5,24,22,6,16,29,86,43,1,"https://fbref.com/en/players/3befc2b6/Andrei-Girotto"
2019,"Nantes","Ligue 1","Edgar Ié","POR","DF","24",1994,8.6,20,13,12,6,2,9,16,56.3,7,10,3,7,8,28,23,0,"https://fbref.com/en/players/3767b3b7/Edgar-Ie"
2019,"Nantes","Ligue 1","Randal Kolo Muani","FRA","FW","19",1998,1.4,2,0,1,1,0,0,1,0,1,2,0,2,0,2,2,0,"https://fbref.com/en/players/c0b3669f/Randal-Kolo-Muani"
2019,"Nantes","Ligue 1","Rene Krhin","SVN","MF","28",1990,11.7,22,14,7,12,3,11,19,57.9,8,7,4,3,21,43,32,0,"https://fbref.com/en/players/9a506145/Rene-Krhin"
2019,"Nantes","Ligue 1","Enock Kwateng","FRA","DF","21",1997,22.7,65,41,34,27,4,33,70,47.1,37,28,4,24,78,143,56,0,"https://fbref.com/en/players/4bf69118/Enock-Kwateng"
2019,"Nantes","Ligue 1","Lucas Lima","BRA","DF,FW","26",1991,27.7,49,28,26,15,8,20,53,37.7,33,39,3,36,29,78,62,1,"https://fbref.com/en/players/0f52f925/Lucas-Lima"
2019,"Nantes","Ligue 1","Anthony Limbombe","BEL","FW","24",1994,13.7,12,10,4,6,2,7,16,43.8,9,5,0,5,8,20,10,0,"https://fbref.com/en/players/ccee698e/Anthony-Limbombe"
2019,"Nantes","Ligue 1","Imran Louza","MAR","MF","19",1999,1,2,0,1,1,0,1,1,100,0,1,0,1,0,2,1,0,"https://fbref.com/en/players/e1df6989/Imran-Louza"
2019,"Nantes","Ligue 1","Abdul Majeed Waris","GHA","FW,MF","26",1991,25,22,13,6,13,3,7,28,25,21,9,0,9,7,29,7,0,"https://fbref.com/en/players/46907171/Abdul-Majeed-Waris"
2019,"Nantes","Ligue 1","Antonio Mance","CRO","FW","22",1995,0.6,1,1,0,0,1,1,2,50,1,0,0,0,0,1,0,0,"https://fbref.com/en/players/171bf11d/Antonio-Mance"
2019,"Nantes","Ligue 1","Kara Mbodji","SEN","DF","28",1989,5.6,12,10,10,1,1,6,8,75,2,4,1,3,6,18,25,0,"https://fbref.com/en/players/8325870c/Kara-Mbodji"
2019,"Nantes","Ligue 1","Matt Miazga","USA","DF","23",1995,8,12,11,11,1,0,7,9,77.8,2,11,7,4,12,24,41,1,"https://fbref.com/en/players/9fc0f253/Matt-Miazga"
2019,"Nantes","Ligue 1","Samuel Moutoussamy","COD","MF,FW","21",1996,18.3,35,20,16,11,8,12,34,35.3,22,17,2,15,9,44,17,0,"https://fbref.com/en/players/af0c835b/Samuel-Moutoussamy"
2019,"Nantes","Ligue 1","Alexandre Olliero","FRA","GK","22",1996,1,0,0,0,0,0,0,0,NA,0,0,0,0,0,0,0,0,"https://fbref.com/en/players/c977ef13/Alexandre-Olliero"
2019,"Nantes","Ligue 1","Nicolas Pallois","FRA","DF","30",1987,24,77,48,60,17,0,40,69,58,29,30,14,16,34,111,114,0,"https://fbref.com/en/players/779847d6/Nicolas-Pallois"
2019,"Nantes","Ligue 1","Valentin Rongier","FRA","MF","23",1994,35.8,86,54,24,46,16,26,65,40,39,46,6,40,33,119,19,0,"https://fbref.com/en/players/ed45c4a5/Valentin-Rongier"
2019,"Nantes","Ligue 1","Emiliano Sala","ARG","FW","27",1990,15.2,7,5,0,2,5,1,8,12.5,7,8,1,7,2,9,20,0,"https://fbref.com/en/players/5d59e0df/Emiliano-Sala"
2019,"Nantes","Ligue 1","Ciprian Tătărușanu","ROU","GK","32",1986,26.6,0,0,0,0,0,0,0,NA,0,0,0,0,2,2,20,0,"https://fbref.com/en/players/b056e3da/Ciprian-Tatarusanu"
2019,"Nantes","Ligue 1","Abdoulaye Touré","FRA","MF","24",1994,30.5,48,31,14,28,6,19,56,33.9,37,25,10,15,47,95,29,1,"https://fbref.com/en/players/ef7cd87a/Abdoulaye-Toure"
2019,"Nantes","Ligue 1","Charles Traore","MLI","DF,FW","26",1992,12.9,40,20,22,16,2,23,34,67.6,11,16,3,13,19,59,46,0,"https://fbref.com/en/players/de488e56/Charles-Traore"
2019,"Nantes","Ligue 1","Anthony Walongwa","COD","DF","24",1993,1,0,0,0,0,0,0,0,NA,0,3,2,1,1,1,2,0,"https://fbref.com/en/players/eb78322b/Anthony-Walongwa"
2019,"Nantes","Ligue 1","Elie Youan","FRA","FW","19",1999,0.2,1,0,0,1,0,0,0,NA,0,0,0,0,0,1,0,0,"https://fbref.com/en/players/698b37b8/Elie-Youan"
2019,"Napoli","Serie A","Raúl Albiol","ESP","DF","32",1985,19,16,8,12,4,0,8,15,53.3,7,19,16,3,20,36,90,1,"https://fbref.com/en/players/4bd414c1/Raul-Albiol"
2019,"Napoli","Serie A","Allan","BRA","MF","27",1991,29.1,106,70,39,55,12,36,107,33.6,71,55,13,42,36,142,28,0,"https://fbref.com/en/players/cc700722/Allan"
2019,"Napoli","Serie A","José Callejón","ESP","MF,FW","31",1987,29.4,34,18,12,14,8,18,57,31.6,39,34,5,29,22,56,11,0,"https://fbref.com/en/players/78841da9/Jose-Callejon"
2019,"Napoli","Serie A","Vlad Chiricheș","ROU","DF","28",1989,1.6,2,1,1,1,0,0,2,0,2,2,2,0,1,3,2,0,"https://fbref.com/en/players/c316607a/Vlad-Chiriches"
2019,"Napoli","Serie A","Amadou Diawara","GUI","MF","21",1997,7.3,12,4,1,9,2,4,5,80,1,6,0,6,11,23,12,0,"https://fbref.com/en/players/bf309d24/Amadou-Diawara"
2019,"Napoli","Serie A","Gianluca Gaetano","ITA","MF,FW","18",2000,0.1,0,0,0,0,0,0,0,NA,0,0,0,0,0,0,0,0,"https://fbref.com/en/players/3b387cc7/Gianluca-Gaetano"
2019,"Napoli","Serie A","Faouzi Ghoulam","ALG","DF","27",1991,12.8,9,7,3,5,1,8,9,88.9,1,6,2,4,8,17,17,0,"https://fbref.com/en/players/c5adc293/Faouzi-Ghoulam"
2019,"Napoli","Serie A","Marek Hamšík","SVK","MF","31",1987,10.2,7,5,2,4,1,0,11,0,11,8,1,7,12,19,14,1,"https://fbref.com/en/players/e6ad16b2/Marek-Hamsik"
2019,"Napoli","Serie A","Elseid Hysaj","ALB","DF","24",1994,23.4,40,28,22,15,3,25,49,51,24,11,3,8,24,64,51,0,"https://fbref.com/en/players/2f3452eb/Elseid-Hysaj"
2019,"Napoli","Serie A","Lorenzo Insigne","ITA","FW,MF","27",1991,23,14,4,5,6,3,6,18,33.3,12,7,0,7,8,22,3,0,"https://fbref.com/en/players/2f557579/Lorenzo-Insigne"
2019,"Napoli","Serie A","Orestis Karnezis","GRE","GK","33",1985,9,0,0,0,0,0,0,0,NA,0,0,0,0,0,0,3,0,"https://fbref.com/en/players/85b011bb/Orestis-Karnezis"
2019,"Napoli","Serie A","Kalidou Koulibaly","SEN","DF","27",1991,34.8,61,40,37,22,2,19,36,52.8,17,55,33,22,40,101,144,0,"https://fbref.com/en/players/da974c7b/Kalidou-Koulibaly"
2019,"Napoli","Serie A","Sebastiano Luperto","ITA","DF","21",1996,8.1,8,6,5,2,1,2,5,40,3,7,3,4,13,21,30,0,"https://fbref.com/en/players/997fff07/Sebastiano-Luperto"
2019,"Napoli","Serie A","Nikola Maksimović","SRB","DF","26",1991,15.3,20,13,14,6,0,6,12,50,6,16,10,6,28,48,56,1,"https://fbref.com/en/players/16b9d5cf/Nikola-Maksimovic"
2019,"Napoli","Serie A","Kévin Malcuit","MAR","DF","27",1991,20.1,43,31,23,14,6,23,36,63.9,13,18,4,14,44,87,67,0,"https://fbref.com/en/players/d6a889ea/Kevin-Malcuit"
2019,"Napoli","Serie A","Alex Meret","ITA","GK","21",1997,12.8,0,0,0,0,0,0,0,NA,0,0,0,0,0,0,3,1,"https://fbref.com/en/players/9413b19f/Alex-Meret"
2019,"Napoli","Serie A","Dries Mertens","BEL","FW","31",1987,25,19,11,2,7,10,1,21,4.8,20,7,0,7,13,32,3,0,"https://fbref.com/en/players/89b2c8a9/Dries-Mertens"
2019,"Napoli","Serie A","Arkadiusz Milik","POL","FW","24",1994,26.6,19,9,1,8,10,1,20,5,19,7,2,5,3,22,15,0,"https://fbref.com/en/players/85613cf0/Arkadiusz-Milik"
2019,"Napoli","Serie A","David Ospina","COL","GK","29",1988,16.2,1,0,1,0,0,1,1,100,0,0,0,0,0,1,7,1,"https://fbref.com/en/players/82b1198a/David-Ospina"
2019,"Napoli","Serie A","Adam Ounas","ALG","MF,FW","21",1996,6,5,2,0,3,2,2,11,18.2,9,6,0,6,2,7,0,1,"https://fbref.com/en/players/ed90babd/Adam-Ounas"
2019,"Napoli","Serie A","Marko Rog","CRO","MF","23",1995,3.7,12,9,3,7,2,5,11,45.5,6,8,2,6,5,17,1,0,"https://fbref.com/en/players/b6b2b820/Marko-Rog"
2019,"Napoli","Serie A","Mário Rui","POR","DF","27",1991,15.7,24,18,9,12,3,14,25,56,11,15,3,12,21,45,38,0,"https://fbref.com/en/players/0b5a292a/Mario-Rui"
2019,"Napoli","Serie A","Fabián Ruiz Peña","ESP","MF","22",1996,22.1,54,33,22,25,7,20,46,43.5,26,23,4,19,21,75,29,2,"https://fbref.com/en/players/c0c7ff58/Fabian-Ruiz-Pena"
2019,"Napoli","Serie A","Simone Verdi","ITA","MF,FW","26",1992,7.8,16,11,5,9,2,8,16,50,8,6,0,6,4,20,3,0,"https://fbref.com/en/players/0375723e/Simone-Verdi"
2019,"Napoli","Serie A","Amin Younes","GER","MF,FW","24",1993,5.5,11,6,3,6,2,3,6,50,3,7,0,7,2,13,0,0,"https://fbref.com/en/players/228f73ae/Amin-Younes"
2019,"Napoli","Serie A","Piotr Zieliński","POL","MF","24",1994,31.9,41,25,11,20,10,13,34,38.2,21,30,4,26,20,61,18,0,"https://fbref.com/en/players/a5296e55/Piotr-Zielinski"
2019,"Newcastle Utd","Premier League","Miguel Almirón","PAR","MF","24",1994,8.4,20,12,7,10,3,4,10,40,6,14,1,13,8,28,5,0,"https://fbref.com/en/players/862a1c15/Miguel-Almiron"
2019,"Newcastle Utd","Premier League","Christian Atsu","GHA","MF","26",1992,16.6,24,15,9,11,4,5,16,31.3,11,13,3,10,7,31,16,0,"https://fbref.com/en/players/8816329f/Christian-Atsu"
2019,"Newcastle Utd","Premier League","Antonio Barreca","ITA","DF","23",1995,0.1,0,0,0,0,0,0,0,NA,0,0,0,0,0,0,0,0,"https://fbref.com/en/players/6a189491/Antonio-Barreca"
2019,"Newcastle Utd","Premier League","Ciaran Clark","IRL","DF","28",1989,9.5,20,17,15,5,0,9,12,75,3,11,7,4,12,32,58,0,"https://fbref.com/en/players/2b91cf8e/Ciaran-Clark"
2019,"Newcastle Utd","Premier League","Mohamed Diamé","SEN","MF","31",1987,24.1,76,46,35,36,5,16,54,29.6,38,42,9,33,30,106,39,1,"https://fbref.com/en/players/b7d082af/Mohamed-Diame"
2019,"Newcastle Utd","Premier League","Martin Dúbravka","SVK","GK","29",1989,38,2,0,2,0,0,1,3,33.3,2,0,0,0,0,2,20,5,"https://fbref.com/en/players/3a949a25/Martin-Dubravka"
2019,"Newcastle Utd","Premier League","Paul Dummett","WAL","DF","26",1991,22.1,34,22,24,9,1,19,32,59.4,13,25,11,14,37,71,133,0,"https://fbref.com/en/players/3fe6bd8c/Paul-Dummett"
2019,"Newcastle Utd","Premier League","Federico Fernández","ARG","DF","29",1989,16.5,16,12,12,4,0,10,18,55.6,8,19,12,7,25,41,106,1,"https://fbref.com/en/players/f25b010f/Federico-Fernandez"
2019,"Newcastle Utd","Premier League","Isaac Hayden","ENG","MF","23",1995,20.7,73,43,19,45,9,23,41,56.1,18,32,4,28,40,113,30,0,"https://fbref.com/en/players/c951a6df/Isaac-Hayden"
2019,"Newcastle Utd","Premier League","Joselu","ESP","FW","28",1990,6.6,14,8,4,5,5,4,9,44.4,5,5,0,5,3,17,15,0,"https://fbref.com/en/players/6265208f/Joselu"
2019,"Newcastle Utd","Premier League","Kenedy","BRA","MF,DF","22",1996,15,30,22,11,16,3,12,29,41.4,17,10,0,10,32,62,24,1,"https://fbref.com/en/players/5eebbfdf/Kenedy"
2019,"Newcastle Utd","Premier League","Jamaal Lascelles","ENG","DF","24",1993,30.5,32,21,25,5,2,11,14,78.6,3,43,28,15,39,71,218,3,"https://fbref.com/en/players/450ab6fc/Jamaal-Lascelles"
2019,"Newcastle Utd","Premier League","Florian Lejeune","FRA","DF","27",1991,11.7,25,15,17,7,1,11,24,45.8,13,16,5,11,21,46,49,0,"https://fbref.com/en/players/6eaed4eb/Florian-Lejeune"
2019,"Newcastle Utd","Premier League","Sean Longstaff","ENG","MF","20",1997,7.6,17,13,6,11,0,9,24,37.5,15,19,4,15,10,27,7,0,"https://fbref.com/en/players/a2b105e0/Sean-Longstaff"
2019,"Newcastle Utd","Premier League","Javier Manquillo","ESP","DF","24",1994,12.2,27,19,14,11,2,9,14,64.3,5,9,1,8,17,44,58,0,"https://fbref.com/en/players/758dd7f0/Javier-Manquillo"
2019,"Newcastle Utd","Premier League","Jacob Murphy","ENG","MF,DF","23",1995,3.4,6,2,4,2,0,2,4,50,2,5,2,3,1,7,7,0,"https://fbref.com/en/players/de112b84/Jacob-Murphy"
2019,"Newcastle Utd","Premier League","Yoshinori Mutō","JPN","FW,MF","26",1992,5.8,8,4,3,5,0,2,7,28.6,5,9,0,9,5,13,3,1,"https://fbref.com/en/players/5343eb4e/Yoshinori-Muto"
2019,"Newcastle Utd","Premier League","Ayoze Pérez","ESP","MF,FW","25",1993,32.4,59,22,24,28,7,17,63,27,46,55,4,51,42,101,33,1,"https://fbref.com/en/players/819aa8e7/Ayoze-Perez"
2019,"Newcastle Utd","Premier League","Matt Ritchie","SCO","DF,MF","28",1989,32.5,70,44,35,27,8,19,47,40.4,28,34,11,23,51,121,76,1,"https://fbref.com/en/players/71ef519e/Matt-Ritchie"
2019,"Newcastle Utd","Premier League","Salomón Rondón","VEN","FW","28",1989,28.9,8,3,2,4,2,4,24,16.7,20,14,3,11,5,13,39,0,"https://fbref.com/en/players/b318a643/Salomon-Rondon"
2019,"Newcastle Utd","Premier League","Fabian Schär","SUI","DF","26",1991,22.2,60,39,37,19,4,24,50,48,26,40,16,24,67,127,145,2,"https://fbref.com/en/players/c8aa95da/Fabian-Schar"
2019,"Newcastle Utd","Premier League","Jonjo Shelvey","ENG","MF","26",1992,10.5,22,12,10,9,3,8,17,47.1,9,10,3,7,7,29,15,0,"https://fbref.com/en/players/3727dd3c/Jonjo-Shelvey"
2019,"Newcastle Utd","Premier League","Ki Sung-yueng","KOR","MF","29",1989,14.5,14,10,5,8,1,3,12,25,9,11,1,10,19,33,20,0,"https://fbref.com/en/players/1d8c99b0/Ki-Sung-yueng"
2019,"Newcastle Utd","Premier League","DeAndre Yedlin","USA","DF","25",1993,27.5,54,32,36,14,4,19,41,46.3,22,36,10,26,28,82,88,0,"https://fbref.com/en/players/ae0a7ddf/DeAndre-Yedlin"
2019,"Nice","Ligue 1","Youcef Atal","ALG","DF,FW","22",1996,25.1,68,44,34,25,9,34,67,50.7,33,38,8,30,56,124,42,0,"https://fbref.com/en/players/6a827d8e/Youcef-Atal"
2019,"Nice","Ligue 1","Mario Balotelli","ITA","FW","27",1990,8.4,1,0,0,1,0,1,4,25,3,9,1,8,1,2,8,0,"https://fbref.com/en/players/8ff07990/Mario-Balotelli"
2019,"Nice","Ligue 1","Danilo Barbosa","BRA","MF","22",1996,17.2,29,20,13,13,3,6,17,35.3,11,17,2,15,15,44,25,1,"https://fbref.com/en/players/0557ff4f/Danilo-Barbosa"
2019,"Nice","Ligue 1","Walter Benítez","ARG","GK","25",1993,35,1,0,1,0,0,1,2,50,1,0,0,0,2,3,6,2,"https://fbref.com/en/players/8a2248b4/Walter-Benitez"
2019,"Nice","Ligue 1","Olivier Boscagli","FRA","DF","20",1997,9.6,20,12,14,4,2,9,20,45,11,12,1,11,17,37,37,0,"https://fbref.com/en/players/403f5d20/Olivier-Boscagli"
2019,"Nice","Ligue 1","Pedro Brazão","POR","MF,FW","15",2002,0.2,0,0,0,0,0,0,1,0,1,0,0,0,0,0,0,0,"https://fbref.com/en/players/0589c701/Pedro-Brazao"
2019,"Nice","Ligue 1","Patrick Burner","MTQ","DF","22",1996,15,36,23,22,10,4,16,34,47.1,18,15,5,10,31,67,40,0,"https://fbref.com/en/players/8746d5d0/Patrick-Burner"
2019,"Nice","Ligue 1","Yoan Cardinale","FRA","GK","24",1994,3,1,0,1,0,0,1,1,100,0,0,0,0,0,1,1,0,"https://fbref.com/en/players/950ff24d/Yoan-Cardinale"
2019,"Nice","Ligue 1","Racine Coly","SEN","DF,MF","22",1995,5.6,7,2,1,5,1,4,11,36.4,7,6,1,5,9,16,11,1,"https://fbref.com/en/players/166a981d/Racine-Coly"
2019,"Nice","Ligue 1","Wylan Cyprien","FRA","MF","23",1995,26.2,40,20,16,21,3,15,43,34.9,28,20,5,15,11,51,15,0,"https://fbref.com/en/players/3e092724/Wylan-Cyprien"
2019,"Nice","Ligue 1","Dante","BRA","DF","34",1983,35.8,54,40,36,16,2,24,41,58.5,17,56,30,26,38,92,156,2,"https://fbref.com/en/players/fd2bc67d/Dante"
2019,"Nice","Ligue 1","Ignatius Ganago","CMR","FW","19",1999,11.5,3,1,0,2,1,0,7,0,7,2,0,2,1,4,7,0,"https://fbref.com/en/players/23c63b7f/Ignatius-Ganago"
2019,"Nice","Ligue 1","Christophe Hérelle","MTQ","DF","25",1992,32.6,72,52,51,19,2,40,50,80,10,39,16,23,61,133,158,2,"https://fbref.com/en/players/3681cfff/Christophe-Herelle"
2019,"Nice","Ligue 1","Christophe Jallet","FRA","DF","34",1983,9.8,29,21,12,13,4,16,27,59.3,11,21,5,16,14,43,32,0,"https://fbref.com/en/players/46d50339/Christophe-Jallet"
2019,"Nice","Ligue 1","Assil Jaziri","TUN","FW","18",1999,0.4,2,2,0,2,0,1,2,50,1,1,0,1,1,3,0,0,"https://fbref.com/en/players/dd73120f/Assil-Jaziri"
2019,"Nice","Ligue 1","Mohamed Lamine Diaby","FRA","FW","17",2001,1.8,1,1,0,1,0,1,1,100,0,2,0,2,2,3,0,0,"https://fbref.com/en/players/15e99107/Mohamed-Lamine-Diaby"
2019,"Nice","Ligue 1","Mickaël Le Bihan","FRA","FW","28",1990,2.3,1,1,0,1,0,1,2,50,1,1,0,1,1,2,1,0,"https://fbref.com/en/players/d512db65/Mickael-Le-Bihan"
2019,"Nice","Ligue 1","Pierre Lees-Melou","FRA","MF","25",1993,26.6,74,46,31,36,7,25,62,40.3,37,44,8,36,36,110,37,0,"https://fbref.com/en/players/f5044e54/Pierre-Lees-Melou"
2019,"Nice","Ligue 1","Jean-Victor Makengo","FRA","MF,FW","20",1998,11.4,10,8,3,6,1,1,5,20,4,5,1,4,9,19,5,0,"https://fbref.com/en/players/22bfb57e/Jean-Victor-Makengo"
2019,"Nice","Ligue 1","Myziane Maolida","FRA","FW","19",1999,10.6,12,8,5,5,2,2,4,50,2,5,0,5,1,13,5,0,"https://fbref.com/en/players/706a60e1/Myziane-Maolida"
2019,"Nice","Ligue 1","Maxime Pélican","FRA","FW,MF","20",1998,1,1,1,0,1,0,0,0,NA,0,1,0,1,0,1,0,0,"https://fbref.com/en/players/09f24df6/Maxime-Pelican"
2019,"Nice","Ligue 1","Andy Pelmard","FRA","DF","18",2000,3.1,5,5,3,2,0,1,4,25,3,0,0,0,3,8,3,0,"https://fbref.com/en/players/f18d7ab2/Andy-Pelmard"
2019,"Nice","Ligue 1","Ihsan Sacko","FRA","FW","21",1997,4.9,7,2,2,5,0,2,5,40,3,5,0,5,2,9,2,0,"https://fbref.com/en/players/68a87d66/Ihsan-Sacko"
2019,"Nice","Ligue 1","Allan Saint-Maximin","FRA","FW","21",1997,32.2,12,6,1,7,4,2,14,14.3,12,11,0,11,4,16,3,0,"https://fbref.com/en/players/2b16cb1a/Allan-Saint-Maximin"
2019,"Nice","Ligue 1","Malang Sarr","FRA","DF","19",1999,33.3,59,36,38,17,4,31,57,54.4,26,29,12,17,68,127,107,2,"https://fbref.com/en/players/4315f30d/Malang-Sarr"
2019,"Nice","Ligue 1","Bassem Srarfi","TUN","FW,MF","21",1997,9.1,20,11,8,8,4,6,17,35.3,11,8,0,8,5,25,5,0,"https://fbref.com/en/players/84549a07/Bassem-Srarfi"
2019,"Nice","Ligue 1","Eddy Sylvestre","FRA","FW,MF","18",1999,3,3,2,0,3,0,3,9,33.3,6,1,0,1,0,3,0,0,"https://fbref.com/en/players/ff3a6a60/Eddy-Sylvestre"
2019,"Nice","Ligue 1","Adrien Tameze","CMR","MF","24",1994,32.7,74,44,32,31,11,39,92,42.4,53,53,12,41,56,130,59,1,"https://fbref.com/en/players/8da74c05/Adrien-Tameze"
2019,"Nice","Ligue 1","Paul Wade","FRA","MF","18",2000,0.1,0,0,0,0,0,0,3,0,3,0,0,0,0,0,1,0,"https://fbref.com/en/players/cfd41fad/Paul-Wade"
2019,"Nice","Ligue 1","Rémi Walter","FRA","MF","23",1995,9.3,20,12,7,10,3,5,15,33.3,10,9,1,8,6,26,11,0,"https://fbref.com/en/players/0984c5d5/Remi-Walter"
2019,"Nîmes","Ligue 1","Sofiane Alakouch","MAR","DF","20",1998,21.1,81,44,44,31,6,36,63,57.1,27,15,4,11,46,127,57,0,"https://fbref.com/en/players/5314e067/Sofiane-Alakouch"
2019,"Nîmes","Ligue 1","Rachid Alioui","MAR","FW","26",1992,13.9,15,5,3,9,3,4,9,44.4,5,8,1,7,10,25,11,0,"https://fbref.com/en/players/bdedd861/Rachid-Alioui"
2019,"Nîmes","Ligue 1","Paul Bernardoni","FRA","GK","21",1997,38,1,1,1,0,0,1,2,50,1,0,0,0,1,2,20,1,"https://fbref.com/en/players/28dabd43/Paul-Bernardoni"
2019,"Nîmes","Ligue 1","Antonin Bobichon","FRA","MF","22",1995,23.9,34,16,17,12,5,16,58,27.6,42,15,3,12,15,49,13,0,"https://fbref.com/en/players/7d937aa1/Antonin-Bobichon"
2019,"Nîmes","Ligue 1","Denis Bouanga","GAB","MF,FW","23",1994,29.3,52,32,21,22,9,13,61,21.3,48,24,3,21,20,72,16,0,"https://fbref.com/en/players/0b0cbe5b/Denis-Bouanga"
2019,"Nîmes","Ligue 1","Umut Bozok","TUR","FW","21",1996,13.7,9,6,0,3,6,2,4,50,2,3,0,3,5,14,1,0,"https://fbref.com/en/players/6e2c94ad/Umut-Bozok"
2019,"Nîmes","Ligue 1","Anthony Briançon","FRA","DF","23",1994,32.5,46,27,36,10,0,27,50,54,23,51,38,13,70,116,184,1,"https://fbref.com/en/players/16324e1d/Anthony-Briancon"
2019,"Nîmes","Ligue 1","Clément Depres","FRA","FW","23",1994,4.9,2,2,1,1,0,1,4,25,3,3,0,3,0,2,6,0,"https://fbref.com/en/players/e53ab10b/Clement-Depres"
2019,"Nîmes","Ligue 1","Mustapha Diallo","SEN","MF","32",1986,5.1,16,11,6,9,1,5,13,38.5,8,7,1,6,10,26,14,1,"https://fbref.com/en/players/6c6ecdd4/Mustapha-Diallo"
2019,"Nîmes","Ligue 1","Jordan Ferri","FRA","MF","26",1992,20.8,52,31,22,23,7,26,62,41.9,36,27,2,25,15,67,9,1,"https://fbref.com/en/players/375622c5/Jordan-Ferri"
2019,"Nîmes","Ligue 1","Baptiste Guillaume","BEL","FW","23",1995,13.1,12,6,1,8,3,2,9,22.2,7,6,0,6,2,14,6,0,"https://fbref.com/en/players/9453d2f4/Baptiste-Guillaume"
2019,"Nîmes","Ligue 1","Féthi Harek","ALG","DF","35",1982,2,4,4,2,2,0,3,4,75,1,1,0,1,1,5,6,0,"https://fbref.com/en/players/d880dc16/Fethi-Harek"
2019,"Nîmes","Ligue 1","Loïck Landre","FRA","DF","26",1992,17.7,31,21,23,8,0,14,22,63.6,8,16,11,5,38,69,83,1,"https://fbref.com/en/players/08082af0/Loick-Landre"
2019,"Nîmes","Ligue 1","Hervé Lybohy","NIG","DF","35",1983,16.4,22,13,13,9,0,11,16,68.8,5,17,11,6,14,36,70,0,"https://fbref.com/en/players/dc709ab5/Herve-Lybohy"
2019,"Nîmes","Ligue 1","Faitout Maouassa","FRA","DF","20",1998,23.7,55,30,35,15,5,23,39,59,16,24,5,19,23,78,81,1,"https://fbref.com/en/players/e54a9890/Faitout-Maouassa"
2019,"Nîmes","Ligue 1","Florian Miguel","FRA","DF","21",1996,12.4,19,16,13,6,0,7,11,63.6,4,15,7,8,21,40,47,0,"https://fbref.com/en/players/b66d1d8a/Florian-Miguel"
2019,"Nîmes","Ligue 1","Gaëtan Paquiez","FRA","DF","24",1994,14.8,43,29,30,10,3,23,48,47.9,25,24,6,18,22,65,50,0,"https://fbref.com/en/players/475583ff/Gaetan-Paquiez"
2019,"Nîmes","Ligue 1","Renaud Ripart","FRA","FW,DF","25",1993,33.4,76,49,41,22,13,32,76,42.1,44,43,7,36,27,103,79,0,"https://fbref.com/en/players/beae3a73/Renaud-Ripart"
2019,"Nîmes","Ligue 1","Théo Sainte-Luce","FRA","MF","19",1998,0,0,0,0,0,0,0,0,NA,0,0,0,0,0,0,0,0,"https://fbref.com/en/players/93c942fb/Theo-Sainte-Luce"
2019,"Nîmes","Ligue 1","Téji Savanier","FRA","MF","26",1991,31.8,95,58,35,52,8,43,116,37.1,73,32,15,17,64,159,53,2,"https://fbref.com/en/players/6bde367b/Teji-Savanier"
2019,"Nîmes","Ligue 1","Sada Thioub","SEN","MF,FW","23",1995,27.5,30,19,13,10,7,20,45,44.4,25,29,1,28,16,46,11,0,"https://fbref.com/en/players/f4bc42b1/Sada-Thioub"
2019,"Nîmes","Ligue 1","Pierrick Valdivia","FRA","MF","30",1988,0.3,1,1,0,1,0,1,2,50,1,1,0,1,1,2,0,0,"https://fbref.com/en/players/e562a02e/Pierrick-Valdivia"
2019,"Nîmes","Ligue 1","Theo Valls","FRA","MF","22",1995,19.7,37,21,16,19,2,15,43,34.9,28,17,4,13,22,59,15,0,"https://fbref.com/en/players/c8090cb3/Theo-Valls"
2019,"Nürnberg","Bundesliga","Robert Bauer","GER","DF","23",1995,19.1,48,29,32,13,3,20,39,51.3,19,19,5,14,28,76,80,0,"https://fbref.com/en/players/9b88e120/Robert-Bauer"
2019,"Nürnberg","Bundesliga","Hanno Behrens","GER","MF","28",1990,29.3,46,26,29,17,0,21,47,44.7,26,43,13,30,33,79,49,0,"https://fbref.com/en/players/77b41ac0/Hanno-Behrens"
2019,"Nürnberg","Bundesliga","Fabian Bredlow","GER","GK","23",1995,12.5,1,1,1,0,0,1,1,100,0,0,0,0,1,2,3,4,"https://fbref.com/en/players/d28339cb/Fabian-Bredlow"
2019,"Nürnberg","Bundesliga","Patrick Erras","GER","MF","23",1995,13.6,15,10,7,7,1,7,19,36.8,12,24,13,11,23,38,45,0,"https://fbref.com/en/players/e3f6253d/Patrick-Erras"
2019,"Nürnberg","Bundesliga","Ewerton","BRA","DF","29",1989,14.9,24,20,21,3,0,8,14,57.1,6,23,16,7,25,49,108,1,"https://fbref.com/en/players/78cd577c/Ewerton"
2019,"Nürnberg","Bundesliga","Alexander Fuchs","GER","MF,FW","21",1997,7.3,14,12,5,7,2,5,15,33.3,10,9,1,8,5,19,10,0,"https://fbref.com/en/players/9c9bd01f/Alexander-Fuchs"
2019,"Nürnberg","Bundesliga","Kevin Goden","GER","DF,MF","19",1999,3,4,3,3,1,0,2,7,28.6,5,4,1,3,4,8,11,0,"https://fbref.com/en/players/25c633b0/Kevin-Goden"
2019,"Nürnberg","Bundesliga","Ivo Iličević","CRO","MF","31",1986,0.4,1,0,0,1,0,1,2,50,1,1,0,1,0,1,0,0,"https://fbref.com/en/players/4e3e4138/Ivo-Ilicevic"
2019,"Nürnberg","Bundesliga","Mikael Ishak","SWE","FW","25",1993,21.3,9,6,3,6,0,3,16,18.8,13,8,3,5,3,12,10,0,"https://fbref.com/en/players/0c3057a9/Mikael-Ishak"
2019,"Nürnberg","Bundesliga","Lukas Jäger","AUT","FW,MF","24",1994,0.3,0,0,0,0,0,0,2,0,2,0,0,0,0,0,0,0,"https://fbref.com/en/players/6be813ab/Lukas-Jager"
2019,"Nürnberg","Bundesliga","Sebastian Kerk","GER","MF,FW","24",1994,13.1,16,9,8,5,3,7,23,30.4,16,14,5,9,3,19,22,1,"https://fbref.com/en/players/87fdfb9b/Sebastian-Kerk"
2019,"Nürnberg","Bundesliga","Törles Knöll","GER","FW,MF","20",1997,4.1,3,2,1,1,1,0,4,0,4,5,1,4,0,3,2,0,"https://fbref.com/en/players/b883006f/Torles-Knoll"
2019,"Nürnberg","Bundesliga","Yuya Kubo","JPN","FW,MF","24",1993,15.1,21,11,6,10,5,12,33,36.4,21,11,0,11,10,31,6,0,"https://fbref.com/en/players/cba16a46/Yuya-Kubo"
2019,"Nürnberg","Bundesliga","Tim Leibold","GER","DF","24",1993,30.7,62,42,45,16,1,33,71,46.5,38,23,3,20,38,100,57,0,"https://fbref.com/en/players/f2571c91/Tim-Leibold"
2019,"Nürnberg","Bundesliga","Eduard Löwen","GER","MF,FW","21",1997,18,30,22,14,13,3,11,34,32.4,23,15,2,13,8,38,23,0,"https://fbref.com/en/players/70678132/Eduard-Lowen"
2019,"Nürnberg","Bundesliga","Georg Margreitter","AUT","DF","29",1988,22.9,39,24,28,8,3,31,38,81.6,7,29,26,3,26,65,141,0,"https://fbref.com/en/players/b5114f85/Georg-Margreitter"
2019,"Nürnberg","Bundesliga","Christian Mathenia","GER","GK","26",1992,21.5,0,0,0,0,0,0,0,NA,0,1,0,1,1,1,18,2,"https://fbref.com/en/players/4a15e95b/Christian-Mathenia"
2019,"Nürnberg","Bundesliga","Virgil Misidjan","NED","MF,FW","25",1993,17.1,21,13,10,5,6,4,25,16,21,17,0,17,9,30,5,0,"https://fbref.com/en/players/09bcc566/Virgil-Misidjan"
2019,"Nürnberg","Bundesliga","Lukas Mühl","GER","DF","21",1997,31,57,34,49,6,2,32,51,62.7,19,53,18,35,48,105,139,2,"https://fbref.com/en/players/6b32d0a6/Lukas-Muhl"
2019,"Nürnberg","Bundesliga","Federico Palacios Martínez","GER","MF,FW","23",1995,10.5,21,10,11,8,2,10,20,50,10,10,0,10,9,30,4,0,"https://fbref.com/en/players/434cf5b7/Federico-Palacios-Martinez"
2019,"Nürnberg","Bundesliga","Matheus Pereira","POR","MF,FW","22",1996,13.7,16,11,4,8,4,2,13,15.4,11,15,2,13,14,30,7,0,"https://fbref.com/en/players/b04ee927/Matheus-Pereira"
2019,"Nürnberg","Bundesliga","Ondřej Petrák","CZE","MF","26",1992,18,36,24,17,18,1,14,25,56,11,18,4,14,40,76,22,0,"https://fbref.com/en/players/3e81a228/Ondrej-Petrak"
2019,"Nürnberg","Bundesliga","Simon Rhein","GER","MF","20",1998,5.5,7,4,7,0,0,2,7,28.6,5,6,1,5,7,14,6,0,"https://fbref.com/en/players/8f6bfe11/Simon-Rhein"
2019,"Nürnberg","Bundesliga","Edgar Salli","CMR","FW,MF","25",1992,1.3,2,1,1,1,0,0,1,0,1,0,0,0,1,3,1,0,"https://fbref.com/en/players/41d1fbc6/Edgar-Salli"
2019,"Nürnberg","Bundesliga","Timothy Tillman","GER","FW,MF","19",1999,2.3,0,0,0,0,0,0,4,0,4,3,0,3,3,3,0,2,"https://fbref.com/en/players/a5bea1fb/Timothy-Tillman"
2019,"Nürnberg","Bundesliga","Enrico Valentini","ITA","DF","29",1989,14.4,44,27,31,10,3,22,40,55,18,17,3,14,13,57,58,0,"https://fbref.com/en/players/5c4d9be7/Enrico-Valentini"
2019,"Nürnberg","Bundesliga","Adam Zreľák","SVK","FW","24",1994,10.5,14,9,2,11,1,5,9,55.6,4,14,2,12,2,16,13,0,"https://fbref.com/en/players/8c8b4a01/Adam-Zrelak"
2019,"Paris S-G","Ligue 1","Dani Alves","BRA","MF,DF","35",1983,18,42,22,16,23,3,13,38,34.2,25,18,5,13,8,50,11,0,"https://fbref.com/en/players/c9e99e49/Dani-Alves"
2019,"Paris S-G","Ligue 1","Alphonse Areola","FRA","GK","25",1993,21,1,1,1,0,0,1,1,100,0,0,0,0,0,1,4,1,"https://fbref.com/en/players/2f965a72/Alphonse-Areola"
2019,"Paris S-G","Ligue 1","Juan Bernat","ESP","DF,MF","25",1993,20.4,47,32,22,19,6,22,46,47.8,24,19,5,14,20,67,41,1,"https://fbref.com/en/players/433dc9a2/Juan-Bernat"
2019,"Paris S-G","Ligue 1","Antoine Bernede","FRA","MF","19",1999,1.9,13,7,3,8,2,5,9,55.6,4,3,1,2,3,16,1,1,"https://fbref.com/en/players/07a821e4/Antoine-Bernede"
2019,"Paris S-G","Ligue 1","Gianluigi Buffon","ITA","GK","40",1978,17,0,0,0,0,0,0,1,0,1,0,0,0,0,0,5,0,"https://fbref.com/en/players/e40d028b/Gianluigi-Buffon"
2019,"Paris S-G","Ligue 1","Edinson Cavani","URU","FW","31",1987,18.6,11,8,1,4,6,3,13,23.1,10,11,2,9,6,17,16,0,"https://fbref.com/en/players/527f063d/Edinson-Cavani"
2019,"Paris S-G","Ligue 1","Colin Dagba","FRA","DF,MF","19",1998,10.2,24,12,10,12,2,13,19,68.4,6,10,0,10,9,33,10,1,"https://fbref.com/en/players/29c02c9f/Colin-Dagba"
2019,"Paris S-G","Ligue 1","Ángel Di María","ARG","FW,MF","30",1988,25.8,29,17,12,10,7,10,42,23.8,32,24,1,23,16,45,4,0,"https://fbref.com/en/players/19cda00b/Angel-Di-Maria"
2019,"Paris S-G","Ligue 1","Moussa Diaby","FRA","MF,DF","19",1999,12.7,14,8,7,2,5,2,11,18.2,9,7,1,6,12,26,6,0,"https://fbref.com/en/players/aeed5c06/Moussa-Diaby"
2019,"Paris S-G","Ligue 1","Lassana Diarra","FRA","MF","33",1985,1.8,2,1,0,2,0,0,1,0,1,0,0,0,2,4,3,0,"https://fbref.com/en/players/79584585/Lassana-Diarra"
2019,"Paris S-G","Ligue 1","Julian Draxler","GER","MF,FW","24",1993,22.7,41,22,11,19,11,16,43,37.2,27,20,1,19,15,56,2,1,"https://fbref.com/en/players/1a992676/Julian-Draxler"
2019,"Paris S-G","Ligue 1","Metehan Güçlü","TUR","MF","19",1999,0.2,0,0,0,0,0,0,0,NA,0,0,0,0,0,0,0,0,"https://fbref.com/en/players/0ee664db/Metehan-Guclu"
2019,"Paris S-G","Ligue 1","Thilo Kehrer","GER","DF","21",1996,21.1,64,43,27,31,6,31,55,56.4,24,32,17,15,31,95,69,1,"https://fbref.com/en/players/51dbeea9/Thilo-Kehrer"
2019,"Paris S-G","Ligue 1","Presnel Kimpembe","FRA","DF","22",1995,22.3,55,34,26,25,4,24,40,60,16,17,10,7,30,85,48,5,"https://fbref.com/en/players/aef6e670/Presnel-Kimpembe"
2019,"Paris S-G","Ligue 1","Layvin Kurzawa","FRA","DF,MF","25",1992,11.2,19,11,6,5,8,6,16,37.5,10,10,2,8,10,29,16,0,"https://fbref.com/en/players/41e7ef1c/Layvin-Kurzawa"
2019,"Paris S-G","Ligue 1","Giovani Lo Celso","ARG","MF","22",1996,0.1,1,1,0,0,1,0,1,0,1,0,0,0,0,1,0,0,"https://fbref.com/en/players/d7553721/Giovani-Lo-Celso"
2019,"Paris S-G","Ligue 1","Marquinhos","BRA","DF,MF","24",1994,29.9,65,41,34,28,3,31,52,59.6,21,30,13,17,44,109,84,1,"https://fbref.com/en/players/d5f2f82b/Marquinhos"
2019,"Paris S-G","Ligue 1","Eric Maxim Choupo-Moting","CMR","FW","29",1989,8.9,9,4,3,2,4,2,9,22.2,7,7,0,7,3,12,4,0,"https://fbref.com/en/players/0e6bc38c/Eric-Maxim-Choupo-Moting"
2019,"Paris S-G","Ligue 1","Kylian Mbappé","FRA","FW","19",1998,26,8,4,2,1,5,1,6,16.7,5,2,0,2,5,13,2,0,"https://fbref.com/en/players/42fd9c7f/Kylian-Mbappe"
2019,"Paris S-G","Ligue 1","Loïc Mbe Soh","FRA","DF","17",2001,2,0,0,0,0,0,0,3,0,3,2,2,0,3,3,5,0,"https://fbref.com/en/players/8f534f8e/Loic-Mbe-Soh"
2019,"Paris S-G","Ligue 1","Thomas Meunier","BEL","DF","26",1991,17.9,44,33,25,15,4,21,35,60,14,13,2,11,19,63,29,0,"https://fbref.com/en/players/e162b013/Thomas-Meunier"
2019,"Paris S-G","Ligue 1","Stanley N'Soki","FRA","DF","19",1999,7.8,20,14,8,10,2,6,13,46.2,7,10,1,9,18,38,20,1,"https://fbref.com/en/players/61590953/Stanley-NSoki"
2019,"Paris S-G","Ligue 1","Neymar","BRA","MF,FW","26",1992,16,14,9,3,10,1,4,21,19,17,8,0,8,5,19,1,1,"https://fbref.com/en/players/69384e5d/Neymar"
2019,"Paris S-G","Ligue 1","Christopher Nkunku","FRA","MF,FW","20",1997,12.8,21,16,8,10,3,7,16,43.8,9,12,2,10,9,30,7,1,"https://fbref.com/en/players/7c56da38/Christopher-Nkunku"
2019,"Paris S-G","Ligue 1","Leandro Paredes","ARG","MF","24",1994,13.9,34,19,16,15,3,13,30,43.3,17,17,5,12,14,48,20,2,"https://fbref.com/en/players/dff153a4/Leandro-Paredes"
2019,"Paris S-G","Ligue 1","Adrien Rabiot","FRA","MF","23",1995,11.8,35,20,13,17,5,9,12,75,3,9,2,7,10,45,20,0,"https://fbref.com/en/players/8794e251/Adrien-Rabiot"
2019,"Paris S-G","Ligue 1","Kévin Rimane","GUF","MF","27",1991,0.1,0,0,0,0,0,0,0,NA,0,0,0,0,0,0,0,0,"https://fbref.com/en/players/7a137df4/Kevin-Rimane"
2019,"Paris S-G","Ligue 1","Thiago Silva","BRA","DF","33",1984,23.1,16,13,7,8,1,6,11,54.5,5,28,20,8,32,48,99,1,"https://fbref.com/en/players/86e7deaf/Thiago-Silva"
2019,"Paris S-G","Ligue 1","Marco Verratti","ITA","MF","25",1992,20.9,72,42,25,39,8,36,81,44.4,45,26,1,25,18,90,8,2,"https://fbref.com/en/players/1467af0d/Marco-Verratti"
2019,"Paris S-G","Ligue 1","Timothy Weah","USA","FW","18",2000,0.6,0,0,0,0,0,0,0,NA,0,0,0,0,0,0,0,0,"https://fbref.com/en/players/8eec784d/Timothy-Weah"
2019,"Parma","Serie A","Bruno Alves","POR","DF","36",1981,32.5,15,8,11,4,0,4,7,57.1,3,36,28,8,29,44,210,0,"https://fbref.com/en/players/585a73a8/Bruno-Alves"
2019,"Parma","Serie A","Antonino Barillà","ITA","MF","30",1988,29.1,64,36,40,17,7,19,53,35.8,34,40,13,27,36,100,50,1,"https://fbref.com/en/players/a64cbd35/Antonino-Barilla"
2019,"Parma","Serie A","Alessandro Bastoni","ITA","DF","19",1999,18.8,25,12,20,5,0,6,15,40,9,26,18,8,22,47,96,0,"https://fbref.com/en/players/75b86fb3/Alessandro-Bastoni"
2019,"Parma","Serie A","Jonathan Biabiany","FRA","FW","30",1988,11.9,30,22,18,10,2,9,17,52.9,8,8,1,7,11,41,11,1,"https://fbref.com/en/players/6b99d135/Jonathan-Biabiany"
2019,"Parma","Serie A","Fabio Ceravolo","ITA","FW","31",1987,13.2,5,1,2,1,2,1,11,9.1,10,9,1,8,2,7,19,0,"https://fbref.com/en/players/4cc93246/Fabio-Ceravolo"
2019,"Parma","Serie A","Amato Ciciretti","ITA","FW,MF","24",1993,1.5,1,0,1,0,0,0,0,NA,0,3,0,3,3,4,0,0,"https://fbref.com/en/players/1ab0b878/Amato-Ciciretti"
2019,"Parma","Serie A","Alessio da Cruz","CPV","FW,MF","21",1997,1.6,2,1,0,2,0,0,1,0,1,0,0,0,0,2,0,0,"https://fbref.com/en/players/b6667741/Alessio-da-Cruz"
2019,"Parma","Serie A","Alessandro Deiola","ITA","MF,FW","22",1995,6.1,12,8,4,7,1,4,10,40,6,15,4,11,11,23,10,0,"https://fbref.com/en/players/7f267d66/Alessandro-Deiola"
2019,"Parma","Serie A","Jacopo Dezi","ITA","MF","26",1992,1,1,1,1,0,0,0,1,0,1,1,0,1,3,4,2,0,"https://fbref.com/en/players/e921b9db/Jacopo-Dezi"
2019,"Parma","Serie A","Antonio Di Gaudio","ITA","FW","28",1989,7.8,2,0,0,1,1,1,5,20,4,6,1,5,3,5,5,0,"https://fbref.com/en/players/434b8c73/Antonio-Di-Gaudio"
2019,"Parma","Serie A","Federico Dimarco","ITA","DF,MF","20",1997,9.9,22,7,10,8,4,10,20,50,10,13,6,7,15,37,27,0,"https://fbref.com/en/players/970b8574/Federico-Dimarco"
2019,"Parma","Serie A","Pierluigi Frattali","ITA","GK","32",1985,1,0,0,0,0,0,0,0,NA,0,0,0,0,0,0,1,0,"https://fbref.com/en/players/71dac2c2/Pierluigi-Frattali"
2019,"Parma","Serie A","Riccardo Gagliolo","SWE","DF","28",1990,33.8,69,45,52,15,2,33,68,48.5,35,60,33,27,66,135,213,2,"https://fbref.com/en/players/173061c0/Riccardo-Gagliolo"
2019,"Parma","Serie A","Marcello Gazzola","ITA","DF,MF","33",1985,10.2,9,4,2,5,2,5,9,55.6,4,6,3,3,4,13,33,0,"https://fbref.com/en/players/93390969/Marcello-Gazzola"
2019,"Parma","Serie A","Gervinho","CIV","FW","31",1987,25.6,19,12,11,5,3,5,13,38.5,8,7,0,7,10,29,2,0,"https://fbref.com/en/players/e468c053/Gervinho"
2019,"Parma","Serie A","Massimo Gobbi","ITA","DF","37",1980,13.1,14,7,5,5,4,8,25,32,17,16,8,8,9,23,48,0,"https://fbref.com/en/players/635b0bae/Massimo-Gobbi"
2019,"Parma","Serie A","Alberto Grassi","ITA","MF","23",1995,5.1,20,12,7,10,3,2,10,20,8,8,2,6,8,28,10,0,"https://fbref.com/en/players/6cc97b6a/Alberto-Grassi"
2019,"Parma","Serie A","Simone Iacoponi","ITA","DF","31",1987,37.2,62,43,50,11,1,27,47,57.4,20,40,26,14,37,99,178,3,"https://fbref.com/en/players/63071a3f/Simone-Iacoponi"
2019,"Parma","Serie A","Roberto Inglese","ITA","FW","26",1991,21.8,20,14,7,7,6,1,13,7.7,12,26,2,24,6,26,27,0,"https://fbref.com/en/players/6c1f7328/Roberto-Inglese"
2019,"Parma","Serie A","Juraj Kucka","SVK","MF","31",1987,17.1,51,32,17,29,5,19,53,35.8,34,27,7,20,17,68,37,1,"https://fbref.com/en/players/5aaef9ef/Juraj-Kucka"
2019,"Parma","Serie A","Abdou Lahat Diakhate","SEN","MF","19",1998,0,0,0,0,0,0,0,0,NA,0,0,0,0,0,0,0,0,"https://fbref.com/en/players/8e809937/Abdou-Lahat-Diakhate"
2019,"Parma","Serie A","Gianni Munari","ITA","MF","35",1983,0,0,0,0,0,0,0,0,NA,0,0,0,0,0,0,0,0,"https://fbref.com/en/players/e50613bd/Gianni-Munari"
2019,"Parma","Serie A","Pepín","EQG","MF","21",1996,0.9,4,2,3,1,0,1,4,25,3,0,0,0,3,7,0,0,"https://fbref.com/en/players/7afb1573/Pepin"
2019,"Parma","Serie A","Luca Rigoni","ITA","MF","33",1984,19.6,42,25,25,15,2,9,26,34.6,17,19,2,17,18,60,39,0,"https://fbref.com/en/players/4dba2a97/Luca-Rigoni"
2019,"Parma","Serie A","Nicolás Schiappacasse","URU","FW,MF","19",1999,0.9,0,0,0,0,0,0,0,NA,0,2,0,2,0,0,0,0,"https://fbref.com/en/players/afe31d55/Nicolas-Schiappacasse"
2019,"Parma","Serie A","Matteo Scozzarella","ITA","MF","30",1988,16.2,18,13,9,8,1,9,33,27.3,24,22,10,12,23,41,33,0,"https://fbref.com/en/players/ea164f99/Matteo-Scozzarella"
2019,"Parma","Serie A","Luigi Sepe","ITA","GK","27",1991,37,1,1,1,0,0,1,2,50,1,0,0,0,3,4,21,3,"https://fbref.com/en/players/343f753a/Luigi-Sepe"
2019,"Parma","Serie A","Francisco Sierralta","CHI","DF","21",1997,3,11,8,8,3,0,4,6,66.7,2,1,1,0,4,15,27,0,"https://fbref.com/en/players/0f933743/Francisco-Sierralta"
2019,"Parma","Serie A","Luca Siligardi","ITA","FW","30",1988,18.2,30,20,10,13,7,8,23,34.8,15,19,3,16,15,45,11,0,"https://fbref.com/en/players/1cac99dc/Luca-Siligardi"
2019,"Parma","Serie A","Mattia Sprocati","ITA","FW,MF","25",1993,7.2,10,4,5,5,0,5,11,45.5,6,6,0,6,7,17,6,0,"https://fbref.com/en/players/bdd0692f/Mattia-Sprocati"
2019,"Parma","Serie A","Leo Štulac","SVN","MF","23",1994,16.1,21,13,10,10,1,4,17,23.5,13,29,13,16,34,55,31,1,"https://fbref.com/en/players/92948398/Leo-Stulac"
2019,"RB Leipzig","Bundesliga","Tyler Adams","USA","MF","19",1999,8,29,17,12,16,1,11,26,42.3,15,17,1,16,16,45,8,0,"https://fbref.com/en/players/2b09d998/Tyler-Adams"
2019,"RB Leipzig","Bundesliga","Jean-Kévin Augustin","FRA","FW","21",1997,5.1,2,0,0,0,2,0,1,0,1,6,0,6,3,5,0,0,"https://fbref.com/en/players/97bfa797/Jean-Kevin-Augustin"
2019,"RB Leipzig","Bundesliga","Bruma","POR","MF","23",1994,6.1,5,2,3,1,1,1,5,20,4,4,0,4,4,9,2,0,"https://fbref.com/en/players/5caa62a7/Bruma"
2019,"RB Leipzig","Bundesliga","Matheus Cunha","BRA","FW,MF","19",1999,9.5,10,6,3,5,2,3,13,23.1,10,13,1,12,4,14,8,0,"https://fbref.com/en/players/dc62b55d/Matheus-Cunha"
2019,"RB Leipzig","Bundesliga","Diego Demme","GER","MF","26",1991,22.8,75,47,24,43,8,33,67,49.3,34,36,3,33,26,101,15,0,"https://fbref.com/en/players/dc3fa3b5/Diego-Demme"
2019,"RB Leipzig","Bundesliga","Emil Forsberg","SWE","MF,FW","26",1991,13.9,12,7,0,12,0,5,16,31.3,11,16,1,15,3,15,6,0,"https://fbref.com/en/players/9a2e0ccc/Emil-Forsberg"
2019,"RB Leipzig","Bundesliga","Péter Gulácsi","HUN","GK","28",1990,32.5,0,0,0,0,0,0,0,NA,0,0,0,0,0,0,11,0,"https://fbref.com/en/players/bcb2ccd8/Peter-Gulacsi"
2019,"RB Leipzig","Bundesliga","Amadou Haidara","MLI","MF","20",1998,4.2,13,11,4,8,1,8,14,57.1,6,9,1,8,4,17,7,0,"https://fbref.com/en/players/92432bc6/Amadou-Haidara"
2019,"RB Leipzig","Bundesliga","Marcel Halstenberg","GER","DF,FW","26",1991,26.8,68,44,31,24,13,42,65,64.6,23,27,4,23,38,106,69,0,"https://fbref.com/en/players/8ff2354e/Marcel-Halstenberg"
2019,"RB Leipzig","Bundesliga","Stefan Ilsanker","AUT","DF,MF","29",1989,10.4,26,17,15,10,1,14,23,60.9,9,9,2,7,18,44,43,1,"https://fbref.com/en/players/8494acc4/Stefan-Ilsanker"
2019,"RB Leipzig","Bundesliga","Kevin Kampl","SVN","MF","27",1990,23.5,41,24,16,21,4,8,28,28.6,20,32,2,30,33,74,22,0,"https://fbref.com/en/players/b825a650/Kevin-Kampl"
2019,"RB Leipzig","Bundesliga","Lukas Klostermann","GER","DF","22",1996,22.3,50,29,33,12,5,29,45,64.4,16,37,5,32,29,79,74,0,"https://fbref.com/en/players/ca8033cb/Lukas-Klostermann"
2019,"RB Leipzig","Bundesliga","Ibrahima Konaté","FRA","DF","19",1999,27,44,32,30,14,0,17,27,63,10,29,18,11,58,102,126,0,"https://fbref.com/en/players/5ed9b537/Ibrahima-Konate"
2019,"RB Leipzig","Bundesliga","Konrad Laimer","AUT","MF,DF","21",1997,20.8,72,38,21,34,17,20,71,28.2,51,67,2,65,32,104,23,0,"https://fbref.com/en/players/c1b7847c/Konrad-Laimer"
2019,"RB Leipzig","Bundesliga","Nordi Mukiele","FRA","DF","20",1997,13.6,38,21,23,12,3,19,22,86.4,3,17,3,14,24,62,35,0,"https://fbref.com/en/players/ac73ec79/Nordi-Mukiele"
2019,"RB Leipzig","Bundesliga","Yvon Mvogo","SUI","GK","24",1994,1.5,0,0,0,0,0,0,0,NA,0,0,0,0,0,0,1,0,"https://fbref.com/en/players/dc29b608/Yvon-Mvogo"
2019,"RB Leipzig","Bundesliga","Willi Orban","HUN","DF","25",1992,22.8,49,26,31,15,3,24,38,63.2,14,33,15,18,36,85,140,0,"https://fbref.com/en/players/20030c06/Willi-Orban"
2019,"RB Leipzig","Bundesliga","Yussuf Poulsen","DEN","FW","24",1994,27.2,20,10,5,10,5,3,25,12,22,33,2,31,7,27,28,0,"https://fbref.com/en/players/d2416c2e/Yussuf-Poulsen"
2019,"RB Leipzig","Bundesliga","Marcel Sabitzer","AUT","MF","24",1994,26.1,45,28,17,21,7,18,46,39.1,28,21,2,19,33,78,31,0,"https://fbref.com/en/players/e280527c/Marcel-Sabitzer"
2019,"RB Leipzig","Bundesliga","Marcelo Saracchi","URU","DF","20",1998,7.3,17,11,12,4,1,8,13,61.5,5,12,1,11,11,28,14,0,"https://fbref.com/en/players/1c96ad85/Marcelo-Saracchi"
2019,"RB Leipzig","Bundesliga","Emile Smith Rowe","ENG","MF","18",2000,0.3,1,0,0,1,0,1,1,100,0,0,0,0,1,2,0,0,"https://fbref.com/en/players/17695062/Emile-Smith-Rowe"
2019,"RB Leipzig","Bundesliga","Dayot Upamecano","FRA","DF","19",1998,14.4,22,16,14,8,0,15,18,83.3,3,19,5,14,33,55,47,0,"https://fbref.com/en/players/d248cd8f/Dayot-Upamecano"
2019,"RB Leipzig","Bundesliga","Timo Werner","GER","FW","22",1996,27.9,18,12,6,8,4,3,16,18.8,13,18,2,16,3,21,7,0,"https://fbref.com/en/players/49fe9070/Timo-Werner"
2019,"Rayo Vallecano","La Liga","Luis Advíncula","PER","DF","28",1990,26.5,52,38,38,12,2,21,31,67.7,10,22,2,20,19,71,60,1,"https://fbref.com/en/players/cacadf4f/Luis-Advincula"
2019,"Rayo Vallecano","La Liga","Sergio Akieme","ESP","DF","20",1997,2,3,3,3,0,0,2,2,100,0,0,0,0,1,4,5,0,"https://fbref.com/en/players/06efa9dc/Sergio-Akieme"
2019,"Rayo Vallecano","La Liga","Álex Alegría","ESP","FW,MF","25",1992,1.6,1,1,0,1,0,0,3,0,3,1,0,1,0,1,0,0,"https://fbref.com/en/players/46166b49/Alex-Alegria"
2019,"Rayo Vallecano","La Liga","Jordi Amat","IDN","DF","26",1992,30.7,54,31,34,19,1,24,42,57.1,18,31,10,21,43,97,133,1,"https://fbref.com/en/players/d70a2141/Jordi-Amat"
2019,"Rayo Vallecano","La Liga","Abdoulaye Ba","SEN","DF","27",1991,23.4,46,33,37,8,1,29,39,74.4,10,32,18,14,29,75,165,4,"https://fbref.com/en/players/1f54ed90/Abdoulaye-Ba"
2019,"Rayo Vallecano","La Liga","Bebé","CPV","FW,MF","28",1990,14.5,19,9,10,4,5,9,19,47.4,10,16,1,15,9,28,16,1,"https://fbref.com/en/players/d8712bf9/Bebe"
2019,"Rayo Vallecano","La Liga","Catena","ESP","DF","23",1994,2,4,4,3,1,0,2,2,100,0,4,2,2,8,12,8,0,"https://fbref.com/en/players/274ab13c/Catena"
2019,"Rayo Vallecano","La Liga","Chechu","ESP","DF","36",1982,1,0,0,0,0,0,0,2,0,2,0,0,0,2,2,5,0,"https://fbref.com/en/players/e98f3a6a/Chechu"
2019,"Rayo Vallecano","La Liga","Santi Comesaña","ESP","MF","21",1996,22.6,56,35,29,25,2,22,61,36.1,39,30,5,25,30,86,45,2,"https://fbref.com/en/players/5ae499d0/Santi-Comesana"
2019,"Rayo Vallecano","La Liga","Franco Di Santo","ARG","FW","29",1989,1.9,2,2,1,0,1,1,2,50,1,0,0,0,0,2,2,0,"https://fbref.com/en/players/549c6ba7/Franco-Di-Santo"
2019,"Rayo Vallecano","La Liga","Stole Dimitrievski","MKD","GK","24",1993,21,0,0,0,0,0,0,1,0,1,0,0,0,0,0,8,1,"https://fbref.com/en/players/fc70e345/Stole-Dimitrievski"
2019,"Rayo Vallecano","La Liga","Gorka Elustondo","ESP","MF,DF","31",1987,3.2,7,5,4,3,0,5,8,62.5,3,6,1,5,6,13,10,0,"https://fbref.com/en/players/7b309e55/Gorka-Elustondo"
2019,"Rayo Vallecano","La Liga","Adri Embarba","ESP","MF,FW","26",1992,25.4,54,26,20,24,10,22,61,36.1,39,38,2,36,29,83,22,0,"https://fbref.com/en/players/db8f0eba/Adri-Embarba"
2019,"Rayo Vallecano","La Liga","Álex Gálvez","ESP","DF","29",1989,15.7,38,28,25,13,0,14,28,50,14,7,2,5,45,83,69,1,"https://fbref.com/en/players/960fb42d/Alex-Galvez"
2019,"Rayo Vallecano","La Liga","Alberto García","ESP","GK","33",1985,17,1,1,1,0,0,1,3,33.3,2,1,0,1,2,3,1,2,"https://fbref.com/en/players/17d9e354/Alberto-Garcia"
2019,"Rayo Vallecano","La Liga","Álvaro García","ESP","FW,MF","25",1992,19.6,22,19,11,7,4,4,25,16,21,24,0,24,19,41,30,0,"https://fbref.com/en/players/90bbd822/Alvaro-Garcia"
2019,"Rayo Vallecano","La Liga","Javi Guerra","ESP","FW,MF","36",1982,2.6,3,3,1,1,1,0,3,0,3,2,0,2,1,4,0,0,"https://fbref.com/en/players/aa386464/Javi-Guerra"
2019,"Rayo Vallecano","La Liga","Uche Henry Agbo","NGA","MF","22",1995,4.1,7,4,3,4,0,5,10,50,5,3,1,2,6,13,1,0,"https://fbref.com/en/players/98554bfd/Uche-Henry-Agbo"
2019,"Rayo Vallecano","La Liga","Giannelli Imbula","COD","MF","25",1992,19.2,14,7,6,7,1,5,12,41.7,7,12,3,9,8,22,6,0,"https://fbref.com/en/players/b86fe156/Giannelli-Imbula"
2019,"Rayo Vallecano","La Liga","Gaël Kakuta","COD","MF,FW","27",1991,8,12,7,5,5,2,2,10,20,8,4,1,3,9,21,9,0,"https://fbref.com/en/players/5b1bf5e3/Gael-Kakuta"
2019,"Rayo Vallecano","La Liga","Álvaro Medrán","ESP","MF","24",1994,12.8,15,8,5,6,4,6,21,28.6,15,10,1,9,17,32,9,0,"https://fbref.com/en/players/31223bcf/Alvaro-Medran"
2019,"Rayo Vallecano","La Liga","Álex Moreno","ESP","DF","25",1993,34.8,63,40,41,18,4,29,53,54.7,24,35,9,26,41,104,97,0,"https://fbref.com/en/players/16e9d0ea/Alex-Moreno"
2019,"Rayo Vallecano","La Liga","Sergio Moreno","ESP","FW","19",1999,0.2,0,0,0,0,0,0,0,NA,0,0,0,0,0,0,0,0,"https://fbref.com/en/players/014b57f5/Sergio-Moreno"
2019,"Rayo Vallecano","La Liga","José Pozo","ESP","MF","22",1996,18,13,10,4,5,4,4,25,16,21,7,1,6,4,17,6,0,"https://fbref.com/en/players/fc8b614b/Jose-Pozo"
2019,"Rayo Vallecano","La Liga","Mario Suárez","ESP","MF","31",1987,11.4,37,23,17,17,3,15,28,53.6,13,10,3,7,14,51,17,2,"https://fbref.com/en/players/7106f0a0/Mario-Suarez"
2019,"Rayo Vallecano","La Liga","Tito","ESP","DF","33",1985,12.2,14,9,12,2,0,7,22,31.8,15,22,2,20,17,31,41,0,"https://fbref.com/en/players/7cefa219/Tito"
2019,"Rayo Vallecano","La Liga","Raúl de Tomás","ESP","FW","23",1994,31.3,8,3,0,7,1,0,12,0,12,18,4,14,9,17,45,0,"https://fbref.com/en/players/02ef8778/Raul-de-Tomas"
2019,"Rayo Vallecano","La Liga","Óscar Trejo","ARG","MF,FW","30",1988,19.6,57,41,21,25,11,8,33,24.2,25,24,2,22,18,75,15,0,"https://fbref.com/en/players/fc647b34/Oscar-Trejo"
2019,"Rayo Vallecano","La Liga","Emiliano Velázquez","URU","DF","24",1994,14.2,49,32,38,9,2,20,34,58.8,14,29,7,22,47,96,106,1,"https://fbref.com/en/players/5efb80d5/Emiliano-Velazquez"
2019,"Real Madrid","La Liga","Marco Asensio","ESP","FW","22",1996,19.8,12,8,3,5,4,2,24,8.3,22,16,1,15,14,26,7,0,"https://fbref.com/en/players/45af8a54/Marco-Asensio"
2019,"Real Madrid","La Liga","Gareth Bale","WAL","FW","29",1989,19.8,16,8,5,7,4,6,20,30,14,19,3,16,11,27,13,0,"https://fbref.com/en/players/a58bb1e1/Gareth-Bale"
2019,"Real Madrid","La Liga","Karim Benzema","FRA","FW","30",1987,32.8,24,11,2,11,11,2,17,11.8,15,16,1,15,8,32,25,0,"https://fbref.com/en/players/70d74ece/Karim-Benzema"
2019,"Real Madrid","La Liga","Dani Carvajal","ESP","DF","26",1992,23.4,40,24,17,15,8,18,41,43.9,23,31,7,24,26,66,35,0,"https://fbref.com/en/players/4958bfb2/Dani-Carvajal"
2019,"Real Madrid","La Liga","Casemiro","BRA","MF","26",1992,25.7,86,52,44,35,7,38,94,40.4,56,52,12,40,41,127,56,3,"https://fbref.com/en/players/4d224fe8/Casemiro"
2019,"Real Madrid","La Liga","Dani Ceballos","ESP","MF,FW","21",1996,13.9,32,21,9,16,7,11,31,35.5,20,26,1,25,15,47,6,0,"https://fbref.com/en/players/c0617e2b/Dani-Ceballos"
2019,"Real Madrid","La Liga","Thibaut Courtois","BEL","GK","26",1992,27,0,0,0,0,0,0,2,0,2,0,0,0,2,2,5,0,"https://fbref.com/en/players/1840e36d/Thibaut-Courtois"
2019,"Real Madrid","La Liga","Brahim Díaz","ESP","FW","18",1999,4.2,9,7,5,4,0,3,8,37.5,5,2,0,2,0,9,0,0,"https://fbref.com/en/players/407feb71/Brahim-Diaz"
2019,"Real Madrid","La Liga","Cristo González","ESP","FW","20",1997,0.5,1,0,0,1,0,0,0,NA,0,0,0,0,1,2,0,0,"https://fbref.com/en/players/896b5df2/Cristo-Gonzalez"
2019,"Real Madrid","La Liga","Isco","ESP","MF,FW","26",1992,13.2,29,14,14,8,7,14,34,41.2,20,9,1,8,6,35,3,0,"https://fbref.com/en/players/a0b4bb3e/Isco"
2019,"Real Madrid","La Liga","Vinicius Júnior","BRA","FW,MF","18",2000,9.7,10,6,3,6,1,3,16,18.8,13,6,1,5,7,17,1,0,"https://fbref.com/en/players/7111d552/Vinicius-Junior"
2019,"Real Madrid","La Liga","Toni Kroos","GER","MF","28",1990,24.7,51,35,18,24,9,14,57,24.6,43,25,4,21,14,65,13,1,"https://fbref.com/en/players/6ce1f46f/Toni-Kroos"
2019,"Real Madrid","La Liga","Marcos Llorente","ESP","MF","23",1995,6,16,12,7,7,2,8,18,44.4,10,8,0,8,7,23,12,0,"https://fbref.com/en/players/02c15616/Marcos-Llorente"
2019,"Real Madrid","La Liga","Marcelo","BRA","DF","30",1988,20.6,34,19,17,12,5,15,39,38.5,24,19,2,17,17,51,21,0,"https://fbref.com/en/players/603116a7/Marcelo"
2019,"Real Madrid","La Liga","Mariano","DOM","FW","24",1993,5,2,1,1,1,0,0,3,0,3,2,0,2,0,2,2,0,"https://fbref.com/en/players/5c4dc0ff/Mariano"
2019,"Real Madrid","La Liga","Luka Modrić","CRO","MF","32",1985,29,49,30,11,25,13,14,48,29.2,34,20,3,17,31,80,7,1,"https://fbref.com/en/players/6025fab1/Luka-Modric"
2019,"Real Madrid","La Liga","Nacho","ESP","DF","28",1990,18.9,26,19,14,7,5,11,22,50,11,19,7,12,32,58,65,1,"https://fbref.com/en/players/2946f9a1/Nacho"
2019,"Real Madrid","La Liga","Keylor Navas","CRC","GK","31",1986,10,0,0,0,0,0,0,0,NA,0,0,0,0,1,1,5,0,"https://fbref.com/en/players/ecada4fc/Keylor-Navas"
2019,"Real Madrid","La Liga","Álvaro Odriozola","ESP","DF","22",1995,13.1,28,25,13,11,4,14,18,77.8,4,11,1,10,11,39,17,1,"https://fbref.com/en/players/1d1691ad/Alvaro-Odriozola"
2019,"Real Madrid","La Liga","Sergio Ramos","ESP","DF","32",1986,27.5,41,32,25,12,4,22,39,56.4,17,29,15,14,37,78,90,2,"https://fbref.com/en/players/08511d65/Sergio-Ramos"
2019,"Real Madrid","La Liga","Sergio Reguilón","ESP","DF","21",1996,12.4,25,14,15,9,1,10,21,47.6,11,13,3,10,20,45,41,1,"https://fbref.com/en/players/3353737a/Sergio-Reguilon"
2019,"Real Madrid","La Liga","Javi Sánchez","ESP","DF","21",1997,0.5,1,0,1,0,0,0,0,NA,0,0,0,0,0,1,4,0,"https://fbref.com/en/players/60359288/Javi-Sanchez"
2019,"Real Madrid","La Liga","Jesús Vallejo","ESP","DF","21",1997,3.5,6,5,4,2,0,5,6,83.3,1,4,4,0,7,13,12,0,"https://fbref.com/en/players/c2111b45/Jesus-Vallejo"
2019,"Real Madrid","La Liga","Federico Valverde","URU","MF","20",1998,7.3,12,8,3,7,2,5,11,45.5,6,10,2,8,21,33,10,0,"https://fbref.com/en/players/0959c2a2/Federico-Valverde"
2019,"Real Madrid","La Liga","Raphaël Varane","FRA","DF","25",1993,30.6,33,18,25,7,1,15,19,78.9,4,21,9,12,32,65,141,1,"https://fbref.com/en/players/9f8e9423/Raphael-Varane"
2019,"Real Madrid","La Liga","Lucas Vázquez","ESP","FW,MF","27",1991,16.8,43,26,11,21,11,15,41,36.6,26,16,1,15,12,55,11,0,"https://fbref.com/en/players/fd51b456/Lucas-Vazquez"
2019,"Real Madrid","La Liga","Luca Zidane","FRA","GK","20",1998,1,0,0,0,0,0,0,0,NA,0,0,0,0,0,0,0,0,"https://fbref.com/en/players/c818c4d9/Luca-Zidane"
2019,"Real Sociedad","La Liga","Miguel Ángel Moyá","ESP","GK","34",1984,11,1,1,1,0,0,1,2,50,1,0,0,0,1,2,9,2,"https://fbref.com/en/players/011d8c56/Miguel-Angel-Moya"
2019,"Real Sociedad","La Liga","Ander Barrenetxea","ESP","FW,MF","16",2001,4.4,7,2,2,0,5,2,8,25,6,8,0,8,4,11,1,0,"https://fbref.com/en/players/200e89e1/Ander-Barrenetxea"
2019,"Real Sociedad","La Liga","Jon Bautista","ESP","FW","23",1995,6.6,5,3,0,3,2,0,3,0,3,8,1,7,5,10,4,0,"https://fbref.com/en/players/debc6b55/Jon-Bautista"
2019,"Real Sociedad","La Liga","Aritz Elustondo","ESP","DF","24",1994,25,47,29,31,14,2,26,41,63.4,15,23,7,16,39,86,150,0,"https://fbref.com/en/players/f7dc2ae5/Aritz-Elustondo"
2019,"Real Sociedad","La Liga","Andoni Gorosabel","ESP","DF","21",1996,5.1,16,9,10,5,1,8,13,61.5,5,5,1,4,4,20,20,1,"https://fbref.com/en/players/6f5f82c0/Andoni-Gorosabel"
2019,"Real Sociedad","La Liga","Ander Guevara","ESP","MF","21",1997,1,3,1,0,3,0,2,6,33.3,4,1,0,1,1,4,0,0,"https://fbref.com/en/players/8e48dc61/Ander-Guevara"
2019,"Real Sociedad","La Liga","Theo Hernández","FRA","DF","20",1997,22,54,33,30,15,9,28,44,63.6,16,21,5,16,33,87,42,3,"https://fbref.com/en/players/d4c9725f/Theo-Hernandez"
2019,"Real Sociedad","La Liga","Asier Illarramendi","ESP","MF","28",1990,20.2,39,24,22,14,3,21,51,41.2,30,36,9,27,31,70,46,1,"https://fbref.com/en/players/5ce0b5ba/Asier-Illarramendi"
2019,"Real Sociedad","La Liga","Adnan Januzaj","BEL","FW,MF","23",1995,13.9,11,8,5,2,4,3,13,23.1,10,7,0,7,6,17,6,0,"https://fbref.com/en/players/4737cebe/Adnan-Januzaj"
2019,"Real Sociedad","La Liga","Willian José","BRA","FW","26",1991,26.3,5,3,1,3,1,2,7,28.6,5,11,5,6,1,6,27,0,"https://fbref.com/en/players/d87e2cae/Willian-Jose"
2019,"Real Sociedad","La Liga","Juanmi","ESP","FW,MF","25",1993,16.9,21,12,7,11,3,8,22,36.4,14,12,0,12,16,37,13,0,"https://fbref.com/en/players/84399660/Juanmi"
2019,"Real Sociedad","La Liga","Robin Le Normand","FRA","DF","21",1996,3.2,5,2,2,3,0,1,3,33.3,2,3,0,3,4,9,13,1,"https://fbref.com/en/players/9a64e67e/Robin-Le-Normand"
2019,"Real Sociedad","La Liga","Diego Llorente","ESP","DF","24",1993,19.5,26,15,16,8,2,17,29,58.6,12,27,15,12,26,52,83,2,"https://fbref.com/en/players/bba30585/Diego-Llorente"
2019,"Real Sociedad","La Liga","Roberto López","ESP","MF","18",2000,0.3,0,0,0,0,0,0,1,0,1,1,0,1,1,1,2,0,"https://fbref.com/en/players/2a8c9f98/Roberto-Lopez"
2019,"Real Sociedad","La Liga","Mikel Merino","ESP","MF","22",1996,22.8,50,28,19,25,6,14,52,26.9,38,37,2,35,29,79,37,1,"https://fbref.com/en/players/d080ed5e/Mikel-Merino"
2019,"Real Sociedad","La Liga","Martín Merquelanz","ESP","MF","23",1995,0.1,0,0,0,0,0,0,0,NA,0,0,0,0,0,0,0,0,"https://fbref.com/en/players/ddd5348b/Martin-Merquelanz"
2019,"Real Sociedad","La Liga","Héctor Moreno","MEX","DF","30",1988,21.5,16,9,12,4,0,9,17,52.9,8,34,19,15,31,47,73,0,"https://fbref.com/en/players/5d311e8d/Hector-Moreno"
2019,"Real Sociedad","La Liga","Aihen Muñoz","ESP","DF","20",1997,10.6,13,8,11,2,0,10,19,52.6,9,19,9,10,7,20,26,0,"https://fbref.com/en/players/228b0d9d/Aihen-Munoz"
2019,"Real Sociedad","La Liga","Raúl Navas","ESP","DF","30",1988,14.6,23,14,20,3,0,13,21,61.9,8,20,9,11,20,43,60,1,"https://fbref.com/en/players/ad178594/Raul-Navas"
2019,"Real Sociedad","La Liga","Mikel Oyarzabal","ESP","FW,MF","21",1997,35,36,20,15,15,6,12,49,24.5,37,54,3,51,14,50,26,0,"https://fbref.com/en/players/8c3c640c/Mikel-Oyarzabal"
2019,"Real Sociedad","La Liga","Rubén Pardo","ESP","MF,FW","25",1992,15.2,11,7,2,9,0,4,17,23.5,13,14,6,8,21,32,9,0,"https://fbref.com/en/players/2306bfde/Ruben-Pardo"
2019,"Real Sociedad","La Liga","Sandro Ramírez","ESP","FW,MF","23",1995,11.7,19,10,7,10,2,4,11,36.4,7,12,1,11,9,28,3,0,"https://fbref.com/en/players/833fb62e/Sandro-Ramirez"
2019,"Real Sociedad","La Liga","Kévin Rodrigues","POR","DF","24",1994,5.4,21,11,14,6,1,9,17,52.9,8,13,3,10,8,29,15,0,"https://fbref.com/en/players/f1bed920/Kevin-Rodrigues"
2019,"Real Sociedad","La Liga","Gerónimo Rulli","ARG","GK","26",1992,27,2,1,2,0,0,1,3,33.3,2,1,0,1,1,3,12,6,"https://fbref.com/en/players/625c144a/Geronimo-Rulli"
2019,"Real Sociedad","La Liga","Luca Sangalli","ESP","MF,FW","23",1995,11.1,19,13,6,11,2,5,22,22.7,17,9,1,8,5,24,5,0,"https://fbref.com/en/players/7958dc65/Luca-Sangalli"
2019,"Real Sociedad","La Liga","Alex Sola","ESP","DF","19",1999,1,4,3,0,3,1,3,4,75,1,0,0,0,1,5,2,0,"https://fbref.com/en/players/5fa714d5/Alex-Sola"
2019,"Real Sociedad","La Liga","Joseba Zaldúa","ESP","DF","26",1992,23.8,36,27,23,10,3,15,32,46.9,17,19,3,16,38,74,72,0,"https://fbref.com/en/players/5ca20b7a/Joseba-Zaldua"
2019,"Real Sociedad","La Liga","Igor Zubeldia","ESP","MF","21",1997,28.3,61,35,32,24,5,22,54,40.7,32,30,6,24,45,106,60,0,"https://fbref.com/en/players/5c7845f6/Igor-Zubeldia"
2019,"Real Sociedad","La Liga","Martín Zubimendi","ESP","MF","19",1999,0.1,1,0,0,1,0,0,1,0,1,0,0,0,0,1,0,0,"https://fbref.com/en/players/3ee0dd59/Martin-Zubimendi"
2019,"Real Sociedad","La Liga","David Zurutuza","ESP","MF","32",1986,13.6,27,16,9,15,3,8,22,36.4,14,19,4,15,24,51,26,1,"https://fbref.com/en/players/d9bda115/David-Zurutuza"
2019,"Reims","Ligue 1","Yunis Abdelhamid","MAR","DF","30",1987,38,60,33,48,11,1,30,40,75,10,44,24,20,65,125,196,0,"https://fbref.com/en/players/32c2d95f/Yunis-Abdelhamid"
2019,"Reims","Ligue 1","Mathieu Cafaro","FRA","FW,MF","21",1997,23.3,59,28,29,24,6,18,63,28.6,45,28,0,28,20,79,14,0,"https://fbref.com/en/players/2a657da0/Mathieu-Cafaro"
2019,"Reims","Ligue 1","Moreto Cassamã","GNB","MF","20",1998,0.7,3,3,1,2,0,1,7,14.3,6,1,0,1,1,4,2,0,"https://fbref.com/en/players/f54d2149/Moreto-Cassama"
2019,"Reims","Ligue 1","Xavier Chavalerin","FRA","MF","27",1991,36,106,61,56,39,11,28,72,38.9,44,44,12,32,72,178,39,1,"https://fbref.com/en/players/279ddf6a/Xavier-Chavalerin"
2019,"Reims","Ligue 1","Pablo Chavarría","ARG","FW","30",1988,21.9,20,12,8,6,6,3,15,20,12,11,0,11,4,24,19,0,"https://fbref.com/en/players/4207e578/Pablo-Chavarria"
2019,"Reims","Ligue 1","Boulaye Dia","SEN","FW","21",1996,8.3,12,6,3,8,1,5,11,45.5,6,4,2,2,4,16,9,0,"https://fbref.com/en/players/244bc2c8/Boulaye-Dia"
2019,"Reims","Ligue 1","Tristan Dingomé","CMR","MF","27",1991,14.9,27,15,11,10,6,7,24,29.2,17,16,3,13,11,38,5,0,"https://fbref.com/en/players/92b56413/Tristan-Dingome"
2019,"Reims","Ligue 1","Axel Disasi","FRA","DF","20",1998,1.8,2,1,1,1,0,1,2,50,1,2,1,1,2,4,16,0,"https://fbref.com/en/players/ad82197c/Axel-Disasi"
2019,"Reims","Ligue 1","Moussa Doumbia","MLI","FW,MF","23",1994,17.8,28,13,13,13,2,11,39,28.2,28,7,2,5,7,35,13,0,"https://fbref.com/en/players/6481421d/Moussa-Doumbia"
2019,"Reims","Ligue 1","Björn Engels","BEL","DF","23",1994,33,11,8,6,5,0,6,16,37.5,10,30,24,6,44,55,181,3,"https://fbref.com/en/players/4fdf1fd9/Bjorn-Engels"
2019,"Reims","Ligue 1","Thomas Foket","BEL","DF","23",1994,32,91,52,55,23,13,42,69,60.9,27,30,4,26,49,140,80,1,"https://fbref.com/en/players/90eb507d/Thomas-Foket"
2019,"Reims","Ligue 1","Thomas Fontaine","MAD","DF,MF","27",1991,4.7,6,3,5,0,1,2,5,40,3,6,2,4,7,13,28,1,"https://fbref.com/en/players/9f90c06b/Thomas-Fontaine"
2019,"Reims","Ligue 1","Suk Hyun-jun","KOR","FW","27",1991,8.8,11,8,1,6,4,0,8,0,8,2,1,1,2,13,4,1,"https://fbref.com/en/players/7ffaf233/Suk-Hyun-jun"
2019,"Reims","Ligue 1","Hassane Kamara","CIV","DF,FW","24",1994,10.3,29,21,22,5,2,16,19,84.2,3,6,1,5,14,43,41,0,"https://fbref.com/en/players/19a12bed/Hassane-Kamara"
2019,"Reims","Ligue 1","Ghislain Konan","CIV","DF","22",1995,20,45,28,31,10,4,24,40,60,16,18,4,14,40,85,55,1,"https://fbref.com/en/players/6b2c894b/Ghislain-Konan"
2019,"Reims","Ligue 1","Grejohn Kyei","FRA","FW","22",1995,0,0,0,0,0,0,0,1,0,1,0,0,0,0,0,0,0,"https://fbref.com/en/players/397ba086/Grejohn-Kyei"
2019,"Reims","Ligue 1","Marvin Martin","FRA","MF","30",1988,6.9,2,1,0,2,0,0,6,0,6,2,1,1,2,4,1,0,"https://fbref.com/en/players/f4319ee8/Marvin-Martin"
2019,"Reims","Ligue 1","Nolan Mbemba","CGO","MF,DF","23",1995,4,14,8,10,4,0,6,9,66.7,3,4,1,3,10,24,4,2,"https://fbref.com/en/players/6c9642ae/Nolan-Mbemba"
2019,"Reims","Ligue 1","Edouard Mendy","SEN","GK","26",1992,38,0,0,0,0,0,0,1,0,1,1,0,1,2,2,16,3,"https://fbref.com/en/players/33887998/Edouard-Mendy"
2019,"Reims","Ligue 1","Romain Métanire","MAD","DF","28",1990,3.5,12,9,10,1,1,5,7,71.4,2,4,3,1,6,18,13,0,"https://fbref.com/en/players/0fb21da9/Romain-Metanire"
2019,"Reims","Ligue 1","Aly Ndom","FRA","MF","22",1996,4,11,9,5,5,1,3,7,42.9,4,6,2,4,3,14,9,1,"https://fbref.com/en/players/df819670/Aly-Ndom"
2019,"Reims","Ligue 1","Sheyi Ojo","ENG","FW,MF","21",1997,5.2,8,6,2,4,2,2,8,25,6,1,0,1,3,11,2,0,"https://fbref.com/en/players/7b9a86e6/Sheyi-Ojo"
2019,"Reims","Ligue 1","Remi Oudin","FRA","FW,MF","21",1996,29,51,32,25,18,8,20,45,44.4,25,29,5,24,42,93,34,0,"https://fbref.com/en/players/ea02beaf/Remi-Oudin"
2019,"Reims","Ligue 1","Virgile Pinson","FRA","MF","22",1996,0.1,0,0,0,0,0,0,0,NA,0,0,0,0,0,0,0,0,"https://fbref.com/en/players/43af5b1b/Virgile-Pinson"
2019,"Reims","Ligue 1","Baba Rahman","GHA","DF","24",1994,10.7,26,20,17,8,1,18,21,85.7,3,21,3,18,16,42,37,2,"https://fbref.com/en/players/e4086af3/Baba-Rahman"
2019,"Reims","Ligue 1","Alaixys Romao","TOG","MF","34",1984,35.1,118,71,61,50,7,43,102,42.2,59,44,16,28,58,176,65,1,"https://fbref.com/en/players/0aa874f4/Alaixys-Romao"
2019,"Reims","Ligue 1","Arber Zeneli","KVX","FW","23",1995,9,8,6,3,2,3,0,10,0,10,3,0,3,2,10,3,1,"https://fbref.com/en/players/095e4199/Arber-Zeneli"
2019,"Rennes","Ligue 1","Benjamin André","FRA","MF","27",1990,27.7,101,60,39,50,12,33,85,38.8,52,40,6,34,54,155,58,0,"https://fbref.com/en/players/ef9c1c95/Benjamin-Andre"
2019,"Rennes","Ligue 1","Ludovic Baal","GUF","DF","32",1986,1.4,4,3,3,1,0,0,0,NA,0,1,0,1,2,6,1,0,"https://fbref.com/en/players/d3ce9f1f/Ludovic-Baal"
2019,"Rennes","Ligue 1","Hatem Ben Arfa","FRA","FW,MF","31",1987,22.6,15,7,4,8,3,7,16,43.8,9,9,0,9,4,19,0,0,"https://fbref.com/en/players/74dc806c/Hatem-Ben-Arfa"
2019,"Rennes","Ligue 1","Ramy Bensebaini","ALG","DF","23",1995,23.9,69,48,42,19,8,40,58,69,18,24,10,14,41,110,98,0,"https://fbref.com/en/players/378825c7/Ramy-Bensebaini"
2019,"Rennes","Ligue 1","Sacha Boey","FRA","DF","17",2000,0.2,0,0,0,0,0,0,0,NA,0,0,0,0,0,0,0,0,"https://fbref.com/en/players/6c8ddd52/Sacha-Boey"
2019,"Rennes","Ligue 1","Benjamin Bourigeaud","FRA","MF,FW","24",1994,26.9,55,35,23,21,11,20,67,29.9,47,44,5,39,32,87,34,1,"https://fbref.com/en/players/20e73fac/Benjamin-Bourigeaud"
2019,"Rennes","Ligue 1","Eduardo Camavinga","FRA","MF","15",2002,4,23,15,8,12,3,8,18,44.4,10,13,2,11,4,27,4,0,"https://fbref.com/en/players/7b9c2d84/Eduardo-Camavinga"
2019,"Rennes","Ligue 1","Damien Da Silva","FRA","DF","30",1988,31.9,41,25,31,9,1,18,24,75,6,42,36,6,39,80,152,0,"https://fbref.com/en/players/1ec7e1c5/Damien-Da-Silva"
2019,"Rennes","Ligue 1","Romain Del Castillo","FRA","MF,FW","22",1996,14.9,36,20,15,13,8,13,37,35.1,24,19,0,19,20,56,7,1,"https://fbref.com/en/players/0be95d34/Romain-Del-Castillo"
2019,"Rennes","Ligue 1","Abdoulaye Diallo","SEN","GK","26",1992,5.5,1,1,1,0,0,1,1,100,0,0,0,0,0,1,1,0,"https://fbref.com/en/players/26383ea5/Abdoulaye-Diallo"
2019,"Rennes","Ligue 1","Souleyman Doumbia","CIV","DF","21",1996,6.7,11,7,9,2,0,6,10,60,4,6,1,5,4,15,20,0,"https://fbref.com/en/players/9daeac61/Souleyman-Doumbia"
2019,"Rennes","Ligue 1","Jérémy Gélin","FRA","DF,MF","21",1997,14.2,30,16,18,10,2,18,34,52.9,16,14,6,8,19,49,29,0,"https://fbref.com/en/players/4c700f46/Jeremy-Gelin"
2019,"Rennes","Ligue 1","Clément Grenier","FRA","MF","27",1991,29.6,44,27,7,33,4,21,61,34.4,40,28,4,24,29,73,34,1,"https://fbref.com/en/players/8b298f56/Clement-Grenier"
2019,"Rennes","Ligue 1","Adrien Hunou","FRA","FW,MF","24",1994,13.8,11,7,3,5,3,2,9,22.2,7,14,0,14,5,16,8,0,"https://fbref.com/en/players/d14229f3/Adrien-Hunou"
2019,"Rennes","Ligue 1","Nicolas Janvier","FRA","MF","19",1998,0,0,0,0,0,0,0,0,NA,0,0,0,0,0,0,0,0,"https://fbref.com/en/players/22a62523/Nicolas-Janvier"
2019,"Rennes","Ligue 1","Jakob Johansson","SWE","MF","28",1990,7.9,17,9,5,12,0,10,20,50,10,7,3,4,3,20,17,1,"https://fbref.com/en/players/e4a26a91/Jakob-Johansson"
2019,"Rennes","Ligue 1","Tomáš Koubek","CZE","GK","25",1992,32.5,0,0,0,0,0,0,1,0,1,0,0,0,0,0,26,4,"https://fbref.com/en/players/dc366c36/Tomas-Koubek"
2019,"Rennes","Ligue 1","Armand Lauriente","FRA","MF","19",1998,0,0,0,0,0,0,0,0,NA,0,0,0,0,0,0,0,0,"https://fbref.com/en/players/2d22cea7/Armand-Lauriente"
2019,"Rennes","Ligue 1","James Lea Siliki","CMR","MF,FW","22",1996,13.6,26,17,13,10,3,12,35,34.3,23,14,1,13,10,36,7,1,"https://fbref.com/en/players/7cf431a5/James-Lea-Siliki"
2019,"Rennes","Ligue 1","Mexer","MOZ","DF","29",1988,27.4,23,12,18,5,0,12,18,66.7,6,26,18,8,30,53,125,0,"https://fbref.com/en/players/ce492295/Mexer"
2019,"Rennes","Ligue 1","M'Baye Niang","SEN","FW,MF","23",1994,19.9,16,10,3,8,5,2,11,18.2,9,19,3,16,8,24,14,0,"https://fbref.com/en/players/2054d037/MBaye-Niang"
2019,"Rennes","Ligue 1","Gerzino Nyamsi","FRA","DF","21",1997,6,6,3,5,1,0,4,9,44.4,5,8,4,4,4,10,17,0,"https://fbref.com/en/players/6043997c/Gerzino-Nyamsi"
2019,"Rennes","Ligue 1","Jordan Pefok","USA","FW","22",1996,6.8,6,2,0,3,3,2,4,50,2,7,2,5,4,10,5,0,"https://fbref.com/en/players/b684a484/Jordan-Pefok"
2019,"Rennes","Ligue 1","Denis-Will Poha","FRA","MF","21",1997,0.3,0,0,0,0,0,0,1,0,1,0,0,0,1,1,1,0,"https://fbref.com/en/players/854a2041/Denis-Will-Poha"
2019,"Rennes","Ligue 1","Diafra Sakho","SEN","FW","28",1989,1.6,2,1,0,0,2,0,0,NA,0,0,0,0,0,2,0,0,"https://fbref.com/en/players/57c433c8/Diafra-Sakho"
2019,"Rennes","Ligue 1","Ismaila Sarr","SEN","FW,MF","20",1998,31,35,24,16,15,4,17,34,50,17,17,2,15,14,49,4,0,"https://fbref.com/en/players/bfdb33aa/Ismaila-Sarr"
2019,"Rennes","Ligue 1","Hamari Traoré","MLI","DF","26",1992,33,61,33,32,27,2,36,71,50.7,35,39,11,28,44,105,82,0,"https://fbref.com/en/players/a4b1028a/Hamari-Traore"
2019,"Rennes","Ligue 1","Mehdi Zeffane","ALG","DF,MF","26",1992,13.5,19,13,12,7,0,10,26,38.5,16,14,5,9,18,37,35,1,"https://fbref.com/en/players/c8c02ac7/Mehdi-Zeffane"
2019,"Roma","Serie A","Žan Celar","SVN","FW","19",1999,0.1,0,0,0,0,0,0,0,NA,0,0,0,0,0,0,0,0,"https://fbref.com/en/players/868c6958/Zan-Celar"
2019,"Roma","Serie A","Ante Ćorić","CRO","MF","21",1997,0.3,0,0,0,0,0,0,0,NA,0,0,0,0,0,0,0,0,"https://fbref.com/en/players/2d3f7367/Ante-Coric"
2019,"Roma","Serie A","Bryan Cristante","ITA","MF","23",1995,26.9,63,34,21,35,7,19,49,38.8,30,37,5,32,29,92,48,0,"https://fbref.com/en/players/16657b95/Bryan-Cristante"
2019,"Roma","Serie A","Daniele De Rossi","ITA","MF","35",1983,14.1,16,10,6,7,3,3,14,21.4,11,18,12,6,26,42,33,0,"https://fbref.com/en/players/532d2690/Daniele-De-Rossi"
2019,"Roma","Serie A","Edin Džeko","BIH","FW","32",1986,28.7,13,7,3,5,5,4,16,25,12,10,1,9,0,13,36,1,"https://fbref.com/en/players/3bb7f478/Edin-Dzeko"
2019,"Roma","Serie A","Federico Fazio","ARG","DF","31",1987,31.2,28,20,14,11,3,12,25,48,13,45,33,12,53,81,171,2,"https://fbref.com/en/players/4e358a2d/Federico-Fazio"
2019,"Roma","Serie A","Alessandro Florenzi","ITA","DF,FW","27",1991,24.2,38,21,22,11,5,17,37,45.9,20,27,5,22,46,84,58,0,"https://fbref.com/en/players/e288d4b3/Alessandro-Florenzi"
2019,"Roma","Serie A","Juan Jesus","BRA","DF","27",1991,15.6,37,29,30,5,2,17,30,56.7,13,20,12,8,16,53,41,0,"https://fbref.com/en/players/79083382/Juan-Jesus"
2019,"Roma","Serie A","Rick Karsdorp","NED","DF","23",1995,6.6,9,6,3,5,1,5,11,45.5,6,4,2,2,12,21,12,1,"https://fbref.com/en/players/9f84febe/Rick-Karsdorp"
2019,"Roma","Serie A","Justin Kluivert","NED","FW","19",1999,14.9,28,27,12,9,7,10,23,43.5,13,17,0,17,7,35,12,0,"https://fbref.com/en/players/4c3a6744/Justin-Kluivert"
2019,"Roma","Serie A","Aleksandar Kolarov","SRB","DF","32",1985,32.3,38,26,22,10,6,21,34,61.8,13,23,15,8,41,79,82,2,"https://fbref.com/en/players/eda40760/Aleksandar-Kolarov"
2019,"Roma","Serie A","Kostas Manolas","GRE","DF","27",1991,25.8,32,24,23,8,1,17,26,65.4,9,34,25,9,50,82,117,2,"https://fbref.com/en/players/c707411f/Kostas-Manolas"
2019,"Roma","Serie A","Iván Marcano","ESP","DF","31",1987,9,8,4,4,4,0,5,8,62.5,3,13,6,7,24,32,45,0,"https://fbref.com/en/players/7a20d90a/Ivan-Marcano"
2019,"Roma","Serie A","Antonio Mirante","ITA","GK","35",1983,11,0,0,0,0,0,0,0,NA,0,0,0,0,0,0,6,1,"https://fbref.com/en/players/30223b33/Antonio-Mirante"
2019,"Roma","Serie A","Steven Nzonzi","FRA","MF","29",1988,29.1,66,45,24,36,6,21,34,61.8,13,40,24,16,27,93,55,2,"https://fbref.com/en/players/c7526c18/Steven-Nzonzi"
2019,"Roma","Serie A","Robin Olsen","SWE","GK","28",1990,27,0,0,0,0,0,0,1,0,1,1,0,1,0,0,10,4,"https://fbref.com/en/players/e7ee38c3/Robin-Olsen"
2019,"Roma","Serie A","Javier Pastore","ARG","MF,FW","29",1989,6.6,10,4,4,3,3,4,16,25,12,7,0,7,3,13,5,0,"https://fbref.com/en/players/881ef58c/Javier-Pastore"
2019,"Roma","Serie A","Lorenzo Pellegrini","ITA","MF","22",1996,20.2,39,23,16,18,5,10,30,33.3,20,20,2,18,12,51,21,0,"https://fbref.com/en/players/4a5a45c7/Lorenzo-Pellegrini"
2019,"Roma","Serie A","Luca Pellegrini","ITA","DF","19",1999,1.8,1,1,1,0,0,1,2,50,1,2,1,1,3,4,2,0,"https://fbref.com/en/players/3b61c9ec/Luca-Pellegrini"
2019,"Roma","Serie A","Diego Perotti","ARG","FW,MF","30",1988,7.4,14,12,5,5,4,6,19,31.6,13,4,0,4,4,18,2,0,"https://fbref.com/en/players/a40d5a0c/Diego-Perotti"
2019,"Roma","Serie A","Davide Santon","ITA","DF","27",1991,11.2,14,6,8,6,0,8,12,66.7,4,11,7,4,15,29,27,0,"https://fbref.com/en/players/88c89891/Davide-Santon"
2019,"Roma","Serie A","Patrik Schick","CZE","FW,MF","22",1996,14.6,11,5,3,5,3,1,19,5.3,18,19,2,17,3,14,15,1,"https://fbref.com/en/players/5d4f7d61/Patrik-Schick"
2019,"Roma","Serie A","Stephan El Shaarawy","ITA","FW,MF","25",1992,23.4,27,14,14,8,5,9,24,37.5,15,11,2,9,20,47,9,0,"https://fbref.com/en/players/d3aaad90/Stephan-El-Shaarawy"
2019,"Roma","Serie A","Kevin Strootman","NED","MF","28",1990,1,2,2,1,0,1,0,1,0,1,5,0,5,2,4,2,0,"https://fbref.com/en/players/ef2e5e1a/Kevin-Strootman"
2019,"Roma","Serie A","Cengiz Ünder","TUR","FW","21",1997,15.3,6,3,3,3,0,2,11,18.2,9,7,0,7,13,19,5,0,"https://fbref.com/en/players/1880614f/Cengiz-Under"
2019,"Roma","Serie A","Nicolò Zaniolo","ITA","MF,FW","19",1999,19.6,35,21,7,18,10,7,37,18.9,30,14,0,14,13,48,8,0,"https://fbref.com/en/players/9907b1c8/Nicolo-Zaniolo"
2019,"SPAL","Serie A","Mirco Antenucci","ITA","FW","33",1984,23.7,11,9,5,1,5,1,10,10,9,14,0,14,5,16,5,0,"https://fbref.com/en/players/43a2e16c/Mirco-Antenucci"
2019,"SPAL","Serie A","Kevin Bonifazi","ITA","DF","22",1996,25.6,40,24,31,8,1,15,33,45.5,18,38,21,17,36,76,79,0,"https://fbref.com/en/players/fb77bfef/Kevin-Bonifazi"
2019,"SPAL","Serie A","Thiago Cionek","POL","DF","32",1986,28.2,75,44,46,25,4,29,56,51.8,27,34,22,12,55,130,144,0,"https://fbref.com/en/players/46f5c54d/Thiago-Cionek"
2019,"SPAL","Serie A","Filippo Costa","ITA","DF,FW","23",1995,6.3,15,13,6,6,3,4,9,44.4,5,10,3,7,8,23,31,1,"https://fbref.com/en/players/00528660/Filippo-Costa"
2019,"SPAL","Serie A","Felipe dal Belo","BRA","DF","34",1984,26.2,36,25,21,13,2,16,32,50,16,29,18,11,17,53,88,1,"https://fbref.com/en/players/8cea6319/Felipe-dal-Belo"
2019,"SPAL","Serie A","Lorenzo Dickmann","ITA","DF,MF","21",1996,1.9,5,4,4,1,0,5,7,71.4,2,0,0,0,1,6,5,0,"https://fbref.com/en/players/12851227/Lorenzo-Dickmann"
2019,"SPAL","Serie A","Johan Djourou","SUI","DF","31",1987,3.1,3,1,3,0,0,2,2,100,0,5,3,2,4,7,20,0,"https://fbref.com/en/players/b8673e18/Johan-Djourou"
2019,"SPAL","Serie A","Mohamed Fares","ALG","DF","22",1996,32.8,63,43,37,18,8,25,54,46.3,29,48,4,44,54,117,83,2,"https://fbref.com/en/players/b7a5bc86/Mohamed-Fares"
2019,"SPAL","Serie A","Sergio Floccari","ITA","FW","36",1981,10.8,13,5,1,5,7,1,7,14.3,6,6,2,4,2,15,6,0,"https://fbref.com/en/players/df301450/Sergio-Floccari"
2019,"SPAL","Serie A","Alfred Gomis","SEN","GK","24",1993,19.2,0,0,0,0,0,0,1,0,1,0,0,0,1,1,14,1,"https://fbref.com/en/players/cecbce23/Alfred-Gomis"
2019,"SPAL","Serie A","Marko Janković","MNE","DF,MF","23",1995,0.6,3,1,2,1,0,0,2,0,2,0,0,0,0,3,0,0,"https://fbref.com/en/players/9866afec/Marko-Jankovic"
2019,"SPAL","Serie A","Jasmin Kurtić","SVN","MF","29",1989,28.4,35,20,19,13,3,13,41,31.7,28,30,3,27,20,55,52,0,"https://fbref.com/en/players/144607cc/Jasmin-Kurtic"
2019,"SPAL","Serie A","Manuel Lazzari","ITA","DF","24",1993,31.5,29,17,16,10,3,13,24,54.2,11,26,5,21,20,49,51,1,"https://fbref.com/en/players/02caf6e0/Manuel-Lazzari"
2019,"SPAL","Serie A","Everton Luiz","BRA","MF","30",1988,3.5,11,6,5,5,1,4,7,57.1,3,9,1,8,3,14,7,2,"https://fbref.com/en/players/3799e138/Everton-Luiz"
2019,"SPAL","Serie A","Vanja Milinković-Savić","SRB","GK","21",1997,1.8,0,0,0,0,0,0,0,NA,0,0,0,0,0,0,1,0,"https://fbref.com/en/players/9fa26bc2/Vanja-Milinkovic-Savic"
2019,"SPAL","Serie A","Simone Missiroli","ITA","MF","32",1986,30.5,58,43,31,22,5,25,49,51,24,44,11,33,46,104,46,0,"https://fbref.com/en/players/331c0a43/Simone-Missiroli"
2019,"SPAL","Serie A","Gabriele Moncini","ITA","MF","22",1996,0.1,1,1,1,0,0,0,0,NA,0,0,0,0,0,1,0,0,"https://fbref.com/en/players/c4efe2b4/Gabriele-Moncini"
2019,"SPAL","Serie A","Alessandro Murgia","ITA","MF","21",1996,11.9,22,15,9,12,1,7,32,21.9,25,14,2,12,19,41,12,1,"https://fbref.com/en/players/fb2c533b/Alessandro-Murgia"
2019,"SPAL","Serie A","Alberto Paloschi","ITA","FW","28",1990,9.6,13,9,3,5,5,1,2,50,1,2,0,2,1,14,0,0,"https://fbref.com/en/players/b5cae4e6/Alberto-Paloschi"
2019,"SPAL","Serie A","Andrea Petagna","ITA","FW","23",1995,33.7,15,6,5,5,5,2,9,22.2,7,23,8,15,4,19,15,0,"https://fbref.com/en/players/03f946ed/Andrea-Petagna"
2019,"SPAL","Serie A","Giacomo Poluzzi","ITA","GK","30",1988,0.1,0,0,0,0,0,0,0,NA,0,0,0,0,0,0,0,0,"https://fbref.com/en/players/07f55871/Giacomo-Poluzzi"
2019,"SPAL","Serie A","Vasco Regini","ITA","DF,FW","27",1990,0.9,1,0,0,1,0,1,3,33.3,2,2,1,1,0,1,4,0,"https://fbref.com/en/players/339c6ed4/Vasco-Regini"
2019,"SPAL","Serie A","Pasquale Schiattarella","ITA","MF","31",1987,20.5,43,27,18,21,4,13,38,34.2,25,17,5,12,22,65,25,1,"https://fbref.com/en/players/bd84fc61/Pasquale-Schiattarella"
2019,"SPAL","Serie A","Lorenco Šimić","CRO","DF","22",1996,2.6,6,3,5,1,0,2,4,50,2,2,1,1,12,18,19,1,"https://fbref.com/en/players/65e4dede/Lorenco-Simic"
2019,"SPAL","Serie A","Mirko Valdifiori","ITA","MF","32",1986,7.4,20,15,12,7,1,8,14,57.1,6,4,2,2,5,25,9,0,"https://fbref.com/en/players/c710f7d5/Mirko-Valdifiori"
2019,"SPAL","Serie A","Mattia Valoti","ITA","MF","24",1993,13.6,33,19,13,14,6,13,29,44.8,16,23,0,23,19,52,17,1,"https://fbref.com/en/players/c414df9d/Mattia-Valoti"
2019,"SPAL","Serie A","Francesco Vicari","ITA","DF","23",1994,25.9,28,24,21,7,0,18,28,64.3,10,31,24,7,34,62,139,1,"https://fbref.com/en/players/de045b15/Francesco-Vicari"
2019,"SPAL","Serie A","Emiliano Viviano","ITA","GK","32",1985,16.9,0,0,0,0,0,0,0,NA,0,0,0,0,0,0,5,2,"https://fbref.com/en/players/03760df0/Emiliano-Viviano"
2019,"Saint-Étienne","Ligue 1","Charles Abi","FRA","DF,FW","18",2000,0.4,4,4,2,1,1,2,2,100,0,1,0,1,0,4,1,0,"https://fbref.com/en/players/469d3d84/Charles-Abi"
2019,"Saint-Étienne","Ligue 1","Youssef Aït Bennasser","MAR","MF","22",1996,10.4,25,13,9,12,4,13,28,46.4,15,15,2,13,19,44,6,2,"https://fbref.com/en/players/c46fa34c/Youssef-Ait-Bennasser"
2019,"Saint-Étienne","Ligue 1","Robert Berić","SVN","FW","27",1991,13.1,12,5,1,9,2,1,11,9.1,10,8,2,6,4,16,3,0,"https://fbref.com/en/players/9001138b/Robert-Beric"
2019,"Saint-Étienne","Ligue 1","Rémy Cabella","FRA","MF,FW","28",1990,33.3,88,51,31,38,19,30,87,34.5,57,39,1,38,19,107,5,3,"https://fbref.com/en/players/148e136f/Remy-Cabella"
2019,"Saint-Étienne","Ligue 1","Mahdi Camara","FRA","FW","20",1998,0.1,0,0,0,0,0,0,0,NA,0,0,0,0,0,0,2,0,"https://fbref.com/en/players/8577e60a/Mahdi-Camara"
2019,"Saint-Étienne","Ligue 1","Mathieu Debuchy","FRA","DF","33",1985,21.6,43,26,25,13,5,22,37,59.5,15,17,7,10,47,90,64,0,"https://fbref.com/en/players/92232aad/Mathieu-Debuchy"
2019,"Saint-Étienne","Ligue 1","Lois Diony","FRA","FW","25",1992,17.7,17,12,3,9,5,4,10,40,6,14,0,14,1,18,9,0,"https://fbref.com/en/players/4be0b467/Lois-Diony"
2019,"Saint-Étienne","Ligue 1","Assane Dioussé","SEN","MF","20",1997,2.4,6,4,3,3,0,2,4,50,2,2,0,2,1,7,7,1,"https://fbref.com/en/players/7f622eef/Assane-Diousse"
2019,"Saint-Étienne","Ligue 1","Wesley Fofana","FRA","DF","17",2000,1.8,7,6,5,2,0,6,13,46.2,7,1,0,1,4,11,9,0,"https://fbref.com/en/players/132a82f1/Wesley-Fofana"
2019,"Saint-Étienne","Ligue 1","Lamine Ghezali","FRA","FW,MF","19",1999,0.5,1,1,0,1,0,1,2,50,1,0,0,0,0,1,2,0,"https://fbref.com/en/players/ce84946a/Lamine-Ghezali"
2019,"Saint-Étienne","Ligue 1","Makhtar Gueye","SEN","FW,MF","20",1997,0.6,2,1,2,0,0,2,2,100,0,2,0,2,0,2,0,0,"https://fbref.com/en/players/92b1763b/Makhtar-Gueye"
2019,"Saint-Étienne","Ligue 1","Romain Hamouma","FRA","FW,MF","31",1987,17.6,30,19,6,18,6,12,32,37.5,20,12,1,11,9,39,7,0,"https://fbref.com/en/players/0b4d8274/Romain-Hamouma"
2019,"Saint-Étienne","Ligue 1","Wahbi Khazri","TUN","FW,MF","27",1991,31.3,41,26,8,14,19,17,49,34.7,32,27,2,25,11,52,5,0,"https://fbref.com/en/players/2677a1de/Wahbi-Khazri"
2019,"Saint-Étienne","Ligue 1","Timothée Kolodziejczak","FRA","DF","26",1991,35.4,34,22,21,10,3,20,45,44.4,25,25,11,14,53,87,118,2,"https://fbref.com/en/players/ab096c6f/Timothee-Kolodziejczak"
2019,"Saint-Étienne","Ligue 1","Yann M'Vila","FRA","MF","28",1990,36.2,72,40,22,48,2,29,72,40.3,43,42,12,30,74,146,86,5,"https://fbref.com/en/players/d4133fa1/Yann-MVila"
2019,"Saint-Étienne","Ligue 1","Kévin Monnet-Paquet","FRA","DF,MF","29",1988,16.5,46,25,23,16,7,20,36,55.6,16,22,4,18,14,60,28,0,"https://fbref.com/en/players/4a57580c/Kevin-Monnet-Paquet"
2019,"Saint-Étienne","Ligue 1","Jessy Moulin","FRA","GK","32",1986,1,1,0,1,0,0,1,1,100,0,0,0,0,0,1,2,0,"https://fbref.com/en/players/28a65a2c/Jessy-Moulin"
2019,"Saint-Étienne","Ligue 1","Arnaud Nordin","FRA","FW,MF","20",1998,11.7,14,12,4,4,6,4,11,36.4,7,13,2,11,5,19,9,0,"https://fbref.com/en/players/7b9a9e25/Arnaud-Nordin"
2019,"Saint-Étienne","Ligue 1","Mickaël Panos","FRA","DF","21",1997,0.3,1,0,0,1,0,1,2,50,1,2,0,2,1,2,0,0,"https://fbref.com/en/players/d8fc044e/Mickael-Panos"
2019,"Saint-Étienne","Ligue 1","Loïc Perrin","FRA","DF","32",1985,30,53,36,34,17,2,20,33,60.6,13,37,24,13,44,97,118,2,"https://fbref.com/en/players/6b200d45/Loic-Perrin"
2019,"Saint-Étienne","Ligue 1","Pierre-Yves Polomat","FRA","DF","24",1993,10.6,18,13,11,6,1,10,18,55.6,8,4,2,2,21,39,27,0,"https://fbref.com/en/players/2ef637bd/Pierre-Yves-Polomat"
2019,"Saint-Étienne","Ligue 1","Kenny Rocha Santos","CPV","MF","18",2000,0,0,0,0,0,0,0,0,NA,0,0,0,0,0,0,0,0,"https://fbref.com/en/players/86df8ac0/Kenny-Rocha-Santos"
2019,"Saint-Étienne","Ligue 1","Stéphane Ruffier","FRA","GK","31",1986,37,2,2,2,0,0,2,4,50,2,0,0,0,0,2,18,3,"https://fbref.com/en/players/cac76a72/Stephane-Ruffier"
2019,"Saint-Étienne","Ligue 1","William Saliba","FRA","DF","17",2001,14.2,32,20,28,4,0,16,24,66.7,8,11,10,1,28,60,44,2,"https://fbref.com/en/players/972aeb2a/William-Saliba"
2019,"Saint-Étienne","Ligue 1","Yannis Salibur","FRA","FW,MF","27",1991,9.8,9,5,1,7,1,1,7,14.3,6,6,0,6,8,17,4,0,"https://fbref.com/en/players/bb4a42be/Yannis-Salibur"
2019,"Saint-Étienne","Ligue 1","Ole Selnæs","NOR","MF","24",1994,18.5,44,26,12,23,9,13,35,37.1,22,24,7,17,19,63,29,0,"https://fbref.com/en/players/4db2157a/Ole-Selnaes"
2019,"Saint-Étienne","Ligue 1","Gabriel Silva","BRA","DF","27",1991,15.9,19,10,13,6,0,6,17,35.3,11,15,3,12,14,33,60,1,"https://fbref.com/en/players/4914ed4a/Gabriel-Silva"
2019,"Saint-Étienne","Ligue 1","Neven Subotić","SRB","DF","29",1988,23.9,44,23,36,7,1,20,39,51.3,19,14,6,8,38,82,107,3,"https://fbref.com/en/players/821233cc/Neven-Subotic"
2019,"Saint-Étienne","Ligue 1","Valentín Vada","ARG","MF","22",1996,4.5,7,4,4,3,0,3,12,25,9,4,1,3,7,14,4,0,"https://fbref.com/en/players/dcf7cf44/Valentin-Vada"
2019,"Sampdoria","Serie A","Joachim Andersen","DEN","DF","22",1996,32,40,27,31,8,1,19,31,61.3,12,30,15,15,35,75,147,1,"https://fbref.com/en/players/e34fc66d/Joachim-Andersen"
2019,"Sampdoria","Serie A","Emil Audero","ITA","GK","21",1997,36,4,3,4,0,0,3,3,100,0,0,0,0,1,5,21,4,"https://fbref.com/en/players/649b01d8/Emil-Audero"
2019,"Sampdoria","Serie A","Édgar Barreto","PAR","MF","34",1984,8.7,28,19,15,6,7,10,26,38.5,16,11,3,8,17,45,7,0,"https://fbref.com/en/players/43a1bea5/Edgar-Barreto"
2019,"Sampdoria","Serie A","Bartosz Bereszyński","POL","DF","26",1992,24.4,46,30,27,15,4,24,51,47.1,27,22,7,15,31,77,76,0,"https://fbref.com/en/players/61b3978f/Bartosz-Bereszynski"
2019,"Sampdoria","Serie A","Rafael Cabral","BRA","GK","28",1990,2,0,0,0,0,0,0,0,NA,0,0,0,0,0,0,0,0,"https://fbref.com/en/players/806f7a26/Rafael-Cabral"
2019,"Sampdoria","Serie A","Gianluca Caprari","ITA","FW,MF","25",1993,11.5,15,9,4,9,2,5,12,41.7,7,7,0,7,4,19,3,0,"https://fbref.com/en/players/54e53b7e/Gianluca-Caprari"
2019,"Sampdoria","Serie A","Omar Colley","GAM","DF","25",1992,19.6,18,11,12,6,0,12,13,92.3,1,24,16,8,22,40,102,0,"https://fbref.com/en/players/8b95acda/Omar-Colley"
2019,"Sampdoria","Serie A","Grégoire Defrel","MTQ","FW,MF","27",1991,26,40,29,10,16,14,9,21,42.9,12,15,0,15,3,43,9,0,"https://fbref.com/en/players/854ee61a/Gregoire-Defrel"
2019,"Sampdoria","Serie A","Albin Ekdal","SWE","MF","29",1989,29.4,61,39,16,38,7,37,68,54.4,31,42,12,30,53,114,62,1,"https://fbref.com/en/players/f503ea63/Albin-Ekdal"
2019,"Sampdoria","Serie A","Alex Ferrari","ITA","DF","24",1994,6,10,8,4,6,0,5,7,71.4,2,7,4,3,9,19,26,0,"https://fbref.com/en/players/d0dbca9f/Alex-Ferrari"
2019,"Sampdoria","Serie A","Manolo Gabbiadini","ITA","FW","26",1991,9,5,2,1,3,1,3,11,27.3,8,6,1,5,4,9,4,0,"https://fbref.com/en/players/8f866fe8/Manolo-Gabbiadini"
2019,"Sampdoria","Serie A","Jakub Jankto","CZE","MF","22",1996,10.7,7,4,5,2,0,4,15,26.7,11,18,2,16,9,16,16,0,"https://fbref.com/en/players/1ea5f91c/Jakub-Jankto"
2019,"Sampdoria","Serie A","Dawid Kownacki","POL","FW","21",1997,1.9,2,1,0,1,1,1,4,25,3,0,0,0,0,2,0,0,"https://fbref.com/en/players/be5e1c4c/Dawid-Kownacki"
2019,"Sampdoria","Serie A","Karol Linetty","POL","MF","23",1995,27.9,72,48,26,32,14,15,69,21.7,54,39,4,35,25,97,17,0,"https://fbref.com/en/players/d023d70f/Karol-Linetty"
2019,"Sampdoria","Serie A","Nicola Murru","ITA","DF","23",1994,32.6,83,59,42,25,16,41,54,75.9,13,50,22,28,41,124,99,0,"https://fbref.com/en/players/d183e9d6/Nicola-Murru"
2019,"Sampdoria","Serie A","Dennis Praet","BEL","MF","24",1994,32.1,62,44,30,25,7,27,51,52.9,24,33,4,29,36,98,31,0,"https://fbref.com/en/players/86695068/Dennis-Praet"
2019,"Sampdoria","Serie A","Fabio Quagliarella","ITA","FW","35",1983,35.5,14,8,6,4,4,2,15,13.3,13,32,1,31,8,22,17,0,"https://fbref.com/en/players/ee4f2f3b/Fabio-Quagliarella"
2019,"Sampdoria","Serie A","Gastón Ramírez","URU","MF","27",1990,17.5,38,22,12,18,8,11,31,35.5,20,28,4,24,8,46,27,0,"https://fbref.com/en/players/2c851997/Gaston-Ramirez"
2019,"Sampdoria","Serie A","Jacopo Sala","ITA","DF","26",1991,16.9,38,23,20,14,4,23,41,56.1,18,11,3,8,20,58,47,2,"https://fbref.com/en/players/da5a981b/Jacopo-Sala"
2019,"Sampdoria","Serie A","Riccardo Saponara","ITA","MF","26",1991,10.1,12,6,2,6,4,3,12,25,9,5,1,4,4,16,10,0,"https://fbref.com/en/players/3bb7af3b/Riccardo-Saponara"
2019,"Sampdoria","Serie A","Marco Sau","ITA","MF,FW","30",1987,0.6,0,0,0,0,0,0,0,NA,0,1,0,1,0,0,0,0,"https://fbref.com/en/players/1ad1f50d/Marco-Sau"
2019,"Sampdoria","Serie A","Júnior Tavares","BRA","DF","21",1996,2,2,1,1,1,0,2,4,50,2,0,0,0,2,4,1,0,"https://fbref.com/en/players/f1675fdd/Junior-Tavares"
2019,"Sampdoria","Serie A","Lorenzo Tonelli","ITA","DF","28",1990,18.4,31,22,19,9,3,15,19,78.9,4,27,21,6,24,55,92,0,"https://fbref.com/en/players/8cc29864/Lorenzo-Tonelli"
2019,"Sampdoria","Serie A","Ronaldo Vieira","GNB","MF","20",1998,6.7,NA,10,NA,NA,NA,NA,NA,NA,NA,NA,NA,NA,7,NA,NA,NA,"https://fbref.com/en/players/75e60d75/Ronaldo-Vieira"
2019,"Sassuolo","Serie A","Claud Adjapong","ITA","MF,FW","20",1998,3,4,2,1,3,0,1,2,50,1,3,1,2,1,5,4,0,"https://fbref.com/en/players/ce5b170a/Claud-Adjapong"
2019,"Sassuolo","Serie A","Khouma Babacar","SEN","FW","25",1993,16.5,7,3,2,5,0,2,10,20,8,8,2,6,3,10,25,1,"https://fbref.com/en/players/422ec08a/Khouma-Babacar"
2019,"Sassuolo","Serie A","Domenico Berardi","ITA","FW,MF","23",1994,31.9,38,21,16,9,13,15,73,20.5,58,31,2,29,27,65,24,0,"https://fbref.com/en/players/53a0e358/Domenico-Berardi"
2019,"Sassuolo","Serie A","Kevin-Prince Boateng","GHA","FW","31",1987,10.4,5,4,0,4,1,1,4,25,3,7,3,4,3,8,13,0,"https://fbref.com/en/players/f4ec4fd0/Kevin-Prince-Boateng"
2019,"Sassuolo","Serie A","Jeremie Boga","CIV","FW,MF","21",1997,16,7,4,5,1,1,4,14,28.6,10,19,0,19,2,9,4,0,"https://fbref.com/en/players/fe012aca/Jeremie-Boga"
2019,"Sassuolo","Serie A","Mehdi Bourabia","MAR","MF","26",1991,22.3,51,28,23,21,7,15,46,32.6,31,28,5,23,33,84,32,0,"https://fbref.com/en/players/0d077b88/Mehdi-Bourabia"
2019,"Sassuolo","Serie A","Enrico Brignola","ITA","FW,MF","19",1999,1.9,2,2,2,0,0,0,2,0,2,0,0,0,1,3,1,0,"https://fbref.com/en/players/d0643f8f/Enrico-Brignola"
2019,"Sassuolo","Serie A","Andrea Consigli","ITA","GK","31",1987,35.7,0,0,0,0,0,0,2,0,2,0,0,0,1,1,15,6,"https://fbref.com/en/players/8cabdc1e/Andrea-Consigli"
2019,"Sassuolo","Serie A","Cristian Dell'Orco","ITA","DF","24",1994,1.2,1,1,1,0,0,1,3,33.3,2,1,0,1,1,2,3,0,"https://fbref.com/en/players/b0243215/Cristian-DellOrco"
2019,"Sassuolo","Serie A","Merih Demiral","TUR","DF","20",1998,14,24,16,23,1,0,10,13,76.9,3,16,11,5,19,43,80,0,"https://fbref.com/en/players/e3cceee6/Merih-Demiral"
2019,"Sassuolo","Serie A","Federico Di Francesco","ITA","FW,MF","24",1994,11.9,10,6,3,4,3,4,7,57.1,3,12,1,11,5,15,5,0,"https://fbref.com/en/players/1fca9171/Federico-Di-Francesco"
2019,"Sassuolo","Serie A","Alfred Duncan","GHA","MF","25",1993,20.5,33,21,15,15,3,19,48,39.6,29,20,6,14,15,48,18,0,"https://fbref.com/en/players/528492ea/Alfred-Duncan"
2019,"Sassuolo","Serie A","Mauricio Lemos","URU","DF","22",1995,2,2,1,2,0,0,1,2,50,1,2,1,1,3,5,10,1,"https://fbref.com/en/players/dbe5a587/Mauricio-Lemos"
2019,"Sassuolo","Serie A","Pol Lirola","ESP","DF,MF","20",1997,33.1,35,22,19,11,5,21,34,61.8,13,25,5,20,32,67,89,0,"https://fbref.com/en/players/ff800ed8/Pol-Lirola"
2019,"Sassuolo","Serie A","Manuel Locatelli","ITA","MF","20",1998,20.5,44,28,19,15,10,13,29,44.8,16,21,3,18,27,71,33,1,"https://fbref.com/en/players/a8a874f1/Manuel-Locatelli"
2019,"Sassuolo","Serie A","Francesco Magnanelli","ITA","MF","33",1984,20.7,52,33,29,22,1,22,49,44.9,27,18,5,13,24,76,38,2,"https://fbref.com/en/players/07767f42/Francesco-Magnanelli"
2019,"Sassuolo","Serie A","Giangiacomo Magnani","ITA","DF","22",1995,16.8,11,9,9,2,0,6,15,40,9,17,13,4,16,27,99,1,"https://fbref.com/en/players/cce9f582/Giangiacomo-Magnani"
2019,"Sassuolo","Serie A","Gian Marco Ferrari","ITA","DF","26",1992,31,41,23,27,12,2,12,16,75,4,36,20,16,36,77,97,1,"https://fbref.com/en/players/8650af85/Gian-Marco-Ferrari"
2019,"Sassuolo","Serie A","Marlon","BRA","DF","22",1995,16.8,29,18,25,3,1,15,21,71.4,6,22,12,10,24,53,39,0,"https://fbref.com/en/players/cdf65d12/Marlon"
2019,"Sassuolo","Serie A","Alessandro Matri","ITA","FW","33",1984,6.7,2,1,0,0,2,0,3,0,3,4,2,2,4,6,7,0,"https://fbref.com/en/players/58d97e77/Alessandro-Matri"
2019,"Sassuolo","Serie A","Jens Odgaard","DEN","FW","19",1999,0.2,0,0,0,0,0,0,0,NA,0,1,0,1,0,0,1,0,"https://fbref.com/en/players/75374ee7/Jens-Odgaard"
2019,"Sassuolo","Serie A","Gianluca Pegolo","ITA","GK","37",1981,2.3,0,0,0,0,0,0,0,NA,0,0,0,0,0,0,0,0,"https://fbref.com/en/players/f058ed1f/Gianluca-Pegolo"
2019,"Sassuolo","Serie A","Federico Peluso","ITA","DF","34",1984,15.1,23,14,15,5,3,13,16,81.3,3,8,3,5,23,46,70,0,"https://fbref.com/en/players/4f2908e5/Federico-Peluso"
2019,"Sassuolo","Serie A","Giacomo Raspadori","ITA","DF","18",2000,0,0,0,0,0,0,0,0,NA,0,0,0,0,0,0,0,0,"https://fbref.com/en/players/6e058f06/Giacomo-Raspadori"
2019,"Sassuolo","Serie A","Rogério","BRA","DF,MF","20",1998,29.7,55,38,35,13,7,30,55,54.5,25,32,7,25,37,92,109,1,"https://fbref.com/en/players/10e7f486/Rogerio"
2019,"Sassuolo","Serie A","Stefano Sensi","ITA","MF","22",1995,21.9,36,20,15,18,3,6,30,20,24,36,7,29,33,69,17,0,"https://fbref.com/en/players/b70bde8f/Stefano-Sensi"
2019,"Sassuolo","Serie A","Leonardo Sernicola","ITA","FW","21",1997,0.1,0,0,0,0,0,0,0,NA,0,0,0,0,0,0,0,0,"https://fbref.com/en/players/dd7febd8/Leonardo-Sernicola"
2019,"Sassuolo","Serie A","Marcello Trotta","ITA","MF","25",1992,0.1,0,0,0,0,0,0,1,0,1,0,0,0,0,0,0,0,"https://fbref.com/en/players/acdad0aa/Marcello-Trotta"
2019,"Sassuolo","Serie A","Filip Đuričić","SRB","FW,MF","26",1992,13.9,17,13,2,11,4,5,22,22.7,17,20,1,19,8,25,8,1,"https://fbref.com/en/players/eccbe56a/Filip-Djuricic"
2019,"Schalke 04","Bundesliga","Nabil Bentaleb","ALG","MF","23",1994,19.9,32,17,8,21,3,4,18,22.2,14,28,8,20,35,67,19,0,"https://fbref.com/en/players/3189f61a/Nabil-Bentaleb"
2019,"Schalke 04","Bundesliga","Nassim Boujellab","MAR","MF","19",1999,4.2,10,4,3,6,1,3,11,27.3,8,6,0,6,2,12,3,0,"https://fbref.com/en/players/541127d5/Nassim-Boujellab"
2019,"Schalke 04","Bundesliga","Jeffrey Bruma","NED","DF","26",1991,6.9,12,11,8,4,0,6,12,50,6,8,2,6,4,16,35,0,"https://fbref.com/en/players/fbffc4b1/Jeffrey-Bruma"
2019,"Schalke 04","Bundesliga","Guido Burgstaller","AUT","FW","29",1989,17,11,9,2,5,4,3,8,37.5,5,5,0,5,2,13,10,0,"https://fbref.com/en/players/2bcc6d52/Guido-Burgstaller"
2019,"Schalke 04","Bundesliga","Daniel Caligiuri","ITA","DF,FW","30",1988,30.6,93,52,55,29,9,44,103,42.7,59,66,10,56,50,143,72,1,"https://fbref.com/en/players/d1273f09/Daniel-Caligiuri"
2019,"Schalke 04","Bundesliga","Jonas Carls","GER","FW","21",1997,1,5,2,4,0,1,5,5,100,0,0,0,0,1,6,0,0,"https://fbref.com/en/players/2bb48e86/Jonas-Carls"
2019,"Schalke 04","Bundesliga","Franco Di Santo","ARG","MF,FW","29",1989,2.7,2,1,0,2,0,1,4,25,3,3,1,2,1,3,3,0,"https://fbref.com/en/players/549c6ba7/Franco-Di-Santo"
2019,"Schalke 04","Bundesliga","Breel Embolo","SUI","FW","21",1997,14.9,22,17,4,13,5,1,9,11.1,8,11,0,11,4,26,6,0,"https://fbref.com/en/players/0b4f388a/Breel-Embolo"
2019,"Schalke 04","Bundesliga","Ralf Fährmann","GER","GK","29",1988,16.3,0,0,0,0,0,0,0,NA,0,0,0,0,2,2,10,4,"https://fbref.com/en/players/1e43fad8/Ralf-Fahrmann"
2019,"Schalke 04","Bundesliga","Amine Harit","MAR","MF,FW","21",1997,12,15,8,4,9,2,8,24,33.3,16,11,1,10,9,24,2,0,"https://fbref.com/en/players/e7d59f4f/Amine-Harit"
2019,"Schalke 04","Bundesliga","Yevhen Konoplyanka","UKR","FW,MF","28",1989,7.3,2,0,0,0,2,2,4,50,2,6,0,6,3,5,3,0,"https://fbref.com/en/players/d9a5d930/Yevhen-Konoplyanka"
2019,"Schalke 04","Bundesliga","Ahmed Kutucu","TUR","FW,MF","18",2000,4.7,8,3,3,4,1,1,3,33.3,2,2,1,1,0,8,0,0,"https://fbref.com/en/players/beda9675/Ahmed-Kutucu"
2019,"Schalke 04","Bundesliga","Omar Mascarell","ESP","MF","25",1993,11,20,10,9,9,2,10,24,41.7,14,21,7,14,23,43,8,0,"https://fbref.com/en/players/11fd2b75/Omar-Mascarell"
2019,"Schalke 04","Bundesliga","Rabbi Matondo","WAL","FW,MF","17",2000,2.1,4,1,4,0,0,1,5,20,4,2,0,2,0,4,1,0,"https://fbref.com/en/players/33144cc5/Rabbi-Matondo"
2019,"Schalke 04","Bundesliga","Weston McKennie","USA","MF,FW","19",1998,19.4,28,14,5,17,6,11,35,31.4,24,28,9,19,36,64,46,1,"https://fbref.com/en/players/01c3aff5/Weston-McKennie"
2019,"Schalke 04","Bundesliga","Hamza Mendyl","MAR","DF","20",1997,6,17,15,6,8,3,8,18,44.4,10,11,2,9,8,25,8,0,"https://fbref.com/en/players/f99fe221/Hamza-Mendyl"
2019,"Schalke 04","Bundesliga","Naldo","BRA","DF","35",1982,7,10,7,8,2,0,5,8,62.5,3,8,3,5,14,24,25,0,"https://fbref.com/en/players/03bd0bf4/Naldo"
2019,"Schalke 04","Bundesliga","Matija Nastasić","SRB","DF","25",1993,27.2,35,23,22,13,0,20,29,69,9,32,20,12,38,73,114,1,"https://fbref.com/en/players/f35430a4/Matija-Nastasic"
2019,"Schalke 04","Bundesliga","Alexander Nübel","GER","GK","21",1996,17.6,0,0,0,0,0,0,1,0,1,0,0,0,1,1,4,1,"https://fbref.com/en/players/afb0c500/Alexander-Nubel"
2019,"Schalke 04","Bundesliga","Bastian Oczipka","GER","DF,FW","29",1989,20.8,41,27,20,19,2,21,26,80.8,5,23,5,18,24,65,24,2,"https://fbref.com/en/players/d1661819/Bastian-Oczipka"
2019,"Schalke 04","Bundesliga","Baba Rahman","GHA","DF","24",1994,1.8,3,1,1,1,1,1,1,100,0,3,0,3,2,5,2,0,"https://fbref.com/en/players/e4086af3/Baba-Rahman"
2019,"Schalke 04","Bundesliga","Sascha Riether","GER","FW","35",1983,0,0,0,0,0,0,0,0,NA,0,0,0,0,0,0,0,0,"https://fbref.com/en/players/3cb009c5/Sascha-Riether"
2019,"Schalke 04","Bundesliga","Sebastian Rudy","GER","MF","28",1990,15.1,44,24,11,27,6,11,41,26.8,30,23,2,21,15,59,15,0,"https://fbref.com/en/players/80f36c88/Sebastian-Rudy"
2019,"Schalke 04","Bundesliga","Salif Sané","SEN","DF","27",1990,29,54,37,34,19,1,27,46,58.7,19,44,29,15,68,122,146,3,"https://fbref.com/en/players/791abba1/Salif-Sane"
2019,"Schalke 04","Bundesliga","Alessandro Schöpf","AUT","MF,DF","24",1994,11.2,26,16,12,13,1,12,29,41.4,17,14,0,14,9,35,12,0,"https://fbref.com/en/players/106bca06/Alessandro-Schopf"
2019,"Schalke 04","Bundesliga","Suat Serdar","GER","MF","21",1997,19.2,51,32,20,26,5,14,49,28.6,35,37,6,31,23,74,5,1,"https://fbref.com/en/players/b3325a30/Suat-Serdar"
2019,"Schalke 04","Bundesliga","Steven Skrzybski","GER","FW,MF","25",1992,7.4,9,3,0,6,3,3,11,27.3,8,8,1,7,3,12,2,0,"https://fbref.com/en/players/58ce23e5/Steven-Skrzybski"
2019,"Schalke 04","Bundesliga","Benjamin Stambouli","FRA","DF,MF","27",1990,19.6,51,31,24,24,3,25,46,54.3,21,41,9,32,32,83,65,2,"https://fbref.com/en/players/5939baa2/Benjamin-Stambouli"
2019,"Schalke 04","Bundesliga","Cedric Teuchert","GER","FW,MF","21",1997,1.8,0,0,0,0,0,0,0,NA,0,2,0,2,1,1,0,0,"https://fbref.com/en/players/f956479d/Cedric-Teuchert"
2019,"Schalke 04","Bundesliga","George Timotheou","AUS","DF","21",1997,1,3,3,3,0,0,0,0,NA,0,1,1,0,1,4,4,0,"https://fbref.com/en/players/8fa80ec8/George-Timotheou"
2019,"Schalke 04","Bundesliga","Mark Uth","GER","FW,MF","26",1991,15.6,20,11,8,8,4,4,23,17.4,19,19,2,17,8,28,12,0,"https://fbref.com/en/players/a3ddb1b9/Mark-Uth"
2019,"Schalke 04","Bundesliga","Haji Wright","USA","FW","20",1998,2.2,3,2,1,1,1,0,1,0,1,1,0,1,0,3,1,0,"https://fbref.com/en/players/91cd37b7/Haji-Wright"
2019,"Sevilla","La Liga","Ibrahim Amadou","FRA","MF,DF","25",1993,8.5,27,20,9,15,3,2,9,22.2,7,7,4,3,11,38,24,0,"https://fbref.com/en/players/9260926b/Ibrahim-Amadou"
2019,"Sevilla","La Liga","Guilherme Arana","BRA","DF","21",1997,7,11,6,5,5,1,6,7,85.7,1,6,3,3,9,20,8,0,"https://fbref.com/en/players/2b15a82a/Guilherme-Arana"
2019,"Sevilla","La Liga","Éver Banega","ARG","MF","30",1988,29.6,71,50,32,35,4,20,70,28.6,50,26,5,21,28,99,28,0,"https://fbref.com/en/players/fa937f7a/Ever-Banega"
2019,"Sevilla","La Liga","Wissam Ben Yedder","FRA","FW","27",1990,31.2,18,16,3,11,4,2,12,16.7,10,18,0,18,11,29,2,0,"https://fbref.com/en/players/942b4f90/Wissam-Ben-Yedder"
2019,"Sevilla","La Liga","Bryan","ESP","MF,FW","17",2001,1.9,6,4,4,1,1,1,5,20,4,0,0,0,1,7,0,0,"https://fbref.com/en/players/7b5ab7f2/Bryan"
2019,"Sevilla","La Liga","Daniel Carriço","POR","DF","29",1988,23.7,35,18,23,11,1,12,20,60,8,19,12,7,31,66,104,1,"https://fbref.com/en/players/e1deea75/Daniel-Carrico"
2019,"Sevilla","La Liga","Javier Díaz","ESP","GK","21",1997,1,0,0,0,0,0,0,0,NA,0,0,0,0,0,0,0,0,"https://fbref.com/en/players/17a1299d/Javier-Diaz"
2019,"Sevilla","La Liga","Sergio Escudero","ESP","DF,FW","28",1989,17.2,43,29,20,18,5,18,35,51.4,17,22,4,18,24,67,52,0,"https://fbref.com/en/players/b0616e3d/Sergio-Escudero"
2019,"Sevilla","La Liga","Joris Gnagnon","FRA","DF,MF","21",1997,5,11,8,6,4,1,4,7,57.1,3,2,2,0,10,21,16,0,"https://fbref.com/en/players/1232e1dc/Joris-Gnagnon"
2019,"Sevilla","La Liga","Sergi Gómez","ESP","DF","26",1992,30.7,49,38,33,12,4,18,28,64.3,10,30,20,10,40,89,135,1,"https://fbref.com/en/players/bc6f5f06/Sergi-Gomez"
2019,"Sevilla","La Liga","Maxime Gonalons","FRA","MF","29",1989,6,8,4,2,5,1,1,15,6.7,14,10,4,6,5,13,12,0,"https://fbref.com/en/players/b8c1de25/Maxime-Gonalons"
2019,"Sevilla","La Liga","Munir El Haddadi","MAR","FW,MF","22",1995,11.6,17,10,5,7,5,2,7,28.6,5,15,0,15,6,23,9,0,"https://fbref.com/en/players/8696bc90/Munir-El-Haddadi"
2019,"Sevilla","La Liga","Simon Kjær","DEN","DF","29",1989,22.3,29,19,25,3,1,9,16,56.3,7,41,34,7,27,56,136,0,"https://fbref.com/en/players/8b8a56ce/Simon-Kjaer"
2019,"Sevilla","La Liga","Gabriel Mercado","ARG","DF","31",1987,19.3,35,23,21,12,2,18,36,50,18,24,12,12,26,61,75,1,"https://fbref.com/en/players/bf97c188/Gabriel-Mercado"
2019,"Sevilla","La Liga","Roque Mesa","ESP","MF","29",1989,19.4,46,27,16,22,8,15,38,39.5,23,16,0,16,14,60,12,4,"https://fbref.com/en/players/7c4243d4/Roque-Mesa"
2019,"Sevilla","La Liga","Luis Muriel","COL","MF,FW","27",1991,1.4,0,0,0,0,0,0,6,0,6,3,0,3,0,0,1,0,"https://fbref.com/en/players/eb2fe5b6/Luis-Muriel"
2019,"Sevilla","La Liga","Jesús Navas","ESP","DF,FW","32",1985,30.1,28,21,15,11,2,16,24,66.7,8,23,5,18,29,57,62,0,"https://fbref.com/en/players/3f10bd22/Jesus-Navas"
2019,"Sevilla","La Liga","Nolito","ESP","FW,DF","31",1986,0.8,3,2,1,1,1,1,2,50,1,2,0,2,0,3,1,0,"https://fbref.com/en/players/b2d0ec1b/Nolito"
2019,"Sevilla","La Liga","Quincy Promes","NED","FW,DF","26",1992,17.6,35,25,23,9,3,15,22,68.2,7,19,3,16,25,60,22,1,"https://fbref.com/en/players/b182a240/Quincy-Promes"
2019,"Sevilla","La Liga","Marko Rog","CRO","MF","23",1995,4,12,11,4,8,0,5,9,55.6,4,4,0,4,8,20,1,0,"https://fbref.com/en/players/b6b2b820/Marko-Rog"
2019,"Sevilla","La Liga","Pablo Sarabia","ESP","MF,FW","26",1992,30.3,30,15,6,15,9,6,47,12.8,41,30,3,27,22,52,20,0,"https://fbref.com/en/players/9744ff80/Pablo-Sarabia"
2019,"Sevilla","La Liga","André Silva","POR","FW","22",1995,24,8,5,1,4,3,1,11,9.1,10,17,1,16,3,11,32,0,"https://fbref.com/en/players/3effaa34/Andre-Silva"
2019,"Sevilla","La Liga","Juan Soriano","ESP","GK","20",1997,4,0,0,0,0,0,0,0,NA,0,0,0,0,1,1,1,0,"https://fbref.com/en/players/5512b1a9/Juan-Soriano"
2019,"Sevilla","La Liga","Tomáš Vaclík","CZE","GK","29",1989,33,0,0,0,0,0,0,1,0,1,0,0,0,0,0,9,6,"https://fbref.com/en/players/7b456af7/Tomas-Vaclik"
2019,"Sevilla","La Liga","Franco Vázquez","ARG","MF","29",1989,25.3,51,37,21,21,9,23,66,34.8,43,25,2,23,23,74,27,1,"https://fbref.com/en/players/467bae22/Franco-Vazquez"
2019,"Sevilla","La Liga","Aleix Vidal","ESP","DF,MF","28",1989,5.9,13,11,5,5,3,5,14,35.7,9,5,0,5,4,17,12,0,"https://fbref.com/en/players/04965583/Aleix-Vidal"
2019,"Sevilla","La Liga","Maximilian Wöber","AUT","DF","20",1998,6,12,9,8,2,2,3,6,50,3,6,0,6,7,19,16,0,"https://fbref.com/en/players/4b803b3c/Maximilian-Wober"
2019,"Southampton","Premier League","Stuart Armstrong","SCO","MF","26",1992,15.9,28,20,14,6,8,8,42,19,34,14,0,14,12,40,12,0,"https://fbref.com/en/players/97333cf5/Stuart-Armstrong"
2019,"Southampton","Premier League","Charlie Austin","ENG","FW","29",1989,10.9,13,7,3,6,4,6,11,54.5,5,12,2,10,2,15,13,0,"https://fbref.com/en/players/8d228291/Charlie-Austin"
2019,"Southampton","Premier League","Jan Bednarek","POL","DF","22",1996,23.9,41,25,25,16,0,21,37,56.8,16,44,27,17,71,112,171,0,"https://fbref.com/en/players/4115ce4e/Jan-Bednarek"
2019,"Southampton","Premier League","Ryan Bertrand","ENG","DF","28",1989,24,46,27,22,20,4,16,31,51.6,15,27,5,22,28,74,51,0,"https://fbref.com/en/players/01226327/Ryan-Bertrand"
2019,"Southampton","Premier League","Steven Davis","NIR","MF","33",1985,1.1,2,2,0,2,0,0,0,NA,0,2,0,2,1,3,5,0,"https://fbref.com/en/players/cf15bbb1/Steven-Davis"
2019,"Southampton","Premier League","Mohamed Elyounoussi","NOR","MF","23",1994,8.8,16,12,7,6,3,6,19,31.6,13,11,1,10,6,22,5,0,"https://fbref.com/en/players/68dc0dac/Mohamed-Elyounoussi"
2019,"Southampton","Premier League","Fraser Forster","ENG","GK","30",1988,1,0,0,0,0,0,0,0,NA,0,0,0,0,0,0,1,0,"https://fbref.com/en/players/c3e39f12/Fraser-Forster"
2019,"Southampton","Premier League","Manolo Gabbiadini","ITA","FW,MF","26",1991,5.3,6,2,1,4,1,1,2,50,1,5,0,5,3,9,6,0,"https://fbref.com/en/players/8f866fe8/Manolo-Gabbiadini"
2019,"Southampton","Premier League","Sam Gallagher","ENG","FW","22",1995,0.4,0,0,0,0,0,0,0,NA,0,1,0,1,0,0,1,0,"https://fbref.com/en/players/44361ade/Sam-Gallagher"
2019,"Southampton","Premier League","Angus Gunn","ENG","GK","22",1996,12,0,0,0,0,0,0,0,NA,0,0,0,0,0,0,8,3,"https://fbref.com/en/players/e082af5b/Angus-Gunn"
2019,"Southampton","Premier League","Wesley Hoedt","NED","DF","24",1994,13,28,12,23,5,0,17,26,65.4,9,20,13,7,23,51,79,2,"https://fbref.com/en/players/875898c7/Wesley-Hoedt"
2019,"Southampton","Premier League","Pierre Højbjerg","DEN","MF","22",1995,30.7,71,49,20,44,7,24,73,32.9,49,51,8,43,60,131,30,1,"https://fbref.com/en/players/8b04d6c1/Pierre-Hojbjerg"
2019,"Southampton","Premier League","Danny Ings","ENG","FW","26",1992,18.3,30,14,5,19,6,11,28,39.3,17,30,2,28,5,35,9,0,"https://fbref.com/en/players/07802f7f/Danny-Ings"
2019,"Southampton","Premier League","Tyreke Johnson","ENG","MF","19",1998,0,0,0,0,0,0,0,0,NA,0,0,0,0,0,0,0,0,"https://fbref.com/en/players/4701e130/Tyreke-Johnson"
2019,"Southampton","Premier League","Mario Lemina","GAB","MF","24",1993,17.9,49,32,23,23,3,15,34,44.1,19,27,3,24,43,92,31,1,"https://fbref.com/en/players/2b471f99/Mario-Lemina"
2019,"Southampton","Premier League","Shane Long","IRL","FW,MF","31",1987,14.1,15,8,4,5,6,3,16,18.8,13,10,1,9,7,22,18,0,"https://fbref.com/en/players/9f472354/Shane-Long"
2019,"Southampton","Premier League","Alex McCarthy","ENG","GK","28",1989,25,0,0,0,0,0,0,0,NA,0,0,0,0,0,0,6,2,"https://fbref.com/en/players/36c2ca73/Alex-McCarthy"
2019,"Southampton","Premier League","Michael Obafemi","IRL","FW","18",2000,1.5,1,1,0,0,1,0,0,NA,0,1,1,0,1,2,0,0,"https://fbref.com/en/players/caa1a7f0/Michael-Obafemi"
2019,"Southampton","Premier League","Kayne Ramsey","ENG","DF","17",2000,1,0,0,0,0,0,0,0,NA,0,0,0,0,0,0,7,0,"https://fbref.com/en/players/dc31b84c/Kayne-Ramsey"
2019,"Southampton","Premier League","Nathan Redmond","ENG","MF,FW","24",1994,36.3,45,22,14,19,12,14,41,34.1,27,54,2,52,20,65,23,1,"https://fbref.com/en/players/ab651565/Nathan-Redmond"
2019,"Southampton","Premier League","Oriol Romeu","ESP","MF","26",1991,23.7,81,46,39,38,4,32,77,41.6,45,43,17,26,52,133,44,1,"https://fbref.com/en/players/4b511457/Oriol-Romeu"
2019,"Southampton","Premier League","Josh Sims","ENG","MF","21",1997,2.4,1,0,1,0,0,1,3,33.3,2,2,0,2,1,2,1,0,"https://fbref.com/en/players/6d6f09dc/Josh-Sims"
2019,"Southampton","Premier League","Callum Slattery","ENG","MF","19",1999,1.2,4,3,0,4,0,3,7,42.9,4,1,1,0,2,6,1,0,"https://fbref.com/en/players/059948df/Callum-Slattery"
2019,"Southampton","Premier League","Cédric Soares","POR","DF","26",1991,16.6,22,16,15,6,1,9,15,60,6,21,5,16,22,44,60,2,"https://fbref.com/en/players/839c14e1/Cedric-Soares"
2019,"Southampton","Premier League","Jack Stephens","ENG","DF","24",1994,18.9,25,13,17,7,1,16,28,57.1,12,25,13,12,37,62,96,2,"https://fbref.com/en/players/6adbc307/Jack-Stephens"
2019,"Southampton","Premier League","Matt Targett","ENG","DF","22",1995,13.2,27,19,15,7,5,12,26,46.2,14,19,3,16,27,54,42,0,"https://fbref.com/en/players/e514ab62/Matt-Targett"
2019,"Southampton","Premier League","Yan Valery","TUN","DF","19",1999,19,42,36,26,10,6,16,29,55.2,13,24,3,21,22,64,72,1,"https://fbref.com/en/players/531a4aa8/Yan-Valery"
2019,"Southampton","Premier League","Jannik Vestergaard","DEN","DF","25",1992,22.5,53,33,37,13,3,28,45,62.2,17,35,20,15,35,88,174,1,"https://fbref.com/en/players/1900032e/Jannik-Vestergaard"
2019,"Southampton","Premier League","James Ward-Prowse","ENG","MF,DF","23",1994,21.6,36,17,19,13,4,14,43,32.6,29,30,6,24,27,63,59,0,"https://fbref.com/en/players/3515d404/James-Ward-Prowse"
2019,"Southampton","Premier League","Maya Yoshida","JPN","DF","29",1988,16.9,16,12,5,10,1,4,13,30.8,9,24,20,4,42,58,103,1,"https://fbref.com/en/players/caffaf5a/Maya-Yoshida"
2019,"Strasbourg","Ligue 1","Ismael Aaneba","FRA","DF","19",1999,2.3,12,6,7,5,0,5,10,50,5,5,0,5,8,20,9,0,"https://fbref.com/en/players/a7e4760c/Ismael-Aaneba"
2019,"Strasbourg","Ligue 1","Ludovic Ajorque","FRA","FW","24",1994,17,17,13,1,10,6,4,9,44.4,5,5,0,5,5,22,9,0,"https://fbref.com/en/players/462475ed/Ludovic-Ajorque"
2019,"Strasbourg","Ligue 1","Anthony Caci","FRA","DF","21",1997,25.5,56,30,38,14,4,24,46,52.2,22,20,10,10,47,103,63,0,"https://fbref.com/en/players/0118c54c/Anthony-Caci"
2019,"Strasbourg","Ligue 1","Lionel Carole","FRA","DF,FW","27",1991,19.2,25,12,16,7,2,11,16,68.8,5,19,5,14,32,57,51,0,"https://fbref.com/en/players/5b5724d2/Lionel-Carole"
2019,"Strasbourg","Ligue 1","Benjamin Corgnet","FRA","MF,FW","31",1987,7.5,21,12,7,9,5,4,11,36.4,7,1,0,1,6,27,9,0,"https://fbref.com/en/players/cfd8dde3/Benjamin-Corgnet"
2019,"Strasbourg","Ligue 1","Nuno da Costa","CPV","FW","27",1991,22.8,39,27,10,19,10,10,38,26.3,28,24,1,23,14,53,9,0,"https://fbref.com/en/players/909222de/Nuno-da-Costa"
2019,"Strasbourg","Ligue 1","Youssouf Fofana","FRA","MF","19",1999,10.1,28,20,5,20,3,9,27,33.3,18,7,0,7,11,39,8,0,"https://fbref.com/en/players/822d51d7/Youssouf-Fofana"
2019,"Strasbourg","Ligue 1","Anthony Gonçalves","FRA","MF,FW","32",1986,11.8,22,15,12,8,2,7,22,31.8,15,21,2,19,10,32,17,0,"https://fbref.com/en/players/c27dfb82/Anthony-Goncalves"
2019,"Strasbourg","Ligue 1","Samuel Grandsir","FRA","MF,FW","21",1996,2.6,9,6,5,3,1,3,7,42.9,4,2,0,2,1,10,0,0,"https://fbref.com/en/players/d2448564/Samuel-Grandsir"
2019,"Strasbourg","Ligue 1","Jérémy Grimm","FRA","MF","31",1987,1.9,4,2,2,2,0,3,5,60,2,1,0,1,4,8,5,0,"https://fbref.com/en/players/53283127/Jeremy-Grimm"
2019,"Strasbourg","Ligue 1","Eiji Kawashima","JPN","GK","35",1983,1,0,0,0,0,0,0,0,NA,0,0,0,0,0,0,0,0,"https://fbref.com/en/players/a4527d33/Eiji-Kawashima"
2019,"Strasbourg","Ligue 1","Lamine Koné","CIV","DF","29",1989,23.9,21,16,9,9,3,6,9,66.7,3,18,13,5,33,54,66,3,"https://fbref.com/en/players/a46472d0/Lamine-Kone"
2019,"Strasbourg","Ligue 1","Kenny Lala","FRA","DF,FW","26",1991,34,78,45,48,23,7,30,53,56.6,23,26,9,17,28,106,62,2,"https://fbref.com/en/players/770d7eb8/Kenny-Lala"
2019,"Strasbourg","Ligue 1","Dimitri Liénard","FRA","MF,DF","30",1988,14.3,33,18,20,9,4,21,45,46.7,24,11,2,9,18,51,22,0,"https://fbref.com/en/players/f7691f63/Dimitri-Lienard"
2019,"Strasbourg","Ligue 1","Jonas Martin","FRA","MF","28",1990,22.9,46,28,23,18,5,17,33,51.5,16,30,12,18,30,76,42,0,"https://fbref.com/en/players/468fdbad/Jonas-Martin"
2019,"Strasbourg","Ligue 1","Pablo Martinez","FRA","DF","29",1989,31.3,51,34,34,17,0,30,49,61.2,19,37,23,14,52,103,132,1,"https://fbref.com/en/players/1ad8cb67/Pablo-Martinez"
2019,"Strasbourg","Ligue 1","Stefan Mitrović","SRB","DF","28",1990,33.6,23,16,20,3,0,12,24,50,12,41,31,10,46,69,146,2,"https://fbref.com/en/players/e6777e6b/Stefan-Mitrovic"
2019,"Strasbourg","Ligue 1","Lebo Mothiba","RSA","FW","22",1996,19.7,10,9,2,7,1,0,8,0,8,5,1,4,0,10,6,0,"https://fbref.com/en/players/3eaf8817/Lebo-Mothiba"
2019,"Strasbourg","Ligue 1","Abdallah N'dour","SEN","DF","24",1993,3.2,6,4,3,3,0,4,9,44.4,5,4,2,2,5,11,8,0,"https://fbref.com/en/players/4749367a/Abdallah-Ndour"
2019,"Strasbourg","Ligue 1","Sanjin Prcić","BIH","MF","24",1993,11.7,19,14,11,7,1,8,18,44.4,10,22,8,14,18,37,7,1,"https://fbref.com/en/players/51c30111/Sanjin-Prcic"
2019,"Strasbourg","Ligue 1","Idriss Saadi","ALG","FW,MF","26",1992,0.1,0,0,0,0,0,0,0,NA,0,0,0,0,0,0,0,0,"https://fbref.com/en/players/17f29fb0/Idriss-Saadi"
2019,"Strasbourg","Ligue 1","Matz Sels","BEL","GK","26",1992,37,0,0,0,0,0,0,1,0,1,0,0,0,1,1,24,1,"https://fbref.com/en/players/834b5c4c/Matz-Sels"
2019,"Strasbourg","Ligue 1","Ibrahima Sissoko","FRA","MF","20",1997,29.6,60,41,23,34,3,23,55,41.8,32,37,3,34,34,94,39,1,"https://fbref.com/en/players/0f8418aa/Ibrahima-Sissoko"
2019,"Strasbourg","Ligue 1","Adrien Thomasson","FRA","MF,FW","24",1993,27.5,54,27,18,23,13,21,66,31.8,45,29,5,24,18,72,12,1,"https://fbref.com/en/players/c76b7567/Adrien-Thomasson"
2019,"Strasbourg","Ligue 1","Mootaz Zemzemi","TUN","FW,MF","18",1999,0,1,0,0,0,1,0,0,NA,0,0,0,0,0,1,0,0,"https://fbref.com/en/players/242b350c/Mootaz-Zemzemi"
2019,"Strasbourg","Ligue 1","Kévin Zohi","MLI","FW,MF","21",1996,7,14,10,6,6,2,5,9,55.6,4,8,0,8,7,21,5,0,"https://fbref.com/en/players/775185ae/Kevin-Zohi"
2019,"Stuttgart","Bundesliga","Antonis Aidonis","GER","DF","17",2001,0.9,3,1,1,1,1,1,4,25,3,1,0,1,2,5,2,0,"https://fbref.com/en/players/54507986/Antonis-Aidonis"
2019,"Stuttgart","Bundesliga","Chadrac Akolo","COD","MF,FW","23",1995,5.8,9,6,2,7,0,1,3,33.3,2,7,0,7,4,13,1,0,"https://fbref.com/en/players/debc2f28/Chadrac-Akolo"
2019,"Stuttgart","Bundesliga","Dennis Aogo","GER","MF","31",1987,11.4,15,10,6,7,2,6,15,40,9,8,1,7,9,24,19,0,"https://fbref.com/en/players/c311243f/Dennis-Aogo"
2019,"Stuttgart","Bundesliga","Santiago Ascacíbar","ARG","MF","21",1997,27,78,50,43,29,6,34,74,45.9,40,48,10,38,43,121,34,1,"https://fbref.com/en/players/e26fcca3/Santiago-Ascacibar"
2019,"Stuttgart","Bundesliga","Holger Badstuber","GER","DF","29",1989,5.8,12,4,8,4,0,7,8,87.5,1,6,2,4,9,21,21,1,"https://fbref.com/en/players/45b7edae/Holger-Badstuber"
2019,"Stuttgart","Bundesliga","Timo Baumgartl","GER","DF","22",1996,18,33,23,21,12,0,11,19,57.9,8,31,22,9,26,59,100,0,"https://fbref.com/en/players/bd7d2e6d/Timo-Baumgartl"
2019,"Stuttgart","Bundesliga","Andreas Beck","GER","DF","31",1987,19.7,35,19,17,17,1,11,27,40.7,16,32,6,26,22,57,54,0,"https://fbref.com/en/players/00a6485f/Andreas-Beck"
2019,"Stuttgart","Bundesliga","Gonzalo Castro","GER","MF","31",1987,18.8,50,28,21,25,4,19,43,44.2,24,23,5,18,29,79,22,1,"https://fbref.com/en/players/68829001/Gonzalo-Castro"
2019,"Stuttgart","Bundesliga","Leon Dajaku","GER","DF,MF","17",2001,0.3,2,1,0,1,1,0,0,NA,0,1,0,1,0,2,0,0,"https://fbref.com/en/players/aeaf1bc1/Leon-Dajaku"
2019,"Stuttgart","Bundesliga","Daniel Didavi","GER","MF,FW","28",1990,10.6,21,15,8,10,3,7,20,35,13,11,1,10,4,25,5,0,"https://fbref.com/en/players/d3096421/Daniel-Didavi"
2019,"Stuttgart","Bundesliga","Anastasios Donis","GRE","FW,MF","21",1996,10.7,15,13,8,4,3,3,11,27.3,8,7,0,7,4,19,0,0,"https://fbref.com/en/players/0f26fd24/Anastasios-Donis"
2019,"Stuttgart","Bundesliga","Alexander Esswein","GER","MF,FW","28",1990,13.9,17,11,6,4,7,6,21,28.6,15,17,0,17,12,29,16,0,"https://fbref.com/en/players/b48215cd/Alexander-Esswein"
2019,"Stuttgart","Bundesliga","Christian Gentner","GER","MF,FW","32",1985,22.4,61,38,29,26,6,16,50,32,34,30,3,27,31,92,41,1,"https://fbref.com/en/players/a4f94a0d/Christian-Gentner"
2019,"Stuttgart","Bundesliga","Mario Gómez","GER","FW","33",1985,24.6,19,11,6,10,3,2,12,16.7,10,17,6,11,5,24,33,0,"https://fbref.com/en/players/71a20ce8/Mario-Gomez"
2019,"Stuttgart","Bundesliga","Nicolás González","ARG","FW,MF","20",1998,24,19,14,3,7,9,9,19,47.4,10,32,2,30,11,30,27,0,"https://fbref.com/en/players/2374aaca/Nicolas-Gonzalez"
2019,"Stuttgart","Bundesliga","Emiliano Insúa","ARG","DF","29",1989,23.5,51,33,26,18,7,25,42,59.5,17,29,2,27,31,82,55,1,"https://fbref.com/en/players/f3cccffe/Emiliano-Insua"
2019,"Stuttgart","Bundesliga","Ozan Kabak","TUR","DF","18",2000,15,33,19,22,9,2,9,19,47.4,10,15,8,7,23,56,58,1,"https://fbref.com/en/players/2d61d13a/Ozan-Kabak"
2019,"Stuttgart","Bundesliga","Marc-Oliver Kempf","GER","DF","23",1995,22.5,33,18,26,7,0,12,24,50,12,35,21,14,46,79,141,1,"https://fbref.com/en/players/815c314f/Marc-Oliver-Kempf"
2019,"Stuttgart","Bundesliga","Pablo Maffeo","ESP","DF,MF","21",1997,6.6,15,13,10,5,0,6,13,46.2,7,8,4,4,13,28,17,0,"https://fbref.com/en/players/5db04597/Pablo-Maffeo"
2019,"Stuttgart","Bundesliga","Hans Nunoo Sarpei","GHA","FW,MF","19",1998,0.5,1,1,0,1,0,0,0,NA,0,0,0,0,0,1,0,0,"https://fbref.com/en/players/9593331d/Hans-Nunoo-Sarpei"
2019,"Stuttgart","Bundesliga","Berkay Özcan","TUR","MF,DF","20",1998,0.6,0,0,0,0,0,0,0,NA,0,1,0,1,0,0,0,0,"https://fbref.com/en/players/31114001/Berkay-Ozcan"
2019,"Stuttgart","Bundesliga","Benjamin Pavard","FRA","DF","22",1996,29,28,20,21,6,1,12,19,63.2,7,27,19,8,48,76,189,2,"https://fbref.com/en/players/45a03961/Benjamin-Pavard"
2019,"Stuttgart","Bundesliga","Borna Sosa","CRO","DF,MF","20",1998,6.8,13,7,8,4,1,4,9,44.4,5,5,1,4,6,19,34,0,"https://fbref.com/en/players/af0d79a9/Borna-Sosa"
2019,"Stuttgart","Bundesliga","Erik Thommy","GER","MF,FW","23",1994,8.8,5,3,3,1,1,1,7,14.3,6,16,1,15,14,19,4,0,"https://fbref.com/en/players/df8e7b62/Erik-Thommy"
2019,"Stuttgart","Bundesliga","Ron-Robert Zieler","GER","GK","29",1989,34,2,1,2,0,0,1,4,25,3,1,0,1,1,3,19,3,"https://fbref.com/en/players/a0606ae8/Ron-Robert-Zieler"
2019,"Stuttgart","Bundesliga","Steven Zuber","SUI","MF,FW","26",1991,11.7,6,3,2,2,2,1,13,7.7,12,14,2,12,6,12,6,0,"https://fbref.com/en/players/b6a6e0a7/Steven-Zuber"
2019,"Torino","Serie A","Ola Aina","NGA","DF","21",1996,24,54,36,32,20,2,23,48,47.9,25,30,3,27,39,93,59,2,"https://fbref.com/en/players/246d153b/Ola-Aina"
2019,"Torino","Serie A","Cristian Ansaldi","ARG","DF,MF","31",1986,20.1,50,26,19,21,10,15,30,50,15,21,4,17,15,65,31,0,"https://fbref.com/en/players/bbafc0c4/Cristian-Ansaldi"
2019,"Torino","Serie A","Daniele Baselli","ITA","MF","26",1992,26.4,65,45,22,34,9,16,44,36.4,28,30,6,24,34,99,32,0,"https://fbref.com/en/players/ea06dd97/Daniele-Baselli"
2019,"Torino","Serie A","Andrea Belotti","ITA","FW","24",1993,36.7,33,22,8,15,10,6,30,20,24,36,5,31,15,48,23,0,"https://fbref.com/en/players/d705ba44/Andrea-Belotti"
2019,"Torino","Serie A","Álex Berenguer","ESP","MF,DF","23",1995,16.5,31,20,12,17,2,14,34,41.2,20,20,1,19,8,39,14,0,"https://fbref.com/en/players/dc1c2fce/Alex-Berenguer"
2019,"Torino","Serie A","Gleison Bremer","BRA","DF","21",1997,2,3,1,1,2,0,1,2,50,1,4,1,3,8,11,9,0,"https://fbref.com/en/players/5fd5ed86/Gleison-Bremer"
2019,"Torino","Serie A","Vitalie Damașcan","MDA","MF","19",1999,0,1,1,0,1,0,1,1,100,0,0,0,0,0,1,0,0,"https://fbref.com/en/players/54e0c0cc/Vitalie-Damascan"
2019,"Torino","Serie A","Lorenzo De Silvestri","ITA","DF","30",1988,26.8,15,11,8,5,2,7,24,29.2,17,53,3,50,22,37,69,2,"https://fbref.com/en/players/e74f0e59/Lorenzo-De-Silvestri"
2019,"Torino","Serie A","Koffi Djidji","CIV","DF","25",1992,15.4,37,23,27,9,1,12,20,60,8,26,19,7,24,61,72,1,"https://fbref.com/en/players/933d3b51/Koffi-Djidji"
2019,"Torino","Serie A","Simone Edera","ITA","MF","21",1997,0.9,0,0,0,0,0,0,1,0,1,1,0,1,1,1,0,0,"https://fbref.com/en/players/8697c095/Simone-Edera"
2019,"Torino","Serie A","Iago Falque","ESP","FW,MF","28",1990,17.9,13,8,3,8,2,3,16,18.8,13,14,0,14,3,16,2,0,"https://fbref.com/en/players/440c84ed/Iago-Falque"
2019,"Torino","Serie A","Salvador Ichazo","URU","GK","26",1992,2.8,0,0,0,0,0,0,0,NA,0,0,0,0,0,0,0,0,"https://fbref.com/en/players/514f0896/Salvador-Ichazo"
2019,"Torino","Serie A","Armando Izzo","ITA","DF","26",1992,36.3,76,50,35,35,6,33,53,62.3,20,52,24,28,88,164,149,2,"https://fbref.com/en/players/89976232/Armando-Izzo"
2019,"Torino","Serie A","Adem Ljajić","SRB","MF","26",1991,0.3,0,0,0,0,0,0,1,0,1,0,0,0,0,0,0,0,"https://fbref.com/en/players/2648e18f/Adem-Ljajic"
2019,"Torino","Serie A","Saša Lukić","SRB","MF","21",1996,11,21,11,5,11,5,5,16,31.3,11,13,4,9,12,33,11,0,"https://fbref.com/en/players/c6e8cf1f/Sasa-Lukic"
2019,"Torino","Serie A","Lyanco","BRA","DF","21",1997,1,1,1,1,0,0,0,0,NA,0,1,1,0,4,5,5,0,"https://fbref.com/en/players/b5bf1770/Lyanco"
2019,"Torino","Serie A","Soualiho Meïté","FRA","MF","24",1994,29.5,46,21,13,22,11,23,46,50,23,46,6,40,29,75,26,0,"https://fbref.com/en/players/5cec2c74/Soualiho-Meite"
2019,"Torino","Serie A","Vincenzo Millico","ITA","MF","17",2000,0,0,0,0,0,0,0,0,NA,0,0,0,0,0,0,0,0,"https://fbref.com/en/players/6817095b/Vincenzo-Millico"
2019,"Torino","Serie A","Emiliano Moretti","ITA","DF","37",1981,22.3,30,21,21,9,0,13,20,65,7,14,6,8,24,54,65,1,"https://fbref.com/en/players/55667895/Emiliano-Moretti"
2019,"Torino","Serie A","Nicolas Nkoulou","CMR","DF","28",1990,35.7,45,29,34,10,1,15,25,60,10,42,28,14,70,115,174,2,"https://fbref.com/en/players/93cf32a8/Nicolas-Nkoulou"
2019,"Torino","Serie A","Vittorio Parigini","ITA","MF,DF","22",1996,4.2,11,10,3,6,2,6,9,66.7,3,3,0,3,1,12,5,0,"https://fbref.com/en/players/75efed2e/Vittorio-Parigini"
2019,"Torino","Serie A","Tomás Rincón","VEN","MF","30",1988,31.1,75,44,25,41,9,31,68,45.6,37,35,5,30,42,117,71,1,"https://fbref.com/en/players/f1cfc209/Tomas-Rincon"
2019,"Torino","Serie A","Salvatore Sirigu","ITA","GK","31",1987,35.2,0,0,0,0,0,0,2,0,2,0,0,0,2,2,21,1,"https://fbref.com/en/players/10dc46f0/Salvatore-Sirigu"
2019,"Torino","Serie A","Roberto Soriano","ITA","MF","27",1991,5.2,9,5,0,5,4,1,8,12.5,7,9,0,9,6,15,1,0,"https://fbref.com/en/players/9d4c45d6/Roberto-Soriano"
2019,"Torino","Serie A","Simone Zaza","ITA","FW,MF","27",1991,16,20,9,3,12,5,1,8,12.5,7,12,1,11,4,24,9,0,"https://fbref.com/en/players/9592289a/Simone-Zaza"
2019,"Tottenham","Premier League","Toby Alderweireld","BEL","DF","29",1989,32.5,37,23,25,10,2,12,22,54.5,10,41,22,19,24,61,175,0,"https://fbref.com/en/players/f7d50789/Toby-Alderweireld"
2019,"Tottenham","Premier League","Dele Alli","ENG","MF","22",1996,20.3,33,19,6,14,13,5,24,20.8,19,33,5,28,19,52,20,0,"https://fbref.com/en/players/cea4ee8f/Dele-Alli"
2019,"Tottenham","Premier League","Luke Amos","ENG","MF","21",1997,0,1,0,0,1,0,0,0,NA,0,0,0,0,0,1,0,0,"https://fbref.com/en/players/77128f7e/Luke-Amos"
2019,"Tottenham","Premier League","Serge Aurier","CIV","DF","25",1992,6.3,20,12,12,4,4,8,15,53.3,7,8,2,6,7,27,20,0,"https://fbref.com/en/players/5c2b4f07/Serge-Aurier"
2019,"Tottenham","Premier League","Ben Davies","WAL","DF","25",1993,20.5,56,30,39,13,4,38,54,70.4,16,23,10,13,23,79,68,1,"https://fbref.com/en/players/44781702/Ben-Davies"
2019,"Tottenham","Premier League","Mousa Dembélé","BEL","MF","31",1987,5.7,13,9,6,6,1,4,7,57.1,3,4,1,3,7,20,5,2,"https://fbref.com/en/players/f7ee69fb/Mousa-Dembele"
2019,"Tottenham","Premier League","Eric Dier","ENG","MF,DF","24",1994,16.7,26,16,7,15,4,19,47,40.4,28,27,12,15,21,47,46,1,"https://fbref.com/en/players/ac861941/Eric-Dier"
2019,"Tottenham","Premier League","Christian Eriksen","DEN","MF","26",1992,30.8,41,25,8,20,13,17,59,28.8,42,26,3,23,15,56,13,0,"https://fbref.com/en/players/980522ec/Christian-Eriksen"
2019,"Tottenham","Premier League","Juan Foyth","ARG","DF","20",1998,9.9,31,17,20,11,0,14,19,73.7,5,12,5,7,10,41,50,1,"https://fbref.com/en/players/6c7762c3/Juan-Foyth"
2019,"Tottenham","Premier League","Paulo Gazzaniga","ARG","GK","26",1992,3,0,0,0,0,0,0,0,NA,0,0,0,0,0,0,1,0,"https://fbref.com/en/players/63d17038/Paulo-Gazzaniga"
2019,"Tottenham","Premier League","Son Heung-min","KOR","FW,MF","26",1992,22.7,23,12,7,12,4,10,34,29.4,24,26,2,24,8,31,4,1,"https://fbref.com/en/players/92e7e919/Son-Heung-min"
2019,"Tottenham","Premier League","Vincent Janssen","NED","FW","24",1994,0.4,2,1,0,2,0,0,0,NA,0,0,0,0,0,2,1,0,"https://fbref.com/en/players/31dce0c8/Vincent-Janssen"
2019,"Tottenham","Premier League","Harry Kane","ENG","FW","25",1993,26.9,10,6,2,8,0,1,14,7.1,13,16,6,10,1,11,14,0,"https://fbref.com/en/players/21a66f6a/Harry-Kane"
2019,"Tottenham","Premier League","Érik Lamela","ARG","MF,FW","26",1992,10.8,17,13,6,7,4,5,14,35.7,9,14,0,14,7,24,1,0,"https://fbref.com/en/players/abe66106/Erik-Lamela"
2019,"Tottenham","Premier League","Fernando Llorente","ESP","FW","33",1985,7.7,4,2,3,0,1,2,3,66.7,1,7,2,5,1,5,10,0,"https://fbref.com/en/players/82dbf623/Fernando-Llorente"
2019,"Tottenham","Premier League","Hugo Lloris","FRA","GK","31",1986,33,1,0,1,0,0,0,2,0,2,0,0,0,0,1,13,5,"https://fbref.com/en/players/8f62b6ee/Hugo-Lloris"
2019,"Tottenham","Premier League","Lucas Moura","BRA","FW,MF","25",1992,23.6,35,18,8,20,7,9,27,33.3,18,15,1,14,24,59,24,0,"https://fbref.com/en/players/2b622f01/Lucas-Moura"
2019,"Tottenham","Premier League","Georges-Kévin N'Koudou","CMR","FW","23",1995,0.1,0,0,0,0,0,0,0,NA,0,0,0,0,0,0,0,0,"https://fbref.com/en/players/76c131da/Georges-Kevin-NKoudou"
2019,"Tottenham","Premier League","Danny Rose","ENG","DF","28",1990,20,49,31,26,16,7,20,32,62.5,12,24,4,20,24,73,28,3,"https://fbref.com/en/players/89d10e53/Danny-Rose"
2019,"Tottenham","Premier League","Davinson Sánchez","COL","DF","22",1996,21.6,37,20,28,9,0,20,37,54.1,17,17,9,8,30,67,103,2,"https://fbref.com/en/players/da7b447d/Davinson-Sanchez"
2019,"Tottenham","Premier League","Moussa Sissoko","FRA","MF,FW","28",1989,25.9,36,25,18,14,4,15,29,51.7,14,31,4,27,16,52,25,2,"https://fbref.com/en/players/2acd49b9/Moussa-Sissoko"
2019,"Tottenham","Premier League","Oliver Skipp","ENG","MF","17",2000,2.4,7,3,4,3,0,4,6,66.7,2,2,1,1,1,8,7,0,"https://fbref.com/en/players/6250083a/Oliver-Skipp"
2019,"Tottenham","Premier League","Kieran Trippier","ENG","DF","27",1990,25.3,67,37,43,16,8,37,62,59.7,25,38,5,33,23,90,77,2,"https://fbref.com/en/players/21512407/Kieran-Trippier"
2019,"Tottenham","Premier League","Jan Vertonghen","BEL","DF","31",1987,21.2,39,24,17,20,2,14,24,58.3,10,18,11,7,32,71,81,0,"https://fbref.com/en/players/ba23a904/Jan-Vertonghen"
2019,"Tottenham","Premier League","Michel Vorm","NED","GK","34",1983,2,0,0,0,0,0,0,0,NA,0,0,0,0,0,0,1,0,"https://fbref.com/en/players/1bebde9d/Michel-Vorm"
2019,"Tottenham","Premier League","Kyle Walker-Peters","ENG","DF","21",1997,4.2,7,4,4,2,1,3,4,75,1,5,1,4,4,11,6,0,"https://fbref.com/en/players/984a5a64/Kyle-Walker-Peters"
2019,"Tottenham","Premier League","Victor Wanyama","KEN","MF","27",1991,5.7,13,13,8,5,0,6,12,50,6,9,3,6,7,20,11,0,"https://fbref.com/en/players/e0900238/Victor-Wanyama"
2019,"Tottenham","Premier League","Harry Winks","ENG","MF","22",1996,17.7,22,13,12,9,1,5,30,16.7,25,19,3,16,21,43,19,0,"https://fbref.com/en/players/2f7acede/Harry-Winks"
2019,"Toulouse","Ligue 1","Kelvin Amian","FRA","DF","20",1998,32,68,45,54,12,2,20,30,66.7,10,36,13,23,36,104,113,1,"https://fbref.com/en/players/bcc81786/Kelvin-Amian"
2019,"Toulouse","Ligue 1","Yann Bodiger","FRA","MF","23",1995,0.1,0,0,0,0,0,0,1,0,1,0,0,0,0,0,0,0,"https://fbref.com/en/players/8c2c48a9/Yann-Bodiger"
2019,"Toulouse","Ligue 1","John Bostock","TRI","MF","26",1992,10.9,24,14,14,10,0,9,30,30,21,12,2,10,17,41,11,0,"https://fbref.com/en/players/46291841/John-Bostock"
2019,"Toulouse","Ligue 1","Yannick Cahuzac","FRA","MF,DF","33",1985,15.9,33,19,15,15,3,17,32,53.1,15,16,4,12,24,57,55,0,"https://fbref.com/en/players/677ee102/Yannick-Cahuzac"
2019,"Toulouse","Ligue 1","Bafodé Diakité","FRA","DF","17",2001,7,15,7,5,9,1,10,14,71.4,4,15,3,12,11,26,29,0,"https://fbref.com/en/players/1bfb6fef/Bafode-Diakite"
2019,"Toulouse","Ligue 1","Mathieu Dossevi","TOG","FW,MF","30",1988,27.4,42,28,20,11,11,13,40,32.5,27,29,1,28,33,75,13,0,"https://fbref.com/en/players/6421dd73/Mathieu-Dossevi"
2019,"Toulouse","Ligue 1","Jimmy Durmaz","SWE","MF,FW","29",1989,21.1,34,22,8,13,13,15,38,39.5,23,14,2,12,11,45,16,1,"https://fbref.com/en/players/f09a8b75/Jimmy-Durmaz"
2019,"Toulouse","Ligue 1","Steven Fortes","CPV","DF","26",1992,1.5,3,1,1,2,0,0,0,NA,0,1,1,0,2,5,9,2,"https://fbref.com/en/players/574aa9ec/Steven-Fortes"
2019,"Toulouse","Ligue 1","Manu García","ESP","MF","20",1998,20.5,37,26,14,17,6,15,49,30.6,34,16,1,15,15,52,5,0,"https://fbref.com/en/players/6ed1a2a2/Manu-Garcia"
2019,"Toulouse","Ligue 1","Mauro Goicoechea","URU","GK","30",1988,7.9,0,0,0,0,0,0,0,NA,0,0,0,0,0,0,7,0,"https://fbref.com/en/players/132bb875/Mauro-Goicoechea"
2019,"Toulouse","Ligue 1","Max Gradel","CIV","FW,MF","30",1987,36,58,35,34,19,5,24,70,34.3,46,53,9,44,18,76,41,0,"https://fbref.com/en/players/c5a500ca/Max-Gradel"
2019,"Toulouse","Ligue 1","Corentin Jean","FRA","FW,MF","23",1995,7,9,6,3,6,0,2,8,25,6,8,0,8,2,11,5,0,"https://fbref.com/en/players/7d9b37bf/Corentin-Jean"
2019,"Toulouse","Ligue 1","Christopher Jullien","FRA","DF","25",1993,33.5,35,24,23,10,2,12,32,37.5,20,39,27,12,41,76,203,4,"https://fbref.com/en/players/f323d995/Christopher-Jullien"
2019,"Toulouse","Ligue 1","Kouadio Koné","FRA","MF","17",2001,0.8,4,2,0,4,0,2,4,50,2,0,0,0,0,4,0,0,"https://fbref.com/en/players/86574238/Kouadio-Kone"
2019,"Toulouse","Ligue 1","Aaron Leya Iseka","BEL","FW","20",1997,16,6,4,1,4,1,1,4,25,3,5,3,2,1,7,10,0,"https://fbref.com/en/players/29ef0f49/Aaron-Leya-Iseka"
2019,"Toulouse","Ligue 1","Stéphane Mbia","CMR","DF,MF","32",1986,5,1,0,1,0,0,1,2,50,1,9,4,5,7,8,25,1,"https://fbref.com/en/players/c39d9657/Stephane-Mbia"
2019,"Toulouse","Ligue 1","Clément Michelin","FRA","DF","21",1997,1,3,2,2,1,0,2,3,66.7,1,0,0,0,3,6,7,0,"https://fbref.com/en/players/cb9ec45d/Clement-Michelin"
2019,"Toulouse","Ligue 1","Hakim El Mokeddem","BRA","FW,MF","19",1999,0.3,1,1,1,0,0,0,1,0,1,0,0,0,0,1,1,0,"https://fbref.com/en/players/e493cff8/Hakim-El-Mokeddem"
2019,"Toulouse","Ligue 1","Steven Moreira","FRA","DF,MF","23",1994,9.6,19,8,13,5,1,10,17,58.8,7,14,0,14,10,29,19,1,"https://fbref.com/en/players/f10983ae/Steven-Moreira"
2019,"Toulouse","Ligue 1","François Moubandje","SUI","DF","28",1990,21.5,38,22,22,10,6,17,22,77.3,5,18,4,14,27,65,74,0,"https://fbref.com/en/players/6ca88b2a/Francois-Moubandje"
2019,"Toulouse","Ligue 1","Ndombe Mubele","COD","FW","24",1994,5.2,9,4,5,2,2,4,9,44.4,5,4,0,4,2,11,2,0,"https://fbref.com/en/players/176674ab/Ndombe-Mubele"
2019,"Toulouse","Ligue 1","Nathan N'Goumou","FRA","FW","18",2000,0.8,1,1,0,1,0,0,1,0,1,1,0,1,0,1,3,0,"https://fbref.com/en/players/e110ea4b/Nathan-NGoumou"
2019,"Toulouse","Ligue 1","Baptiste Reynet","FRA","GK","27",1990,30,0,0,0,0,0,0,3,0,3,0,0,0,1,1,14,2,"https://fbref.com/en/players/bcf1b2e9/Baptiste-Reynet"
2019,"Toulouse","Ligue 1","Ibrahim Sangaré","CIV","MF","20",1997,27.4,102,66,50,44,8,32,63,50.8,31,52,20,32,29,131,49,2,"https://fbref.com/en/players/bced0375/Ibrahim-Sangare"
2019,"Toulouse","Ligue 1","Yaya Sanogo","FRA","FW","25",1993,13.8,4,2,0,2,2,2,4,50,2,3,0,3,3,7,15,0,"https://fbref.com/en/players/11ced928/Yaya-Sanogo"
2019,"Toulouse","Ligue 1","Gen Shoji","JPN","DF","25",1992,18,24,13,16,8,0,11,24,45.8,13,22,14,8,21,45,56,0,"https://fbref.com/en/players/8b28686a/Gen-Shoji"
2019,"Toulouse","Ligue 1","Kalidou Sidibé","FRA","MF","19",1999,14,24,12,11,12,1,7,15,46.7,8,16,3,13,17,41,26,1,"https://fbref.com/en/players/ea540835/Kalidou-Sidibe"
2019,"Toulouse","Ligue 1","Issiaga Sylla","GUI","DF,MF","24",1994,22.2,54,36,30,24,0,28,53,52.8,25,36,10,26,39,93,77,0,"https://fbref.com/en/players/b99bec05/Issiaga-Sylla"
2019,"Toulouse","Ligue 1","Jean-Clair Todibo","FRA","DF","18",1999,9.3,21,18,19,2,0,11,13,84.6,2,14,5,9,14,35,62,2,"https://fbref.com/en/players/88f130ed/Jean-Clair-Todibo"
2019,"Udinese","Serie A","Emmanuel Agyemang-Badu","GHA","MF","27",1990,1.8,4,0,1,2,1,1,1,100,0,2,0,2,1,5,2,0,"https://fbref.com/en/players/fe0b8f0e/Emmanuel-Agyemang-Badu"
2019,"Udinese","Serie A","Andrija Balić","CRO","FW,MF","20",1997,0.3,1,0,0,0,1,0,1,0,1,0,0,0,0,1,1,0,"https://fbref.com/en/players/9be4ee80/Andrija-Balic"
2019,"Udinese","Serie A","Antonín Barák","CZE","MF,FW","23",1994,3.7,9,6,4,5,0,2,11,18.2,9,4,0,4,2,11,2,0,"https://fbref.com/en/players/01efac19/Antonin-Barak"
2019,"Udinese","Serie A","Valon Behrami","SUI","MF","33",1985,15.1,65,38,25,34,6,18,44,40.9,26,29,12,17,18,83,26,0,"https://fbref.com/en/players/d3d758d8/Valon-Behrami"
2019,"Udinese","Serie A","Marco D'Alessandro","ITA","DF","27",1991,16.6,55,34,34,15,6,29,49,59.2,20,24,2,22,9,64,50,1,"https://fbref.com/en/players/060606ec/Marco-DAlessandro"
2019,"Udinese","Serie A","Sebastien De Maio","FRA","DF","31",1987,13,11,7,7,4,0,3,12,25,9,22,17,5,12,23,93,0,"https://fbref.com/en/players/952a03fe/Sebastien-De-Maio"
2019,"Udinese","Serie A","Rodrigo De Paul","ARG","MF,FW","24",1994,35.4,53,33,21,27,5,13,42,31,29,35,2,33,32,85,28,0,"https://fbref.com/en/players/162efffd/Rodrigo-De-Paul"
2019,"Udinese","Serie A","Seko Fofana","CIV","MF","23",1995,29.3,25,13,14,10,1,6,36,16.7,30,20,7,13,29,54,18,3,"https://fbref.com/en/players/5313ed43/Seko-Fofana"
2019,"Udinese","Serie A","Emil Hallfreðsson","ISL","MF","34",1984,1.5,0,0,0,0,0,0,1,0,1,1,1,0,3,3,4,0,"https://fbref.com/en/players/86015b20/Emil-Hallfredsson"
2019,"Udinese","Serie A","Svante Ingelsson","SWE","DF,MF","20",1998,1.1,1,1,1,0,0,0,0,NA,0,2,0,2,0,1,4,0,"https://fbref.com/en/players/4133cfcf/Svante-Ingelsson"
2019,"Udinese","Serie A","Kevin Lasagna","ITA","FW","25",1992,27.3,6,1,0,3,3,2,12,16.7,10,20,2,18,8,14,35,0,"https://fbref.com/en/players/09538fdb/Kevin-Lasagna"
2019,"Udinese","Serie A","Darwin Machís","VEN","FW,MF","25",1993,5.1,7,6,4,3,0,0,4,0,4,6,0,6,2,9,8,0,"https://fbref.com/en/players/ed6ea4d9/Darwin-Machis"
2019,"Udinese","Serie A","Rolando Mandragora","ITA","MF","21",1997,32.4,66,35,25,34,7,24,69,34.8,45,49,9,40,43,109,59,0,"https://fbref.com/en/players/c7259b83/Rolando-Mandragora"
2019,"Udinese","Serie A","Petar Mićin","SRB","MF","19",1998,0,0,0,0,0,0,0,0,NA,0,0,0,0,0,0,0,0,"https://fbref.com/en/players/259deea9/Petar-Micin"
2019,"Udinese","Serie A","Juan Musso","ARG","GK","24",1994,29,0,0,0,0,0,0,1,0,1,0,0,0,0,0,10,4,"https://fbref.com/en/players/a111cf41/Juan-Musso"
2019,"Udinese","Serie A","Bram Nuytinck","NED","DF","28",1990,23.6,50,35,34,13,3,25,33,75.8,8,44,27,17,29,79,126,0,"https://fbref.com/en/players/e33f36d5/Bram-Nuytinck"
2019,"Udinese","Serie A","Stefano Okaka","ITA","FW","28",1989,10.8,13,7,4,5,4,2,8,25,6,6,1,5,0,13,16,1,"https://fbref.com/en/players/601ef102/Stefano-Okaka"
2019,"Udinese","Serie A","Nicholas Opoku","GHA","DF","20",1997,10.1,16,9,15,1,0,10,17,58.8,7,8,5,3,18,34,29,0,"https://fbref.com/en/players/b871bf55/Nicholas-Opoku"
2019,"Udinese","Serie A","Giuseppe Pezzella","ITA","DF","20",1997,2,5,4,4,1,0,2,8,25,6,2,1,1,1,6,9,0,"https://fbref.com/en/players/149c5f5d/Giuseppe-Pezzella"
2019,"Udinese","Serie A","Ignacio Pussetto","ARG","FW,MF","22",1995,24.2,65,40,25,30,10,15,43,34.9,28,28,3,25,29,94,34,0,"https://fbref.com/en/players/62437b4f/Ignacio-Pussetto"
2019,"Udinese","Serie A","Sandro","BRA","MF","29",1989,6.6,18,10,10,8,0,7,13,53.8,6,14,5,9,11,29,16,0,"https://fbref.com/en/players/c1c2c925/Sandro"
2019,"Udinese","Serie A","Samir Santos","BRA","DF","23",1994,20,47,33,27,18,2,19,25,76,6,18,9,9,34,81,96,0,"https://fbref.com/en/players/92b4758e/Samir-Santos"
2019,"Udinese","Serie A","Simone Scuffet","ITA","GK","22",1996,9,0,0,0,0,0,0,1,0,1,0,0,0,0,0,4,2,"https://fbref.com/en/players/41bd99ea/Simone-Scuffet"
2019,"Udinese","Serie A","Jens Stryger Larsen","DEN","DF","27",1991,35.9,42,20,24,14,4,22,44,50,22,27,8,19,26,68,98,1,"https://fbref.com/en/players/f91e81c9/Jens-Stryger-Larsen"
2019,"Udinese","Serie A","Łukasz Teodorczyk","POL","FW","27",1991,4.4,4,2,2,2,0,2,8,25,6,8,2,6,1,5,4,0,"https://fbref.com/en/players/7e81a17d/Lukasz-Teodorczyk"
2019,"Udinese","Serie A","Hidde ter Avest","NED","DF,FW","21",1997,10.8,26,14,17,6,3,14,20,70,6,14,3,11,10,36,39,1,"https://fbref.com/en/players/18f9dbd0/Hidde-ter-Avest"
2019,"Udinese","Serie A","William Troost-Ekong","NGA","DF","24",1993,34,31,15,21,9,1,13,24,54.2,11,53,41,12,40,71,200,2,"https://fbref.com/en/players/7ed4921e/William-Troost-Ekong"
2019,"Udinese","Serie A","Felipe Vizeu","BRA","FW,DF","21",1997,0.4,0,0,0,0,0,0,0,NA,0,0,0,0,0,0,0,0,"https://fbref.com/en/players/0412b9cd/Felipe-Vizeu"
2019,"Udinese","Serie A","Molla Wagué","MLI","DF","27",1991,1.1,1,1,1,0,0,0,1,0,1,1,0,1,4,5,5,0,"https://fbref.com/en/players/a440d8ca/Molla-Wague"
2019,"Udinese","Serie A","Ben Wilmot","ENG","DF,MF","18",1999,2.2,0,0,0,0,0,0,2,0,2,2,2,0,2,2,11,0,"https://fbref.com/en/players/2876eaa3/Ben-Wilmot"
2019,"Udinese","Serie A","Marvin Zeegelaar","NED","DF","27",1990,10.6,30,23,21,6,3,16,24,66.7,8,11,2,9,17,47,38,0,"https://fbref.com/en/players/8abd0c03/Marvin-Zeegelaar"
2019,"Valencia","La Liga","Michy Batshuayi","BEL","FW","24",1993,5.9,1,1,0,1,0,0,3,0,3,5,2,3,0,1,3,0,"https://fbref.com/en/players/2973d8ff/Michy-Batshuayi"
2019,"Valencia","La Liga","Denis Cheryshev","RUS","MF","27",1990,19,46,32,15,22,9,17,37,45.9,20,35,3,32,15,61,16,0,"https://fbref.com/en/players/0ac94a23/Denis-Cheryshev"
2019,"Valencia","La Liga","Francis Coquelin","FRA","MF","27",1991,19.6,46,31,25,14,7,17,35,48.6,18,21,5,16,49,95,29,1,"https://fbref.com/en/players/a6951bf8/Francis-Coquelin"
2019,"Valencia","La Liga","Mouctar Diakhaby","GUI","DF","21",1996,17.6,14,8,10,4,0,5,10,50,5,24,16,8,20,34,94,1,"https://fbref.com/en/players/d2110326/Mouctar-Diakhaby"
2019,"Valencia","La Liga","Jaume Doménech","ESP","GK","27",1990,4,0,0,0,0,0,0,1,0,1,0,0,0,0,0,1,0,"https://fbref.com/en/players/c9cb972b/Jaume-Domenech"
2019,"Valencia","La Liga","Kévin Gameiro","FRA","FW","31",1987,17.9,14,9,4,6,4,1,6,16.7,5,12,2,10,5,19,3,0,"https://fbref.com/en/players/42276181/Kevin-Gameiro"
2019,"Valencia","La Liga","Ezequiel Garay","ARG","DF","31",1986,23.7,20,17,15,3,2,9,18,50,9,30,23,7,16,36,140,0,"https://fbref.com/en/players/ac3fb1be/Ezequiel-Garay"
2019,"Valencia","La Liga","Gonçalo Guedes","POR","MF,FW","21",1996,16.3,31,13,16,12,3,14,43,32.6,29,15,0,15,7,38,1,0,"https://fbref.com/en/players/e6bc67d7/Goncalo-Guedes"
2019,"Valencia","La Liga","Lee Kangin","KOR","MF,FW","17",2001,0.3,2,0,1,1,0,1,3,33.3,2,0,0,0,1,3,0,0,"https://fbref.com/en/players/8455ad90/Lee-Kangin"
2019,"Valencia","La Liga","Geoffrey Kondogbia","CTA","MF","25",1993,13.8,47,33,18,23,6,12,27,44.4,15,20,7,13,27,74,22,2,"https://fbref.com/en/players/cce181df/Geoffrey-Kondogbia"
2019,"Valencia","La Liga","Toni Lato","ESP","DF","20",1997,3,6,4,4,1,1,1,5,20,4,9,3,6,6,12,13,0,"https://fbref.com/en/players/8e088e04/Toni-Lato"
2019,"Valencia","La Liga","José Luis Gayà","ESP","DF","23",1995,34.9,83,59,56,20,7,46,80,57.5,34,48,6,42,43,126,105,1,"https://fbref.com/en/players/b05e2dbd/Jose-Luis-Gaya"
2019,"Valencia","La Liga","Santi Mina","ESP","FW","22",1995,20.6,17,10,1,15,1,3,25,12,22,19,2,17,4,21,20,0,"https://fbref.com/en/players/0b90bb97/Santi-Mina"
2019,"Valencia","La Liga","Jeison Murillo","COL","DF","26",1992,1,2,1,1,1,0,1,2,50,1,1,0,1,2,4,6,0,"https://fbref.com/en/players/b233e8e4/Jeison-Murillo"
2019,"Valencia","La Liga","Neto","BRA","GK","29",1989,34,2,0,2,0,0,2,3,66.7,1,0,0,0,1,3,9,3,"https://fbref.com/en/players/a9dc785c/Neto"
2019,"Valencia","La Liga","Daniel Parejo","ESP","MF","29",1989,34,73,42,41,24,8,31,90,34.4,59,41,7,34,46,119,26,2,"https://fbref.com/en/players/7460ca0d/Daniel-Parejo"
2019,"Valencia","La Liga","Gabriel Paulista","BRA","DF","27",1990,29.1,29,16,20,6,3,14,28,50,14,37,21,16,70,99,162,1,"https://fbref.com/en/players/b7ca5c51/Gabriel-Paulista"
2019,"Valencia","La Liga","Cristiano Piccini","ITA","DF","25",1992,20.8,32,23,25,7,0,13,26,50,13,27,7,20,27,59,64,1,"https://fbref.com/en/players/32c0491f/Cristiano-Piccini"
2019,"Valencia","La Liga","Rodrigo","ESP","FW","27",1991,28.1,21,10,6,9,6,3,17,17.6,14,17,1,16,3,24,18,0,"https://fbref.com/en/players/1fb1c435/Rodrigo"
2019,"Valencia","La Liga","Facundo Roncaglia","ARG","DF","31",1987,6.7,13,10,8,5,0,4,6,66.7,2,4,2,2,10,23,22,0,"https://fbref.com/en/players/51e3954c/Facundo-Roncaglia"
2019,"Valencia","La Liga","Rubén Sobrino","ESP","FW,MF","26",1992,2.1,6,3,1,4,1,1,1,100,0,1,1,0,1,7,1,0,"https://fbref.com/en/players/19b776e9/Ruben-Sobrino"
2019,"Valencia","La Liga","Carlos Soler","ESP","MF","21",1997,27.3,41,28,15,23,3,16,65,24.6,49,46,6,40,19,60,37,0,"https://fbref.com/en/players/fed17f5a/Carlos-Soler"
2019,"Valencia","La Liga","Ferrán Torres","ESP","MF","18",2000,9.4,15,8,4,8,3,5,11,45.5,6,10,1,9,10,25,9,0,"https://fbref.com/en/players/9e1035f8/Ferran-Torres"
2019,"Valencia","La Liga","Rúben Vezo","POR","DF","24",1994,2.2,2,1,2,0,0,2,4,50,2,2,1,1,2,4,10,0,"https://fbref.com/en/players/c67cd65c/Ruben-Vezo"
2019,"Valencia","La Liga","Daniel Wass","DEN","DF,MF","29",1989,26.2,35,25,9,19,7,20,42,47.6,22,23,4,19,34,69,49,0,"https://fbref.com/en/players/d83bbc54/Daniel-Wass"
2019,"Valladolid","La Liga","Rubén Alcaraz","ESP","MF","27",1991,33.1,96,54,50,40,6,32,89,36,57,59,10,49,38,134,52,1,"https://fbref.com/en/players/036bba5f/Ruben-Alcaraz"
2019,"Valladolid","La Liga","Antoñito","ESP","DF,MF","30",1987,20.7,35,21,16,15,4,18,42,42.9,24,21,8,13,18,53,31,0,"https://fbref.com/en/players/dbe519cf/Antonito"
2019,"Valladolid","La Liga","Anuar","MAR","MF,FW","23",1995,12,33,19,15,16,2,6,14,42.9,8,14,1,13,11,44,25,1,"https://fbref.com/en/players/c93231dc/Anuar"
2019,"Valladolid","La Liga","Fernando Calero","ESP","DF","22",1995,34.8,51,31,33,18,0,23,38,60.5,15,55,31,24,55,106,170,0,"https://fbref.com/en/players/41b3069f/Fernando-Calero"
2019,"Valladolid","La Liga","Duje Čop","CRO","FW","28",1990,7.6,5,4,1,2,2,0,8,0,8,8,3,5,3,8,3,0,"https://fbref.com/en/players/8b0b02c9/Duje-Cop"
2019,"Valladolid","La Liga","Moisés Delgado","ESP","DF","24",1994,3,7,6,3,3,1,2,3,66.7,1,2,1,1,3,10,9,0,"https://fbref.com/en/players/248c409d/Moises-Delgado"
2019,"Valladolid","La Liga","Borja Fernández","ESP","MF,DF","37",1981,9.3,17,12,7,9,1,6,16,37.5,10,14,2,12,14,31,25,0,"https://fbref.com/en/players/9127f9ce/Borja-Fernandez"
2019,"Valladolid","La Liga","Joaquín Fernández","ESP","DF,MF","22",1996,9.3,16,9,14,1,1,8,16,50,8,9,7,2,17,33,45,0,"https://fbref.com/en/players/b86a64b2/Joaquin-Fernandez"
2019,"Valladolid","La Liga","Sergi Guardiola","ESP","FW","27",1991,16.8,19,11,1,10,8,2,13,15.4,11,12,0,12,5,24,17,0,"https://fbref.com/en/players/32974271/Sergi-Guardiola"
2019,"Valladolid","La Liga","Hacen","MTN","MF","20",1997,0,0,0,0,0,0,0,0,NA,0,1,0,1,1,1,1,0,"https://fbref.com/en/players/7c689c48/Hacen"
2019,"Valladolid","La Liga","Pablo Hervías","ESP","MF","25",1993,1.8,1,0,0,1,0,0,1,0,1,0,0,0,2,3,0,0,"https://fbref.com/en/players/ba5a9545/Pablo-Hervias"
2019,"Valladolid","La Liga","Ivi","ESP","MF,FW","24",1994,0.2,0,0,0,0,0,0,0,NA,0,0,0,0,0,0,0,0,"https://fbref.com/en/players/d2fa73e7/Ivi"
2019,"Valladolid","La Liga","Keko","ESP","MF,FW","26",1991,17,42,18,21,15,6,18,50,36,32,20,1,19,14,56,17,0,"https://fbref.com/en/players/1512328c/Keko"
2019,"Valladolid","La Liga","Jordi Masip","ESP","GK","29",1989,35,1,1,1,0,0,0,0,NA,0,1,0,1,1,2,3,3,"https://fbref.com/en/players/8fae77ea/Jordi-Masip"
2019,"Valladolid","La Liga","Míchel","ESP","MF","30",1988,28.4,60,38,25,31,4,18,73,24.7,55,40,4,36,43,103,30,1,"https://fbref.com/en/players/418f8f61/Michel"
2019,"Valladolid","La Liga","Miguel","ESP","FW","18",1999,0.1,0,0,0,0,0,0,1,0,1,0,0,0,1,1,0,0,"https://fbref.com/en/players/6763373d/Miguel"
2019,"Valladolid","La Liga","Javi Moyano","ESP","DF","32",1986,23.3,25,17,17,6,2,15,30,50,15,20,9,11,25,50,88,2,"https://fbref.com/en/players/933e8c8a/Javi-Moyano"
2019,"Valladolid","La Liga","Nacho","ESP","DF","29",1989,35,110,66,73,30,7,67,100,67,33,43,10,33,45,155,113,2,"https://fbref.com/en/players/e29d1111/Nacho"
2019,"Valladolid","La Liga","Kiko Olivas","ESP","DF","29",1988,34.4,51,38,35,15,1,22,48,45.8,26,31,18,13,46,97,173,2,"https://fbref.com/en/players/72b07a9c/Kiko-Olivas"
2019,"Valladolid","La Liga","Óscar Plano","ESP","MF,FW","27",1991,29.9,63,45,23,28,12,14,48,29.2,34,19,3,16,22,85,28,1,"https://fbref.com/en/players/7c388b20/Oscar-Plano"
2019,"Valladolid","La Liga","Stiven Plaza","ECU","FW,MF","19",1999,0.4,0,0,0,0,0,0,0,NA,0,0,0,0,0,0,0,0,"https://fbref.com/en/players/f4b7f2ec/Stiven-Plaza"
2019,"Valladolid","La Liga","Chris Ramos","ESP","FW","21",1997,0.7,1,1,0,0,1,1,1,100,0,0,0,0,0,1,1,0,"https://fbref.com/en/players/44e07fac/Chris-Ramos"
2019,"Valladolid","La Liga","Waldo Rubio","ESP","MF","22",1995,5.5,4,2,3,1,0,1,6,16.7,5,2,0,2,1,5,8,1,"https://fbref.com/en/players/ccaa5728/Waldo-Rubio"
2019,"Valladolid","La Liga","Leonardo Suárez","ARG","FW,MF","22",1996,5.7,3,3,2,0,1,2,4,50,2,7,1,6,1,4,4,0,"https://fbref.com/en/players/25c72b36/Leonardo-Suarez"
2019,"Valladolid","La Liga","Enes Ünal","TUR","FW","21",1997,23.9,17,10,3,4,10,4,24,16.7,20,17,4,13,2,19,18,0,"https://fbref.com/en/players/f8eca1b6/Enes-Unal"
2019,"Valladolid","La Liga","Daniele Verde","ITA","MF,FW","22",1996,7.3,6,3,2,2,2,1,6,16.7,5,3,0,3,7,13,3,1,"https://fbref.com/en/players/d3298c99/Daniele-Verde"
2019,"Valladolid","La Liga","Toni Villa","ESP","MF,FW","23",1995,19.6,51,32,24,18,9,20,47,42.6,27,15,0,15,12,63,10,0,"https://fbref.com/en/players/636eae97/Toni-Villa"
2019,"Valladolid","La Liga","Yoel","ESP","GK","29",1988,3,0,0,0,0,0,0,0,NA,0,0,0,0,0,0,0,1,"https://fbref.com/en/players/61bb7498/Yoel"
2019,"Villarreal","La Liga","Sergio Asenjo","ESP","GK","29",1989,32,0,0,0,0,0,0,1,0,1,0,0,0,3,3,26,2,"https://fbref.com/en/players/9f0ea33f/Sergio-Asenjo"
2019,"Villarreal","La Liga","Carlos Bacca","COL","FW","31",1986,14.1,4,2,1,2,1,0,5,0,5,4,0,4,8,12,5,0,"https://fbref.com/en/players/09a9e921/Carlos-Bacca"
2019,"Villarreal","La Liga","Daniele Bonera","ITA","DF","37",1981,2.6,2,2,2,0,0,1,1,100,0,5,5,0,4,6,10,0,"https://fbref.com/en/players/13b0c150/Daniele-Bonera"
2019,"Villarreal","La Liga","Santiago Cáseres","ARG","MF","21",1997,17.6,67,35,20,38,9,25,57,43.9,32,22,9,13,14,81,24,1,"https://fbref.com/en/players/958bba56/Santiago-Caseres"
2019,"Villarreal","La Liga","Santi Cazorla","ESP","MF,FW","33",1984,29.4,69,34,32,26,11,24,69,34.8,45,35,6,29,28,97,17,1,"https://fbref.com/en/players/e2e9c250/Santi-Cazorla"
2019,"Villarreal","La Liga","Samuel Chukwueze","NGA","MF,FW","19",1999,19,19,11,7,10,2,9,31,29,22,11,2,9,10,29,2,0,"https://fbref.com/en/players/b8a642fc/Samuel-Chukwueze"
2019,"Villarreal","La Liga","Jaume Costa","ESP","DF","30",1988,16.6,33,21,26,5,2,20,33,60.6,13,12,3,9,21,54,61,0,"https://fbref.com/en/players/808d48f3/Jaume-Costa"
2019,"Villarreal","La Liga","Andrés Fernández","ESP","GK","31",1986,6,1,0,1,0,0,1,1,100,0,0,0,0,0,1,4,1,"https://fbref.com/en/players/307fcd26/Andres-Fernandez"
2019,"Villarreal","La Liga","Pablo Fornals","ESP","MF,FW","22",1996,27.5,49,26,14,26,9,15,54,27.8,39,32,4,28,24,73,19,0,"https://fbref.com/en/players/82927de4/Pablo-Fornals"
2019,"Villarreal","La Liga","Javi Fuego","ESP","MF","34",1984,2.6,6,3,5,1,0,4,8,50,4,2,0,2,3,9,9,0,"https://fbref.com/en/players/2e8fc160/Javi-Fuego"
2019,"Villarreal","La Liga","Ramiro Funes Mori","ARG","DF,MF","27",1991,29.2,41,29,30,9,2,19,44,43.2,25,36,24,12,42,83,149,2,"https://fbref.com/en/players/89cbc961/Ramiro-Funes-Mori"
2019,"Villarreal","La Liga","Mario Gaspar","ESP","DF","27",1990,28.9,62,43,39,17,6,29,49,59.2,20,48,11,37,42,104,91,0,"https://fbref.com/en/players/fb5d47b3/Mario-Gaspar"
2019,"Villarreal","La Liga","Álvaro González","ESP","DF","28",1990,32.9,49,35,33,14,2,25,35,71.4,10,34,24,10,37,86,177,2,"https://fbref.com/en/players/42dcf26d/Alvaro-Gonzalez"
2019,"Villarreal","La Liga","Vicente Iborra","ESP","MF","30",1988,18.5,31,18,22,5,4,14,37,37.8,23,25,7,18,22,53,41,1,"https://fbref.com/en/players/ad1ffcfd/Vicente-Iborra"
2019,"Villarreal","La Liga","Manuel Iturra","CHI","MF","34",1984,0.8,2,0,0,2,0,0,0,NA,0,1,0,1,2,4,2,0,"https://fbref.com/en/players/000b3da6/Manuel-Iturra"
2019,"Villarreal","La Liga","Miguel Juan Llambrich","ESP","DF,FW","22",1996,6,21,14,11,9,1,6,14,42.9,8,9,2,7,12,33,17,0,"https://fbref.com/en/players/d83f09ff/Miguel-Juan-Llambrich"
2019,"Villarreal","La Liga","Miguel Layún","MEX","MF,DF","30",1988,5.6,8,2,0,7,1,2,6,33.3,4,8,2,6,1,9,10,0,"https://fbref.com/en/players/ad6295d4/Miguel-Layun"
2019,"Villarreal","La Liga","Gerard Moreno","ESP","FW","26",1992,25.7,22,12,2,15,5,8,27,29.6,19,23,9,14,9,31,39,0,"https://fbref.com/en/players/81f0781e/Gerard-Moreno"
2019,"Villarreal","La Liga","Manu Morlanes","ESP","MF","19",1999,6.8,21,11,9,9,3,7,19,36.8,12,7,3,4,5,26,9,0,"https://fbref.com/en/players/a0255c67/Manu-Morlanes"
2019,"Villarreal","La Liga","Alfonso Pedraza","ESP","DF,FW","22",1996,23.3,59,44,34,19,6,22,62,35.5,40,33,7,26,29,88,55,0,"https://fbref.com/en/players/63f04c6c/Alfonso-Pedraza"
2019,"Villarreal","La Liga","Xavi Quintillà","ESP","DF","21",1996,7,10,4,5,4,1,6,12,50,6,5,2,3,8,18,17,0,"https://fbref.com/en/players/84fb6aff/Xavi-Quintilla"
2019,"Villarreal","La Liga","Dani Raba","ESP","MF,FW","22",1995,2.1,6,5,1,2,3,1,5,20,4,1,0,1,1,7,0,0,"https://fbref.com/en/players/ea6a7ab4/Dani-Raba"
2019,"Villarreal","La Liga","Víctor Ruiz","ESP","DF","29",1989,21.9,28,19,20,6,2,13,18,72.2,5,28,16,12,38,66,67,1,"https://fbref.com/en/players/b3dc6eca/Victor-Ruiz"
2019,"Villarreal","La Liga","Nicola Sansone","ITA","FW,MF","26",1991,0.4,0,0,0,0,0,0,0,NA,0,0,0,0,0,0,0,0,"https://fbref.com/en/players/7eb97a8e/Nicola-Sansone"
2019,"Villarreal","La Liga","Karl Toko Ekambi","CMR","FW,MF","25",1992,23.8,11,8,1,6,4,2,14,14.3,12,8,0,8,11,22,9,1,"https://fbref.com/en/players/5ceba7fc/Karl-Toko-Ekambi"
2019,"Villarreal","La Liga","Manu Trigueros","ESP","MF","26",1991,17.2,46,35,18,23,5,20,57,35.1,37,17,6,11,16,62,17,0,"https://fbref.com/en/players/963829d0/Manu-Trigueros"
2019,"Watford","Premier League","Miguel Britos","URU","DF","33",1985,2.1,4,2,4,0,0,2,4,50,2,1,1,0,3,7,11,1,"https://fbref.com/en/players/356a9a62/Miguel-Britos"
2019,"Watford","Premier League","Étienne Capoue","FRA","MF","30",1988,32.7,91,56,36,48,7,33,87,37.9,54,50,13,37,85,176,96,1,"https://fbref.com/en/players/5acc4a10/Etienne-Capoue"
2019,"Watford","Premier League","Craig Cathcart","NIR","DF","29",1989,34.4,50,31,36,11,3,21,37,56.8,16,42,30,12,38,88,184,4,"https://fbref.com/en/players/89e4b358/Craig-Cathcart"
2019,"Watford","Premier League","Nathaniel Chalobah","ENG","MF","23",1994,3,3,2,1,2,0,2,7,28.6,5,2,1,1,5,8,7,0,"https://fbref.com/en/players/422862ea/Nathaniel-Chalobah"
2019,"Watford","Premier League","Tom Cleverley","ENG","MF","28",1989,5.3,17,9,11,4,2,6,22,27.3,16,4,0,4,5,22,11,0,"https://fbref.com/en/players/6cdd8245/Tom-Cleverley"
2019,"Watford","Premier League","Troy Deeney","ENG","FW","30",1988,28.3,24,14,8,10,6,7,32,21.9,25,22,4,18,7,31,29,0,"https://fbref.com/en/players/82e34b69/Troy-Deeney"
2019,"Watford","Premier League","Gerard Deulofeu","ESP","FW,MF","24",1994,23,11,6,5,3,3,4,26,15.4,22,16,0,16,14,25,3,0,"https://fbref.com/en/players/39583cfd/Gerard-Deulofeu"
2019,"Watford","Premier League","Abdoulaye Doucouré","MLI","MF","25",1993,34,71,38,27,32,12,19,57,33.3,38,31,8,23,34,105,55,5,"https://fbref.com/en/players/02b29014/Abdoulaye-Doucoure"
2019,"Watford","Premier League","Kiko Femenía","ESP","DF","27",1991,22.8,48,30,34,12,2,24,51,47.1,27,24,6,18,36,84,68,0,"https://fbref.com/en/players/e5d01ecf/Kiko-Femenia"
2019,"Watford","Premier League","Ben Foster","ENG","GK","35",1983,38,2,2,2,0,0,2,6,33.3,4,0,0,0,2,4,34,3,"https://fbref.com/en/players/d0b3ceb9/Ben-Foster"
2019,"Watford","Premier League","Andre Gray","JAM","FW","27",1991,15.2,3,1,0,2,1,1,6,16.7,5,3,1,2,2,5,6,0,"https://fbref.com/en/players/c24dba2a/Andre-Gray"
2019,"Watford","Premier League","José Holebas","GRE","DF","34",1984,26.6,68,40,44,20,4,28,53,52.8,25,27,8,19,21,89,97,0,"https://fbref.com/en/players/12aa7661/Jose-Holebas"
2019,"Watford","Premier League","Will Hughes","ENG","MF","23",1995,26.9,74,43,27,35,12,25,59,42.4,34,55,6,49,25,99,30,0,"https://fbref.com/en/players/a0666d3e/Will-Hughes"
2019,"Watford","Premier League","Daryl Janmaat","NED","DF","29",1989,16.9,36,24,23,11,2,20,29,69,9,16,6,10,33,69,71,0,"https://fbref.com/en/players/45da6694/Daryl-Janmaat"
2019,"Watford","Premier League","Christian Kabasele","BEL","DF","27",1991,17.6,25,14,20,5,0,10,23,43.5,13,21,16,5,38,63,111,0,"https://fbref.com/en/players/914ab9a1/Christian-Kabasele"
2019,"Watford","Premier League","Adrian Mariappa","JAM","DF","31",1986,21.4,35,22,29,6,0,16,32,50,16,23,15,8,26,61,120,2,"https://fbref.com/en/players/8aa5f52c/Adrian-Mariappa"
2019,"Watford","Premier League","Adam Masina","MAR","DF","24",1994,11.2,30,17,16,13,1,13,25,52,12,19,4,15,17,47,40,0,"https://fbref.com/en/players/de0f152c/Adam-Masina"
2019,"Watford","Premier League","Marc Navarro","ESP","DF","23",1995,0.9,4,2,3,1,0,3,4,75,1,0,0,0,0,4,4,0,"https://fbref.com/en/players/c2846353/Marc-Navarro"
2019,"Watford","Premier League","Stefano Okaka","ITA","FW,MF","28",1989,0.3,0,0,0,0,0,0,0,NA,0,1,0,1,0,0,0,0,"https://fbref.com/en/players/601ef102/Stefano-Okaka"
2019,"Watford","Premier League","Roberto Pereyra","ARG","MF","27",1991,31.3,21,12,10,10,1,7,24,29.2,17,26,0,26,24,45,27,2,"https://fbref.com/en/players/75f2c59f/Roberto-Pereyra"
2019,"Watford","Premier League","Sebastian Prödl","AUT","DF","31",1987,0.1,0,0,0,0,0,0,0,NA,0,0,0,0,0,0,0,0,"https://fbref.com/en/players/f5e6d08d/Sebastian-Prodl"
2019,"Watford","Premier League","Domingos Quina","POR","MF","18",1999,3.8,9,7,3,5,1,3,11,27.3,8,6,0,6,3,12,1,0,"https://fbref.com/en/players/41fb0f4e/Domingos-Quina"
2019,"Watford","Premier League","Ken Sema","SWE","MF,FW","24",1993,8.4,15,7,7,5,3,9,21,42.9,12,7,0,7,8,23,5,0,"https://fbref.com/en/players/1770bd68/Ken-Sema"
2019,"Watford","Premier League","Isaac Success","NGA","FW,MF","22",1996,11.7,15,12,4,8,3,2,5,40,3,6,0,6,2,17,11,0,"https://fbref.com/en/players/f573a8bf/Isaac-Success"
2019,"Watford","Premier League","Ben Wilmot","ENG","MF,DF","18",1999,0.3,0,0,0,0,0,0,1,0,1,2,1,1,0,0,1,0,"https://fbref.com/en/players/2876eaa3/Ben-Wilmot"
2019,"Werder Bremen","Bundesliga","Ludwig Augustinsson","SWE","DF","24",1994,33.6,53,31,25,22,6,23,39,59,16,37,11,26,38,91,86,1,"https://fbref.com/en/players/9fec8860/Ludwig-Augustinsson"
2019,"Werder Bremen","Bundesliga","Philipp Bargfrede","GER","MF,DF","29",1989,12,23,15,9,12,2,10,28,35.7,18,35,11,24,34,57,45,1,"https://fbref.com/en/players/3f7cd8f1/Philipp-Bargfrede"
2019,"Werder Bremen","Bundesliga","Fin Bartels","GER","MF,FW","31",1987,0.3,0,0,0,0,0,0,1,0,1,0,0,0,1,1,0,0,"https://fbref.com/en/players/acc7b7ec/Fin-Bartels"
2019,"Werder Bremen","Bundesliga","Johannes Eggestein","GER","FW,MF","20",1998,12.4,13,9,7,4,2,5,19,26.3,14,13,0,13,4,17,7,0,"https://fbref.com/en/players/d571df78/Johannes-Eggestein"
2019,"Werder Bremen","Bundesliga","Maximilian Eggestein","GER","MF","21",1996,33.9,68,42,29,34,5,24,54,44.4,30,49,10,39,30,98,69,0,"https://fbref.com/en/players/beb882a8/Maximilian-Eggestein"
2019,"Werder Bremen","Bundesliga","Marco Friedl","AUT","DF","20",1998,5.3,8,6,4,3,1,3,11,27.3,8,9,6,3,13,21,21,0,"https://fbref.com/en/players/f86ad3f5/Marco-Friedl"
2019,"Werder Bremen","Bundesliga","Theodor Gebre Selassie","CZE","DF","31",1986,31.3,53,38,27,16,10,22,51,43.1,29,33,8,25,69,122,100,0,"https://fbref.com/en/players/3f65898c/Theodor-Gebre-Selassie"
2019,"Werder Bremen","Bundesliga","Martin Harnik","AUT","FW,MF","31",1987,9.2,12,7,4,3,5,4,15,26.7,11,8,0,8,3,15,10,0,"https://fbref.com/en/players/99b7584f/Martin-Harnik"
2019,"Werder Bremen","Bundesliga","Aron Jóhannsson","USA","MF","27",1990,0,0,0,0,0,0,0,0,NA,0,0,0,0,0,0,0,0,"https://fbref.com/en/players/c0dc9fc7/Aron-Johannsson"
2019,"Werder Bremen","Bundesliga","Florian Kainz","AUT","FW","25",1992,4.1,6,5,5,1,0,3,6,50,3,4,1,3,3,9,5,0,"https://fbref.com/en/players/94c18565/Florian-Kainz"
2019,"Werder Bremen","Bundesliga","Stefanos Kapino","GRE","GK","24",1994,0.5,0,0,0,0,0,0,0,NA,0,0,0,0,0,0,0,0,"https://fbref.com/en/players/62ba5881/Stefanos-Kapino"
2019,"Werder Bremen","Bundesliga","Davy Klaassen","NED","MF","25",1993,31.3,64,47,24,33,7,14,49,28.6,35,44,9,35,47,111,47,0,"https://fbref.com/en/players/15fd5593/Davy-Klaassen"
2019,"Werder Bremen","Bundesliga","Max Kruse","GER","FW,MF","30",1988,31.5,17,5,2,13,2,6,38,15.8,32,16,1,15,8,25,6,2,"https://fbref.com/en/players/f9446dcd/Max-Kruse"
2019,"Werder Bremen","Bundesliga","Sebastian Langkamp","GER","DF","30",1988,15.7,24,15,18,6,0,7,14,50,7,17,11,6,20,44,79,1,"https://fbref.com/en/players/74d70fb5/Sebastian-Langkamp"
2019,"Werder Bremen","Bundesliga","Kevin Möhwald","GER","MF","25",1993,9.7,16,10,3,11,2,3,20,15,17,14,0,14,17,33,14,0,"https://fbref.com/en/players/a5ce09f2/Kevin-Mohwald"
2019,"Werder Bremen","Bundesliga","Niklas Moisander","FIN","DF","32",1985,29.3,34,23,26,8,0,22,51,43.1,29,42,19,23,39,73,140,2,"https://fbref.com/en/players/00844823/Niklas-Moisander"
2019,"Werder Bremen","Bundesliga","Yuya Osako","JPN","FW,MF","28",1990,15,23,11,6,12,5,7,22,31.8,15,15,3,12,7,30,8,0,"https://fbref.com/en/players/f69fba57/Yuya-Osako"
2019,"Werder Bremen","Bundesliga","Jiří Pavlenka","CZE","GK","26",1992,33.1,3,0,3,0,0,3,6,50,3,1,0,1,3,6,14,1,"https://fbref.com/en/players/0a1cb833/Jiri-Pavlenka"
2019,"Werder Bremen","Bundesliga","Claudio Pizarro","PER","FW","39",1978,7.7,10,6,4,2,4,4,7,57.1,3,14,1,13,1,11,7,0,"https://fbref.com/en/players/54b6ee79/Claudio-Pizarro"
2019,"Werder Bremen","Bundesliga","Luca Plogmann","GER","GK","18",2000,0.4,0,0,0,0,0,0,0,NA,0,0,0,0,0,0,0,0,"https://fbref.com/en/players/206c37d3/Luca-Plogmann"
2019,"Werder Bremen","Bundesliga","Milot Rashica","KVX","FW,MF","22",1996,17.2,24,16,8,11,5,9,24,37.5,15,16,2,14,6,30,6,1,"https://fbref.com/en/players/6c6a3300/Milot-Rashica"
2019,"Werder Bremen","Bundesliga","Nuri Şahin","TUR","MF","29",1988,16.4,60,33,22,33,5,23,59,39,36,30,3,27,37,97,39,1,"https://fbref.com/en/players/f4081572/Nuri-Sahin"
2019,"Werder Bremen","Bundesliga","Josh Sargent","USA","FW","18",2000,2.4,2,1,1,0,1,2,2,100,0,2,0,2,0,2,3,0,"https://fbref.com/en/players/a8d4428b/Josh-Sargent"
2019,"Werder Bremen","Bundesliga","Miloš Veljković","SRB","DF","22",1995,20.9,36,24,29,6,1,22,37,59.5,15,27,13,14,27,63,111,0,"https://fbref.com/en/players/a5ae8f8e/Milos-Veljkovic"
2019,"West Ham","Premier League","Felipe Anderson","BRA","MF,FW","25",1993,33.8,89,49,33,44,12,31,101,30.7,70,71,0,71,41,130,18,1,"https://fbref.com/en/players/9f1893b9/Felipe-Anderson"
2019,"West Ham","Premier League","Michail Antonio","JAM","MF,FW","28",1990,23.4,23,14,12,6,5,6,12,50,6,38,3,35,18,41,26,1,"https://fbref.com/en/players/ac05f970/Michail-Antonio"
2019,"West Ham","Premier League","Marko Arnautović","AUT","FW","29",1989,22.1,9,5,4,3,2,1,7,14.3,6,4,2,2,3,12,6,0,"https://fbref.com/en/players/00459419/Marko-Arnautovic"
2019,"West Ham","Premier League","Fabián Balbuena","PAR","DF","26",1991,22.4,40,20,34,6,0,16,42,38.1,26,23,15,8,53,93,175,0,"https://fbref.com/en/players/3626f7d9/Fabian-Balbuena"
2019,"West Ham","Premier League","Andy Carroll","ENG","FW","29",1989,5.1,4,2,1,3,0,1,4,25,3,3,2,1,1,5,8,0,"https://fbref.com/en/players/b581987a/Andy-Carroll"
2019,"West Ham","Premier League","Aaron Cresswell","ENG","DF","28",1989,17.7,29,16,14,11,4,13,25,52,12,28,7,21,23,52,58,0,"https://fbref.com/en/players/4f974391/Aaron-Cresswell"
2019,"West Ham","Premier League","Grady Diangana","ENG","MF,FW","20",1998,6.8,20,9,8,8,4,5,14,35.7,9,11,0,11,1,21,4,0,"https://fbref.com/en/players/f522d7ec/Grady-Diangana"
2019,"West Ham","Premier League","Issa Diop","FRA","DF","21",1997,33,68,38,47,21,0,37,57,64.9,20,58,36,22,64,132,161,4,"https://fbref.com/en/players/a712ca2b/Issa-Diop"
2019,"West Ham","Premier League","Łukasz Fabiański","POL","GK","33",1985,38,1,0,1,0,0,1,3,33.3,2,0,0,0,1,2,10,1,"https://fbref.com/en/players/9328b835/Lukasz-Fabianski"
2019,"West Ham","Premier League","Ryan Fredericks","ENG","DF","25",1992,12.1,38,23,33,5,0,21,32,65.6,11,15,5,10,13,51,49,1,"https://fbref.com/en/players/c067631c/Ryan-Fredericks"
2019,"West Ham","Premier League","Javier Hernández","MEX","FW","30",1988,14.8,3,0,0,3,0,0,6,0,6,8,1,7,1,4,8,0,"https://fbref.com/en/players/189cee7b/Javier-Hernandez"
2019,"West Ham","Premier League","Ben Johnson","ENG","DF","18",2000,0.7,1,0,1,0,0,0,1,0,1,0,0,0,1,2,5,0,"https://fbref.com/en/players/9319781b/Ben-Johnson"
2019,"West Ham","Premier League","Manuel Lanzini","ARG","MF","25",1993,7.6,12,7,5,6,1,5,18,27.8,13,3,1,2,9,21,7,1,"https://fbref.com/en/players/26f6dca8/Manuel-Lanzini"
2019,"West Ham","Premier League","Arthur Masuaku","COD","DF","24",1993,19.5,57,25,38,13,6,31,56,55.4,25,27,6,21,36,93,72,0,"https://fbref.com/en/players/57df7a11/Arthur-Masuaku"
2019,"West Ham","Premier League","Samir Nasri","FRA","MF","31",1987,2.7,0,0,0,0,0,0,0,NA,0,1,0,1,1,1,1,0,"https://fbref.com/en/players/165bed61/Samir-Nasri"
2019,"West Ham","Premier League","Mark Noble","ENG","MF","31",1987,25.5,47,26,19,24,4,17,52,32.7,35,17,2,15,21,68,13,0,"https://fbref.com/en/players/ff527768/Mark-Noble"
2019,"West Ham","Premier League","Pedro Obiang","EQG","MF","26",1992,12.5,41,23,23,16,2,18,43,41.9,25,27,9,18,12,53,18,0,"https://fbref.com/en/players/ba1e04b3/Pedro-Obiang"
2019,"West Ham","Premier League","Angelo Ogbonna","ITA","DF","30",1988,20.8,31,13,23,6,2,14,23,60.9,9,29,19,10,35,66,101,0,"https://fbref.com/en/players/74b2cd7e/Angelo-Ogbonna"
2019,"West Ham","Premier League","Lucas Pérez","ESP","FW,MF","29",1988,5.3,6,4,3,2,1,1,3,33.3,2,2,1,1,2,8,2,0,"https://fbref.com/en/players/a300ac7e/Lucas-Perez"
2019,"West Ham","Premier League","Declan Rice","ENG","MF","19",1999,33.4,98,60,35,58,5,38,88,43.2,50,51,12,39,52,150,56,0,"https://fbref.com/en/players/1c7012b8/Declan-Rice"
2019,"West Ham","Premier League","Carlos Sánchez","COL","MF","32",1986,2.7,4,3,4,0,0,3,8,37.5,5,1,0,1,1,5,5,2,"https://fbref.com/en/players/50b51fac/Carlos-Sanchez"
2019,"West Ham","Premier League","Xande Silva","POR","FW","21",1997,0.2,0,0,0,0,0,0,0,NA,0,1,0,1,0,0,0,0,"https://fbref.com/en/players/15d561fa/Xande-Silva"
2019,"West Ham","Premier League","Robert Snodgrass","SCO","MF","30",1987,24.7,44,27,18,24,2,13,46,28.3,33,24,4,20,11,55,23,0,"https://fbref.com/en/players/9f4647e9/Robert-Snodgrass"
2019,"West Ham","Premier League","Jack Wilshere","ENG","MF","26",1992,4.4,7,4,1,4,2,2,6,33.3,4,3,1,2,7,14,0,0,"https://fbref.com/en/players/9c318325/Jack-Wilshere"
2019,"West Ham","Premier League","Andriy Yarmolenko","UKR","MF,FW","28",1989,5.1,4,1,2,1,1,4,6,66.7,2,4,1,3,2,6,4,2,"https://fbref.com/en/players/849c826a/Andriy-Yarmolenko"
2019,"West Ham","Premier League","Pablo Zabaleta","ARG","DF","33",1985,23.2,47,24,26,15,6,17,44,38.6,27,39,15,24,48,95,96,3,"https://fbref.com/en/players/6813ac34/Pablo-Zabaleta"
2019,"Wolfsburg","Bundesliga","Maximilian Arnold","GER","MF","24",1994,31.9,52,30,21,27,4,21,61,34.4,40,31,10,21,35,87,48,1,"https://fbref.com/en/players/86e119e0/Maximilian-Arnold"
2019,"Wolfsburg","Bundesliga","Josip Brekalo","CRO","FW,MF","20",1998,15.7,15,7,7,6,2,5,18,27.8,13,15,1,14,12,27,9,1,"https://fbref.com/en/players/d4a2533d/Josip-Brekalo"
2019,"Wolfsburg","Bundesliga","John Brooks","USA","DF","25",1993,29,29,15,18,9,2,13,27,48.1,14,28,13,15,37,66,135,3,"https://fbref.com/en/players/e27da244/John-Brooks"
2019,"Wolfsburg","Bundesliga","Jakub Błaszczykowski","POL","MF","32",1985,0.1,0,0,0,0,0,0,0,NA,0,0,0,0,0,0,0,0,"https://fbref.com/en/players/2b350e6b/Jakub-Blaszczykowski"
2019,"Wolfsburg","Bundesliga","Ignacio Camacho","ESP","MF","28",1990,6,15,9,9,6,0,3,7,42.9,4,7,2,5,18,33,12,0,"https://fbref.com/en/players/8ed9b33a/Ignacio-Camacho"
2019,"Wolfsburg","Bundesliga","Koen Casteels","BEL","GK","26",1992,25.5,1,0,1,0,0,1,2,50,1,1,0,1,0,1,11,1,"https://fbref.com/en/players/db401046/Koen-Casteels"
2019,"Wolfsburg","Bundesliga","Ohis Felix Uduokhai","GER","DF","20",1997,2.7,13,7,7,5,1,9,10,90,1,6,2,4,6,19,11,1,"https://fbref.com/en/players/677da306/Ohis-Felix-Uduokhai"
2019,"Wolfsburg","Bundesliga","Yannick Gerhardt","GER","MF","24",1994,27.3,52,34,22,20,10,16,43,37.2,27,35,7,28,30,82,34,0,"https://fbref.com/en/players/62ab9184/Yannick-Gerhardt"
2019,"Wolfsburg","Bundesliga","Daniel Ginczek","GER","FW","27",1991,14.2,9,7,4,3,2,5,19,26.3,14,12,2,10,3,12,23,1,"https://fbref.com/en/players/e5f63987/Daniel-Ginczek"
2019,"Wolfsburg","Bundesliga","Josuha Guilavogui","FRA","MF","27",1990,17.4,31,16,18,13,0,14,25,56,11,17,8,9,43,74,56,2,"https://fbref.com/en/players/e6c43eec/Josuha-Guilavogui"
2019,"Wolfsburg","Bundesliga","Gian-Luca Itter","GER","DF","19",1999,1,4,3,3,1,0,1,2,50,1,2,0,2,1,5,2,0,"https://fbref.com/en/players/e6c15f6e/Gian-Luca-Itter"
2019,"Wolfsburg","Bundesliga","Sebastian Jung","GER","DF","28",1990,0.6,1,0,0,1,0,1,1,100,0,0,0,0,0,1,1,0,"https://fbref.com/en/players/86b30561/Sebastian-Jung"
2019,"Wolfsburg","Bundesliga","Felix Klaus","GER","FW,MF","25",1992,4.9,10,7,4,5,1,2,7,28.6,5,5,0,5,4,14,0,0,"https://fbref.com/en/players/aeda1f69/Felix-Klaus"
2019,"Wolfsburg","Bundesliga","Robin Knoche","GER","DF","26",1992,31,26,20,19,6,1,16,29,55.2,13,46,29,17,44,70,138,2,"https://fbref.com/en/players/6bd5cd5d/Robin-Knoche"
2019,"Wolfsburg","Bundesliga","Yunus Mallı","TUR","MF,FW","26",1992,7.8,15,7,8,6,1,2,11,18.2,9,2,0,2,4,19,1,0,"https://fbref.com/en/players/f3722c97/Yunus-Malli"
2019,"Wolfsburg","Bundesliga","Admir Mehmedi","SUI","FW,MF","27",1991,18.8,46,28,19,19,8,18,44,40.9,26,25,0,25,12,58,9,0,"https://fbref.com/en/players/b500b384/Admir-Mehmedi"
2019,"Wolfsburg","Bundesliga","Pavao Pervan","AUT","GK","30",1987,8.5,0,0,0,0,0,0,0,NA,0,0,0,0,0,0,3,1,"https://fbref.com/en/players/c89e8aae/Pavao-Pervan"
2019,"Wolfsburg","Bundesliga","Elvis Rexhbeçaj","GER","MF","20",1997,12.7,28,18,11,12,5,12,24,50,12,18,2,16,14,42,21,0,"https://fbref.com/en/players/1ae836b1/Elvis-Rexhbecaj"
2019,"Wolfsburg","Bundesliga","Jérôme Roussillon","FRA","DF","25",1993,27.3,42,29,25,15,2,20,30,66.7,10,50,7,43,31,73,54,0,"https://fbref.com/en/players/13203c45/Jerome-Roussillon"
2019,"Wolfsburg","Bundesliga","Renato Steffen","SUI","FW,MF","26",1991,16.7,26,17,5,17,4,7,17,41.2,10,13,2,11,16,42,14,0,"https://fbref.com/en/players/dd669209/Renato-Steffen"
2019,"Wolfsburg","Bundesliga","Marcel Tisserand","COD","DF","25",1993,9.8,14,9,9,5,0,10,13,76.9,3,12,5,7,20,34,42,1,"https://fbref.com/en/players/45954ec7/Marcel-Tisserand"
2019,"Wolfsburg","Bundesliga","Paul Verhaegh","NED","DF","34",1983,2,1,0,0,0,1,1,2,50,1,5,0,5,1,2,7,1,"https://fbref.com/en/players/97655ccd/Paul-Verhaegh"
2019,"Wolfsburg","Bundesliga","Wout Weghorst","NED","FW","25",1992,32.5,30,23,10,12,8,7,35,20,28,27,3,24,9,39,33,0,"https://fbref.com/en/players/c4e87b8b/Wout-Weghorst"
2019,"Wolfsburg","Bundesliga","William","BRA","DF","23",1995,29.7,82,57,52,21,9,35,75,46.7,40,41,2,39,85,167,127,3,"https://fbref.com/en/players/d4d0a9ad/William"
2019,"Wolfsburg","Bundesliga","John Yeboah","GER","MF,FW","18",2000,0.6,0,0,0,0,0,0,3,0,3,1,0,1,1,1,0,0,"https://fbref.com/en/players/8dfdc6c3/John-Yeboah"
2019,"Wolves","Premier League","Ryan Bennett","ENG","DF","28",1990,34,58,32,41,16,1,25,41,61,16,42,21,21,43,101,131,1,"https://fbref.com/en/players/0bad4516/Ryan-Bennett"
2019,"Wolves","Premier League","Willy Boly","CIV","DF","27",1991,35.2,85,52,49,34,2,34,56,60.7,22,55,32,23,72,157,177,6,"https://fbref.com/en/players/a4ac4b8f/Willy-Boly"
2019,"Wolves","Premier League","Léo Bonatini","BRA","FW","24",1994,1.5,1,1,0,0,1,1,5,20,4,1,0,1,0,1,0,0,"https://fbref.com/en/players/da23d58d/Leo-Bonatini"
2019,"Wolves","Premier League","Jonny Castro","ESP","DF,MF","24",1994,30.8,79,43,42,33,4,31,60,51.7,29,45,8,37,60,139,64,2,"https://fbref.com/en/players/e28868f3/Jonny-Castro"
2019,"Wolves","Premier League","Ivan Cavaleiro","POR","FW,MF","24",1993,7.7,5,4,3,1,1,1,14,7.1,13,12,0,12,4,9,5,0,"https://fbref.com/en/players/979b811d/Ivan-Cavaleiro"
2019,"Wolves","Premier League","Conor Coady","ENG","DF","25",1993,38,31,19,26,5,0,17,32,53.1,15,35,27,8,30,61,133,3,"https://fbref.com/en/players/2928dca2/Conor-Coady"
2019,"Wolves","Premier League","Hélder Costa","ANG","FW,MF","24",1994,14.9,18,14,7,7,4,7,23,30.4,16,15,0,15,9,27,6,0,"https://fbref.com/en/players/f13d02a6/Helder-Costa"
2019,"Wolves","Premier League","Leander Dendoncker","BEL","MF","23",1995,16.3,53,26,25,25,3,16,47,34,31,35,6,29,23,76,34,1,"https://fbref.com/en/players/5a7301ae/Leander-Dendoncker"
2019,"Wolves","Premier League","Matt Doherty","IRL","DF,MF","26",1992,34.9,67,42,48,15,4,35,58,60.3,23,49,7,42,60,127,107,2,"https://fbref.com/en/players/d557d734/Matt-Doherty"
2019,"Wolves","Premier League","Morgan Gibbs-White","ENG","MF,FW","18",2000,7.4,6,3,2,4,0,1,4,25,3,6,0,6,1,7,0,0,"https://fbref.com/en/players/32f60ed8/Morgan-Gibbs-White"
2019,"Wolves","Premier League","Raúl Jiménez","MEX","FW","27",1991,34.6,30,18,5,17,8,6,23,26.1,17,25,3,22,26,56,40,0,"https://fbref.com/en/players/b561db50/Raul-Jimenez"
2019,"Wolves","Premier League","Diogo Jota","POR","FW,MF","21",1996,26.2,28,16,11,11,6,10,38,26.3,28,20,1,19,13,41,11,0,"https://fbref.com/en/players/178ae8f8/Diogo-Jota"
2019,"Wolves","Premier League","Max Kilman","ENG","DF","21",1997,0,0,0,0,0,0,0,0,NA,0,0,0,0,0,0,0,0,"https://fbref.com/en/players/d0f72bf1/Max-Kilman"
2019,"Wolves","Premier League","João Moutinho","POR","MF","31",1986,33.7,113,58,50,56,7,44,126,34.9,82,56,11,45,40,153,50,0,"https://fbref.com/en/players/f5a00fa4/Joao-Moutinho"
2019,"Wolves","Premier League","Rúben Neves","POR","MF","21",1997,33.4,75,32,33,36,6,27,83,32.5,56,57,18,39,73,148,46,3,"https://fbref.com/en/players/44bfb6c5/Ruben-Neves"
2019,"Wolves","Premier League","Will Norris","ENG","GK","24",1993,0,0,0,0,0,0,0,0,NA,0,0,0,0,0,0,0,0,"https://fbref.com/en/players/c73ada83/Will-Norris"
2019,"Wolves","Premier League","Rui Patrício","POR","GK","30",1988,37,2,0,2,0,0,2,3,66.7,1,0,0,0,1,3,7,4,"https://fbref.com/en/players/79b0d6a0/Rui-Patricio"
2019,"Wolves","Premier League","John Ruddy","ENG","GK","31",1986,1,0,0,0,0,0,0,0,NA,0,0,0,0,0,0,0,0,"https://fbref.com/en/players/da8b19e2/John-Ruddy"
2019,"Wolves","Premier League","Romain Saïss","MAR","MF,DF","28",1990,12.8,39,26,23,14,2,20,37,54.1,17,25,12,13,26,65,61,0,"https://fbref.com/en/players/9fbbcf39/Romain-Saiss"
2019,"Wolves","Premier League","Adama Traoré","ESP","FW,MF","22",1996,10,16,13,11,3,2,4,9,44.4,5,11,0,11,6,22,7,0,"https://fbref.com/en/players/9a28eba4/Adama-Traore"
2019,"Wolves","Premier League","Rúben Vinagre","POR","DF,MF","19",1999,7.9,14,9,7,7,0,2,5,40,3,10,2,8,14,28,16,1,"https://fbref.com/en/players/b937e490/Ruben-Vinagre"
2020,"Alavés","La Liga","Martin Agirregabiria","ESP","DF","23",1996,23.3,55,30,32,18,5,30,54,55.6,24,19,7,12,18,73,48,0,"https://fbref.com/en/players/355c883a/Martin-Agirregabiria"
2020,"Alavés","La Liga","Burgui","ESP","MF","25",1993,0.2,0,0,0,0,0,0,0,NA,0,0,0,0,0,0,0,0,"https://fbref.com/en/players/45e304c8/Burgui"
2020,"Alavés","La Liga","Oliver Burke","SCO","MF,FW","22",1997,15.9,19,14,8,9,2,10,23,43.5,13,24,0,24,8,27,16,0,"https://fbref.com/en/players/f631c17f/Oliver-Burke"
2020,"Alavés","La Liga","Víctor Camarasa","ESP","MF","25",1994,14.4,18,10,5,10,3,7,18,38.9,11,8,3,5,15,33,12,0,"https://fbref.com/en/players/b2d03887/Victor-Camarasa"
2020,"Alavés","La Liga","Rubén Duarte","ESP","DF","23",1995,29.6,61,32,30,28,3,34,60,56.7,26,30,8,22,47,108,71,0,"https://fbref.com/en/players/1fe0492d/Ruben-Duarte"
2020,"Alavés","La Liga","Rodrigo Ely","BRA","DF","25",1993,23.6,22,13,15,7,0,13,29,44.8,16,23,19,4,32,54,116,0,"https://fbref.com/en/players/fd47b4f2/Rodrigo-Ely"
2020,"Alavés","La Liga","Ljubomir Fejsa","SRB","MF","30",1988,8.7,19,13,8,10,1,6,23,26.1,17,8,1,7,6,25,13,0,"https://fbref.com/en/players/874d7a32/Ljubomir-Fejsa"
2020,"Alavés","La Liga","Manu García","ESP","MF","33",1986,21.9,46,23,11,31,4,17,72,23.6,55,28,12,16,28,74,32,1,"https://fbref.com/en/players/05a4465d/Manu-Garcia"
2020,"Alavés","La Liga","John Guidetti","SWE","FW,MF","27",1992,1.1,2,1,0,1,1,0,0,NA,0,1,0,1,0,2,0,0,"https://fbref.com/en/players/99bebd12/John-Guidetti"
2020,"Alavés","La Liga","Joselu","ESP","FW","29",1990,30.9,26,17,4,12,10,4,32,12.5,28,36,5,31,13,39,46,0,"https://fbref.com/en/players/6265208f/Joselu"
2020,"Alavés","La Liga","Víctor Laguardia","ESP","DF","29",1989,29.5,21,15,15,6,0,16,30,53.3,14,24,18,6,37,58,131,1,"https://fbref.com/en/players/b7c99b9b/Victor-Laguardia"
2020,"Alavés","La Liga","Javi López","ESP","DF","17",2002,1,6,5,4,2,0,4,5,80,1,1,1,0,1,7,5,0,"https://fbref.com/en/players/e9ada8cf/Javi-Lopez"
2020,"Alavés","La Liga","José Luis Rodríguez","PAN","FW","21",1998,0.2,0,0,0,0,0,0,2,0,2,0,0,0,0,0,0,0,"https://fbref.com/en/players/b333b014/Jose-Luis-Rodriguez"
2020,"Alavés","La Liga","Lisandro Magallán","ARG","DF","25",1993,13.3,22,15,10,12,0,8,14,57.1,6,17,6,11,16,38,43,1,"https://fbref.com/en/players/01a49bd2/Lisandro-Magallan"
2020,"Alavés","La Liga","Abdallahi Mahmoud","MTN","MF","19",2000,1.7,4,4,2,1,1,1,6,16.7,5,0,0,0,5,9,2,0,"https://fbref.com/en/players/ab99e4a0/Abdallahi-Mahmoud"
2020,"Alavés","La Liga","Adrián Marín","ESP","DF","22",1997,9.5,22,15,14,6,2,13,15,86.7,2,13,4,9,13,35,32,0,"https://fbref.com/en/players/b7f2edff/Adrian-Marin"
2020,"Alavés","La Liga","Guillermo Maripán","CHI","DF","25",1994,1,1,1,1,0,0,1,2,50,1,0,0,0,2,3,10,0,"https://fbref.com/en/players/d9764034/Guillermo-Maripan"
2020,"Alavés","La Liga","Édgar Méndez","ESP","MF,FW","29",1990,9.6,11,7,4,6,1,5,13,38.5,8,10,2,8,5,16,7,0,"https://fbref.com/en/players/aed746df/Edgar-Mendez"
2020,"Alavés","La Liga","Javier Muñoz","ESP","FW,MF","24",1995,0.6,0,0,0,0,0,0,0,NA,0,1,1,0,0,0,0,0,"https://fbref.com/en/players/ec7c84c2/Javier-Munoz"
2020,"Alavés","La Liga","Ximo Navarro","ESP","DF","29",1990,21.1,34,19,17,15,2,16,28,57.1,12,20,7,13,52,86,76,2,"https://fbref.com/en/players/8db394aa/Ximo-Navarro"
2020,"Alavés","La Liga","Fernando Pacheco","ESP","GK","27",1992,26.2,1,0,1,0,0,1,3,33.3,2,0,0,0,0,1,10,0,"https://fbref.com/en/players/97852360/Fernando-Pacheco"
2020,"Alavés","La Liga","Paulino","ESP","FW,MF","22",1997,0.8,0,0,0,0,0,0,1,0,1,1,0,1,1,1,0,0,"https://fbref.com/en/players/f20fce1b/Paulino"
2020,"Alavés","La Liga","Lucas Pérez","ESP","FW","30",1988,27.7,12,6,2,8,2,3,13,23.1,10,13,2,11,2,14,0,0,"https://fbref.com/en/players/a300ac7e/Lucas-Perez"
2020,"Alavés","La Liga","Tomás Pina Isla","ESP","MF","31",1987,14.9,37,22,13,21,3,12,24,50,12,15,5,10,16,53,31,0,"https://fbref.com/en/players/e54bd0a2/Tomas-Pina-Isla"
2020,"Alavés","La Liga","Pere Pons","ESP","MF","26",1993,12.1,28,16,14,12,2,12,26,46.2,14,16,3,13,12,40,8,1,"https://fbref.com/en/players/29b61deb/Pere-Pons"
2020,"Alavés","La Liga","Luis Rioja","ESP","MF","25",1993,18.2,18,12,11,6,1,8,25,32,17,21,0,21,16,34,6,0,"https://fbref.com/en/players/eb3dd471/Luis-Rioja"
2020,"Alavés","La Liga","Roberto","ESP","GK","33",1986,8.8,1,1,1,0,0,1,1,100,0,0,0,0,0,1,2,0,"https://fbref.com/en/players/ba3ca78f/Roberto"
2020,"Alavés","La Liga","Borja Sainz","ESP","MF,FW","18",2001,6.4,16,9,4,9,3,8,26,30.8,18,14,0,14,3,19,0,0,"https://fbref.com/en/players/1b40049a/Borja-Sainz"
2020,"Alavés","La Liga","Antonio Sivera","ESP","GK","22",1996,3,0,0,0,0,0,0,0,NA,0,0,0,0,0,0,2,0,"https://fbref.com/en/players/9970da54/Antonio-Sivera"
2020,"Alavés","La Liga","Tachi","ESP","DF","21",1997,2.6,2,1,2,0,0,1,4,25,3,5,4,1,4,6,12,0,"https://fbref.com/en/players/8b625720/Tachi"
2020,"Alavés","La Liga","Aleix Vidal","ESP","MF","29",1989,24.1,21,14,8,11,2,8,37,21.6,29,14,1,13,23,44,18,0,"https://fbref.com/en/players/04965583/Aleix-Vidal"
2020,"Alavés","La Liga","Wakaso","GHA","MF","29",1990,14.3,54,31,25,24,5,16,33,48.5,17,23,5,18,17,71,17,1,"https://fbref.com/en/players/999908af/Wakaso"
2020,"Amiens","Ligue 1","Chadrac Akolo","COD","FW,MF","24",1995,6,16,8,8,6,2,5,12,41.7,7,6,1,5,5,21,5,0,"https://fbref.com/en/players/debc2f28/Chadrac-Akolo"
2020,"Amiens","Ligue 1","Haitam Aleesami","NOR","DF","28",1991,21.3,36,16,25,9,2,18,43,41.9,25,33,10,23,34,70,59,1,"https://fbref.com/en/players/4085f08e/Haitam-Aleesami"
2020,"Amiens","Ligue 1","Alexis Blin","FRA","MF","22",1996,20.5,39,25,18,15,6,20,61,32.8,41,25,6,19,16,55,49,0,"https://fbref.com/en/players/c69ef855/Alexis-Blin"
2020,"Amiens","Ligue 1","Mathieu Bodmer","FRA","MF,FW","36",1982,1,0,0,0,0,0,0,1,0,1,1,1,0,1,1,1,0,"https://fbref.com/en/players/f3642ba8/Mathieu-Bodmer"
2020,"Amiens","Ligue 1","Arturo Calabresi","ITA","DF","23",1996,20.9,53,33,29,20,4,33,75,44,42,24,11,13,29,82,60,0,"https://fbref.com/en/players/34bb6fbd/Arturo-Calabresi"
2020,"Amiens","Ligue 1","Aurélien Chedjou","CMR","DF","34",1985,21.9,27,19,18,9,0,10,22,45.5,12,15,11,4,40,67,120,3,"https://fbref.com/en/players/80e4c841/Aurelien-Chedjou"
2020,"Amiens","Ligue 1","Quentin Cornette","FRA","FW,MF","25",1994,3.9,8,3,3,2,3,3,9,33.3,6,7,1,6,6,14,5,0,"https://fbref.com/en/players/5d42d487/Quentin-Cornette"
2020,"Amiens","Ligue 1","Fousseni Diabaté","MLI","FW,MF","23",1995,13.2,16,10,6,6,4,5,16,31.3,11,11,0,11,8,24,3,1,"https://fbref.com/en/players/d07e3b41/Fousseni-Diabate"
2020,"Amiens","Ligue 1","Bakaye Dibassy","MLI","DF","29",1989,20.8,26,14,17,8,1,15,20,75,5,29,18,11,37,63,78,2,"https://fbref.com/en/players/247accfd/Bakaye-Dibassy"
2020,"Amiens","Ligue 1","Juan Ferney Otero","COL","FW,MF","24",1995,13.4,17,10,6,9,2,8,24,33.3,16,12,1,11,19,36,10,0,"https://fbref.com/en/players/05816e19/Juan-Ferney-Otero"
2020,"Amiens","Ligue 1","Saman Ghoddos","IRN","FW","25",1993,2.6,2,2,0,1,1,1,2,50,1,5,0,5,2,4,3,0,"https://fbref.com/en/players/f7b1d4e0/Saman-Ghoddos"
2020,"Amiens","Ligue 1","Eddy Gnahoré","FRA","MF","25",1993,12.6,24,12,7,15,2,8,28,28.6,20,25,4,21,9,33,25,0,"https://fbref.com/en/players/a0434482/Eddy-Gnahore"
2020,"Amiens","Ligue 1","Prince-Désir Gouano","FRA","DF","25",1993,3,3,1,0,3,0,0,0,NA,0,6,3,3,2,5,15,0,"https://fbref.com/en/players/7c6d6c96/Prince-Desir-Gouano"
2020,"Amiens","Ligue 1","Sehrou Guirassy","GUI","FW","23",1996,21.3,7,3,1,4,2,2,7,28.6,5,13,6,7,4,11,21,0,"https://fbref.com/en/players/923f4dda/Sehrou-Guirassy"
2020,"Amiens","Ligue 1","Régis Gurtner","FRA","GK","32",1986,28,1,1,1,0,0,1,2,50,1,0,0,0,0,1,10,4,"https://fbref.com/en/players/bc270726/Regis-Gurtner"
2020,"Amiens","Ligue 1","Christophe Jallet","FRA","DF","35",1983,9.5,24,16,14,8,2,14,37,37.8,23,8,2,6,18,42,29,0,"https://fbref.com/en/players/46d50339/Christophe-Jallet"
2020,"Amiens","Ligue 1","Gaël Kakuta","COD","MF,FW","28",1991,22.2,46,27,13,27,6,17,48,35.4,31,15,1,14,16,62,8,2,"https://fbref.com/en/players/5b1bf5e3/Gael-Kakuta"
2020,"Amiens","Ligue 1","Moussa Konaté","SEN","FW","26",1993,6.8,3,0,0,3,0,0,2,0,2,2,0,2,1,4,1,0,"https://fbref.com/en/players/fcbcbd94/Moussa-Konate"
2020,"Amiens","Ligue 1","Jack Lahne","SWE","FW","17",2001,0.1,1,1,0,0,1,0,0,NA,0,0,0,0,0,1,0,0,"https://fbref.com/en/players/07f73a4f/Jack-Lahne"
2020,"Amiens","Ligue 1","Jordan Lefort","FRA","DF","25",1993,9.4,3,2,2,1,0,3,5,60,2,4,1,3,9,12,29,0,"https://fbref.com/en/players/c3e4ecbb/Jordan-Lefort"
2020,"Amiens","Ligue 1","Isaac Mbenza","BEL","FW","23",1996,0.9,0,0,0,0,0,0,1,0,1,0,0,0,0,0,0,0,"https://fbref.com/en/players/aa1a8c7e/Isaac-Mbenza"
2020,"Amiens","Ligue 1","Stiven Mendoza","COL","FW,MF","27",1992,12.2,12,7,4,5,3,4,22,18.2,18,13,2,11,9,21,3,1,"https://fbref.com/en/players/e68f2cb4/Stiven-Mendoza"
2020,"Amiens","Ligue 1","Thomas Monconduit","FRA","MF","28",1991,15.2,26,12,6,18,2,9,26,34.6,17,11,4,7,10,36,25,3,"https://fbref.com/en/players/84d94b91/Thomas-Monconduit"
2020,"Amiens","Ligue 1","Nicholas Opoku","GHA","DF","21",1997,7,7,5,6,1,0,7,14,50,7,6,2,4,7,14,32,0,"https://fbref.com/en/players/b871bf55/Nicholas-Opoku"
2020,"Amiens","Ligue 1","Mahdi Talal","FRA","FW","21",1997,0.2,0,0,0,0,0,0,1,0,1,1,0,1,0,0,2,0,"https://fbref.com/en/players/814ac171/Mahdi-Talal"
2020,"Amiens","Ligue 1","Cheick Timite","CIV","MF,FW","21",1997,1.3,1,0,0,1,0,0,1,0,1,0,0,0,2,3,1,0,"https://fbref.com/en/players/2c92d3c0/Cheick-Timite"
2020,"Amiens","Ligue 1","Bongani Zungu","RSA","MF","26",1992,11,27,11,10,13,4,18,31,58.1,13,8,2,6,16,43,21,0,"https://fbref.com/en/players/a8797cf1/Bongani-Zungu"
2020,"Angers","Ligue 1","Rayan Aït Nouri","FRA","DF","18",2001,14.2,29,22,14,8,7,10,21,47.6,11,14,1,13,18,47,33,0,"https://fbref.com/en/players/9b398aea/Rayan-Ait-Nouri"
2020,"Angers","Ligue 1","Rachid Alioui","MAR","FW","27",1992,17.4,8,5,0,7,1,2,13,15.4,11,3,0,3,2,10,9,0,"https://fbref.com/en/players/bdedd861/Rachid-Alioui"
2020,"Angers","Ligue 1","Stéphane Bahoken","CMR","FW","27",1992,10.1,7,4,1,2,4,1,7,14.3,6,4,1,3,2,9,2,0,"https://fbref.com/en/players/5046b7d4/Stephane-Bahoken"
2020,"Angers","Ligue 1","Abdoulaye Bamba","CIV","DF","29",1990,6.2,10,7,7,1,2,8,15,53.3,7,4,1,3,4,14,18,0,"https://fbref.com/en/players/7fecbcdb/Abdoulaye-Bamba"
2020,"Angers","Ligue 1","Antonin Bobichon","FRA","MF","23",1995,7.2,9,4,4,5,0,2,19,10.5,17,7,0,7,7,16,4,0,"https://fbref.com/en/players/7d937aa1/Antonin-Bobichon"
2020,"Angers","Ligue 1","Ludovic Butelle","FRA","GK","36",1983,26,1,1,1,0,0,1,2,50,1,1,0,1,0,1,10,4,"https://fbref.com/en/players/26975a92/Ludovic-Butelle"
2020,"Angers","Ligue 1","Pierrick Capelle","FRA","MF,DF","32",1987,19.4,42,32,18,16,8,16,48,33.3,32,17,3,14,21,63,28,0,"https://fbref.com/en/players/79b2399c/Pierrick-Capelle"
2020,"Angers","Ligue 1","Ibrahim Cissé","SEN","DF","23",1996,0.7,2,1,0,2,0,0,0,NA,0,0,0,0,0,2,2,0,"https://fbref.com/en/players/0f87f8c2/Ibrahim-Cisse"
2020,"Angers","Ligue 1","Souleyman Doumbia","CIV","DF","22",1996,5,10,4,7,2,1,5,6,83.3,1,5,0,5,6,16,18,0,"https://fbref.com/en/players/9daeac61/Souleyman-Doumbia"
2020,"Angers","Ligue 1","Angelo Fulgini","FRA","MF","22",1996,17.5,28,18,8,15,5,12,23,52.2,11,6,1,5,19,47,10,0,"https://fbref.com/en/players/4b96c347/Angelo-Fulgini"
2020,"Angers","Ligue 1","Wilfried Kanga","CIV","FW","21",1998,0.8,0,0,0,0,0,0,1,0,1,0,0,0,0,0,0,0,"https://fbref.com/en/players/b4c816a9/Wilfried-Kanga"
2020,"Angers","Ligue 1","Vincent Manceau","FRA","DF","30",1989,22,34,22,18,13,3,16,36,44.4,20,16,3,13,22,56,51,0,"https://fbref.com/en/players/c26a3918/Vincent-Manceau"
2020,"Angers","Ligue 1","Thomas Mangani","FRA","MF","32",1987,20.8,33,23,15,16,2,14,47,29.8,33,17,2,15,12,45,20,1,"https://fbref.com/en/players/c801616a/Thomas-Mangani"
2020,"Angers","Ligue 1","Farid El Melali","ALG","MF,FW","22",1997,3.4,7,5,2,2,3,4,14,28.6,10,5,0,5,2,9,4,0,"https://fbref.com/en/players/d21e361a/Farid-El-Melali"
2020,"Angers","Ligue 1","Casimir Ninga","CHA","MF,FW","26",1993,7.6,5,5,4,0,1,1,5,20,4,5,0,5,3,8,2,0,"https://fbref.com/en/players/91f2da4c/Casimir-Ninga"
2020,"Angers","Ligue 1","Zinédine Ould Khaled","FRA","MF","19",2000,0.7,2,1,0,2,0,2,4,50,2,0,0,0,4,6,0,0,"https://fbref.com/en/players/6b4436ba/Zinedine-Ould-Khaled"
2020,"Angers","Ligue 1","Vincent Pajot","FRA","MF","28",1990,1.3,2,2,1,1,0,1,1,100,0,3,0,3,5,7,0,0,"https://fbref.com/en/players/f86ca403/Vincent-Pajot"
2020,"Angers","Ligue 1","Mateo Pavlović","BIH","DF","29",1990,9,8,2,6,2,0,5,7,71.4,2,4,2,2,5,13,38,1,"https://fbref.com/en/players/450e277f/Mateo-Pavlovic"
2020,"Angers","Ligue 1","Théo Pellenard","FRA","DF","25",1994,5.1,11,8,6,3,2,6,13,46.2,7,4,0,4,5,16,8,0,"https://fbref.com/en/players/97fb4608/Theo-Pellenard"
2020,"Angers","Ligue 1","Mathias Pereira Lage","POR","MF","22",1996,17.1,30,18,16,13,1,12,37,32.4,25,19,0,19,17,47,9,0,"https://fbref.com/en/players/8846a40f/Mathias-Pereira-Lage"
2020,"Angers","Ligue 1","Danijel Petković","MNE","GK","26",1993,2,0,0,0,0,0,0,0,NA,0,0,0,0,0,0,2,0,"https://fbref.com/en/players/b98cea65/Danijel-Petkovic"
2020,"Angers","Ligue 1","Jeff Reine-Adélaïde","FRA","MF","21",1998,0.9,3,1,1,2,0,1,1,100,0,1,0,1,0,3,1,0,"https://fbref.com/en/players/d504b3e1/Jeff-Reine-Adelaide"
2020,"Angers","Ligue 1","Baptiste Santamaria","FRA","MF","24",1995,27.8,91,53,39,43,9,35,79,44.3,44,27,5,22,43,134,36,0,"https://fbref.com/en/players/5e22e2a4/Baptiste-Santamaria"
2020,"Angers","Ligue 1","Sada Thioub","SEN","MF,FW","24",1995,16.8,20,12,8,9,3,5,18,27.8,13,9,1,8,4,24,5,0,"https://fbref.com/en/players/f4bc42b1/Sada-Thioub"
2020,"Angers","Ligue 1","Romain Thomas","FRA","DF","31",1988,26,24,17,16,7,1,8,18,44.4,10,35,18,17,39,63,118,1,"https://fbref.com/en/players/275e2c51/Romain-Thomas"
2020,"Angers","Ligue 1","Ismaël Traoré","CIV","DF","32",1986,22.8,23,12,14,7,2,10,17,58.8,7,23,13,10,27,50,85,1,"https://fbref.com/en/players/b666421b/Ismael-Traore"
2020,"Arsenal","Premier League","Pierre-Emerick Aubameyang","GAB","FW","30",1989,34.8,31,19,10,12,9,12,51,23.5,39,39,1,38,14,45,16,0,"https://fbref.com/en/players/d5dd5f1f/Pierre-Emerick-Aubameyang"
2020,"Arsenal","Premier League","Héctor Bellerín","ESP","DF,MF","24",1995,12.9,20,13,7,11,2,11,29,37.9,18,20,4,16,19,39,27,1,"https://fbref.com/en/players/f874dd44/Hector-Bellerin"
2020,"Arsenal","Premier League","Dani Ceballos","ESP","MF","22",1996,18.8,45,23,26,14,5,18,61,29.5,43,14,3,11,32,77,16,1,"https://fbref.com/en/players/c0617e2b/Dani-Ceballos"
2020,"Arsenal","Premier League","Calum Chambers","ENG","DF","24",1995,12.2,26,10,12,8,6,11,16,68.8,5,13,7,6,16,42,43,1,"https://fbref.com/en/players/dc6f5bdd/Calum-Chambers"
2020,"Arsenal","Premier League","Mattéo Guendouzi","FRA","MF","20",1999,19.4,31,16,14,13,4,14,43,32.6,29,21,7,14,29,60,38,2,"https://fbref.com/en/players/5ea8ef20/Matteo-Guendouzi"
2020,"Arsenal","Premier League","Rob Holding","ENG","DF","23",1995,6.5,4,2,3,1,0,1,3,33.3,2,10,6,4,5,9,45,1,"https://fbref.com/en/players/d79a8c87/Rob-Holding"
2020,"Arsenal","Premier League","Sead Kolašinac","BIH","DF","26",1993,18.9,29,16,18,6,5,12,23,52.2,11,14,4,10,25,54,34,1,"https://fbref.com/en/players/3935e52e/Sead-Kolasinac"
2020,"Arsenal","Premier League","Alexandre Lacazette","FRA","FW","28",1991,20.8,31,16,8,21,2,9,24,37.5,15,14,0,14,7,38,15,0,"https://fbref.com/en/players/9dbb75ca/Alexandre-Lacazette"
2020,"Arsenal","Premier League","Bernd Leno","GER","GK","27",1992,29.4,0,0,0,0,0,0,2,0,2,0,0,0,0,0,9,2,"https://fbref.com/en/players/2628fd2b/Bernd-Leno"
2020,"Arsenal","Premier League","David Luiz","BRA","DF","32",1987,31.2,28,16,14,14,0,13,24,54.2,11,42,37,5,32,60,133,2,"https://fbref.com/en/players/c0e27d1a/David-Luiz"
2020,"Arsenal","Premier League","Ainsley Maitland-Niles","ENG","DF","21",1997,15.4,41,23,34,5,2,22,43,51.2,21,12,3,9,28,69,38,0,"https://fbref.com/en/players/e3a5814e/Ainsley-Maitland-Niles"
2020,"Arsenal","Premier League","Pablo Marí","ESP","DF","25",1993,1.3,2,1,2,0,0,0,0,NA,0,0,0,0,1,3,10,0,"https://fbref.com/en/players/aa54ec6f/Pablo-Mari"
2020,"Arsenal","Premier League","Martinelli","BRA","FW","18",2001,7.4,20,15,10,6,4,7,20,35,13,15,1,14,3,23,8,0,"https://fbref.com/en/players/48a5a5d6/Martinelli"
2020,"Arsenal","Premier League","Emiliano Martínez","ARG","GK","26",1992,8.6,0,0,0,0,0,0,0,NA,0,0,0,0,0,0,1,0,"https://fbref.com/en/players/7956236f/Emiliano-Martinez"
2020,"Arsenal","Premier League","Henrikh Mkhitaryan","ARM","FW","30",1989,1.2,0,0,0,0,0,0,2,0,2,3,0,3,0,0,1,0,"https://fbref.com/en/players/dd0daf32/Henrikh-Mkhitaryan"
2020,"Arsenal","Premier League","Nacho Monreal","ESP","DF","33",1986,3,1,1,1,0,0,1,3,33.3,2,3,1,2,3,4,10,0,"https://fbref.com/en/players/d4cb83cc/Nacho-Monreal"
2020,"Arsenal","Premier League","Shkodran Mustafi","GER","DF","27",1992,13.4,17,10,11,5,1,6,12,50,6,10,6,4,18,35,72,0,"https://fbref.com/en/players/3f2d59fe/Shkodran-Mustafi"
2020,"Arsenal","Premier League","Reiss Nelson","ENG","FW","19",1999,7,11,8,5,4,2,7,17,41.2,10,13,2,11,3,14,3,0,"https://fbref.com/en/players/c5bdb6e3/Reiss-Nelson"
2020,"Arsenal","Premier League","Eddie Nketiah","ENG","FW","20",1999,7,7,5,3,4,0,2,6,33.3,4,9,0,9,2,9,5,0,"https://fbref.com/en/players/a53649b7/Eddie-Nketiah"
2020,"Arsenal","Premier League","Mesut Özil","GER","MF","30",1988,16,17,8,9,7,1,4,23,17.4,19,4,0,4,5,22,1,0,"https://fbref.com/en/players/16380240/Mesut-Ozil"
2020,"Arsenal","Premier League","Sokratis Papastathopoulos","GRE","DF","31",1988,18.8,25,16,17,7,1,10,21,47.6,11,30,24,6,17,42,68,1,"https://fbref.com/en/players/b682dcf6/Sokratis-Papastathopoulos"
2020,"Arsenal","Premier League","Nicolas Pépé","CIV","FW","24",1995,22.3,32,17,15,13,4,8,16,50,8,15,2,13,8,40,5,0,"https://fbref.com/en/players/57e3f0c7/Nicolas-Pepe"
2020,"Arsenal","Premier League","Bukayo Saka","ENG","DF,FW","17",2001,19.5,36,21,21,8,7,19,37,51.4,18,12,3,9,12,48,19,0,"https://fbref.com/en/players/bc7dc64d/Bukayo-Saka"
2020,"Arsenal","Premier League","Emile Smith Rowe","ENG","MF","19",2000,1.1,1,1,1,0,0,1,3,33.3,2,0,0,0,1,2,2,0,"https://fbref.com/en/players/17695062/Emile-Smith-Rowe"
2020,"Arsenal","Premier League","Cédric Soares","POR","MF,DF","27",1991,2.8,8,6,2,6,0,1,3,33.3,2,3,0,3,3,11,4,0,"https://fbref.com/en/players/839c14e1/Cedric-Soares"
2020,"Arsenal","Premier League","Kieran Tierney","SCO","DF,MF","22",1997,11,20,16,13,6,1,11,15,73.3,4,10,4,6,9,29,37,1,"https://fbref.com/en/players/fce2302c/Kieran-Tierney"
2020,"Arsenal","Premier League","Lucas Torreira","URU","MF","23",1996,16.8,31,16,11,15,5,16,39,41,23,24,8,16,34,65,24,0,"https://fbref.com/en/players/52611641/Lucas-Torreira"
2020,"Arsenal","Premier League","Joe Willock","ENG","MF,FW","19",1999,9.5,25,16,9,12,4,8,21,38.1,13,16,2,14,4,29,11,2,"https://fbref.com/en/players/a3b03921/Joe-Willock"
2020,"Arsenal","Premier League","Granit Xhaka","SUI","MF","26",1992,28.7,45,25,20,19,6,25,55,45.5,30,32,16,16,21,66,59,3,"https://fbref.com/en/players/e61b8aee/Granit-Xhaka"
2020,"Aston Villa","Premier League","Borja Bastón","ESP","MF,FW","26",1992,0.2,1,0,0,1,0,0,2,0,2,1,0,1,0,1,0,1,"https://fbref.com/en/players/8c44e37b/Borja-Baston"
2020,"Aston Villa","Premier League","Keinan Davis","ENG","FW","21",1998,6.1,1,1,0,1,0,0,3,0,3,4,0,4,0,1,3,0,"https://fbref.com/en/players/9deaf2c8/Keinan-Davis"
2020,"Aston Villa","Premier League","Danny Drinkwater","ENG","MF","29",1990,2.9,5,3,3,2,0,2,18,11.1,16,5,0,5,5,10,5,1,"https://fbref.com/en/players/2649ff32/Danny-Drinkwater"
2020,"Aston Villa","Premier League","Ahmed Elmohamady","EGY","DF","31",1987,11.5,19,9,10,7,2,10,21,47.6,11,11,5,6,13,32,25,1,"https://fbref.com/en/players/615ef733/Ahmed-Elmohamady"
2020,"Aston Villa","Premier League","Björn Engels","BEL","DF","24",1994,16.1,11,6,8,2,1,8,13,61.5,5,18,17,1,28,39,86,3,"https://fbref.com/en/players/4fdf1fd9/Bjorn-Engels"
2020,"Aston Villa","Premier League","Anwar El Ghazi","NED","FW,MF","24",1995,22.8,20,11,12,5,3,8,26,30.8,18,10,1,9,13,33,16,1,"https://fbref.com/en/players/ffa90327/Anwar-El-Ghazi"
2020,"Aston Villa","Premier League","Jack Grealish","ENG","FW,MF","23",1995,35.9,29,19,12,12,5,13,34,38.2,21,33,12,21,22,51,22,1,"https://fbref.com/en/players/b0b4fd3e/Jack-Grealish"
2020,"Aston Villa","Premier League","Frederic Guilbert","FRA","DF,MF","24",1994,22.7,74,43,48,20,6,36,67,53.7,31,33,10,23,49,123,74,2,"https://fbref.com/en/players/5d8d7454/Frederic-Guilbert"
2020,"Aston Villa","Premier League","Kortney Hause","ENG","DF","24",1995,17.2,21,9,15,5,1,8,15,53.3,7,27,19,8,20,41,98,4,"https://fbref.com/en/players/bf8fad51/Kortney-Hause"
2020,"Aston Villa","Premier League","Tom Heaton","ENG","GK","33",1986,19.9,3,2,3,0,0,3,4,75,1,0,0,0,0,3,6,0,"https://fbref.com/en/players/a6de6361/Tom-Heaton"
2020,"Aston Villa","Premier League","Conor Hourihane","IRL","MF","28",1991,17,16,10,4,8,4,10,25,40,15,19,4,15,9,25,31,0,"https://fbref.com/en/players/fcab00a0/Conor-Hourihane"
2020,"Aston Villa","Premier League","Jota","ESP","FW,MF","28",1991,3.7,3,1,2,0,1,2,5,40,3,1,0,1,3,6,6,0,"https://fbref.com/en/players/9f351459/Jota"
2020,"Aston Villa","Premier League","Jonathan Kodjia","CIV","FW","29",1989,1.3,0,0,0,0,0,0,1,0,1,0,0,0,0,0,1,0,"https://fbref.com/en/players/ecf44e09/Jonathan-Kodjia"
2020,"Aston Villa","Premier League","Ezri Konsa","ENG","DF","21",1997,22.7,18,9,12,6,0,7,16,43.8,9,34,24,10,25,43,70,2,"https://fbref.com/en/players/0313a347/Ezri-Konsa"
2020,"Aston Villa","Premier League","Henri Lansbury","ENG","MF","28",1990,2.2,6,2,3,1,2,2,8,25,6,4,0,4,0,6,3,0,"https://fbref.com/en/players/fe8e6fa1/Henri-Lansbury"
2020,"Aston Villa","Premier League","Douglas Luiz","BRA","MF","21",1998,29,46,24,25,17,4,19,65,29.2,46,42,15,27,36,82,54,1,"https://fbref.com/en/players/6f7d826d/Douglas-Luiz"
2020,"Aston Villa","Premier League","John McGinn","SCO","MF","24",1994,25.7,53,35,19,23,11,18,62,29,44,25,1,24,25,78,18,0,"https://fbref.com/en/players/90f91999/John-McGinn"
2020,"Aston Villa","Premier League","Tyrone Mings","ENG","DF","26",1993,32.2,15,11,11,3,1,10,13,76.9,3,56,48,8,30,45,190,4,"https://fbref.com/en/players/8397a50c/Tyrone-Mings"
2020,"Aston Villa","Premier League","Wesley Moraes","BRA","FW","22",1996,19.8,15,8,3,8,4,0,5,0,5,10,2,8,4,19,23,0,"https://fbref.com/en/players/bfae110f/Wesley-Moraes"
2020,"Aston Villa","Premier League","Marvelous Nakamba","ZIM","MF","25",1994,20.4,55,28,28,20,7,24,67,35.8,43,50,11,39,39,94,38,3,"https://fbref.com/en/players/de5b5570/Marvelous-Nakamba"
2020,"Aston Villa","Premier League","Ørjan Nyland","NOR","GK","28",1990,6,0,0,0,0,0,0,0,NA,0,0,0,0,0,0,1,1,"https://fbref.com/en/players/bdedffac/Orjan-Nyland"
2020,"Aston Villa","Premier League","Pepe Reina","ESP","GK","36",1982,12,0,0,0,0,0,0,2,0,2,0,0,0,0,0,9,1,"https://fbref.com/en/players/e358587b/Pepe-Reina"
2020,"Aston Villa","Premier League","Mbwana Samatta","TAN","FW","26",1992,10.5,6,4,0,3,3,1,8,12.5,7,7,0,7,1,7,6,0,"https://fbref.com/en/players/dae8623e/Mbwana-Samatta"
2020,"Aston Villa","Premier League","Jed Steer","ENG","GK","26",1992,0.1,0,0,0,0,0,0,0,NA,0,0,0,0,0,0,0,0,"https://fbref.com/en/players/a8a3d139/Jed-Steer"
2020,"Aston Villa","Premier League","Matt Targett","ENG","DF,MF","23",1995,25.5,52,29,37,11,4,22,53,41.5,31,28,8,20,56,108,82,0,"https://fbref.com/en/players/e514ab62/Matt-Targett"
2020,"Aston Villa","Premier League","Neil Taylor","WAL","DF","30",1989,12.1,16,11,12,4,0,11,20,55,9,15,5,10,20,36,43,0,"https://fbref.com/en/players/c2f9d19f/Neil-Taylor"
2020,"Aston Villa","Premier League","Trézéguet","EGY","FW,MF","24",1994,21.7,38,16,18,15,5,9,44,20.5,35,23,2,21,25,63,18,0,"https://fbref.com/en/players/3ae14ed1/Trezeguet"
2020,"Aston Villa","Premier League","Indiana Vassilev","USA","FW,MF","18",2001,0.6,0,0,0,0,0,0,0,NA,0,0,0,0,0,0,0,0,"https://fbref.com/en/players/04e195ee/Indiana-Vassilev"
2020,"Atalanta","Serie A","Guilherme Arana","BRA","DF","22",1997,0.9,4,4,1,3,0,3,5,60,2,0,0,0,2,6,0,0,"https://fbref.com/en/players/2b15a82a/Guilherme-Arana"
2020,"Atalanta","Serie A","Musa Barrow","GAM","FW,MF","20",1998,2.1,1,1,0,0,1,1,4,25,3,4,0,4,0,1,1,0,"https://fbref.com/en/players/e5bf73f3/Musa-Barrow"
2020,"Atalanta","Serie A","Raoul Bellanova","ITA","DF","19",2000,0.2,0,0,0,0,0,0,0,NA,0,0,0,0,0,0,0,0,"https://fbref.com/en/players/e3756e72/Raoul-Bellanova"
2020,"Atalanta","Serie A","Mattia Caldara","ITA","DF","25",1994,10.7,21,11,12,8,1,5,11,45.5,6,9,5,4,30,51,22,1,"https://fbref.com/en/players/ac7e640b/Mattia-Caldara"
2020,"Atalanta","Serie A","Timothy Castagne","BEL","DF","23",1995,19.7,31,20,9,16,6,13,25,52,12,34,5,29,17,48,23,0,"https://fbref.com/en/players/197640fd/Timothy-Castagne"
2020,"Atalanta","Serie A","Ebrima Colley","GAM","FW","19",2000,0.9,2,1,1,0,1,1,2,50,1,1,0,1,1,3,0,0,"https://fbref.com/en/players/bf356094/Ebrima-Colley"
2020,"Atalanta","Serie A","Lennart-Marten Czyborra","GER","DF","20",1999,0.2,0,0,0,0,0,0,0,NA,0,2,0,2,0,0,0,0,"https://fbref.com/en/players/7ba1f1ef/Lennart-Marten-Czyborra"
2020,"Atalanta","Serie A","Jacopo Da Riva","ITA","MF","18",2000,0,0,0,0,0,0,0,0,NA,0,0,0,0,0,0,0,0,"https://fbref.com/en/players/9591723b/Jacopo-Da-Riva"
2020,"Atalanta","Serie A","Amad Diallo","CIV","FW","17",2002,0.3,1,1,0,1,0,0,0,NA,0,0,0,0,0,1,0,0,"https://fbref.com/en/players/9dc96f10/Amad-Diallo"
2020,"Atalanta","Serie A","Berat Djimsiti","ALB","DF","26",1993,30.9,42,23,17,23,2,22,39,56.4,17,21,14,7,49,91,92,0,"https://fbref.com/en/players/6eee05f1/Berat-Djimsiti"
2020,"Atalanta","Serie A","Remo Freuler","SUI","MF","27",1992,26,51,30,18,25,8,22,63,34.9,41,41,6,35,28,79,26,0,"https://fbref.com/en/players/98d2c2c4/Remo-Freuler"
2020,"Atalanta","Serie A","Pierluigi Gollini","ITA","GK","24",1995,32,0,0,0,0,0,0,2,0,2,0,0,0,0,0,13,2,"https://fbref.com/en/players/f0f7f62f/Pierluigi-Gollini"
2020,"Atalanta","Serie A","Papu Gómez","ARG","MF,FW","31",1988,31.6,27,13,5,13,9,13,45,28.9,32,24,0,24,17,44,6,1,"https://fbref.com/en/players/6e4df551/Papu-Gomez"
2020,"Atalanta","Serie A","Robin Gosens","GER","DF","25",1994,29.1,53,27,19,26,8,23,51,45.1,28,38,10,28,39,92,40,0,"https://fbref.com/en/players/2d970560/Robin-Gosens"
2020,"Atalanta","Serie A","Hans Hateboer","NED","DF","25",1994,26.2,36,23,20,9,7,18,38,47.4,20,22,7,15,10,46,32,1,"https://fbref.com/en/players/3b333ac3/Hans-Hateboer"
2020,"Atalanta","Serie A","Josip Iličić","SVN","FW,MF","31",1988,18.5,26,19,7,10,9,7,28,25,21,9,0,9,9,35,4,0,"https://fbref.com/en/players/68252d6d/Josip-Ilicic"
2020,"Atalanta","Serie A","Simon Kjær","DEN","DF","30",1989,3.2,9,6,1,8,0,3,4,75,1,5,4,1,7,16,10,1,"https://fbref.com/en/players/8b8a56ce/Simon-Kjaer"
2020,"Atalanta","Serie A","José Luis Palomino","ARG","DF","29",1990,27.6,81,44,46,33,2,28,54,51.9,26,39,14,25,61,142,74,2,"https://fbref.com/en/players/921f6058/Jose-Luis-Palomino"
2020,"Atalanta","Serie A","Ruslan Malinovskyi","UKR","MF,FW","26",1993,17.1,22,14,2,17,3,9,31,29,22,13,2,11,5,27,5,0,"https://fbref.com/en/players/48d5bd33/Ruslan-Malinovskyi"
2020,"Atalanta","Serie A","Andrea Masiello","ITA","DF","33",1986,6,11,4,6,4,1,7,14,50,7,6,4,2,10,21,13,0,"https://fbref.com/en/players/e0314d87/Andrea-Masiello"
2020,"Atalanta","Serie A","Luis Muriel","COL","FW","28",1991,14,15,9,3,8,4,3,14,21.4,11,12,0,12,4,19,0,0,"https://fbref.com/en/players/eb2fe5b6/Luis-Muriel"
2020,"Atalanta","Serie A","Mario Pašalić","CRO","MF","24",1995,26.9,47,21,17,18,12,16,52,30.8,36,27,7,20,27,74,22,2,"https://fbref.com/en/players/e599253a/Mario-Pasalic"
2020,"Atalanta","Serie A","Roberto Piccoli","ITA","FW","18",2001,0.2,0,0,0,0,0,0,0,NA,0,1,0,1,0,0,0,0,"https://fbref.com/en/players/1cadaf34/Roberto-Piccoli"
2020,"Atalanta","Serie A","Marten de Roon","NED","MF,DF","28",1991,30.2,77,43,36,29,12,34,75,45.3,41,32,8,24,46,123,45,0,"https://fbref.com/en/players/2a1beb34/Marten-de-Roon"
2020,"Atalanta","Serie A","Francesco Rossi","ITA","GK","28",1991,0.1,0,0,0,0,0,0,0,NA,0,0,0,0,0,0,0,0,"https://fbref.com/en/players/7b5f516f/Francesco-Rossi"
2020,"Atalanta","Serie A","Marco Sportiello","ITA","GK","27",1992,5.8,0,0,0,0,0,0,0,NA,0,0,0,0,0,0,3,0,"https://fbref.com/en/players/ac4003af/Marco-Sportiello"
2020,"Atalanta","Serie A","Bosko Sutalo","CRO","DF","19",2000,3.1,3,2,2,1,0,0,2,0,2,4,0,4,6,9,6,1,"https://fbref.com/en/players/1d0bb7e4/Bosko-Sutalo"
2020,"Atalanta","Serie A","Adrien Tameze","CMR","MF","25",1994,2.3,4,3,1,1,2,1,2,50,1,3,1,2,3,7,4,1,"https://fbref.com/en/players/8da74c05/Adrien-Tameze"
2020,"Atalanta","Serie A","Rafael Tolói","ITA","DF","28",1990,29,56,29,28,23,5,33,76,43.4,43,31,17,14,45,101,80,0,"https://fbref.com/en/players/c56dc39e/Rafael-Toloi"
2020,"Atalanta","Serie A","Duván Zapata","COL","FW","28",1991,22.5,7,3,1,2,4,1,6,16.7,5,18,7,11,2,9,11,0,"https://fbref.com/en/players/d3de9af0/Duvan-Zapata"
2020,"Athletic Club","La Liga","Aritz Aduriz","ESP","FW,MF","38",1981,2.3,3,2,0,3,0,0,0,NA,0,0,0,0,0,3,2,0,"https://fbref.com/en/players/293211e1/Aritz-Aduriz"
2020,"Athletic Club","La Liga","Yeray Álvarez","ESP","DF","24",1995,31.2,36,19,28,7,1,17,30,56.7,13,33,22,11,62,98,138,2,"https://fbref.com/en/players/3ecc11d8/Yeray-Alvarez"
2020,"Athletic Club","La Liga","Mikel Balenziaga","ESP","DF","31",1988,6.3,15,10,4,10,1,9,11,81.8,2,4,1,3,2,17,20,0,"https://fbref.com/en/players/1fe67e86/Mikel-Balenziaga"
2020,"Athletic Club","La Liga","Yuri Berchiche","ESP","DF","29",1990,31.7,48,35,32,15,1,21,40,52.5,19,26,4,22,30,78,73,1,"https://fbref.com/en/players/b6e50615/Yuri-Berchiche"
2020,"Athletic Club","La Liga","Ander Capa","ESP","DF","27",1992,31.9,64,36,37,21,6,24,59,40.7,35,26,7,19,28,92,63,0,"https://fbref.com/en/players/37f1cf47/Ander-Capa"
2020,"Athletic Club","La Liga","Iñigo Córdoba","ESP","FW","22",1997,16,33,20,16,12,5,14,52,26.9,38,30,2,28,16,49,13,0,"https://fbref.com/en/players/49ea92be/Inigo-Cordoba"
2020,"Athletic Club","La Liga","Beñat Etxebarria","ESP","MF","32",1987,4.4,6,1,2,3,1,2,13,15.4,11,6,1,5,4,10,6,0,"https://fbref.com/en/players/b037bd4f/Benat-Etxebarria"
2020,"Athletic Club","La Liga","Dani García","ESP","MF","29",1990,33.7,59,30,30,27,2,30,86,34.9,56,25,7,18,52,111,56,1,"https://fbref.com/en/players/240d3a0b/Dani-Garcia"
2020,"Athletic Club","La Liga","Raúl García","ESP","MF,FW","33",1986,31.9,57,37,19,26,12,16,76,21.1,60,46,6,40,24,81,44,0,"https://fbref.com/en/players/b418dbd4/Raul-Garcia"
2020,"Athletic Club","La Liga","Ibai Gómez","ESP","FW","29",1989,7.7,5,3,2,2,1,3,8,37.5,5,4,0,4,3,8,6,0,"https://fbref.com/en/players/9d2a3d5f/Ibai-Gomez"
2020,"Athletic Club","La Liga","Iago Herrerín","ESP","GK","31",1988,4.7,0,0,0,0,0,0,0,NA,0,0,0,0,0,0,0,0,"https://fbref.com/en/players/9109185e/Iago-Herrerin"
2020,"Athletic Club","La Liga","Kenan Kodro","BIH","FW,MF","25",1993,4,1,0,0,0,1,0,2,0,2,1,0,1,0,1,4,0,"https://fbref.com/en/players/e82d2807/Kenan-Kodro"
2020,"Athletic Club","La Liga","Larra","ESP","FW,MF","21",1997,2.8,2,2,0,1,1,0,0,NA,0,1,0,1,0,2,0,0,"https://fbref.com/en/players/0d690336/Larra"
2020,"Athletic Club","La Liga","Iñigo Lekue","ESP","FW,DF","26",1993,6.9,22,12,14,6,2,11,14,78.6,3,7,0,7,3,25,11,0,"https://fbref.com/en/players/59b7d823/Inigo-Lekue"
2020,"Athletic Club","La Liga","Unai López","ESP","MF","23",1995,19.9,30,22,8,18,4,10,41,24.4,31,13,2,11,18,48,12,1,"https://fbref.com/en/players/88050721/Unai-Lopez"
2020,"Athletic Club","La Liga","Óscar de Marcos","ESP","DF,FW","30",1989,6,5,3,2,1,2,3,6,50,3,6,0,6,8,13,8,0,"https://fbref.com/en/players/9f323c71/Oscar-de-Marcos"
2020,"Athletic Club","La Liga","Iñigo Martínez","ESP","DF","28",1991,33,48,30,33,13,2,27,47,57.4,20,28,13,15,39,87,140,0,"https://fbref.com/en/players/3fc45c73/Inigo-Martinez"
2020,"Athletic Club","La Liga","Iker Muniain","ESP","FW,MF","26",1992,26.5,26,19,11,10,5,4,24,16.7,20,9,0,9,12,38,7,0,"https://fbref.com/en/players/c05dfb74/Iker-Muniain"
2020,"Athletic Club","La Liga","Unai Núñez","ESP","DF","22",1997,17.5,13,10,10,2,1,6,16,37.5,10,25,17,8,23,36,71,0,"https://fbref.com/en/players/be170419/Unai-Nunez"
2020,"Athletic Club","La Liga","Mikel San José","ESP","MF","30",1989,4,9,4,2,4,3,2,10,20,8,3,1,2,9,18,12,0,"https://fbref.com/en/players/003a5c72/Mikel-San-Jose"
2020,"Athletic Club","La Liga","Oihan Sancet","ESP","MF,FW","19",2000,8.2,11,7,5,4,2,4,11,36.4,7,6,0,6,2,13,2,0,"https://fbref.com/en/players/bdb624a3/Oihan-Sancet"
2020,"Athletic Club","La Liga","Unai Simón","ESP","GK","22",1997,33.2,0,0,0,0,0,0,1,0,1,1,0,1,1,1,10,1,"https://fbref.com/en/players/5dcf3e90/Unai-Simon"
2020,"Athletic Club","La Liga","Unai Vencedor Paris","ESP","MF","18",2000,0.8,0,0,0,0,0,0,0,NA,0,0,0,0,0,0,0,0,"https://fbref.com/en/players/4112ace5/Unai-Vencedor-Paris"
2020,"Athletic Club","La Liga","Mikel Vesga","ESP","MF","26",1993,14.1,25,17,7,12,6,9,45,20,36,18,7,11,31,56,24,1,"https://fbref.com/en/players/b0fce72c/Mikel-Vesga"
2020,"Athletic Club","La Liga","Asier Villalibre","ESP","FW","21",1997,5.9,0,0,0,0,0,0,3,0,3,3,0,3,1,1,4,0,"https://fbref.com/en/players/57be54ec/Asier-Villalibre"
2020,"Athletic Club","La Liga","Iñaki Williams","GHA","FW","25",1994,32.7,15,5,0,7,8,5,18,27.8,13,18,2,16,5,20,29,0,"https://fbref.com/en/players/6a99e0b1/Inaki-Williams"
2020,"Atlético Madrid","La Liga","Antonio Adán","ESP","GK","32",1987,0.3,0,0,0,0,0,0,0,NA,0,0,0,0,0,0,0,0,"https://fbref.com/en/players/65d62814/Antonio-Adan"
2020,"Atlético Madrid","La Liga","Santiago Arias","COL","DF","27",1992,12,36,24,20,12,4,10,18,55.6,8,12,7,5,19,55,20,1,"https://fbref.com/en/players/fdd60087/Santiago-Arias"
2020,"Atlético Madrid","La Liga","Sergio Camello","ESP","FW","18",2001,0.3,0,0,0,0,0,0,0,NA,0,0,0,0,0,0,0,0,"https://fbref.com/en/players/873619c6/Sergio-Camello"
2020,"Atlético Madrid","La Liga","Yannick Carrasco","BEL","MF,FW","25",1993,7,11,7,4,4,3,7,21,33.3,14,9,0,9,5,16,2,0,"https://fbref.com/en/players/de39485a/Yannick-Carrasco"
2020,"Atlético Madrid","La Liga","Óscar Clemente","ESP","MF","20",1999,0,0,0,0,0,0,0,0,NA,0,1,0,1,0,0,0,0,"https://fbref.com/en/players/9dfdbdeb/Oscar-Clemente"
2020,"Atlético Madrid","La Liga","Ángel Correa","ARG","MF,FW","24",1995,22.9,25,9,7,9,9,9,36,25,27,23,5,18,14,39,21,0,"https://fbref.com/en/players/01eb744d/Angel-Correa"
2020,"Atlético Madrid","La Liga","Diego Costa","ESP","FW","30",1988,15,9,5,1,4,4,1,10,10,9,4,2,2,3,12,10,0,"https://fbref.com/en/players/a190d597/Diego-Costa"
2020,"Atlético Madrid","La Liga","Felipe","BRA","DF","30",1989,23.4,27,19,21,6,0,14,24,58.3,10,18,13,5,40,67,130,0,"https://fbref.com/en/players/51a3c4c8/Felipe"
2020,"Atlético Madrid","La Liga","João Félix","POR","FW,MF","19",1999,19.4,9,3,3,3,3,4,14,28.6,10,4,0,4,10,19,4,1,"https://fbref.com/en/players/8aafd64f/Joao-Felix"
2020,"Atlético Madrid","La Liga","Mario Hermoso","ESP","DF","24",1995,13.5,15,8,12,2,1,11,20,55,9,11,5,6,12,27,61,0,"https://fbref.com/en/players/555f3a0b/Mario-Hermoso"
2020,"Atlético Madrid","La Liga","Héctor Herrera","MEX","MF","29",1990,12.5,31,21,9,18,4,13,32,40.6,19,16,7,9,17,48,13,2,"https://fbref.com/en/players/a8542814/Hector-Herrera"
2020,"Atlético Madrid","La Liga","Koke","ESP","MF","27",1992,30,70,42,27,30,13,29,89,32.6,60,33,8,25,29,99,28,2,"https://fbref.com/en/players/55126f3b/Koke"
2020,"Atlético Madrid","La Liga","Thomas Lemar","FRA","MF","23",1995,10.3,12,8,4,5,3,2,11,18.2,9,14,1,13,6,18,6,0,"https://fbref.com/en/players/4dbd0916/Thomas-Lemar"
2020,"Atlético Madrid","La Liga","Marcos Llorente","ESP","MF,FW","24",1995,15.2,29,15,7,16,6,7,21,33.3,14,24,4,20,14,43,9,0,"https://fbref.com/en/players/02c15616/Marcos-Llorente"
2020,"Atlético Madrid","La Liga","Renan Lodi","BRA","DF","21",1998,26.6,73,46,28,35,10,40,65,61.5,25,28,7,21,38,111,56,0,"https://fbref.com/en/players/ed9f7cfe/Renan-Lodi"
2020,"Atlético Madrid","La Liga","José María Giménez","URU","DF","24",1995,19.5,20,16,18,1,1,7,11,63.6,4,14,7,7,23,43,75,1,"https://fbref.com/en/players/f0da930c/Jose-Maria-Gimenez"
2020,"Atlético Madrid","La Liga","Álvaro Morata","ESP","FW","26",1992,23.3,17,8,4,9,4,1,13,7.7,12,12,2,10,5,22,23,0,"https://fbref.com/en/players/129af0db/Alvaro-Morata"
2020,"Atlético Madrid","La Liga","Toni Moya","ESP","MF","21",1998,0,0,0,0,0,0,0,0,NA,0,0,0,0,0,0,0,0,"https://fbref.com/en/players/9e098912/Toni-Moya"
2020,"Atlético Madrid","La Liga","Saúl Ñíguez","ESP","MF,DF","24",1994,34.1,95,59,44,42,9,39,88,44.3,49,58,13,45,55,150,68,1,"https://fbref.com/en/players/c14bc029/Saul-Niguez"
2020,"Atlético Madrid","La Liga","Jan Oblak","SVN","GK","26",1993,37.7,0,0,0,0,0,0,0,NA,0,0,0,0,1,1,4,2,"https://fbref.com/en/players/ee8508c0/Jan-Oblak"
2020,"Atlético Madrid","La Liga","Thomas Partey","GHA","MF","26",1993,28.3,70,41,34,30,6,26,58,44.8,32,32,8,24,48,118,41,7,"https://fbref.com/en/players/529f49ab/Thomas-Partey"
2020,"Atlético Madrid","La Liga","Darío Poveda","ESP","MF","22",1997,0.1,1,0,0,1,0,0,0,NA,0,0,0,0,0,1,0,0,"https://fbref.com/en/players/cbdf7d5c/Dario-Poveda"
2020,"Atlético Madrid","La Liga","Rodrigo Riquelme","ESP","FW,MF","19",2000,0.1,0,0,0,0,0,0,0,NA,0,0,0,0,0,0,0,0,"https://fbref.com/en/players/65154df0/Rodrigo-Riquelme"
2020,"Atlético Madrid","La Liga","Manuel Sánchez","ESP","DF","18",2000,3.6,13,7,2,7,4,8,15,53.3,7,3,0,3,7,20,1,0,"https://fbref.com/en/players/ffacd3d5/Manuel-Sanchez"
2020,"Atlético Madrid","La Liga","Ivan Šaponjić","SRB","DF,FW","21",1997,0.1,0,0,0,0,0,0,0,NA,0,0,0,0,0,0,0,0,"https://fbref.com/en/players/d2aea9ac/Ivan-Saponjic"
2020,"Atlético Madrid","La Liga","Stefan Savić","MNE","DF","28",1991,22,22,17,11,10,1,11,18,61.1,7,16,9,7,24,46,91,1,"https://fbref.com/en/players/f6ac68c1/Stefan-Savic"
2020,"Atlético Madrid","La Liga","Kieran Trippier","ENG","DF","28",1990,22,52,34,24,21,7,34,53,64.2,19,33,7,26,24,76,46,0,"https://fbref.com/en/players/21512407/Kieran-Trippier"
2020,"Atlético Madrid","La Liga","Germán Valera","ESP","FW","17",2002,0,0,0,0,0,0,0,0,NA,0,1,0,1,0,0,0,0,"https://fbref.com/en/players/84f55b4a/German-Valera"
2020,"Atlético Madrid","La Liga","Vitolo","ESP","FW,MF","29",1989,13.6,15,12,7,7,1,5,17,29.4,12,9,0,9,10,25,9,0,"https://fbref.com/en/players/db750822/Vitolo"
2020,"Atlético Madrid","La Liga","Šime Vrsaljko","CRO","DF","27",1992,4,6,5,6,0,0,5,6,83.3,1,5,3,2,8,14,11,0,"https://fbref.com/en/players/46a8347f/Sime-Vrsaljko"
2020,"Augsburg","Bundesliga","Daniel Baier","GER","MF","35",1984,21.6,33,17,14,14,5,15,43,34.9,28,19,7,12,58,91,27,0,"https://fbref.com/en/players/f261abcb/Daniel-Baier"
2020,"Augsburg","Bundesliga","Noah Joel Sarenren Bazee","NGA","FW","22",1996,4.2,4,3,0,4,0,1,4,25,3,2,1,1,5,9,4,0,"https://fbref.com/en/players/fbbc8e15/Noah-Joel-Sarenren-Bazee"
2020,"Augsburg","Bundesliga","Sergio Córdova","VEN","FW","21",1997,4.1,3,0,0,2,1,1,10,10,9,0,0,0,0,3,3,0,"https://fbref.com/en/players/229cd98a/Sergio-Cordova"
2020,"Augsburg","Bundesliga","Ohis Felix Uduokhai","GER","DF","21",1997,21.8,43,26,30,12,1,19,29,65.5,10,40,30,10,36,79,125,2,"https://fbref.com/en/players/677da306/Ohis-Felix-Uduokhai"
2020,"Augsburg","Bundesliga","Alfreð Finnbogason","ISL","FW","30",1989,10.7,11,6,1,9,1,2,7,28.6,5,8,2,6,3,14,8,0,"https://fbref.com/en/players/f9e7c4ac/Alfred-Finnbogason"
2020,"Augsburg","Bundesliga","Raphael Framberger","GER","DF","23",1995,13.1,43,25,23,16,4,21,29,72.4,8,23,9,14,20,63,26,0,"https://fbref.com/en/players/626fab5f/Raphael-Framberger"
2020,"Augsburg","Bundesliga","Jeffrey Gouweleeuw","NED","DF","28",1991,18.3,28,16,22,5,1,12,21,57.1,9,15,8,7,37,65,97,0,"https://fbref.com/en/players/1025db8e/Jeffrey-Gouweleeuw"
2020,"Augsburg","Bundesliga","Michael Gregoritsch","AUT","MF,FW","25",1994,3.4,2,2,0,2,0,0,4,0,4,4,1,3,3,5,7,0,"https://fbref.com/en/players/8e235926/Michael-Gregoritsch"
2020,"Augsburg","Bundesliga","Carlos Gruezo","ECU","MF","24",1995,9.8,28,12,12,15,1,5,24,20.8,19,5,0,5,6,34,5,0,"https://fbref.com/en/players/f2dd9a21/Carlos-Gruezo"
2020,"Augsburg","Bundesliga","André Hahn","GER","FW,MF","28",1990,7.8,15,9,7,5,3,5,21,23.8,16,23,5,18,13,28,14,0,"https://fbref.com/en/players/cd82452e/Andre-Hahn"
2020,"Augsburg","Bundesliga","Iago","BRA","DF,MF","22",1997,7.5,19,12,12,7,0,9,18,50,9,6,2,4,14,33,27,0,"https://fbref.com/en/players/054849d2/Iago"
2020,"Augsburg","Bundesliga","Tin Jedvaj","CRO","DF","23",1995,29.3,44,26,25,19,0,23,47,48.9,24,36,18,18,60,104,123,1,"https://fbref.com/en/players/f820504e/Tin-Jedvaj"
2020,"Augsburg","Bundesliga","Fredrik Jensen","FIN","MF,FW","21",1997,5.1,3,1,2,1,0,2,7,28.6,5,7,1,6,1,4,3,0,"https://fbref.com/en/players/3eeb80e0/Fredrik-Jensen"
2020,"Augsburg","Bundesliga","Rani Khedira","GER","MF","25",1994,29.4,60,36,21,35,4,18,45,40,27,47,12,35,48,108,62,0,"https://fbref.com/en/players/59e4b92e/Rani-Khedira"
2020,"Augsburg","Bundesliga","Tomáš Koubek","CZE","GK","26",1992,24,3,2,3,0,0,3,11,27.3,8,1,0,1,1,4,23,3,"https://fbref.com/en/players/dc366c36/Tomas-Koubek"
2020,"Augsburg","Bundesliga","Stephan Lichtsteiner","SUI","DF","35",1984,14.9,23,14,16,5,2,10,22,45.5,12,15,7,8,16,39,35,0,"https://fbref.com/en/players/99b1d0e6/Stephan-Lichtsteiner"
2020,"Augsburg","Bundesliga","Eduard Löwen","GER","MF","22",1997,7.5,10,8,6,2,2,6,18,33.3,12,11,2,9,5,15,7,0,"https://fbref.com/en/players/70678132/Eduard-Lowen"
2020,"Augsburg","Bundesliga","Andreas Luthe","GER","GK","32",1987,10,1,0,1,0,0,1,2,50,1,0,0,0,0,1,5,1,"https://fbref.com/en/players/7fe12375/Andreas-Luthe"
2020,"Augsburg","Bundesliga","Philipp Max","GER","DF","25",1993,30.1,42,29,22,16,4,20,45,44.4,25,19,4,15,26,68,50,0,"https://fbref.com/en/players/826e8b63/Philipp-Max"
2020,"Augsburg","Bundesliga","Jan Morávek","CZE","MF","29",1989,5.3,23,12,9,14,0,11,24,45.8,13,4,1,3,8,31,11,0,"https://fbref.com/en/players/e7d22eae/Jan-Moravek"
2020,"Augsburg","Bundesliga","Florian Niederlechner","GER","FW,MF","28",1990,30.2,21,13,7,9,5,4,21,19,17,21,5,16,8,29,38,0,"https://fbref.com/en/players/d6862409/Florian-Niederlechner"
2020,"Augsburg","Bundesliga","Reece Oxford","ENG","MF","20",1998,4.2,7,4,2,4,1,2,8,25,6,8,5,3,5,12,10,1,"https://fbref.com/en/players/8b6e0db2/Reece-Oxford"
2020,"Augsburg","Bundesliga","Mads Pedersen","DEN","DF","22",1996,1.1,4,2,3,0,1,2,6,33.3,4,3,1,2,2,6,0,0,"https://fbref.com/en/players/582a5247/Mads-Pedersen"
2020,"Augsburg","Bundesliga","Marco Richter","GER","MF,FW","21",1997,25.3,21,16,7,9,5,14,51,27.5,37,15,0,15,24,45,17,0,"https://fbref.com/en/players/f972644c/Marco-Richter"
2020,"Augsburg","Bundesliga","Julian Schieber","GER","FW","30",1989,0.5,1,1,0,1,0,0,0,NA,0,0,0,0,0,1,0,0,"https://fbref.com/en/players/37c213cf/Julian-Schieber"
2020,"Augsburg","Bundesliga","Marek Suchý","CZE","DF","31",1988,4.4,7,5,7,0,0,4,6,66.7,2,4,1,3,6,13,15,0,"https://fbref.com/en/players/c5224618/Marek-Suchy"
2020,"Augsburg","Bundesliga","Georg Teigl","AUT","DF,MF","28",1991,1.2,3,1,1,2,0,2,4,50,2,0,0,0,3,6,1,0,"https://fbref.com/en/players/c8cfb04d/Georg-Teigl"
2020,"Augsburg","Bundesliga","Ruben Vargas","SUI","FW,MF","20",1998,28.1,32,16,18,7,7,8,36,22.2,28,26,1,25,26,58,35,0,"https://fbref.com/en/players/6ecbddf6/Ruben-Vargas"
2020,"Barcelona","La Liga","Jordi Alba","ESP","DF","30",1989,24.3,20,13,9,7,4,6,27,22.2,21,12,3,9,37,57,40,0,"https://fbref.com/en/players/4601e194/Jordi-Alba"
2020,"Barcelona","La Liga","Carles Aleñá","ESP","MF","21",1998,1.9,2,1,1,1,0,1,4,25,3,1,0,1,0,2,0,0,"https://fbref.com/en/players/6c811eb7/Carles-Alena"
2020,"Barcelona","La Liga","Ronald Araújo","URU","DF","20",1999,2.6,3,2,2,1,0,1,1,100,0,6,2,4,0,3,9,0,"https://fbref.com/en/players/2bef2bca/Ronald-Araujo"
2020,"Barcelona","La Liga","Martin Braithwaite","DEN","FW,MF","28",1991,4.5,2,2,2,0,0,0,8,0,8,3,0,3,1,3,1,0,"https://fbref.com/en/players/fd771f95/Martin-Braithwaite"
2020,"Barcelona","La Liga","Sergio Busquets","ESP","MF","31",1988,27.6,80,44,23,43,14,41,71,57.7,30,36,5,31,44,124,24,2,"https://fbref.com/en/players/5ab0ea87/Sergio-Busquets"
2020,"Barcelona","La Liga","Álex Collado","ESP","FW","20",1999,0.1,0,0,0,0,0,0,0,NA,0,0,0,0,0,0,0,0,"https://fbref.com/en/players/85dace26/Alex-Collado"
2020,"Barcelona","La Liga","Ousmane Dembélé","FRA","FW","22",1997,4,2,2,1,1,0,2,5,40,3,4,0,4,0,2,0,1,"https://fbref.com/en/players/b19db005/Ousmane-Dembele"
2020,"Barcelona","La Liga","Ansu Fati","ESP","FW","16",2002,11.4,16,8,4,7,5,5,15,33.3,10,14,1,13,8,24,3,0,"https://fbref.com/en/players/0ba976e4/Ansu-Fati"
2020,"Barcelona","La Liga","Junior Firpo","ESP","DF","22",1996,11.3,23,15,12,8,3,11,17,64.7,6,15,3,12,17,40,12,1,"https://fbref.com/en/players/24f59bb2/Junior-Firpo"
2020,"Barcelona","La Liga","Antoine Griezmann","FRA","FW","28",1991,28.3,33,18,12,11,10,9,34,26.5,25,22,3,19,12,45,20,1,"https://fbref.com/en/players/df69b544/Antoine-Griezmann"
2020,"Barcelona","La Liga","Frenkie de Jong","NED","MF","22",1997,23.5,26,19,7,12,7,7,22,31.8,15,17,7,10,21,47,9,0,"https://fbref.com/en/players/1bacc518/Frenkie-de-Jong"
2020,"Barcelona","La Liga","Clément Lenglet","FRA","DF","24",1995,26.9,44,31,29,15,0,16,32,50,16,29,15,14,35,79,79,1,"https://fbref.com/en/players/4f28a6ff/Clement-Lenglet"
2020,"Barcelona","La Liga","Arthur Melo","BRA","MF","22",1996,13.1,15,10,4,7,4,4,12,33.3,8,9,0,9,4,19,5,2,"https://fbref.com/en/players/48b3dd60/Arthur-Melo"
2020,"Barcelona","La Liga","Lionel Messi","ARG","FW","32",1987,32,21,10,4,7,10,3,21,14.3,18,9,0,9,7,28,1,0,"https://fbref.com/en/players/d70ce98e/Lionel-Messi"
2020,"Barcelona","La Liga","Neto","BRA","GK","30",1989,2,0,0,0,0,0,0,0,NA,0,0,0,0,0,0,1,0,"https://fbref.com/en/players/a9dc785c/Neto"
2020,"Barcelona","La Liga","Carles Pérez","ESP","FW","21",1998,5.3,7,4,2,2,3,3,15,20,12,5,2,3,1,8,1,0,"https://fbref.com/en/players/a8f21b9f/Carles-Perez"
2020,"Barcelona","La Liga","Gerard Piqué","ESP","DF","32",1987,34.4,32,23,20,11,1,16,26,61.5,10,39,24,15,36,68,157,0,"https://fbref.com/en/players/adfc9123/Gerard-Pique"
2020,"Barcelona","La Liga","Riqui Puig","ESP","MF","19",1999,5.7,11,7,1,9,1,5,17,29.4,12,2,0,2,5,16,1,0,"https://fbref.com/en/players/f090a37a/Riqui-Puig"
2020,"Barcelona","La Liga","Rafinha","BRA","FW,MF","26",1993,2.1,3,2,1,1,1,1,2,50,1,0,0,0,1,4,0,0,"https://fbref.com/en/players/0c2ac3cb/Rafinha"
2020,"Barcelona","La Liga","Ivan Rakitić","CRO","MF","31",1988,17.7,27,14,8,15,4,10,28,35.7,18,19,6,13,15,42,18,1,"https://fbref.com/en/players/89f951b5/Ivan-Rakitic"
2020,"Barcelona","La Liga","Sergi Roberto","ESP","DF,MF","27",1992,26,35,22,16,11,8,15,25,60,10,12,3,9,33,68,36,0,"https://fbref.com/en/players/335fa267/Sergi-Roberto"
2020,"Barcelona","La Liga","Nélson Semedo","POR","DF","25",1993,23.3,51,30,27,18,6,21,36,58.3,15,18,3,15,22,73,30,0,"https://fbref.com/en/players/d04b94db/Nelson-Semedo"
2020,"Barcelona","La Liga","Luis Suárez","URU","FW","32",1987,22.2,4,0,0,1,3,2,12,16.7,10,6,1,5,1,5,11,0,"https://fbref.com/en/players/a6154613/Luis-Suarez"
2020,"Barcelona","La Liga","Marc-André ter Stegen","GER","GK","27",1992,36,2,2,2,0,0,2,3,66.7,1,0,0,0,2,4,17,6,"https://fbref.com/en/players/6f51e382/Marc-Andre-ter-Stegen"
2020,"Barcelona","La Liga","Jean-Clair Todibo","FRA","DF","19",1999,0.9,1,0,1,0,0,0,1,0,1,0,0,0,0,1,6,0,"https://fbref.com/en/players/88f130ed/Jean-Clair-Todibo"
2020,"Barcelona","La Liga","Samuel Umtiti","FRA","DF","25",1993,10.5,11,5,5,5,1,5,8,62.5,3,4,2,2,22,33,32,0,"https://fbref.com/en/players/3eed9821/Samuel-Umtiti"
2020,"Barcelona","La Liga","Arturo Vidal","CHI","MF","32",1987,18.6,63,38,22,30,11,24,58,41.4,34,31,7,24,17,80,16,1,"https://fbref.com/en/players/67cdbc0e/Arturo-Vidal"
2020,"Barcelona","La Liga","Moussa Wagué","SEN","DF","20",1998,1,2,1,1,0,1,1,1,100,0,0,0,0,1,3,0,0,"https://fbref.com/en/players/808df563/Moussa-Wague"
2020,"Bayern Munich","Bundesliga","David Alaba","AUT","DF","27",1992,27.8,30,17,14,15,1,16,25,64,9,19,10,9,29,59,40,0,"https://fbref.com/en/players/05439de2/David-Alaba"
2020,"Bayern Munich","Bundesliga","Thiago Alcántara","ESP","MF","28",1991,19.7,45,26,17,23,5,12,33,36.4,21,12,3,9,45,90,13,1,"https://fbref.com/en/players/77e84962/Thiago-Alcantara"
2020,"Bayern Munich","Bundesliga","Oliver Batista-Meier","GER","MF","18",2001,0.1,0,0,0,0,0,0,2,0,2,0,0,0,0,0,0,0,"https://fbref.com/en/players/b7828a08/Oliver-Batista-Meier"
2020,"Bayern Munich","Bundesliga","Jérôme Boateng","GER","DF","30",1988,20,21,14,9,12,0,11,22,50,11,15,11,4,33,54,58,1,"https://fbref.com/en/players/2db2fd7b/Jerome-Boateng"
2020,"Bayern Munich","Bundesliga","Kingsley Coman","FRA","FW,MF","23",1996,16.7,19,11,6,7,6,12,27,44.4,15,9,0,9,4,23,3,0,"https://fbref.com/en/players/042e8a49/Kingsley-Coman"
2020,"Bayern Munich","Bundesliga","Philippe Coutinho","BRA","MF,FW","27",1992,15.7,21,15,1,13,7,2,13,15.4,11,9,2,7,6,27,0,0,"https://fbref.com/en/players/0ef89a37/Philippe-Coutinho"
2020,"Bayern Munich","Bundesliga","Mickaël Cuisance","FRA","MF,FW","19",1999,3.4,2,1,0,2,0,1,9,11.1,8,1,1,0,3,5,0,0,"https://fbref.com/en/players/5722eced/Mickael-Cuisance"
2020,"Bayern Munich","Bundesliga","Leon Dajaku","GER","DF,MF","18",2001,0.1,0,0,0,0,0,0,1,0,1,0,0,0,0,0,0,0,"https://fbref.com/en/players/aeaf1bc1/Leon-Dajaku"
2020,"Bayern Munich","Bundesliga","Alphonso Davies","CAN","DF","18",2000,24.8,70,43,35,24,11,38,58,65.5,20,35,6,29,31,101,51,0,"https://fbref.com/en/players/d781d855/Alphonso-Davies"
2020,"Bayern Munich","Bundesliga","Serge Gnabry","GER","FW,MF","24",1995,24.4,36,16,4,19,13,9,29,31,20,17,0,17,16,52,2,1,"https://fbref.com/en/players/88e357ef/Serge-Gnabry"
2020,"Bayern Munich","Bundesliga","Leon Goretzka","GER","MF","24",1995,16.8,28,15,7,18,3,10,32,31.3,22,18,2,16,24,52,8,0,"https://fbref.com/en/players/cc86b9a3/Leon-Goretzka"
2020,"Bayern Munich","Bundesliga","Lucas Hernández","FRA","DF","23",1996,10.2,18,9,13,3,2,9,15,60,6,6,1,5,15,33,17,0,"https://fbref.com/en/players/c3ee18ef/Lucas-Hernandez"
2020,"Bayern Munich","Bundesliga","Joshua Kimmich","GER","MF,DF","24",1995,31.3,52,29,21,20,11,22,55,40,33,38,9,29,29,81,29,0,"https://fbref.com/en/players/49296448/Joshua-Kimmich"
2020,"Bayern Munich","Bundesliga","Robert Lewandowski","POL","FW","30",1988,30.7,18,9,3,9,6,3,15,20,12,13,1,12,7,25,13,0,"https://fbref.com/en/players/8d78e732/Robert-Lewandowski"
2020,"Bayern Munich","Bundesliga","Javi Martínez","ESP","DF,MF","30",1988,7.5,16,12,9,7,0,9,11,81.8,2,9,8,1,18,34,30,0,"https://fbref.com/en/players/7f97771d/Javi-Martinez"
2020,"Bayern Munich","Bundesliga","Thomas Müller","GER","MF,FW","29",1989,25.1,45,27,7,26,12,22,69,31.9,47,27,3,24,12,57,8,0,"https://fbref.com/en/players/3c6089ab/Thomas-Muller"
2020,"Bayern Munich","Bundesliga","Jamal Musiala","GER","MF","16",2003,0,0,0,0,0,0,0,0,NA,0,0,0,0,0,0,0,0,"https://fbref.com/en/players/2c0558b8/Jamal-Musiala"
2020,"Bayern Munich","Bundesliga","Manuel Neuer","GER","GK","33",1986,33,2,1,1,0,1,2,4,50,2,0,0,0,0,2,15,4,"https://fbref.com/en/players/8778c910/Manuel-Neuer"
2020,"Bayern Munich","Bundesliga","Álvaro Odriozola","ESP","DF","23",1995,1.7,2,2,1,0,1,2,3,66.7,1,1,0,1,1,3,2,0,"https://fbref.com/en/players/1d1691ad/Alvaro-Odriozola"
2020,"Bayern Munich","Bundesliga","Kwasi Okyere Wriedt","GHA","FW","25",1994,0.2,0,0,0,0,0,0,0,NA,0,0,0,0,0,0,0,0,"https://fbref.com/en/players/7124239e/Kwasi-Okyere-Wriedt"
2020,"Bayern Munich","Bundesliga","Benjamin Pavard","FRA","DF","23",1996,31,34,22,15,10,9,16,28,57.1,12,28,10,18,52,86,60,0,"https://fbref.com/en/players/45a03961/Benjamin-Pavard"
2020,"Bayern Munich","Bundesliga","Ivan Perišić","CRO","FW,MF","30",1989,13.4,16,12,5,6,5,8,33,24.2,25,14,3,11,4,20,8,0,"https://fbref.com/en/players/6fe90922/Ivan-Perisic"
2020,"Bayern Munich","Bundesliga","Chris Richards","USA","DF","19",2000,0.1,0,0,0,0,0,0,0,NA,0,0,0,0,0,0,1,0,"https://fbref.com/en/players/0a3d6d2b/Chris-Richards"
2020,"Bayern Munich","Bundesliga","Renato Sanches","POR","MF","21",1997,0.1,0,0,0,0,0,0,0,NA,0,0,0,0,0,0,0,0,"https://fbref.com/en/players/032f894e/Renato-Sanches"
2020,"Bayern Munich","Bundesliga","Sarpreet Singh","NZL","FW,MF","20",1999,0.8,1,0,0,1,0,0,1,0,1,0,0,0,0,1,0,0,"https://fbref.com/en/players/4ba886c6/Sarpreet-Singh"
2020,"Bayern Munich","Bundesliga","Niklas Süle","GER","DF","23",1995,7.1,10,6,8,2,0,4,5,80,1,8,6,2,8,18,22,1,"https://fbref.com/en/players/e33c06cf/Niklas-Sule"
2020,"Bayern Munich","Bundesliga","Corentin Tolisso","FRA","MF","24",1994,7.1,9,4,4,3,2,1,9,11.1,8,9,3,6,4,13,2,1,"https://fbref.com/en/players/652d4c37/Corentin-Tolisso"
2020,"Bayern Munich","Bundesliga","Sven Ulreich","GER","GK","30",1988,1,0,0,0,0,0,0,0,NA,0,0,0,0,0,0,0,0,"https://fbref.com/en/players/7d3e7da6/Sven-Ulreich"
2020,"Bayern Munich","Bundesliga","Joshua Zirkzee","NED","FW","18",2001,3.3,5,2,0,2,3,2,4,50,2,2,0,2,1,6,0,0,"https://fbref.com/en/players/028e70b9/Joshua-Zirkzee"
2020,"Betis","La Liga","Carles Aleñá","ESP","MF,FW","21",1998,8.2,14,9,5,7,2,3,17,17.6,14,4,1,3,1,15,3,0,"https://fbref.com/en/players/6c811eb7/Carles-Alena"
2020,"Betis","La Liga","Antonio Barragán","ESP","DF","32",1987,7.1,7,5,4,2,1,3,6,50,3,2,2,0,8,15,22,0,"https://fbref.com/en/players/487d9b09/Antonio-Barragan"
2020,"Betis","La Liga","Marc Bartra","ESP","DF,MF","28",1991,28,62,34,39,23,0,27,54,50,27,45,24,21,35,97,127,0,"https://fbref.com/en/players/b742cc0d/Marc-Bartra"
2020,"Betis","La Liga","Sergio Canales","ESP","MF,FW","28",1991,35.1,25,16,14,6,5,7,28,25,21,30,1,29,13,38,16,0,"https://fbref.com/en/players/a6de370d/Sergio-Canales"
2020,"Betis","La Liga","William Carvalho","POR","MF","27",1992,9.9,7,4,4,2,1,4,14,28.6,10,7,5,2,4,11,8,1,"https://fbref.com/en/players/dee86451/William-Carvalho"
2020,"Betis","La Liga","Emerson","BRA","DF","20",1999,31.5,74,46,49,19,6,36,79,45.6,43,30,9,21,31,105,57,1,"https://fbref.com/en/players/df8b52a5/Emerson"
2020,"Betis","La Liga","Zouhair Feddal","MAR","DF","30",1989,15.9,20,13,14,5,1,10,14,71.4,4,15,9,6,23,43,74,0,"https://fbref.com/en/players/89151b16/Zouhair-Feddal"
2020,"Betis","La Liga","Nabil Fekir","FRA","MF,FW","26",1993,29.3,41,26,14,19,8,12,37,32.4,25,27,3,24,10,51,3,0,"https://fbref.com/en/players/bece776f/Nabil-Fekir"
2020,"Betis","La Liga","Javi García","ESP","MF","32",1987,4.2,2,2,2,0,0,2,3,66.7,1,1,0,1,4,6,15,0,"https://fbref.com/en/players/167c1bb0/Javi-Garcia"
2020,"Betis","La Liga","Édgar González","ESP","MF","22",1997,7.6,8,3,3,5,0,2,14,14.3,12,4,2,2,10,18,16,0,"https://fbref.com/en/players/49d028db/Edgar-Gonzalez"
2020,"Betis","La Liga","Andrés Guardado","MEX","MF","32",1986,22.7,30,14,15,11,4,15,41,36.6,26,15,4,11,18,48,22,1,"https://fbref.com/en/players/ef322658/Andres-Guardado"
2020,"Betis","La Liga","Borja Iglesias","ESP","FW","26",1993,21.4,7,5,1,4,2,0,9,0,9,7,4,3,5,12,18,0,"https://fbref.com/en/players/75645f0e/Borja-Iglesias"
2020,"Betis","La Liga","Ismael","ESP","MF","18",2000,0.9,2,1,1,1,0,1,2,50,1,2,1,1,2,4,2,0,"https://fbref.com/en/players/19cdceb0/Ismael"
2020,"Betis","La Liga","Joaquín","ESP","MF,FW","38",1981,22.9,14,7,4,8,2,4,11,36.4,7,10,2,8,15,29,22,1,"https://fbref.com/en/players/4c5b14d2/Joaquin"
2020,"Betis","La Liga","Juanmi","ESP","FW,MF","26",1993,2.9,4,1,1,2,1,1,4,25,3,1,0,1,0,4,0,0,"https://fbref.com/en/players/84399660/Juanmi"
2020,"Betis","La Liga","Wilfrid Kaptoum","CMR","MF","23",1996,2.2,5,2,3,2,0,3,3,100,0,4,1,3,1,6,3,0,"https://fbref.com/en/players/d717630e/Wilfrid-Kaptoum"
2020,"Betis","La Liga","Diego Lainez","MEX","MF,FW","19",2000,3.9,6,5,2,4,0,5,8,62.5,3,6,0,6,1,7,1,0,"https://fbref.com/en/players/bf12926c/Diego-Lainez"
2020,"Betis","La Liga","Aïssa Mandi","ALG","DF","27",1991,28.6,33,15,22,8,3,18,28,64.3,10,29,15,14,38,71,93,0,"https://fbref.com/en/players/fbd6378b/Aissa-Mandi"
2020,"Betis","La Liga","Daniel Martín","ESP","GK","21",1998,5.9,0,0,0,0,0,0,0,NA,0,0,0,0,0,0,3,0,"https://fbref.com/en/players/4df0dff8/Daniel-Martin"
2020,"Betis","La Liga","Álex Moreno","ESP","DF","26",1993,25.2,37,20,27,8,2,12,32,37.5,20,21,8,13,23,60,47,1,"https://fbref.com/en/players/16e9d0ea/Alex-Moreno"
2020,"Betis","La Liga","Loren Morón","ESP","FW","25",1993,22.6,18,12,6,7,5,9,23,39.1,14,25,6,19,9,27,13,0,"https://fbref.com/en/players/3aa4a3be/Loren-Moron"
2020,"Betis","La Liga","Alfonso Pedraza","ESP","DF","23",1996,15,30,19,16,11,3,19,33,57.6,14,18,6,12,16,46,26,1,"https://fbref.com/en/players/63f04c6c/Alfonso-Pedraza"
2020,"Betis","La Liga","Raúl","ESP","FW,MF","18",2000,0.2,0,0,0,0,0,0,2,0,2,0,0,0,0,0,0,0,"https://fbref.com/en/players/18f0a9f0/Raul"
2020,"Betis","La Liga","Joel Robles","ESP","GK","29",1990,32.1,0,0,0,0,0,0,2,0,2,0,0,0,0,0,13,2,"https://fbref.com/en/players/cda0b317/Joel-Robles"
2020,"Betis","La Liga","Guido Rodríguez","ARG","MF","25",1994,10.4,24,16,11,11,2,15,25,60,10,13,4,9,10,34,21,0,"https://fbref.com/en/players/34e393f2/Guido-Rodriguez"
2020,"Betis","La Liga","Sidnei","BRA","DF","29",1989,13.1,23,19,17,6,0,9,14,64.3,5,15,12,3,21,44,57,0,"https://fbref.com/en/players/b14d0c5d/Sidnei"
2020,"Betis","La Liga","Cristian Tello","ESP","MF,FW","27",1991,8.7,8,5,2,2,4,4,8,50,4,5,0,5,4,12,0,0,"https://fbref.com/en/players/72a99e38/Cristian-Tello"
2020,"Bologna","Serie A","Mattia Bani","ITA","DF","25",1993,24.5,47,28,27,19,1,25,36,69.4,11,29,15,14,52,99,92,2,"https://fbref.com/en/players/0821331c/Mattia-Bani"
2020,"Bologna","Serie A","Musa Barrow","GAM","FW,MF","20",1998,15,20,13,11,7,2,6,20,30,14,15,0,15,5,25,11,0,"https://fbref.com/en/players/e5bf73f3/Musa-Barrow"
2020,"Bologna","Serie A","Federico Bonini","ITA","DF","17",2001,0.1,0,0,0,0,0,0,0,NA,0,0,0,0,0,0,0,0,"https://fbref.com/en/players/f8f0744b/Federico-Bonini"
2020,"Bologna","Serie A","Gianmarco Cangiano","ITA","FW,MF","17",2001,0.2,1,1,0,1,0,0,0,NA,0,0,0,0,1,2,0,0,"https://fbref.com/en/players/a36084cd/Gianmarco-Cangiano"
2020,"Bologna","Serie A","Gabriele Corbo","ITA","DF","19",2000,1.4,1,1,1,0,0,0,3,0,3,2,2,0,4,5,5,0,"https://fbref.com/en/players/091795f2/Gabriele-Corbo"
2020,"Bologna","Serie A","Angelo da Costa Júnior","BRA","GK","35",1983,1,0,0,0,0,0,0,0,NA,0,0,0,0,0,0,0,0,"https://fbref.com/en/players/18736214/Angelo-da-Costa-Junior"
2020,"Bologna","Serie A","Stefano Denswil","NED","DF","26",1993,24.9,49,28,29,19,1,26,44,59.1,18,23,8,15,31,80,68,0,"https://fbref.com/en/players/5832ebfe/Stefano-Denswil"
2020,"Bologna","Serie A","Mattia Destro","ITA","FW","28",1991,2.1,3,2,1,2,0,1,3,33.3,2,1,0,1,0,3,0,0,"https://fbref.com/en/players/d7d32194/Mattia-Destro"
2020,"Bologna","Serie A","Mitchell Dijks","NED","DF","26",1993,11.2,13,10,6,5,2,8,12,66.7,4,5,1,4,10,23,23,0,"https://fbref.com/en/players/0a3065c8/Mitchell-Dijks"
2020,"Bologna","Serie A","Nicolás Domínguez","ARG","MF","21",1998,7.8,21,14,15,5,1,7,18,38.9,11,12,2,10,12,33,7,0,"https://fbref.com/en/players/20b3a502/Nicolas-Dominguez"
2020,"Bologna","Serie A","Blerim Džemaili","SUI","MF","33",1986,7.8,19,12,3,13,3,4,22,18.2,18,9,3,6,7,26,6,0,"https://fbref.com/en/players/756959aa/Blerim-Dzemaili"
2020,"Bologna","Serie A","Andri Fannar Baldursson","ISL","MF","17",2002,1.6,1,0,0,1,0,0,1,0,1,2,0,2,1,2,3,0,"https://fbref.com/en/players/61f2f56a/Andri-Fannar-Baldursson"
2020,"Bologna","Serie A","Musa Juwara","GAM","FW,MF","17",2001,1.7,4,2,1,1,2,1,5,20,4,2,1,1,0,4,1,0,"https://fbref.com/en/players/7737dee2/Musa-Juwara"
2020,"Bologna","Serie A","Ladislav Krejčí","CZE","DF","27",1992,11.7,15,10,6,7,2,9,19,47.4,10,7,4,3,10,25,23,0,"https://fbref.com/en/players/58027adc/Ladislav-Krejci"
2020,"Bologna","Serie A","Danilo Larangeira","BRA","DF","35",1984,29.3,34,17,19,15,0,16,28,57.1,12,54,39,15,30,64,99,0,"https://fbref.com/en/players/fed5f993/Danilo-Larangeira"
2020,"Bologna","Serie A","Ibrahima Mbaye","SEN","DF","24",1994,16.7,19,10,13,4,2,7,17,41.2,10,22,11,11,15,34,42,0,"https://fbref.com/en/players/cfbf9881/Ibrahima-Mbaye"
2020,"Bologna","Serie A","Gary Medel","CHI","MF","31",1987,19.8,43,22,15,24,4,16,43,37.2,27,24,8,16,34,77,31,2,"https://fbref.com/en/players/563a68ad/Gary-Medel"
2020,"Bologna","Serie A","Kingsley Michael","NGA","MF","19",1999,0.8,2,1,0,2,0,0,0,NA,0,0,0,0,1,3,1,0,"https://fbref.com/en/players/e63e122d/Kingsley-Michael"
2020,"Bologna","Serie A","Riccardo Orsolini","ITA","FW,MF","22",1997,29.8,36,22,21,10,5,12,47,25.5,35,23,1,22,16,52,20,0,"https://fbref.com/en/players/e14ec482/Riccardo-Orsolini"
2020,"Bologna","Serie A","Rodrigo Palacio","ARG","FW","37",1982,28,19,11,0,9,10,4,27,14.8,23,17,3,14,5,24,38,2,"https://fbref.com/en/players/8d8178ac/Rodrigo-Palacio"
2020,"Bologna","Serie A","Nehuén Paz","ARG","DF","26",1993,1.3,1,1,0,1,0,0,2,0,2,3,3,0,5,6,12,0,"https://fbref.com/en/players/42b1a58a/Nehuen-Paz"
2020,"Bologna","Serie A","Andrea Poli","ITA","MF","29",1989,21.3,44,24,19,21,4,16,52,30.8,36,19,3,16,40,84,11,0,"https://fbref.com/en/players/b3fd7075/Andrea-Poli"
2020,"Bologna","Serie A","Dion Ruffo Luci","ITA","MF","18",2001,0,0,0,0,0,0,0,0,NA,0,0,0,0,0,0,0,0,"https://fbref.com/en/players/f239e6dd/Dion-Ruffo-Luci"
2020,"Bologna","Serie A","Nicola Sansone","ITA","FW,MF","27",1991,25.2,34,20,12,18,4,15,59,25.4,44,21,0,21,11,45,9,0,"https://fbref.com/en/players/7eb97a8e/Nicola-Sansone"
2020,"Bologna","Serie A","Federico Santander","PAR","FW","28",1991,8.6,13,8,3,0,10,1,4,25,3,3,0,3,7,20,12,0,"https://fbref.com/en/players/df85d472/Federico-Santander"
2020,"Bologna","Serie A","Jerdy Schouten","NED","MF","22",1997,12,26,16,13,11,2,10,26,38.5,16,19,7,12,26,52,22,0,"https://fbref.com/en/players/2cfae697/Jerdy-Schouten"
2020,"Bologna","Serie A","Łukasz Skorupski","POL","GK","28",1991,37,1,0,1,0,0,0,1,0,1,0,0,0,2,3,15,5,"https://fbref.com/en/players/ab4449d6/Lukasz-Skorupski"
2020,"Bologna","Serie A","Andreas Skov Olsen","DEN","FW,MF","19",1999,8.4,11,8,5,5,1,4,12,33.3,8,10,1,9,8,19,5,0,"https://fbref.com/en/players/c50cee19/Andreas-Skov-Olsen"
2020,"Bologna","Serie A","Roberto Soriano","ITA","MF","28",1991,27.4,43,25,15,21,7,10,46,21.7,36,19,0,19,17,60,23,1,"https://fbref.com/en/players/9d4c45d6/Roberto-Soriano"
2020,"Bologna","Serie A","Mattias Svanberg","SWE","MF","20",1999,11.7,13,8,9,4,0,6,31,19.4,25,15,4,11,13,26,10,0,"https://fbref.com/en/players/92d83c27/Mattias-Svanberg"
2020,"Bologna","Serie A","Takehiro Tomiyasu","JPN","DF","20",1998,28.1,42,24,25,13,4,22,41,53.7,19,34,9,25,49,91,78,1,"https://fbref.com/en/players/b3af9be1/Takehiro-Tomiyasu"
2020,"Bordeaux","Ligue 1","Yacine Adli","FRA","MF","19",2000,11.3,22,14,4,15,3,11,34,32.4,23,10,0,10,8,30,3,0,"https://fbref.com/en/players/26777636/Yacine-Adli"
2020,"Bordeaux","Ligue 1","Youssef Aït Bennasser","MAR","MF","23",1996,6,11,8,6,4,1,4,24,16.7,20,6,1,5,4,15,10,1,"https://fbref.com/en/players/c46fa34c/Youssef-Ait-Bennasser"
2020,"Bordeaux","Ligue 1","Toma Bašić","CRO","MF","22",1996,11,26,22,9,16,1,12,27,44.4,15,14,2,12,9,35,12,1,"https://fbref.com/en/players/80556f08/Toma-Basic"
2020,"Bordeaux","Ligue 1","Raoul Bellanova","ITA","DF","19",2000,0.7,1,1,1,0,0,0,1,0,1,0,0,0,0,1,0,0,"https://fbref.com/en/players/e3756e72/Raoul-Bellanova"
2020,"Bordeaux","Ligue 1","Loris Benito","SUI","DF","27",1992,21.1,40,25,23,11,6,16,43,37.2,27,14,5,9,29,69,58,1,"https://fbref.com/en/players/f5b6fb78/Loris-Benito"
2020,"Bordeaux","Ligue 1","Yassine Benrahou","FRA","FW,MF","20",1999,1.9,3,0,1,1,1,2,5,40,3,1,0,1,2,5,1,0,"https://fbref.com/en/players/fbf76716/Yassine-Benrahou"
2020,"Bordeaux","Ligue 1","Jimmy Briand","FRA","FW","33",1985,16.9,12,8,5,4,3,3,13,23.1,10,8,4,4,6,18,12,0,"https://fbref.com/en/players/f83c8d6c/Jimmy-Briand"
2020,"Bordeaux","Ligue 1","Jonathan Cafu","BRA","DF","28",1991,2.2,7,3,4,3,0,4,7,57.1,3,1,0,1,1,8,3,0,"https://fbref.com/en/players/8d043f1d/Jonathan-Cafu"
2020,"Bordeaux","Ligue 1","Benoît Costil","FRA","GK","32",1987,28,0,0,0,0,0,0,3,0,3,0,0,0,2,2,9,0,"https://fbref.com/en/players/2434f24a/Benoit-Costil"
2020,"Bordeaux","Ligue 1","Vukašin Jovanović","SRB","DF","23",1996,6.4,18,11,12,6,0,14,21,66.7,7,5,3,2,15,33,15,0,"https://fbref.com/en/players/0eb03d5b/Vukasin-Jovanovic"
2020,"Bordeaux","Ligue 1","Samuel Kalu","NGA","DF,FW","21",1997,15.1,33,17,19,12,2,16,36,44.4,20,13,1,12,24,57,10,0,"https://fbref.com/en/players/b8d22478/Samuel-Kalu"
2020,"Bordeaux","Ligue 1","François Kamano","GUI","DF,MF","23",1996,7.2,12,6,5,4,3,8,15,53.3,7,5,0,5,3,15,2,0,"https://fbref.com/en/players/81d3318f/Francois-Kamano"
2020,"Bordeaux","Ligue 1","Laurent Koscielny","FRA","DF","33",1985,24.3,28,13,24,4,0,10,20,50,10,23,19,4,26,54,104,0,"https://fbref.com/en/players/f5efb153/Laurent-Koscielny"
2020,"Bordeaux","Ligue 1","Enock Kwateng","FRA","DF","22",1997,10.9,36,22,17,17,2,22,47,46.8,25,16,6,10,22,58,41,0,"https://fbref.com/en/players/4bf69118/Enock-Kwateng"
2020,"Bordeaux","Ligue 1","Albert Lottin","FRA","MF","17",2001,0.5,2,0,2,0,0,1,4,25,3,0,0,0,2,4,2,0,"https://fbref.com/en/players/934a0957/Albert-Lottin"
2020,"Bordeaux","Ligue 1","Josh Maja","NGA","FW","20",1998,8.2,5,2,0,2,3,1,10,10,9,8,4,4,1,6,3,0,"https://fbref.com/en/players/bc0bfc64/Josh-Maja"
2020,"Bordeaux","Ligue 1","Mexer","MOZ","DF","30",1988,16.5,16,11,14,1,1,10,30,33.3,20,14,13,1,15,31,47,0,"https://fbref.com/en/players/ce492295/Mexer"
2020,"Bordeaux","Ligue 1","Otávio","BRA","MF","25",1994,24.6,80,45,23,52,5,35,82,42.7,47,26,9,17,41,121,40,6,"https://fbref.com/en/players/243f4a0b/Otavio"
2020,"Bordeaux","Ligue 1","Remi Oudin","FRA","FW,MF","22",1996,6.2,9,6,4,4,1,4,14,28.6,10,7,1,6,9,18,5,0,"https://fbref.com/en/players/ea02beaf/Remi-Oudin"
2020,"Bordeaux","Ligue 1","Pablo","BRA","DF","28",1991,24.1,27,15,22,5,0,16,31,51.6,15,25,14,11,40,67,130,2,"https://fbref.com/en/players/29d8ad3f/Pablo"
2020,"Bordeaux","Ligue 1","Rubén Pardo","ESP","MF","26",1992,2.1,3,2,2,1,0,2,3,66.7,1,0,0,0,1,4,2,1,"https://fbref.com/en/players/2306bfde/Ruben-Pardo"
2020,"Bordeaux","Ligue 1","Maxime Poundjé","FRA","DF","26",1992,0,0,0,0,0,0,0,0,NA,0,0,0,0,0,0,0,0,"https://fbref.com/en/players/b92edde2/Maxime-Poundje"
2020,"Bordeaux","Ligue 1","Nicolas de Préville","FRA","MF,FW","28",1991,22.2,35,21,9,22,4,18,56,32.1,38,15,3,12,6,41,19,0,"https://fbref.com/en/players/b0547a87/Nicolas-de-Preville"
2020,"Bordeaux","Ligue 1","Youssouf Sabaly","SEN","DF","26",1993,10.1,18,11,9,4,5,6,22,27.3,16,8,1,7,18,36,23,0,"https://fbref.com/en/players/fbbb9269/Youssouf-Sabaly"
2020,"Bordeaux","Ligue 1","Aurélien Tchouaméni","FRA","MF","19",2000,12.3,30,14,15,13,2,11,27,40.7,16,11,3,8,13,43,19,1,"https://fbref.com/en/players/4f255115/Aurelien-Tchouameni"
2020,"Bordeaux","Ligue 1","Hwang Ui-jo","KOR","FW,MF","26",1992,18.1,9,7,2,5,2,4,20,20,16,7,0,7,5,14,5,0,"https://fbref.com/en/players/a2d873dd/Hwang-Ui-jo"
2020,"Bournemouth","Premier League","Nathan Aké","NED","DF","24",1995,27.8,31,21,23,8,0,14,23,60.9,9,40,29,11,36,67,152,0,"https://fbref.com/en/players/eaeca114/Nathan-Ake"
2020,"Bournemouth","Premier League","Philip Billing","DEN","MF","23",1996,28.1,72,46,30,37,5,17,65,26.2,48,59,16,43,66,138,97,1,"https://fbref.com/en/players/d328a254/Philip-Billing"
2020,"Bournemouth","Premier League","David Brooks","WAL","MF,FW","22",1997,5.6,5,5,1,2,2,2,14,14.3,12,5,1,4,2,7,1,0,"https://fbref.com/en/players/dc4cae05/David-Brooks"
2020,"Bournemouth","Premier League","Lewis Cook","ENG","MF,FW","22",1997,15,27,14,15,9,3,10,47,21.3,37,17,5,12,17,44,17,1,"https://fbref.com/en/players/2afc7272/Lewis-Cook"
2020,"Bournemouth","Premier League","Steve Cook","ENG","DF","28",1991,27,22,11,18,4,0,8,20,40,12,32,23,9,44,66,153,1,"https://fbref.com/en/players/3e5e4e63/Steve-Cook"
2020,"Bournemouth","Premier League","Charlie Daniels","ENG","DF","32",1986,1.4,1,1,0,1,0,0,1,0,1,2,0,2,1,2,5,1,"https://fbref.com/en/players/9d107085/Charlie-Daniels"
2020,"Bournemouth","Premier League","Arnaut Danjuma","NED","MF","22",1997,7,4,2,3,1,0,1,4,25,3,2,0,2,8,12,4,1,"https://fbref.com/en/players/f08490a6/Arnaut-Danjuma"
2020,"Bournemouth","Premier League","Simon Francis","ENG","DF","34",1985,10.8,13,9,11,2,0,11,21,52.4,10,17,12,5,20,33,71,0,"https://fbref.com/en/players/1e0b6a73/Simon-Francis"
2020,"Bournemouth","Premier League","Ryan Fraser","SCO","MF,FW","25",1994,23,12,6,5,5,2,7,22,31.8,15,15,3,12,15,27,24,0,"https://fbref.com/en/players/d56543a0/Ryan-Fraser"
2020,"Bournemouth","Premier League","Dan Gosling","ENG","MF","29",1990,14,26,10,14,9,3,6,27,22.2,21,31,11,20,20,46,26,0,"https://fbref.com/en/players/7fec31a0/Dan-Gosling"
2020,"Bournemouth","Premier League","Jordon Ibe","ENG","DF","23",1995,0.6,2,2,2,0,0,1,1,100,0,0,0,0,0,2,1,0,"https://fbref.com/en/players/9f736ed2/Jordon-Ibe"
2020,"Bournemouth","Premier League","Lloyd Kelly","ENG","DF","20",1998,7.1,7,3,3,4,0,6,7,85.7,1,9,5,4,6,13,15,1,"https://fbref.com/en/players/f31def1e/Lloyd-Kelly"
2020,"Bournemouth","Premier League","Joshua King","NOR","FW,MF","27",1992,22.3,16,6,4,8,4,4,16,25,12,20,3,17,8,24,9,0,"https://fbref.com/en/players/43458538/Joshua-King"
2020,"Bournemouth","Premier League","Jefferson Lerma","COL","MF","24",1994,30,54,32,17,31,6,22,48,45.8,26,28,12,16,57,111,54,1,"https://fbref.com/en/players/9b5ce51a/Jefferson-Lerma"
2020,"Bournemouth","Premier League","Chris Mepham","WAL","DF","21",1997,10.1,20,9,13,7,0,11,14,78.6,3,17,11,6,17,37,62,1,"https://fbref.com/en/players/fed96827/Chris-Mepham"
2020,"Bournemouth","Premier League","Aaron Ramsdale","ENG","GK","21",1998,37,4,3,4,0,0,3,3,100,0,0,0,0,0,4,25,1,"https://fbref.com/en/players/466fb2c5/Aaron-Ramsdale"
2020,"Bournemouth","Premier League","Diego Rico","ESP","DF","26",1993,25.9,61,39,32,24,5,29,59,49.2,30,31,7,24,84,145,91,0,"https://fbref.com/en/players/d9ba39fc/Diego-Rico"
2020,"Bournemouth","Premier League","Jack Simpson","ENG","DF","22",1996,2.7,5,2,4,1,0,2,8,25,6,1,0,1,2,7,12,1,"https://fbref.com/en/players/76fa5f80/Jack-Simpson"
2020,"Bournemouth","Premier League","Adam Smith","ENG","DF","28",1991,22.8,47,32,29,16,2,23,50,46,27,27,6,21,25,72,64,1,"https://fbref.com/en/players/20b104bc/Adam-Smith"
2020,"Bournemouth","Premier League","Dominic Solanke","ENG","FW","21",1997,18.3,8,4,2,5,1,5,33,15.2,28,9,1,8,8,16,18,1,"https://fbref.com/en/players/e77dc3b2/Dominic-Solanke"
2020,"Bournemouth","Premier League","Jack Stacey","ENG","DF","23",1996,17.2,21,11,9,11,1,8,22,36.4,14,27,11,16,18,39,64,1,"https://fbref.com/en/players/558807c0/Jack-Stacey"
2020,"Bournemouth","Premier League","Junior Stanislas","ENG","MF,FW","29",1989,7.9,10,7,2,3,5,3,8,37.5,5,6,0,6,4,14,6,0,"https://fbref.com/en/players/6992791d/Junior-Stanislas"
2020,"Bournemouth","Premier League","Andrew Surman","ENG","MF","32",1986,2.6,4,2,2,2,0,1,3,33.3,2,1,0,1,1,5,5,1,"https://fbref.com/en/players/7d41b619/Andrew-Surman"
2020,"Bournemouth","Premier League","Sam Surridge","ENG","FW,MF","21",1998,0.3,0,0,0,0,0,0,0,NA,0,1,0,1,1,1,0,0,"https://fbref.com/en/players/b017b770/Sam-Surridge"
2020,"Bournemouth","Premier League","Mark Travers","IRL","GK","20",1999,1,0,0,0,0,0,0,0,NA,0,0,0,0,0,0,1,1,"https://fbref.com/en/players/fe558029/Mark-Travers"
2020,"Bournemouth","Premier League","Callum Wilson","ENG","FW","27",1992,32.3,12,9,3,6,3,2,17,11.8,15,16,2,14,4,16,16,0,"https://fbref.com/en/players/c596fcb0/Callum-Wilson"
2020,"Bournemouth","Premier League","Harry Wilson","WAL","MF,FW","22",1997,18.3,23,13,8,10,5,11,34,32.4,23,26,2,24,11,34,15,1,"https://fbref.com/en/players/c6dc9ecd/Harry-Wilson"
2020,"Brescia","Serie A","Enrico Alfonso","ITA","GK","31",1988,3.1,0,0,0,0,0,0,0,NA,0,0,0,0,0,0,2,0,"https://fbref.com/en/players/95adf1e1/Enrico-Alfonso"
2020,"Brescia","Serie A","Lorenzo Andrenacci","ITA","GK","24",1995,5.9,1,0,1,0,0,1,3,33.3,2,0,0,0,0,1,0,0,"https://fbref.com/en/players/fe471a89/Lorenzo-Andrenacci"
2020,"Brescia","Serie A","Florian Ayé","FRA","FW,MF","22",1997,15.3,17,9,9,5,3,6,13,46.2,7,17,2,15,4,21,18,1,"https://fbref.com/en/players/718b8afd/Florian-Aye"
2020,"Brescia","Serie A","Mario Balotelli","ITA","FW","28",1990,15.6,2,2,0,2,0,0,2,0,2,1,1,0,8,10,22,0,"https://fbref.com/en/players/8ff07990/Mario-Balotelli"
2020,"Brescia","Serie A","Dimitri Bisoli","ITA","MF","25",1994,23.9,64,35,34,20,10,30,49,61.2,19,41,7,34,25,89,49,0,"https://fbref.com/en/players/16569fef/Dimitri-Bisoli"
2020,"Brescia","Serie A","Birkir Bjarnason","ISL","MF,FW","31",1988,8.9,5,3,1,3,1,2,13,15.4,11,9,4,5,5,10,4,0,"https://fbref.com/en/players/da13074e/Birkir-Bjarnason"
2020,"Brescia","Serie A","Jhon Chancellor","VEN","DF","27",1992,24.9,30,14,22,8,0,11,22,50,11,34,29,5,34,64,145,3,"https://fbref.com/en/players/84b6acaa/Jhon-Chancellor"
2020,"Brescia","Serie A","Andrea Cistana","ITA","DF","22",1997,20.4,20,8,13,7,0,6,17,35.3,11,38,34,4,33,53,96,1,"https://fbref.com/en/players/fe6a7685/Andrea-Cistana"
2020,"Brescia","Serie A","Felipe Curcio","BRA","DF","25",1993,0.1,0,0,0,0,0,0,0,NA,0,0,0,0,0,0,0,0,"https://fbref.com/en/players/8913a9f9/Felipe-Curcio"
2020,"Brescia","Serie A","Daniele Dessena","ITA","MF","32",1987,20.8,21,11,5,14,2,6,25,24,19,11,1,10,11,32,21,0,"https://fbref.com/en/players/02b2937c/Daniele-Dessena"
2020,"Brescia","Serie A","Alfredo Donnarumma","ITA","FW","28",1990,18.7,17,9,3,9,5,6,18,33.3,12,7,0,7,5,22,1,0,"https://fbref.com/en/players/5592007b/Alfredo-Donnarumma"
2020,"Brescia","Serie A","Daniele Gastaldello","ITA","DF","36",1983,4.3,8,5,5,3,0,2,3,66.7,1,6,3,3,5,13,29,1,"https://fbref.com/en/players/13f89eaa/Daniele-Gastaldello"
2020,"Brescia","Serie A","Andrea Ghezzi","ITA","FW,MF","18",2001,0.4,2,0,0,1,1,1,1,100,0,0,0,0,0,2,0,0,"https://fbref.com/en/players/c840baa2/Andrea-Ghezzi"
2020,"Brescia","Serie A","Jesse Joronen","FIN","GK","26",1993,29,3,1,3,0,0,3,3,100,0,0,0,0,6,9,22,0,"https://fbref.com/en/players/7f66ea09/Jesse-Joronen"
2020,"Brescia","Serie A","Giangiacomo Magnani","ITA","DF","23",1995,1.3,0,0,0,0,0,0,1,0,1,2,2,0,2,2,6,0,"https://fbref.com/en/players/cce9f582/Giangiacomo-Magnani"
2020,"Brescia","Serie A","Massimiliano Mangraviti","ITA","DF","21",1998,10.8,8,6,1,6,1,3,6,50,3,11,6,5,8,16,43,0,"https://fbref.com/en/players/33914f14/Massimiliano-Mangraviti"
2020,"Brescia","Serie A","Bruno Martella","ITA","DF","26",1992,14.1,18,9,14,3,1,9,16,56.3,7,13,7,6,17,35,48,1,"https://fbref.com/en/players/1e12c53b/Bruno-Martella"
2020,"Brescia","Serie A","Aleš Matějů","CZE","DF","23",1996,28.3,48,27,33,9,6,23,45,51.1,22,41,24,17,37,85,109,3,"https://fbref.com/en/players/deb748c9/Ales-Mateju"
2020,"Brescia","Serie A","Alessandro Matri","ITA","FW,MF","34",1984,1,1,0,0,0,1,0,0,NA,0,1,0,1,0,1,1,0,"https://fbref.com/en/players/58d97e77/Alessandro-Matri"
2020,"Brescia","Serie A","Leonardo Morosini","ITA","FW,DF","23",1995,0.3,1,1,1,0,0,0,0,NA,0,1,0,1,1,2,1,0,"https://fbref.com/en/players/d89b0ebb/Leonardo-Morosini"
2020,"Brescia","Serie A","Emanuele Ndoj","ALB","MF","22",1996,6.2,9,6,2,6,1,3,13,23.1,10,7,0,7,5,14,5,0,"https://fbref.com/en/players/482145e9/Emanuele-Ndoj"
2020,"Brescia","Serie A","Andrea Papetti","ITA","DF","17",2002,10.2,9,7,8,1,0,4,14,28.6,10,15,11,4,15,24,39,0,"https://fbref.com/en/players/4195b8b6/Andrea-Papetti"
2020,"Brescia","Serie A","Rômulo","ITA","MF","32",1987,19.1,30,19,12,14,4,12,34,35.3,22,18,1,17,8,38,12,1,"https://fbref.com/en/players/07abb358/Romulo"
2020,"Brescia","Serie A","Stefano Sabelli","ITA","DF","26",1993,35.2,83,44,51,28,4,50,106,47.2,56,40,13,27,58,141,107,0,"https://fbref.com/en/players/0ccac09c/Stefano-Sabelli"
2020,"Brescia","Serie A","Alessandro Semprini","ITA","DF","21",1998,7,10,4,7,3,0,7,9,77.8,2,10,3,7,9,19,16,0,"https://fbref.com/en/players/dd29f81d/Alessandro-Semprini"
2020,"Brescia","Serie A","Simon Skrabb","FIN","FW,MF","24",1995,2.9,7,6,2,4,1,6,12,50,6,4,1,3,0,7,3,0,"https://fbref.com/en/players/45af5134/Simon-Skrabb"
2020,"Brescia","Serie A","Nikolas Špalek","SVK","MF,FW","22",1997,17.5,24,10,6,11,7,7,31,22.6,24,15,1,14,6,30,10,0,"https://fbref.com/en/players/9e90fb5d/Nikolas-Spalek"
2020,"Brescia","Serie A","Sandro Tonali","ITA","MF","19",2000,33.5,39,25,16,20,3,16,55,29.1,39,36,14,22,41,80,42,0,"https://fbref.com/en/players/0db169ae/Sandro-Tonali"
2020,"Brescia","Serie A","Ernesto Torregrossa","VEN","FW","27",1992,20.5,17,7,5,10,2,6,22,27.3,16,10,2,8,5,22,22,0,"https://fbref.com/en/players/bf39bdec/Ernesto-Torregrossa"
2020,"Brescia","Serie A","Luca Tremolada","ITA","MF","27",1991,0.2,0,0,0,0,0,0,0,NA,0,0,0,0,0,0,0,0,"https://fbref.com/en/players/ed65da8c/Luca-Tremolada"
2020,"Brescia","Serie A","Mattia Viviani","ITA","MF","18",2000,3.8,3,1,0,3,0,1,8,12.5,7,3,3,0,9,12,2,1,"https://fbref.com/en/players/360b2bb1/Mattia-Viviani"
2020,"Brescia","Serie A","Jaromír Zmrhal","CZE","MF","25",1993,12.5,10,4,2,5,3,5,18,27.8,13,8,1,7,4,14,11,0,"https://fbref.com/en/players/cbec1196/Jaromir-Zmrhal"
2020,"Brest","Ligue 1","Mathias Autret","FRA","MF,FW","28",1991,13.6,23,17,5,11,7,8,25,32,17,14,1,13,10,33,3,0,"https://fbref.com/en/players/7dfbba27/Mathias-Autret"
2020,"Brest","Ligue 1","Ludovic Baal","GUF","DF","33",1986,9.2,27,15,13,12,2,10,22,45.5,12,9,3,6,17,44,20,0,"https://fbref.com/en/players/d3ce9f1f/Ludovic-Baal"
2020,"Brest","Ligue 1","Dénys Bain","FRA","DF","26",1993,14.1,21,14,15,6,0,9,9,100,0,13,10,3,28,49,66,0,"https://fbref.com/en/players/5065d67d/Denys-Bain"
2020,"Brest","Ligue 1","Cristian Battocchio","ITA","MF","27",1992,15.5,31,24,13,13,5,14,36,38.9,22,13,4,9,19,50,21,0,"https://fbref.com/en/players/0f9b8301/Cristian-Battocchio"
2020,"Brest","Ligue 1","Gaëtan Belaud","FRA","DF","32",1986,6.4,13,7,10,2,1,4,8,50,4,8,3,5,15,28,15,0,"https://fbref.com/en/players/3f1a7191/Gaetan-Belaud"
2020,"Brest","Ligue 1","Haris Belkebla","ALG","MF","25",1994,20.2,44,24,17,17,10,10,28,35.7,18,25,5,20,53,97,21,2,"https://fbref.com/en/players/2b1bed19/Haris-Belkebla"
2020,"Brest","Ligue 1","Irvin Cardona","FRA","FW,MF","21",1997,16.1,13,8,5,6,2,9,32,28.1,23,8,0,8,1,14,7,0,"https://fbref.com/en/players/5e080f73/Irvin-Cardona"
2020,"Brest","Ligue 1","Jean-Charles Castelletto","CMR","DF","24",1995,20.4,18,9,13,5,0,9,18,50,9,20,16,4,33,51,87,1,"https://fbref.com/en/players/e0f3a1f6/Jean-Charles-Castelletto"
2020,"Brest","Ligue 1","Gaëtan Charbonnier","FRA","FW,MF","30",1988,22.9,36,16,11,11,14,10,35,28.6,25,19,6,13,7,43,33,1,"https://fbref.com/en/players/18ebca4b/Gaetan-Charbonnier"
2020,"Brest","Ligue 1","Brendan Chardonnet","FRA","DF","24",1994,9.1,12,6,10,2,0,7,12,58.3,5,8,5,3,15,27,50,0,"https://fbref.com/en/players/16aa7d4c/Brendan-Chardonnet"
2020,"Brest","Ligue 1","Yoann Court","FRA","FW,MF","29",1990,16.3,48,26,28,17,3,20,64,31.3,44,21,0,21,15,63,14,0,"https://fbref.com/en/players/26e4447b/Yoann-Court"
2020,"Brest","Ligue 1","Ibrahima Diallo","FRA","MF","20",1999,17.3,38,24,15,22,1,12,29,41.4,17,9,2,7,23,61,16,3,"https://fbref.com/en/players/11ff3d56/Ibrahima-Diallo"
2020,"Brest","Ligue 1","Jean-Kevin Duverne","FRA","DF","22",1997,13.1,12,8,5,6,1,2,6,33.3,4,23,8,15,20,32,50,0,"https://fbref.com/en/players/0cbc8baa/Jean-Kevin-Duverne"
2020,"Brest","Ligue 1","Julien Faussurier","FRA","DF","32",1987,22,36,22,23,13,0,21,53,39.6,32,22,7,15,33,69,46,1,"https://fbref.com/en/players/767212e6/Julien-Faussurier"
2020,"Brest","Ligue 1","Samuel Grandsir","FRA","FW,MF","22",1996,16.6,34,22,13,16,5,11,30,36.7,19,9,0,9,14,48,5,0,"https://fbref.com/en/players/d2448564/Samuel-Grandsir"
2020,"Brest","Ligue 1","Gautier Larsonneur","FRA","GK","22",1997,26.6,2,1,2,0,0,2,4,50,2,1,0,1,4,6,14,3,"https://fbref.com/en/players/b49729cb/Gautier-Larsonneur"
2020,"Brest","Ligue 1","Paul Lasne","FRA","MF,FW","30",1989,13.6,25,13,13,11,1,6,20,30,14,7,2,5,7,32,5,0,"https://fbref.com/en/players/542cc80f/Paul-Lasne"
2020,"Brest","Ligue 1","Donovan Léon","GUF","GK","26",1992,1.4,0,0,0,0,0,0,0,NA,0,1,0,1,0,0,0,0,"https://fbref.com/en/players/51c83a90/Donovan-Leon"
2020,"Brest","Ligue 1","Hugo Magnetti","FRA","MF","21",1998,2.6,16,10,7,7,2,5,9,55.6,4,4,0,4,7,23,4,0,"https://fbref.com/en/players/d4d35152/Hugo-Magnetti"
2020,"Brest","Ligue 1","Hianga Mananga Mbock","FRA","MF","19",1999,1.6,1,1,1,0,0,0,0,NA,0,0,0,0,4,5,0,0,"https://fbref.com/en/players/0f86995c/Hianga-Mananga-Mbock"
2020,"Brest","Ligue 1","Kévin Mayi","GAB","FW,MF","26",1993,0,0,0,0,0,0,0,0,NA,0,0,0,0,0,0,0,0,"https://fbref.com/en/players/6a26e528/Kevin-Mayi"
2020,"Brest","Ligue 1","Alexandre Mendy","GNB","FW","25",1994,10,5,1,1,0,4,1,4,25,3,4,1,3,0,5,10,0,"https://fbref.com/en/players/e067808c/Alexandre-Mendy"
2020,"Brest","Ligue 1","Ferris N'Goma","FRA","MF,FW","26",1993,0.3,0,0,0,0,0,0,0,NA,0,1,0,1,0,0,0,0,"https://fbref.com/en/players/2b3d9aad/Ferris-NGoma"
2020,"Brest","Ligue 1","Romain Perraud","FRA","DF","21",1997,18.6,29,14,18,9,2,14,28,50,14,24,9,15,27,56,50,0,"https://fbref.com/en/players/6dfd8f05/Romain-Perraud"
2020,"Brighton","Premier League","Steven Alzate","COL","MF,DF","20",1998,13.2,33,19,20,11,2,17,27,63,10,18,3,15,14,47,13,0,"https://fbref.com/en/players/ad1f61f3/Steven-Alzate"
2020,"Brighton","Premier League","Florin Andone","ROU","FW","26",1993,0.8,1,1,0,1,0,1,1,100,0,1,1,0,0,1,1,0,"https://fbref.com/en/players/dc008610/Florin-Andone"
2020,"Brighton","Premier League","Bernardo","BRA","DF,MF","24",1995,7.5,27,16,12,9,6,13,17,76.5,4,7,3,4,6,33,24,0,"https://fbref.com/en/players/17370b95/Bernardo"
2020,"Brighton","Premier League","Yves Bissouma","MLI","MF","22",1996,14,49,38,24,22,3,17,40,42.5,23,18,2,16,21,70,23,0,"https://fbref.com/en/players/6c203af0/Yves-Bissouma"
2020,"Brighton","Premier League","Gaëtan Bong","CMR","DF,MF","31",1988,0.7,1,0,0,0,1,0,0,NA,0,1,1,0,0,1,0,0,"https://fbref.com/en/players/cfd5e123/Gaetan-Bong"
2020,"Brighton","Premier League","Dan Burn","ENG","DF","27",1992,32,67,42,35,27,5,25,53,47.2,28,44,20,24,42,109,130,0,"https://fbref.com/en/players/b2d31e83/Dan-Burn"
2020,"Brighton","Premier League","Aaron Connolly","IRL","FW","19",2000,14,7,6,1,4,2,3,10,30,7,11,0,11,0,7,3,0,"https://fbref.com/en/players/27c01749/Aaron-Connolly"
2020,"Brighton","Premier League","Shane Duffy","IRL","DF","27",1992,13.8,18,9,14,4,0,6,17,35.3,11,13,7,6,21,39,72,0,"https://fbref.com/en/players/7314bba4/Shane-Duffy"
2020,"Brighton","Premier League","Lewis Dunk","ENG","DF","27",1991,35.9,40,24,23,17,0,15,34,44.1,19,55,33,22,55,95,125,2,"https://fbref.com/en/players/282f75f3/Lewis-Dunk"
2020,"Brighton","Premier League","Pascal Groß","GER","MF,FW","28",1991,20,36,13,8,21,7,14,39,35.9,25,25,3,22,9,45,7,0,"https://fbref.com/en/players/8aec0537/Pascal-Gross"
2020,"Brighton","Premier League","Alireza Jahanbakhsh","IRN","FW,MF","25",1993,3.5,8,4,3,2,3,0,2,0,2,5,0,5,3,11,2,0,"https://fbref.com/en/players/08452314/Alireza-Jahanbakhsh"
2020,"Brighton","Premier League","Tariq Lamptey","GHA","DF","18",2000,6.5,7,6,6,1,0,2,9,22.2,7,6,0,6,16,23,17,0,"https://fbref.com/en/players/f4e433d4/Tariq-Lamptey"
2020,"Brighton","Premier League","Jürgen Locadia","NED","FW,MF","25",1993,1,0,0,0,0,0,0,0,NA,0,0,0,0,0,0,0,0,"https://fbref.com/en/players/6cc47ae1/Jurgen-Locadia"
2020,"Brighton","Premier League","Alexis Mac Allister","ARG","MF,FW","20",1998,3.9,9,5,4,3,2,5,9,55.6,4,12,0,12,1,10,2,0,"https://fbref.com/en/players/83d074ff/Alexis-Mac-Allister"
2020,"Brighton","Premier League","Solly March","ENG","FW,MF","25",1994,12.7,25,12,16,6,3,9,19,47.4,10,16,4,12,20,45,14,2,"https://fbref.com/en/players/bb5fbd2b/Solly-March"
2020,"Brighton","Premier League","Neal Maupay","FRA","FW","22",1996,30.7,20,12,1,13,6,9,29,31,20,24,0,24,4,24,10,0,"https://fbref.com/en/players/4bcf39f6/Neal-Maupay"
2020,"Brighton","Premier League","Martín Montoya","ESP","DF,MF","28",1991,21.1,57,29,31,20,6,30,56,53.6,26,19,5,14,24,81,40,0,"https://fbref.com/en/players/5cec2487/Martin-Montoya"
2020,"Brighton","Premier League","Aaron Mooy","AUS","MF,FW","28",1990,23.2,37,24,9,18,10,6,40,15,34,36,7,29,23,60,32,1,"https://fbref.com/en/players/47b7e3af/Aaron-Mooy"
2020,"Brighton","Premier League","Glenn Murray","ENG","FW","35",1983,8.9,5,2,0,3,2,2,9,22.2,7,6,2,4,1,6,12,0,"https://fbref.com/en/players/f2f29dda/Glenn-Murray"
2020,"Brighton","Premier League","Davy Pröpper","NED","MF","27",1991,31.4,64,35,28,28,8,23,74,31.1,51,27,8,19,38,102,36,4,"https://fbref.com/en/players/fdd85f94/Davy-Propper"
2020,"Brighton","Premier League","Mathew Ryan","AUS","GK","27",1992,38,1,1,1,0,0,1,4,25,3,0,0,0,2,3,13,2,"https://fbref.com/en/players/4535e4bb/Mathew-Ryan"
2020,"Brighton","Premier League","Ezequiel Schelotto","ITA","DF","30",1989,4,4,3,1,2,1,2,8,25,6,3,0,3,7,11,14,0,"https://fbref.com/en/players/a6e316c1/Ezequiel-Schelotto"
2020,"Brighton","Premier League","Dale Stephens","ENG","MF","30",1989,28.1,73,44,30,37,6,25,75,33.3,50,31,11,20,58,131,42,2,"https://fbref.com/en/players/653ee42d/Dale-Stephens"
2020,"Brighton","Premier League","Leandro Trossard","BEL","FW,MF","24",1994,22.3,22,17,7,12,3,6,38,15.8,32,16,1,15,9,31,8,0,"https://fbref.com/en/players/38ceb24a/Leandro-Trossard"
2020,"Brighton","Premier League","Adam Webster","ENG","DF","24",1995,29.6,30,17,21,8,1,14,32,43.8,18,43,26,17,45,75,110,2,"https://fbref.com/en/players/c40b6180/Adam-Webster"
2020,"Burnley","Premier League","Phil Bardsley","SCO","DF","34",1985,21,49,36,16,24,9,24,37,64.9,13,24,11,13,30,79,73,0,"https://fbref.com/en/players/1ae30132/Phil-Bardsley"
2020,"Burnley","Premier League","Ashley Barnes","ENG","FW","29",1989,15,10,5,3,5,2,3,9,33.3,6,7,2,5,6,16,9,0,"https://fbref.com/en/players/2691c772/Ashley-Barnes"
2020,"Burnley","Premier League","Jóhann Berg Guðmundsson","ISL","MF","28",1990,6.9,4,2,2,2,0,1,8,12.5,7,8,1,7,7,11,9,0,"https://fbref.com/en/players/f72293fc/Johann-Berg-Gudmundsson"
2020,"Burnley","Premier League","Robbie Brady","IRL","MF","27",1992,5,11,9,5,4,2,3,10,30,7,10,2,8,5,16,8,0,"https://fbref.com/en/players/96bb8cc2/Robbie-Brady"
2020,"Burnley","Premier League","Josh Brownhill","ENG","MF","23",1995,8.9,14,8,5,7,2,5,13,38.5,8,9,4,5,14,28,18,0,"https://fbref.com/en/players/47369df8/Josh-Brownhill"
2020,"Burnley","Premier League","Jack Cork","ENG","MF","30",1989,29,35,24,10,20,5,12,62,19.4,50,34,12,22,28,63,49,0,"https://fbref.com/en/players/74e12f1e/Jack-Cork"
2020,"Burnley","Premier League","Danny Drinkwater","ENG","MF","29",1990,0.6,2,1,1,1,0,0,1,0,1,0,0,0,1,3,0,0,"https://fbref.com/en/players/2649ff32/Danny-Drinkwater"
2020,"Burnley","Premier League","Jeff Hendrick","IRL","MF","27",1992,21.5,18,10,7,8,3,7,27,25.9,20,21,8,13,20,38,20,0,"https://fbref.com/en/players/989d5705/Jeff-Hendrick"
2020,"Burnley","Premier League","Aaron Lennon","ENG","MF","32",1987,5.5,14,8,7,4,3,7,10,70,3,6,1,5,8,22,3,0,"https://fbref.com/en/players/2ff964a0/Aaron-Lennon"
2020,"Burnley","Premier League","Kevin Long","IRL","DF","28",1990,6.3,7,5,6,1,0,4,9,44.4,5,9,7,2,4,11,31,0,"https://fbref.com/en/players/5a4280b1/Kevin-Long"
2020,"Burnley","Premier League","Matthew Lowton","ENG","DF","30",1989,17,41,22,20,18,3,22,33,66.7,11,20,6,14,27,68,57,1,"https://fbref.com/en/players/9a9c05db/Matthew-Lowton"
2020,"Burnley","Premier League","Dwight McNeil","ENG","MF","19",1999,37.1,47,33,18,22,7,23,71,32.4,48,60,8,52,30,77,34,0,"https://fbref.com/en/players/fc15fb84/Dwight-McNeil"
2020,"Burnley","Premier League","Ben Mee","ENG","DF","29",1989,32,41,22,25,16,0,17,29,58.6,12,42,31,11,42,83,165,2,"https://fbref.com/en/players/8df7a2fb/Ben-Mee"
2020,"Burnley","Premier League","Erik Pieters","NED","DF,MF","30",1988,20.9,54,32,18,29,7,28,69,40.6,41,30,4,26,28,82,60,1,"https://fbref.com/en/players/1ef37668/Erik-Pieters"
2020,"Burnley","Premier League","Nick Pope","ENG","GK","27",1992,38,1,1,1,0,0,1,2,50,1,0,0,0,3,4,15,3,"https://fbref.com/en/players/4b40d9ca/Nick-Pope"
2020,"Burnley","Premier League","Jay Rodriguez","ENG","FW","30",1989,22.4,29,19,4,13,12,8,33,24.2,25,33,6,27,5,34,12,0,"https://fbref.com/en/players/4ab53cdb/Jay-Rodriguez"
2020,"Burnley","Premier League","James Tarkowski","ENG","DF","26",1992,38,66,43,47,19,0,31,54,57.4,23,63,47,16,63,129,204,4,"https://fbref.com/en/players/15ea812b/James-Tarkowski"
2020,"Burnley","Premier League","Charlie Taylor","ENG","DF","25",1993,21.6,39,24,26,9,4,19,39,48.7,20,29,9,20,29,68,78,1,"https://fbref.com/en/players/cc2d7ad5/Charlie-Taylor"
2020,"Burnley","Premier League","Max Thompson","ENG","FW","17",2002,0,0,0,0,0,0,0,0,NA,0,0,0,0,0,0,0,0,"https://fbref.com/en/players/fa38722f/Max-Thompson"
2020,"Burnley","Premier League","Matěj Vydra","CZE","FW","27",1992,9.1,4,3,0,3,1,3,6,50,3,7,3,4,1,5,6,0,"https://fbref.com/en/players/0d4ceb32/Matej-Vydra"
2020,"Burnley","Premier League","Ashley Westwood","ENG","MF","29",1990,35,54,33,15,32,7,17,48,35.4,31,23,11,12,32,86,32,3,"https://fbref.com/en/players/495945ef/Ashley-Westwood"
2020,"Burnley","Premier League","Chris Wood","NZL","FW","27",1991,27.1,7,4,2,4,1,5,15,33.3,10,15,2,13,4,11,18,0,"https://fbref.com/en/players/4e9a0555/Chris-Wood"
2020,"Cagliari","Serie A","Valter Birsa","SVN","MF,FW","32",1986,4.8,10,6,3,6,1,7,21,33.3,14,6,1,5,4,14,3,0,"https://fbref.com/en/players/455a2b79/Valter-Birsa"
2020,"Cagliari","Serie A","Fabrizio Cacciatore","ITA","DF","32",1986,12.8,14,4,9,4,1,6,9,66.7,3,10,6,4,16,30,44,0,"https://fbref.com/en/players/00b0bb87/Fabrizio-Cacciatore"
2020,"Cagliari","Serie A","Andrea Carboni","ITA","DF","18",2001,4.1,8,4,3,5,0,3,4,75,1,6,6,0,7,15,20,0,"https://fbref.com/en/players/f7e2af2c/Andrea-Carboni"
2020,"Cagliari","Serie A","Lucas Castro","ARG","MF","30",1989,6.7,7,3,3,4,0,1,12,8.3,11,6,1,5,8,15,14,0,"https://fbref.com/en/players/56b2957b/Lucas-Castro"
2020,"Cagliari","Serie A","Luca Ceppitelli","ITA","DF","29",1989,13.8,22,15,16,6,0,6,11,54.5,5,23,17,6,23,45,66,2,"https://fbref.com/en/players/7d50454d/Luca-Ceppitelli"
2020,"Cagliari","Serie A","Alberto Cerri","ITA","FW","23",1996,2.7,3,1,1,0,2,2,6,33.3,4,1,0,1,2,5,4,0,"https://fbref.com/en/players/1079c685/Alberto-Cerri"
2020,"Cagliari","Serie A","Luca Cigarini","ITA","MF","33",1986,17.8,37,20,23,13,1,16,40,40,24,28,10,18,20,57,29,0,"https://fbref.com/en/players/ae64d449/Luca-Cigarini"
2020,"Cagliari","Serie A","Alessio Cragno","ITA","GK","25",1994,16,0,0,0,0,0,0,0,NA,0,0,0,0,0,0,10,0,"https://fbref.com/en/players/f554e29b/Alessio-Cragno"
2020,"Cagliari","Serie A","Alessandro Deiola","ITA","MF","23",1995,0,0,0,0,0,0,0,0,NA,0,0,0,0,1,1,0,0,"https://fbref.com/en/players/7f267d66/Alessandro-Deiola"
2020,"Cagliari","Serie A","Paolo Faragò","ITA","DF,MF","26",1993,14.9,41,28,21,15,5,23,46,50,23,18,9,9,10,51,58,0,"https://fbref.com/en/players/9085dd7c/Paolo-Farago"
2020,"Cagliari","Serie A","Luca Gagliano","ITA","FW","19",2000,0.6,0,0,0,0,0,0,0,NA,0,0,0,0,1,1,0,0,"https://fbref.com/en/players/1d00a56c/Luca-Gagliano"
2020,"Cagliari","Serie A","Artur Ioniță","MDA","MF","28",1990,21.1,38,23,12,22,4,12,37,32.4,25,32,10,22,18,56,24,2,"https://fbref.com/en/players/cedb3e36/Artur-Ionita"
2020,"Cagliari","Serie A","Ragnar Klavan","EST","DF","33",1985,26.2,29,16,20,9,0,14,28,50,14,29,19,10,25,54,118,1,"https://fbref.com/en/players/008a6e6d/Ragnar-Klavan"
2020,"Cagliari","Serie A","Riccardo Ladinetti","ITA","MF","18",2000,1.4,2,2,0,2,0,1,1,100,0,0,0,0,4,6,0,1,"https://fbref.com/en/players/ff4296df/Riccardo-Ladinetti"
2020,"Cagliari","Serie A","Charalambos Lykogiannis","GRE","DF","25",1993,14.9,14,9,9,3,2,7,18,38.9,11,25,9,16,23,37,71,0,"https://fbref.com/en/players/5efc5389/Charalambos-Lykogiannis"
2020,"Cagliari","Serie A","Federico Marigosu","ITA","MF","18",2001,0.3,0,0,0,0,0,0,0,NA,0,0,0,0,0,0,1,0,"https://fbref.com/en/players/66a9470c/Federico-Marigosu"
2020,"Cagliari","Serie A","Federico Mattiello","ITA","DF","24",1995,10.3,30,21,19,7,4,11,27,40.7,16,20,7,13,18,48,22,0,"https://fbref.com/en/players/fba81826/Federico-Mattiello"
2020,"Cagliari","Serie A","Radja Nainggolan","BEL","MF","31",1988,23,30,18,9,12,9,9,29,31,20,25,6,19,13,43,30,0,"https://fbref.com/en/players/1f9328da/Radja-Nainggolan"
2020,"Cagliari","Serie A","Nahitan Nández","URU","MF,DF","23",1995,32.2,58,38,37,17,4,25,69,36.2,44,30,1,29,25,83,26,0,"https://fbref.com/en/players/95facda1/Nahitan-Nandez"
2020,"Cagliari","Serie A","Christian Oliva","URU","MF","23",1996,5.2,13,7,9,4,0,5,15,33.3,10,5,0,5,7,20,14,0,"https://fbref.com/en/players/d3b888e3/Christian-Oliva"
2020,"Cagliari","Serie A","Robin Olsen","SWE","GK","29",1990,16.9,0,0,0,0,0,0,1,0,1,0,0,0,0,0,8,0,"https://fbref.com/en/players/e7ee38c3/Robin-Olsen"
2020,"Cagliari","Serie A","Alberto Paloschi","ITA","FW,MF","29",1990,2.3,0,0,0,0,0,0,1,0,1,1,0,1,1,1,3,0,"https://fbref.com/en/players/b5cae4e6/Alberto-Paloschi"
2020,"Cagliari","Serie A","Leonardo Pavoletti","ITA","FW","30",1988,0.5,0,0,0,0,0,0,0,NA,0,0,0,0,1,1,3,0,"https://fbref.com/en/players/d37b0350/Leonardo-Pavoletti"
2020,"Cagliari","Serie A","João Pedro","ITA","FW,MF","27",1992,35,17,11,5,7,5,4,24,16.7,20,35,8,27,9,26,39,0,"https://fbref.com/en/players/81255c03/Joao-Pedro"
2020,"Cagliari","Serie A","Luca Pellegrini","ITA","DF","20",1999,21.2,31,15,20,7,4,15,38,39.5,23,19,2,17,21,52,45,2,"https://fbref.com/en/players/3b61c9ec/Luca-Pellegrini"
2020,"Cagliari","Serie A","Gastón Pereiro","URU","MF,FW","24",1995,3.9,2,2,2,0,0,1,4,25,3,1,0,1,0,2,1,1,"https://fbref.com/en/players/7ec7738e/Gaston-Pereiro"
2020,"Cagliari","Serie A","Simone Pinna","ITA","DF","21",1997,1,1,1,0,1,0,0,0,NA,0,3,1,2,5,6,4,1,"https://fbref.com/en/players/6523afa4/Simone-Pinna"
2020,"Cagliari","Serie A","Fabio Pisacane","ITA","DF","33",1986,27.1,32,21,22,10,0,21,37,56.8,16,36,28,8,27,59,110,2,"https://fbref.com/en/players/56400c01/Fabio-Pisacane"
2020,"Cagliari","Serie A","Rafael","BRA","GK","37",1982,5,0,0,0,0,0,0,0,NA,0,0,0,0,0,0,3,0,"https://fbref.com/en/players/dd06d56c/Rafael"
2020,"Cagliari","Serie A","Daniele Ragatzu","ITA","MF,FW","27",1991,3.5,3,2,0,2,1,1,3,33.3,2,1,0,1,1,4,5,0,"https://fbref.com/en/players/282b3a4d/Daniele-Ragatzu"
2020,"Cagliari","Serie A","Marko Rog","CRO","MF","24",1995,25.7,69,47,31,29,9,22,84,26.2,62,40,12,28,22,91,23,0,"https://fbref.com/en/players/b6b2b820/Marko-Rog"
2020,"Cagliari","Serie A","Giovanni Simeone","ARG","FW","24",1995,32.5,24,13,9,10,5,5,32,15.6,27,24,7,17,11,35,16,1,"https://fbref.com/en/players/343c0d52/Giovanni-Simeone"
2020,"Cagliari","Serie A","Sebastian Walukiewicz","POL","DF","19",2000,12.9,25,11,17,8,0,14,22,63.6,8,21,14,7,14,39,41,0,"https://fbref.com/en/players/217875a4/Sebastian-Walukiewicz"
2020,"Celta Vigo","La Liga","Joseph Aidoo","GHA","DF","23",1995,27.8,43,27,30,11,2,13,27,48.1,14,31,14,17,45,88,124,3,"https://fbref.com/en/players/18abe173/Joseph-Aidoo"
2020,"Celta Vigo","La Liga","Sergio Álvarez","ESP","GK","32",1986,2,0,0,0,0,0,0,0,NA,0,0,0,0,0,0,1,0,"https://fbref.com/en/players/8875b8c9/Sergio-Alvarez"
2020,"Celta Vigo","La Liga","Néstor Araujo","MEX","DF","27",1991,32.1,44,27,35,8,1,22,36,61.1,14,26,18,8,52,96,142,0,"https://fbref.com/en/players/27a013f7/Nestor-Araujo"
2020,"Celta Vigo","La Liga","Iago Aspas","ESP","FW","31",1987,36.2,29,19,7,9,13,12,45,26.7,33,16,1,15,22,51,7,0,"https://fbref.com/en/players/7dcf86f6/Iago-Aspas"
2020,"Celta Vigo","La Liga","Fran Beltrán","ESP","MF","20",1999,20.3,31,19,15,12,4,11,35,31.4,24,14,1,13,14,45,17,0,"https://fbref.com/en/players/ed5c5fa3/Fran-Beltran"
2020,"Celta Vigo","La Liga","Sergio Bermejo","ESP","MF,FW","21",1997,0.1,0,0,0,0,0,0,0,NA,0,0,0,0,0,0,0,0,"https://fbref.com/en/players/d166c007/Sergio-Bermejo"
2020,"Celta Vigo","La Liga","Rubén Blanco","ESP","GK","24",1995,32.9,1,1,1,0,0,1,1,100,0,0,0,0,0,1,14,1,"https://fbref.com/en/players/967f34d3/Ruben-Blanco"
2020,"Celta Vigo","La Liga","Filip Bradarić","CRO","MF","27",1992,7.8,12,9,5,5,2,3,8,37.5,5,12,3,9,17,29,19,0,"https://fbref.com/en/players/605873e1/Filip-Bradaric"
2020,"Celta Vigo","La Liga","Pape Cheikh Diop","SEN","MF","21",1997,6.7,10,4,6,3,1,2,12,16.7,10,4,2,2,5,15,3,0,"https://fbref.com/en/players/873ce3a2/Pape-Cheikh-Diop"
2020,"Celta Vigo","La Liga","David Costas","ESP","DF","24",1995,3.8,4,3,3,1,0,2,4,50,2,3,3,0,8,12,12,0,"https://fbref.com/en/players/545e2f01/David-Costas"
2020,"Celta Vigo","La Liga","Gabriel Fernández","URU","FW,MF","25",1994,6.2,1,0,0,1,0,1,3,33.3,2,5,1,4,2,3,2,0,"https://fbref.com/en/players/36c5f77b/Gabriel-Fernandez"
2020,"Celta Vigo","La Liga","Juan Hernández","ESP","FW,MF","24",1994,1,0,0,0,0,0,0,0,NA,0,0,0,0,1,1,0,0,"https://fbref.com/en/players/1fc3c3d7/Juan-Hernandez"
2020,"Celta Vigo","La Liga","Jacobo","ESP","DF,MF","22",1997,0.9,3,3,2,1,0,1,1,100,0,0,0,0,0,3,2,0,"https://fbref.com/en/players/09e81276/Jacobo"
2020,"Celta Vigo","La Liga","David Juncà","ESP","DF","25",1993,2.9,6,5,4,1,1,2,3,66.7,1,4,1,3,2,8,3,0,"https://fbref.com/en/players/de7d40d6/David-Junca"
2020,"Celta Vigo","La Liga","Stanislav Lobotka","SVK","MF","24",1994,15.4,19,11,13,5,1,4,19,21.1,15,8,2,6,8,27,7,0,"https://fbref.com/en/players/e1cbb531/Stanislav-Lobotka"
2020,"Celta Vigo","La Liga","Losada","ESP","MF,FW","17",2001,0.1,0,0,0,0,0,0,0,NA,0,0,0,0,0,0,0,0,"https://fbref.com/en/players/41521385/Losada"
2020,"Celta Vigo","La Liga","Hugo Mallo","ESP","DF","28",1991,21.8,62,42,44,16,2,27,48,56.3,21,24,8,16,22,84,97,1,"https://fbref.com/en/players/cb574619/Hugo-Mallo"
2020,"Celta Vigo","La Liga","Brais Méndez","ESP","MF,FW","22",1997,16.4,26,11,14,9,3,12,39,30.8,27,20,0,20,12,38,23,1,"https://fbref.com/en/players/c9e39d91/Brais-Mendez"
2020,"Celta Vigo","La Liga","Santi Mina","ESP","FW,MF","23",1995,21.6,13,8,8,5,0,5,38,13.2,33,19,2,17,10,23,27,0,"https://fbref.com/en/players/0b90bb97/Santi-Mina"
2020,"Celta Vigo","La Liga","Jeison Murillo","COL","DF","27",1992,17,37,20,30,6,1,18,27,66.7,9,13,9,4,20,57,74,2,"https://fbref.com/en/players/b233e8e4/Jeison-Murillo"
2020,"Celta Vigo","La Liga","Nolito","ESP","MF,FW","32",1986,3.6,7,5,5,2,0,3,8,37.5,5,4,1,3,1,8,4,0,"https://fbref.com/en/players/b2d0ec1b/Nolito"
2020,"Celta Vigo","La Liga","Lucas Olaza","URU","DF","25",1994,34.9,56,39,36,17,3,39,59,66.1,20,37,10,27,31,87,60,1,"https://fbref.com/en/players/4cee5954/Lucas-Olaza"
2020,"Celta Vigo","La Liga","Rafinha","BRA","MF","26",1993,23.5,71,37,29,37,5,20,62,32.3,42,37,4,33,33,104,25,0,"https://fbref.com/en/players/0c2ac3cb/Rafinha"
2020,"Celta Vigo","La Liga","Jorge Sáenz","ESP","DF","22",1996,4.1,6,1,4,2,0,3,5,60,2,5,2,3,10,16,15,0,"https://fbref.com/en/players/bfca375c/Jorge-Saenz"
2020,"Celta Vigo","La Liga","Pione Sisto","DEN","FW,MF","24",1995,9.9,17,8,5,6,6,4,19,21.1,15,18,0,18,6,23,4,1,"https://fbref.com/en/players/fd9c4805/Pione-Sisto"
2020,"Celta Vigo","La Liga","Fyodor Smolov","RUS","FW","29",1990,8.3,2,1,0,2,0,1,9,11.1,8,6,0,6,7,9,9,0,"https://fbref.com/en/players/cbbfa2e7/Fyodor-Smolov"
2020,"Celta Vigo","La Liga","Denis Suárez","ESP","MF,FW","25",1994,18.1,22,15,14,7,1,10,37,27,27,9,1,8,14,36,12,1,"https://fbref.com/en/players/12c50af5/Denis-Suarez"
2020,"Celta Vigo","La Liga","Kevin Vázquez","ESP","DF","26",1993,14.7,26,15,16,6,4,15,28,53.6,13,18,1,17,26,52,28,0,"https://fbref.com/en/players/ee923664/Kevin-Vazquez"
2020,"Celta Vigo","La Liga","Iván Villar","ESP","GK","22",1997,3.1,0,0,0,0,0,0,0,NA,0,0,0,0,0,0,5,0,"https://fbref.com/en/players/cde52ef5/Ivan-Villar"
2020,"Celta Vigo","La Liga","Okay Yokuşlu","TUR","MF","25",1994,21.9,41,27,18,21,2,20,42,47.6,22,12,5,7,28,69,71,1,"https://fbref.com/en/players/e49ce451/Okay-Yokuslu"
2020,"Chelsea","Premier League","Tammy Abraham","ENG","FW","21",1997,24.6,8,4,2,5,1,3,14,21.4,11,20,2,18,6,14,27,0,"https://fbref.com/en/players/f586779e/Tammy-Abraham"
2020,"Chelsea","Premier League","Marcos Alonso","ESP","DF","28",1990,15.9,28,16,20,6,2,14,33,42.4,19,18,2,16,20,48,32,0,"https://fbref.com/en/players/f4290206/Marcos-Alonso"
2020,"Chelsea","Premier League","Faustino Anjorin","ENG","FW","17",2001,0.2,0,0,0,0,0,0,0,NA,0,1,0,1,0,0,0,0,"https://fbref.com/en/players/b105919e/Faustino-Anjorin"
2020,"Chelsea","Premier League","Kepa Arrizabalaga","ESP","GK","24",1994,33,1,1,1,0,0,1,2,50,1,0,0,0,1,2,7,2,"https://fbref.com/en/players/28d596a0/Kepa-Arrizabalaga"
2020,"Chelsea","Premier League","César Azpilicueta","ESP","DF","29",1989,35.9,86,56,40,32,14,35,69,50.7,34,56,21,35,67,153,94,0,"https://fbref.com/en/players/53cad200/Cesar-Azpilicueta"
2020,"Chelsea","Premier League","Ross Barkley","ENG","MF","25",1993,12.3,16,9,6,6,4,5,18,27.8,13,7,2,5,7,23,7,0,"https://fbref.com/en/players/3a24769f/Ross-Barkley"
2020,"Chelsea","Premier League","Michy Batshuayi","BEL","FW","25",1993,2.7,4,1,2,2,0,0,5,0,5,1,1,0,0,4,1,0,"https://fbref.com/en/players/2973d8ff/Michy-Batshuayi"
2020,"Chelsea","Premier League","Armando Broja","ALB","FW","17",2001,0.1,0,0,0,0,0,0,0,NA,0,0,0,0,0,0,0,0,"https://fbref.com/en/players/97220da2/Armando-Broja"
2020,"Chelsea","Premier League","Willy Caballero","ARG","GK","37",1981,5,0,0,0,0,0,0,0,NA,0,0,0,0,0,0,3,0,"https://fbref.com/en/players/a179d516/Willy-Caballero"
2020,"Chelsea","Premier League","Andreas Christensen","DEN","DF","23",1996,19.5,38,21,25,12,1,15,21,71.4,6,12,8,4,29,67,56,0,"https://fbref.com/en/players/1cb49278/Andreas-Christensen"
2020,"Chelsea","Premier League","Billy Gilmour","SCO","MF","18",2001,2.2,5,2,3,2,0,2,4,50,2,2,0,2,3,8,3,1,"https://fbref.com/en/players/df10e27c/Billy-Gilmour"
2020,"Chelsea","Premier League","Olivier Giroud","FRA","FW","32",1986,11,8,3,2,5,1,1,11,9.1,10,14,1,13,2,10,13,0,"https://fbref.com/en/players/16ceb862/Olivier-Giroud"
2020,"Chelsea","Premier League","Callum Hudson-Odoi","ENG","FW,MF","18",2000,9.6,10,4,4,5,1,1,7,14.3,6,9,0,9,5,15,4,1,"https://fbref.com/en/players/15f3ec41/Callum-Hudson-Odoi"
2020,"Chelsea","Premier League","Reece James","ENG","DF","19",1999,16.8,36,23,18,14,4,11,29,37.9,18,19,8,11,22,58,28,0,"https://fbref.com/en/players/1265a93a/Reece-James"
2020,"Chelsea","Premier League","Jorginho","ITA","MF","27",1991,26.4,66,40,24,34,8,35,91,38.5,56,30,5,25,64,130,27,2,"https://fbref.com/en/players/45db685d/Jorginho"
2020,"Chelsea","Premier League","N'Golo Kanté","FRA","MF","28",1991,19.2,44,20,22,14,8,17,36,47.2,19,29,5,24,44,88,32,2,"https://fbref.com/en/players/b9fbae28/NGolo-Kante"
2020,"Chelsea","Premier League","Mateo Kovačić","CRO","MF","25",1994,23,63,38,29,32,2,26,65,40,39,15,1,14,22,85,16,1,"https://fbref.com/en/players/79c0821a/Mateo-Kovacic"
2020,"Chelsea","Premier League","Tariq Lamptey","GHA","DF","18",2000,0.4,2,2,1,1,0,2,2,100,0,0,0,0,0,2,0,0,"https://fbref.com/en/players/f4e433d4/Tariq-Lamptey"
2020,"Chelsea","Premier League","Ruben Loftus-Cheek","ENG","MF,FW","23",1996,2.3,0,0,0,0,0,0,2,0,2,1,1,0,2,2,2,0,"https://fbref.com/en/players/e97fd090/Ruben-Loftus-Cheek"
2020,"Chelsea","Premier League","Mason Mount","ENG","MF,FW","20",1999,31.9,37,17,8,19,10,9,42,21.4,33,25,3,22,16,53,18,0,"https://fbref.com/en/players/9674002f/Mason-Mount"
2020,"Chelsea","Premier League","Emerson Palmieri","ITA","DF","24",1994,11.4,23,12,8,11,4,10,15,66.7,5,13,1,12,18,41,19,0,"https://fbref.com/en/players/e0bc6fdc/Emerson-Palmieri"
2020,"Chelsea","Premier League","Pedro","ESP","FW,MF","32",1987,7.3,15,7,5,9,1,3,15,20,12,9,0,9,9,24,1,0,"https://fbref.com/en/players/3ca7254a/Pedro"
2020,"Chelsea","Premier League","Christian Pulisic","USA","FW","20",1998,19.1,23,11,13,4,6,7,24,29.2,17,15,0,15,6,29,11,0,"https://fbref.com/en/players/1bf33a9a/Christian-Pulisic"
2020,"Chelsea","Premier League","Antonio Rüdiger","GER","DF","26",1993,19,28,18,19,7,2,16,25,64,9,15,9,6,16,44,59,1,"https://fbref.com/en/players/18b896d6/Antonio-Rudiger"
2020,"Chelsea","Premier League","Fikayo Tomori","ENG","DF","21",1997,14.3,29,16,21,8,0,10,15,66.7,5,13,7,6,22,51,48,2,"https://fbref.com/en/players/7edfbb8a/Fikayo-Tomori"
2020,"Chelsea","Premier League","Willian","BRA","FW,MF","30",1988,28.9,45,27,14,24,7,14,43,32.6,29,15,0,15,20,65,7,0,"https://fbref.com/en/players/8b9ebd03/Willian"
2020,"Chelsea","Premier League","Kurt Zouma","FRA","DF","24",1994,26,23,14,17,6,0,9,16,56.3,7,22,14,8,58,81,116,2,"https://fbref.com/en/players/ce4246f5/Kurt-Zouma"
2020,"Crystal Palace","Premier League","Patrick van Aanholt","NED","DF","28",1990,27.9,43,23,31,10,2,23,50,46,27,31,9,22,45,88,52,1,"https://fbref.com/en/players/5f09991f/Patrick-van-Aanholt"
2020,"Crystal Palace","Premier League","Jordan Ayew","GHA","FW","27",1991,35,48,30,10,22,16,17,49,34.7,32,29,4,25,15,63,21,0,"https://fbref.com/en/players/da052c14/Jordan-Ayew"
2020,"Crystal Palace","Premier League","Christian Benteke","BEL","FW","28",1990,14,9,5,1,6,2,0,10,0,10,11,4,7,4,13,28,1,"https://fbref.com/en/players/ab070c55/Christian-Benteke"
2020,"Crystal Palace","Premier League","Gary Cahill","ENG","DF","33",1985,24.1,15,8,11,4,0,7,15,46.7,8,34,25,9,18,33,114,1,"https://fbref.com/en/players/7914b9fe/Gary-Cahill"
2020,"Crystal Palace","Premier League","Víctor Camarasa","ESP","FW","25",1994,0.1,0,0,0,0,0,0,0,NA,0,0,0,0,0,0,0,0,"https://fbref.com/en/players/b2d03887/Victor-Camarasa"
2020,"Crystal Palace","Premier League","Scott Dann","ENG","DF","32",1987,14.1,8,4,7,1,0,8,14,57.1,6,9,7,2,14,22,67,0,"https://fbref.com/en/players/52105203/Scott-Dann"
2020,"Crystal Palace","Premier League","Vicente Guaita","ESP","GK","32",1987,35,1,1,1,0,0,1,2,50,1,0,0,0,0,1,18,3,"https://fbref.com/en/players/ab13a5aa/Vicente-Guaita"
2020,"Crystal Palace","Premier League","Wayne Hennessey","WAL","GK","32",1987,3,0,0,0,0,0,0,0,NA,0,0,0,0,1,1,3,1,"https://fbref.com/en/players/76eca7e2/Wayne-Hennessey"
2020,"Crystal Palace","Premier League","Martin Kelly","ENG","DF","29",1990,17.2,23,18,19,4,0,14,31,45.2,17,18,10,8,16,39,86,1,"https://fbref.com/en/players/d7492450/Martin-Kelly"
2020,"Crystal Palace","Premier League","Cheikhou Kouyaté","SEN","MF,DF","29",1989,28.1,67,32,43,20,4,26,48,54.2,22,35,11,24,43,110,58,1,"https://fbref.com/en/players/8d3c902d/Cheikhou-Kouyate"
2020,"Crystal Palace","Premier League","James McArthur","SCO","MF","31",1987,34.3,88,51,43,34,11,37,106,34.9,69,69,19,50,60,148,56,0,"https://fbref.com/en/players/cee31595/James-McArthur"
2020,"Crystal Palace","Premier League","James McCarthy","IRL","MF","28",1990,18.7,82,47,36,36,10,40,76,52.6,36,24,5,19,24,106,11,0,"https://fbref.com/en/players/64b08de7/James-McCarthy"
2020,"Crystal Palace","Premier League","Max Meyer","GER","MF,FW","23",1995,7.3,19,11,10,9,0,8,18,44.4,10,6,1,5,7,26,4,0,"https://fbref.com/en/players/eba42d2b/Max-Meyer"
2020,"Crystal Palace","Premier League","Luka Milivojević","SRB","MF","28",1991,27.9,61,32,32,25,4,35,84,41.7,49,30,7,23,42,103,39,4,"https://fbref.com/en/players/2ce2508a/Luka-Milivojevic"
2020,"Crystal Palace","Premier League","Tyrick Mitchell","ENG","DF","19",1999,2.2,5,2,2,2,1,1,7,14.3,6,2,0,2,2,7,3,0,"https://fbref.com/en/players/5cbd1eb0/Tyrick-Mitchell"
2020,"Crystal Palace","Premier League","Brandon Pierrick","ENG","MF,FW","17",2001,0.2,0,0,0,0,0,0,0,NA,0,0,0,0,0,0,1,0,"https://fbref.com/en/players/9a526299/Brandon-Pierrick"
2020,"Crystal Palace","Premier League","Jaïro Riedewald","NED","DF,MF","22",1996,8.5,14,10,4,10,0,7,11,63.6,4,7,2,5,17,31,23,1,"https://fbref.com/en/players/7a1f2c08/Jairo-Riedewald"
2020,"Crystal Palace","Premier League","Mamadou Sakho","FRA","DF","29",1990,10.3,7,5,5,1,1,2,5,40,3,12,5,7,20,27,46,2,"https://fbref.com/en/players/87935cf3/Mamadou-Sakho"
2020,"Crystal Palace","Premier League","Jeffrey Schlupp","GHA","FW,MF","26",1992,11.5,18,9,10,7,1,6,16,37.5,10,11,3,8,13,31,15,0,"https://fbref.com/en/players/3312f911/Jeffrey-Schlupp"
2020,"Crystal Palace","Premier League","James Tomkins","ENG","DF","30",1989,17.6,29,17,21,8,0,18,25,72,7,17,15,2,21,50,103,0,"https://fbref.com/en/players/e7ca0439/James-Tomkins"
2020,"Crystal Palace","Premier League","Cenk Tosun","TUR","FW","28",1991,2,2,2,2,0,0,0,2,0,2,0,0,0,0,2,1,0,"https://fbref.com/en/players/9a104dee/Cenk-Tosun"
2020,"Crystal Palace","Premier League","Andros Townsend","ENG","FW,MF","28",1991,14.4,34,21,12,17,5,15,37,40.5,22,18,0,18,15,49,10,1,"https://fbref.com/en/players/b28bbd58/Andros-Townsend"
2020,"Crystal Palace","Premier League","Joel Ward","ENG","DF","29",1989,26.5,69,42,48,16,5,39,56,69.6,17,13,6,7,48,117,93,1,"https://fbref.com/en/players/8a7ff278/Joel-Ward"
2020,"Crystal Palace","Premier League","Connor Wickham","ENG","FW,MF","26",1993,1.1,1,1,1,0,0,0,0,NA,0,1,0,1,1,2,0,0,"https://fbref.com/en/players/41cc19c2/Connor-Wickham"
2020,"Crystal Palace","Premier League","Wilfried Zaha","CIV","FW,MF","26",1992,36.4,43,19,18,12,13,12,49,24.5,37,22,2,20,18,61,4,0,"https://fbref.com/en/players/b2bc3b1f/Wilfried-Zaha"
2020,"Dijon","Ligue 1","Nayef Aguerd","MAR","DF","23",1996,10.6,13,9,7,5,1,8,12,66.7,4,11,11,0,18,31,54,0,"https://fbref.com/en/players/288e1e13/Nayef-Aguerd"
2020,"Dijon","Ligue 1","Rúnar Alex Rúnarsson","ISL","GK","24",1995,10,0,0,0,0,0,0,2,0,2,0,0,0,0,0,3,3,"https://fbref.com/en/players/8fa8f8d2/Runar-Alex-Runarsson"
2020,"Dijon","Ligue 1","Mickaël Alphonse","GLP","DF","30",1989,15.3,39,25,26,12,1,23,37,62.2,14,19,3,16,17,56,64,0,"https://fbref.com/en/players/0a63446f/Mickael-Alphonse"
2020,"Dijon","Ligue 1","Romain Amalfitano","FRA","MF","29",1989,18.8,43,27,18,21,4,21,61,34.4,40,23,9,14,36,79,14,2,"https://fbref.com/en/players/d7bf3d19/Romain-Amalfitano"
2020,"Dijon","Ligue 1","Florent Balmont","FRA","MF","39",1980,4.5,12,6,5,7,0,7,12,58.3,5,6,0,6,1,13,3,0,"https://fbref.com/en/players/4e7bfc23/Florent-Balmont"
2020,"Dijon","Ligue 1","Yassine Benzia","ALG","MF","24",1994,1.9,3,2,2,1,0,1,6,16.7,5,4,2,2,3,6,1,0,"https://fbref.com/en/players/6fbde63a/Yassine-Benzia"
2020,"Dijon","Ligue 1","Jhonder Cádiz","VEN","FW,MF","24",1995,8.9,16,8,6,7,3,3,7,42.9,4,4,2,2,1,17,9,0,"https://fbref.com/en/players/e8edfdc9/Jhonder-Cadiz"
2020,"Dijon","Ligue 1","Fouad Chafik","MAR","DF","32",1986,17,32,21,22,7,3,17,36,47.2,19,12,5,7,26,58,36,0,"https://fbref.com/en/players/edd1466a/Fouad-Chafik"
2020,"Dijon","Ligue 1","Mounir Chouiar","FRA","MF,FW","20",1999,16.7,36,23,13,18,5,12,42,28.6,30,8,0,8,13,49,13,0,"https://fbref.com/en/players/45c1c326/Mounir-Chouiar"
2020,"Dijon","Ligue 1","Senou Coulibaly","MLI","DF","24",1994,7.4,14,7,11,3,0,2,4,50,2,11,10,1,10,24,44,1,"https://fbref.com/en/players/67b7357e/Senou-Coulibaly"
2020,"Dijon","Ligue 1","Bruno Ecuele Manga","GAB","DF","31",1988,28,22,15,17,5,0,9,20,45,11,34,23,11,37,59,112,2,"https://fbref.com/en/players/72a0fb65/Bruno-Ecuele-Manga"
2020,"Dijon","Ligue 1","Alfred Gomis","SEN","GK","25",1993,18,1,0,1,0,0,1,2,50,1,2,0,2,0,1,14,2,"https://fbref.com/en/players/cecbce23/Alfred-Gomis"
2020,"Dijon","Ligue 1","Didier Ibrahim Ndong","GAB","MF","25",1994,26.5,62,35,30,31,1,30,59,50.8,29,27,6,21,49,111,31,0,"https://fbref.com/en/players/885b7aa7/Didier-Ibrahim-Ndong"
2020,"Dijon","Ligue 1","Benjamin Jeannot","FRA","MF,FW","27",1992,1.9,2,1,0,1,1,0,4,0,4,2,0,2,2,4,4,0,"https://fbref.com/en/players/2e52206e/Benjamin-Jeannot"
2020,"Dijon","Ligue 1","Jules Keita","GUI","MF,FW","21",1998,1.8,4,3,2,1,1,1,6,16.7,5,1,0,1,3,7,0,0,"https://fbref.com/en/players/8c955557/Jules-Keita"
2020,"Dijon","Ligue 1","Wesley Lautoa","NCL","MF,DF","31",1987,20.8,54,29,24,28,2,28,63,44.4,35,31,16,15,42,96,48,2,"https://fbref.com/en/players/6e5b5a45/Wesley-Lautoa"
2020,"Dijon","Ligue 1","Enzo Loiodice","FRA","MF","18",2000,2.1,6,4,1,4,1,1,3,33.3,2,2,0,2,2,8,1,0,"https://fbref.com/en/players/6bca20fe/Enzo-Loiodice"
2020,"Dijon","Ligue 1","Jordan Marié","FRA","MF,FW","27",1991,2.2,7,5,4,3,0,4,9,44.4,5,3,1,2,4,11,2,0,"https://fbref.com/en/players/0d2158d5/Jordan-Marie"
2020,"Dijon","Ligue 1","Stephy Mavididi","ENG","FW,MF","21",1998,15.5,18,11,7,8,3,10,26,38.5,16,11,0,11,7,25,5,0,"https://fbref.com/en/players/30144daa/Stephy-Mavididi"
2020,"Dijon","Ligue 1","Hamza Mendyl","MAR","DF","21",1997,16,49,32,31,14,4,29,46,63,17,16,4,12,23,72,47,0,"https://fbref.com/en/players/f99fe221/Hamza-Mendyl"
2020,"Dijon","Ligue 1","Muzinga Ngonda","COD","DF","24",1994,6,15,6,10,3,2,7,10,70,3,5,4,1,11,26,23,0,"https://fbref.com/en/players/b748968d/Muzinga-Ngonda"
2020,"Dijon","Ligue 1","Ahmad Ngouyamsa","CMR","DF","18",2000,0.6,1,0,1,0,0,0,3,0,3,1,1,0,1,2,5,0,"https://fbref.com/en/players/8413ceb1/Ahmad-Ngouyamsa"
2020,"Dijon","Ligue 1","Rayan Philippe","FRA","FW","18",2000,0.3,0,0,0,0,0,0,1,0,1,0,0,0,1,1,1,1,"https://fbref.com/en/players/a046fc35/Rayan-Philippe"
2020,"Dijon","Ligue 1","Mama Samba Baldé","GNB","FW,MF","23",1995,18.6,24,13,9,8,7,7,30,23.3,23,17,0,17,7,31,24,0,"https://fbref.com/en/players/fb14aa28/Mama-Samba-Balde"
2020,"Dijon","Ligue 1","Frédéric Sammaritano","FRA","MF,FW","33",1986,5.8,9,7,4,4,1,4,11,36.4,7,6,1,5,2,11,3,1,"https://fbref.com/en/players/8802c1d5/Frederic-Sammaritano"
2020,"Dijon","Ligue 1","Matheus Pereira da Silva","BRA","MF,FW","21",1998,5.2,10,6,1,6,3,4,10,40,6,11,0,11,6,16,5,0,"https://fbref.com/en/players/bef22bc4/Matheus-Pereira-da-Silva"
2020,"Dijon","Ligue 1","Bryan Soumaré","FRA","MF,FW","20",1999,4.3,12,1,6,5,1,6,9,66.7,3,1,0,1,2,14,1,0,"https://fbref.com/en/players/85e2d218/Bryan-Soumare"
2020,"Dijon","Ligue 1","Júlio Tavares","CPV","FW","30",1988,22.2,12,8,1,6,5,4,17,23.5,13,9,2,7,8,20,29,0,"https://fbref.com/en/players/d520120b/Julio-Tavares"
2020,"Dortmund","Bundesliga","Manuel Akanji","SUI","DF","24",1995,25.7,38,21,23,14,1,12,20,60,8,20,11,9,30,68,61,2,"https://fbref.com/en/players/89ac64a6/Manuel-Akanji"
2020,"Dortmund","Bundesliga","Paco Alcácer","ESP","FW","25",1993,5.9,2,2,0,2,0,1,5,20,4,4,1,3,2,4,3,0,"https://fbref.com/en/players/a7a9d95a/Paco-Alcacer"
2020,"Dortmund","Bundesliga","Leonardo Balerdi","ARG","DF,MF","20",1999,1.5,2,1,1,1,0,2,2,100,0,0,0,0,4,6,3,0,"https://fbref.com/en/players/7c3ed041/Leonardo-Balerdi"
2020,"Dortmund","Bundesliga","Julian Brandt","GER","MF,FW","23",1996,24.5,48,33,15,21,12,25,55,45.5,30,35,2,33,16,64,10,1,"https://fbref.com/en/players/a167537f/Julian-Brandt"
2020,"Dortmund","Bundesliga","Jacob Bruun Larsen","DEN","FW","20",1998,0.8,0,0,0,0,0,0,0,NA,0,0,0,0,0,0,0,0,"https://fbref.com/en/players/4e204552/Jacob-Bruun-Larsen"
2020,"Dortmund","Bundesliga","Roman Bürki","SUI","GK","28",1990,30.8,2,2,2,0,0,2,3,66.7,1,1,0,1,2,4,13,1,"https://fbref.com/en/players/9d12e142/Roman-Burki"
2020,"Dortmund","Bundesliga","Emre Can","GER","MF,DF","25",1994,10.6,19,12,11,7,1,5,12,41.7,7,14,6,8,19,38,15,0,"https://fbref.com/en/players/a65ce836/Emre-Can"
2020,"Dortmund","Bundesliga","Mahmoud Dahoud","GER","MF","23",1996,6.2,10,6,4,4,2,6,18,33.3,12,8,2,6,8,18,4,0,"https://fbref.com/en/players/db4ed67b/Mahmoud-Dahoud"
2020,"Dortmund","Bundesliga","Thomas Delaney","DEN","MF","27",1991,9.2,22,10,10,11,1,9,15,60,6,16,7,9,26,48,26,0,"https://fbref.com/en/players/fe641c1a/Thomas-Delaney"
2020,"Dortmund","Bundesliga","Mario Götze","GER","FW","27",1992,5.8,10,7,0,6,4,3,12,25,9,3,0,3,2,12,1,0,"https://fbref.com/en/players/9efa1d25/Mario-Gotze"
2020,"Dortmund","Bundesliga","Raphaël Guerreiro","POR","DF,MF","25",1993,25.9,44,24,18,21,5,20,32,62.5,12,27,3,24,42,86,26,0,"https://fbref.com/en/players/048a1cbc/Raphael-Guerreiro"
2020,"Dortmund","Bundesliga","Erling Haaland","NOR","FW","19",2000,11.8,4,2,1,0,3,0,4,0,4,7,4,3,4,8,4,0,"https://fbref.com/en/players/1f44ac21/Erling-Haaland"
2020,"Dortmund","Bundesliga","Achraf Hakimi","MAR","DF,MF","20",1998,30.2,60,41,38,14,8,27,64,42.2,37,26,2,24,30,90,27,2,"https://fbref.com/en/players/e42d61c7/Achraf-Hakimi"
2020,"Dortmund","Bundesliga","Thorgan Hazard","BEL","FW,MF","26",1993,26.4,40,27,17,14,9,12,50,24,38,29,0,29,13,53,2,1,"https://fbref.com/en/players/50871bcc/Thorgan-Hazard"
2020,"Dortmund","Bundesliga","Marwin Hitz","SUI","GK","31",1987,3.2,0,0,0,0,0,0,0,NA,0,0,0,0,0,0,0,0,"https://fbref.com/en/players/2e7ff968/Marwin-Hitz"
2020,"Dortmund","Bundesliga","Mats Hummels","GER","DF","30",1988,28.7,57,30,30,26,1,20,38,52.6,18,41,18,23,59,116,110,1,"https://fbref.com/en/players/05d548d8/Mats-Hummels"
2020,"Dortmund","Bundesliga","Mateu Morey","ESP","DF,MF","19",2000,2.2,7,3,2,4,1,4,10,40,6,4,0,4,5,12,3,0,"https://fbref.com/en/players/5fd5e542/Mateu-Morey"
2020,"Dortmund","Bundesliga","Łukasz Piszczek","POL","DF","34",1985,23.4,45,32,27,16,2,28,50,56,22,27,11,16,26,71,47,1,"https://fbref.com/en/players/fe2db476/Lukasz-Piszczek"
2020,"Dortmund","Bundesliga","Tobias Raschl","GER","MF","19",2000,0.3,0,0,0,0,0,0,1,0,1,1,0,1,0,0,0,0,"https://fbref.com/en/players/bd992863/Tobias-Raschl"
2020,"Dortmund","Bundesliga","Marco Reus","GER","MF,FW","30",1989,16.6,26,16,5,11,10,3,19,15.8,16,17,2,15,9,35,11,0,"https://fbref.com/en/players/36a3ff67/Marco-Reus"
2020,"Dortmund","Bundesliga","Gio Reyna","USA","MF,FW","16",2002,3.9,6,2,1,5,0,1,4,25,3,3,0,3,0,6,2,0,"https://fbref.com/en/players/7fa4e703/Gio-Reyna"
2020,"Dortmund","Bundesliga","Jadon Sancho","ENG","FW,MF","19",2000,25.4,14,11,6,6,2,8,24,33.3,16,8,0,8,14,28,6,0,"https://fbref.com/en/players/dbf053da/Jadon-Sancho"
2020,"Dortmund","Bundesliga","Marcel Schmelzer","GER","DF","31",1988,0.7,2,1,1,1,0,1,1,100,0,0,0,0,1,3,2,0,"https://fbref.com/en/players/89565ac5/Marcel-Schmelzer"
2020,"Dortmund","Bundesliga","Nico Schulz","GER","DF,MF","26",1993,6.6,11,7,3,6,2,8,13,61.5,5,14,4,10,9,20,9,0,"https://fbref.com/en/players/fa274d97/Nico-Schulz"
2020,"Dortmund","Bundesliga","Julian Weigl","GER","MF,DF","23",1995,11.3,16,9,12,3,1,9,16,56.3,7,10,0,10,8,24,21,0,"https://fbref.com/en/players/346d51d9/Julian-Weigl"
2020,"Dortmund","Bundesliga","Axel Witsel","BEL","MF","30",1989,24.9,28,20,10,17,1,14,33,42.4,19,26,7,19,31,59,19,1,"https://fbref.com/en/players/5dfc6ad5/Axel-Witsel"
2020,"Dortmund","Bundesliga","Dan-Axel Zagadou","FRA","DF","20",1999,10.9,16,10,12,4,0,6,8,75,2,12,8,4,15,31,38,0,"https://fbref.com/en/players/a4effc55/Dan-Axel-Zagadou"
2020,"Düsseldorf","Bundesliga","Opoku Ampomah","GHA","FW,MF","23",1996,5.6,9,4,3,4,2,3,12,25,9,3,0,3,4,13,5,0,"https://fbref.com/en/players/e7199efb/Opoku-Ampomah"
2020,"Düsseldorf","Bundesliga","Kaan Ayhan","TUR","DF","24",1994,30.3,38,25,26,11,1,20,37,54.1,17,28,15,13,45,83,72,1,"https://fbref.com/en/players/2200181e/Kaan-Ayhan"
2020,"Düsseldorf","Bundesliga","Lewis Baker","ENG","MF","24",1995,6.1,8,5,6,2,0,2,10,20,8,5,2,3,2,10,5,0,"https://fbref.com/en/players/1b278bf5/Lewis-Baker"
2020,"Düsseldorf","Bundesliga","Aymen Barkok","MAR","FW,MF","21",1998,0.9,1,1,0,0,1,0,2,0,2,2,0,2,3,4,1,0,"https://fbref.com/en/players/a2a85828/Aymen-Barkok"
2020,"Düsseldorf","Bundesliga","Valon Berisha","KVX","MF","26",1993,10.5,14,9,3,8,3,6,21,28.6,15,4,1,3,9,23,8,0,"https://fbref.com/en/players/d5575935/Valon-Berisha"
2020,"Düsseldorf","Bundesliga","Adam Bodzek","GER","MF","33",1985,22.4,42,26,21,20,1,14,46,30.4,32,34,11,23,25,67,39,0,"https://fbref.com/en/players/bb8a42fa/Adam-Bodzek"
2020,"Düsseldorf","Bundesliga","Robin Bormuth","GER","DF","23",1995,2,2,1,2,0,0,2,3,66.7,1,6,5,1,0,2,12,0,"https://fbref.com/en/players/d728acae/Robin-Bormuth"
2020,"Düsseldorf","Bundesliga","Oliver Fink","GER","MF,FW","37",1982,7.5,21,12,7,11,3,5,16,31.3,11,12,1,11,15,36,7,0,"https://fbref.com/en/players/316162b6/Oliver-Fink"
2020,"Düsseldorf","Bundesliga","Niko Gießelmann","GER","DF","27",1991,22.9,46,31,31,11,4,22,45,48.9,23,23,6,17,27,73,55,1,"https://fbref.com/en/players/7242b495/Niko-Giesselmann"
2020,"Düsseldorf","Bundesliga","Rouwen Hennings","GER","FW","31",1987,27.3,11,5,2,7,2,3,18,16.7,15,12,0,12,2,13,33,0,"https://fbref.com/en/players/17611373/Rouwen-Hennings"
2020,"Düsseldorf","Bundesliga","André Hoffmann","GER","DF","26",1993,27,48,22,30,18,0,16,50,32,34,22,9,13,56,104,90,0,"https://fbref.com/en/players/34b306a1/Andre-Hoffmann"
2020,"Düsseldorf","Bundesliga","Mathias Jørgensen","DEN","DF","29",1990,5.5,4,3,3,1,0,2,4,50,2,7,3,4,13,17,33,0,"https://fbref.com/en/players/0db5d2c8/Mathias-Jorgensen"
2020,"Düsseldorf","Bundesliga","Kenan Karaman","TUR","FW,MF","25",1994,15,11,5,2,5,4,4,9,44.4,5,9,4,5,2,13,7,0,"https://fbref.com/en/players/8f0f2230/Kenan-Karaman"
2020,"Düsseldorf","Bundesliga","Florian Kastenmeier","GER","GK","22",1997,17,1,1,1,0,0,0,0,NA,0,0,0,0,2,3,3,1,"https://fbref.com/en/players/dc2e4736/Florian-Kastenmeier"
2020,"Düsseldorf","Bundesliga","Dawid Kownacki","POL","FW,MF","22",1997,12.1,13,8,5,7,1,9,20,45,11,13,2,11,6,19,8,0,"https://fbref.com/en/players/be5e1c4c/Dawid-Kownacki"
2020,"Düsseldorf","Bundesliga","Alfredo Morales","USA","MF","29",1990,19.2,31,15,11,16,4,11,35,31.4,24,17,6,11,18,49,37,0,"https://fbref.com/en/players/ff45add5/Alfredo-Morales"
2020,"Düsseldorf","Bundesliga","Kasim Nuhu","GHA","DF","24",1995,11.1,14,7,12,1,1,9,19,47.4,10,16,12,4,25,39,54,0,"https://fbref.com/en/players/93a50d2c/Kasim-Nuhu"
2020,"Düsseldorf","Bundesliga","Kelvin Ofori","GHA","MF","18",2001,0.4,0,0,0,0,0,0,0,NA,0,0,0,0,0,0,0,0,"https://fbref.com/en/players/1151fb6e/Kelvin-Ofori"
2020,"Düsseldorf","Bundesliga","Thomas Pledl","GER","MF,FW","25",1994,1,4,2,2,2,0,0,1,0,1,0,0,0,0,4,1,0,"https://fbref.com/en/players/1748c9f7/Thomas-Pledl"
2020,"Düsseldorf","Bundesliga","Steven Skrzybski","GER","FW,MF","26",1992,5.9,4,4,2,1,1,0,16,0,16,10,0,10,10,14,4,0,"https://fbref.com/en/players/58ce23e5/Steven-Skrzybski"
2020,"Düsseldorf","Bundesliga","Marcel Sobottka","GER","MF","25",1994,7.8,15,10,6,8,1,4,13,30.8,9,9,1,8,9,24,12,0,"https://fbref.com/en/players/664590fa/Marcel-Sobottka"
2020,"Düsseldorf","Bundesliga","Zack Steffen","USA","GK","24",1995,17,0,0,0,0,0,0,0,NA,0,0,0,0,0,0,5,4,"https://fbref.com/en/players/42130443/Zack-Steffen"
2020,"Düsseldorf","Bundesliga","Kevin Stöger","AUT","MF","25",1993,14.1,21,15,10,7,4,6,24,25,18,24,2,22,26,47,7,1,"https://fbref.com/en/players/e5649a78/Kevin-Stoger"
2020,"Düsseldorf","Bundesliga","Markus Suttner","AUT","DF","32",1987,14.9,21,16,11,9,1,11,24,45.8,13,22,7,15,13,34,33,0,"https://fbref.com/en/players/7391c2d9/Markus-Suttner"
2020,"Düsseldorf","Bundesliga","Bernard Tekpetey","GHA","FW,MF","21",1997,5,4,4,1,2,1,0,2,0,2,5,0,5,2,6,0,0,"https://fbref.com/en/players/7bf8ad6c/Bernard-Tekpetey"
2020,"Düsseldorf","Bundesliga","Erik Thommy","GER","MF,FW","24",1994,25.1,40,23,16,16,8,15,39,38.5,24,23,2,21,16,56,20,1,"https://fbref.com/en/players/df8e7b62/Erik-Thommy"
2020,"Düsseldorf","Bundesliga","Jean Zimmer","GER","DF,FW","25",1993,8,11,6,5,5,1,5,10,50,5,3,1,2,3,14,0,0,"https://fbref.com/en/players/912e63b5/Jean-Zimmer"
2020,"Düsseldorf","Bundesliga","Matthias Zimmermann","GER","DF,MF","27",1992,32.5,62,47,26,27,9,31,64,48.4,33,41,15,26,43,105,59,0,"https://fbref.com/en/players/e199d5b0/Matthias-Zimmermann"
2020,"Eibar","La Liga","Sergio Álvarez","ESP","MF,DF","27",1992,12.7,37,22,11,24,2,8,24,33.3,16,16,2,14,17,54,26,1,"https://fbref.com/en/players/88d91621/Sergio-Alvarez"
2020,"Eibar","La Liga","José Ángel","ESP","DF","29",1989,26.2,54,31,26,25,3,26,43,60.5,17,23,7,16,33,87,61,1,"https://fbref.com/en/players/3024e383/Jose-Angel"
2020,"Eibar","La Liga","Anaitz Arbilla","ESP","DF","32",1987,22.3,33,20,23,8,2,16,34,47.1,18,20,4,16,29,62,82,0,"https://fbref.com/en/players/850c0a0d/Anaitz-Arbilla"
2020,"Eibar","La Liga","Miguel Atienza","ESP","MF","20",1999,0.3,1,1,0,1,0,1,2,50,1,1,1,0,2,3,1,0,"https://fbref.com/en/players/12eda7be/Miguel-Atienza"
2020,"Eibar","La Liga","Pedro Bigas","ESP","DF","28",1990,19.7,18,9,11,7,0,9,19,47.4,10,16,10,6,36,54,82,0,"https://fbref.com/en/players/697295b1/Pedro-Bigas"
2020,"Eibar","La Liga","Pablo de Blasis","ARG","DF,MF","31",1988,17.8,41,32,22,13,6,30,63,47.6,33,13,0,13,24,65,21,0,"https://fbref.com/en/players/9ab48bde/Pablo-de-Blasis"
2020,"Eibar","La Liga","Esteban Burgos","ARG","DF","27",1992,12.4,11,9,9,2,0,5,9,55.6,4,11,6,5,17,28,66,2,"https://fbref.com/en/players/40449bbd/Esteban-Burgos"
2020,"Eibar","La Liga","Charles","BRA","FW","35",1984,14.5,10,5,0,6,4,4,22,18.2,18,7,2,5,7,17,6,0,"https://fbref.com/en/players/c4b8bcf4/Charles"
2020,"Eibar","La Liga","Rober Correa","ESP","DF","26",1992,10.3,13,6,8,3,2,6,10,60,4,6,4,2,16,29,31,0,"https://fbref.com/en/players/46bd3a5b/Rober-Correa"
2020,"Eibar","La Liga","Sebastián Cristóforo","URU","MF","25",1993,9.7,35,19,11,14,10,13,32,40.6,19,25,3,22,8,43,2,0,"https://fbref.com/en/players/3c05c659/Sebastian-Cristoforo"
2020,"Eibar","La Liga","Papakouli Diop","SEN","MF","33",1986,25,39,26,13,22,4,18,42,42.9,24,24,7,17,34,73,38,0,"https://fbref.com/en/players/7329018e/Papakouli-Diop"
2020,"Eibar","La Liga","Marko Dmitrović","SRB","GK","27",1992,35,3,2,3,0,0,3,5,60,2,1,0,1,3,6,24,0,"https://fbref.com/en/players/ac295d9e/Marko-Dmitrovic"
2020,"Eibar","La Liga","Sergi Enrich","ESP","FW","29",1990,20.7,17,6,4,8,5,4,21,19,17,16,2,14,9,26,12,0,"https://fbref.com/en/players/bb4b1242/Sergi-Enrich"
2020,"Eibar","La Liga","Gonzalo Escalante","ARG","MF","26",1993,18.6,41,22,15,17,9,24,41,58.5,17,22,4,18,29,70,14,0,"https://fbref.com/en/players/3f79a1c8/Gonzalo-Escalante"
2020,"Eibar","La Liga","Edu Expósito","ESP","MF","22",1996,25.7,52,28,12,31,9,18,49,36.7,31,20,6,14,31,83,18,1,"https://fbref.com/en/players/283c7121/Edu-Exposito"
2020,"Eibar","La Liga","Takashi Inui","JPN","MF,FW","31",1988,21.8,20,10,7,8,5,11,34,32.4,23,23,4,19,18,38,12,0,"https://fbref.com/en/players/61bd33d0/Takashi-Inui"
2020,"Eibar","La Liga","Kike","ESP","FW","29",1989,19.6,13,7,0,5,8,4,12,33.3,8,15,1,14,1,14,9,0,"https://fbref.com/en/players/e897d8ba/Kike"
2020,"Eibar","La Liga","Pedro León","ESP","MF,FW","32",1986,21.1,28,20,8,9,11,12,25,48,13,18,1,17,19,47,7,0,"https://fbref.com/en/players/d66b9872/Pedro-Leon"
2020,"Eibar","La Liga","Miguel Marí","ESP","MF","22",1997,0.1,0,0,0,0,0,0,0,NA,0,0,0,0,0,0,0,0,"https://fbref.com/en/players/d70a3661/Miguel-Mari"
2020,"Eibar","La Liga","Paulo Oliveira","POR","DF","27",1992,23.2,31,19,22,8,1,18,30,60,12,23,13,10,42,73,107,1,"https://fbref.com/en/players/a8fbae1d/Paulo-Oliveira"
2020,"Eibar","La Liga","Fabián Orellana","CHI","MF,FW","33",1986,26.6,29,18,10,6,13,14,52,26.9,38,9,0,9,20,49,2,0,"https://fbref.com/en/players/c90977db/Fabian-Orellana"
2020,"Eibar","La Liga","Quique","ESP","FW,MF","29",1990,5.4,2,1,1,0,1,0,0,NA,0,3,0,3,0,2,3,0,"https://fbref.com/en/players/c966fce1/Quique"
2020,"Eibar","La Liga","Iván Ramis","ESP","DF","34",1984,5.1,3,2,2,1,0,1,4,25,3,2,0,2,4,7,23,2,"https://fbref.com/en/players/d2be40f2/Ivan-Ramis"
2020,"Eibar","La Liga","Rafa Soares","POR","DF","24",1995,4.8,6,5,5,0,1,5,11,45.5,6,1,0,1,2,8,6,0,"https://fbref.com/en/players/062fc2e6/Rafa-Soares"
2020,"Eibar","La Liga","Álvaro Tejero","ESP","DF","23",1996,16.1,30,18,17,10,3,14,23,60.9,9,17,4,13,28,58,38,0,"https://fbref.com/en/players/868ce848/Alvaro-Tejero"
2020,"Eibar","La Liga","Yoel","ESP","GK","30",1988,3,0,0,0,0,0,0,0,NA,0,0,0,0,1,1,1,0,"https://fbref.com/en/players/61bb7498/Yoel"
2020,"Eint Frankfurt","Bundesliga","David Abraham","ARG","DF","33",1986,18.8,21,14,16,4,1,15,32,46.9,17,27,11,16,25,46,61,1,"https://fbref.com/en/players/565bf0da/David-Abraham"
2020,"Eint Frankfurt","Bundesliga","Timothy Chandler","USA","DF,MF","29",1990,13.6,22,10,9,8,5,9,16,56.3,7,9,4,5,13,35,21,0,"https://fbref.com/en/players/b3b7f5a6/Timothy-Chandler"
2020,"Eint Frankfurt","Bundesliga","Danny da Costa","GER","DF,FW","26",1993,15.4,26,17,14,8,4,6,16,37.5,10,16,1,15,15,41,26,0,"https://fbref.com/en/players/5ddb8f9f/Danny-da-Costa"
2020,"Eint Frankfurt","Bundesliga","Bas Dost","NED","FW","30",1989,16.4,11,7,1,7,3,3,7,42.9,4,6,2,4,5,16,22,0,"https://fbref.com/en/players/dc90cfbe/Bas-Dost"
2020,"Eint Frankfurt","Bundesliga","Erik Durm","GER","DF,FW","27",1992,5.7,13,6,9,2,2,9,17,52.9,8,11,2,9,3,16,11,0,"https://fbref.com/en/players/cf623c78/Erik-Durm"
2020,"Eint Frankfurt","Bundesliga","Simon Falette","GUI","DF","27",1992,1,0,0,0,0,0,0,1,0,1,3,3,0,3,3,5,0,"https://fbref.com/en/players/b82880c6/Simon-Falette"
2020,"Eint Frankfurt","Bundesliga","Gelson Fernandes","SUI","MF","32",1986,8.6,30,18,13,17,0,7,21,33.3,14,11,3,8,16,46,9,2,"https://fbref.com/en/players/8e58987d/Gelson-Fernandes"
2020,"Eint Frankfurt","Bundesliga","Mijat Gaćinović","SRB","MF,FW","24",1995,11.6,19,11,7,8,4,6,25,24,19,26,2,24,15,34,6,0,"https://fbref.com/en/players/16daec92/Mijat-Gacinovic"
2020,"Eint Frankfurt","Bundesliga","Jonathan de Guzmán","NED","MF","31",1987,1,1,1,0,1,0,1,7,14.3,6,2,0,2,1,2,0,0,"https://fbref.com/en/players/1bcca8b8/Jonathan-de-Guzman"
2020,"Eint Frankfurt","Bundesliga","Makoto Hasebe","JPN","DF,MF","35",1984,21.9,28,20,16,9,3,18,39,46.2,21,38,10,28,26,54,38,0,"https://fbref.com/en/players/9ab16552/Makoto-Hasebe"
2020,"Eint Frankfurt","Bundesliga","Martin Hinteregger","AUT","DF","26",1992,30.2,66,51,33,30,3,28,57,49.1,29,41,21,20,36,102,96,0,"https://fbref.com/en/players/080440a4/Martin-Hinteregger"
2020,"Eint Frankfurt","Bundesliga","Stefan Ilsanker","AUT","DF,MF","30",1989,9.3,23,15,16,7,0,10,23,43.5,13,8,1,7,19,42,26,0,"https://fbref.com/en/players/8494acc4/Stefan-Ilsanker"
2020,"Eint Frankfurt","Bundesliga","Dejan Joveljić","SRB","FW","19",1999,1.7,2,2,1,1,0,0,1,0,1,0,0,0,0,2,1,0,"https://fbref.com/en/players/95a24690/Dejan-Joveljic"
2020,"Eint Frankfurt","Bundesliga","Daichi Kamada","JPN","MF,FW","22",1996,21.9,29,20,7,17,5,8,42,19,34,16,1,15,10,39,6,0,"https://fbref.com/en/players/15b287da/Daichi-Kamada"
2020,"Eint Frankfurt","Bundesliga","Dominik Kohr","GER","MF","25",1994,16.1,44,35,15,25,4,18,53,34,35,31,11,20,30,74,16,0,"https://fbref.com/en/players/0fbecd11/Dominik-Kohr"
2020,"Eint Frankfurt","Bundesliga","Filip Kostić","SRB","DF,FW","26",1992,32.9,59,38,30,20,9,22,59,37.3,37,45,2,43,23,82,16,0,"https://fbref.com/en/players/b1cd37e6/Filip-Kostic"
2020,"Eint Frankfurt","Bundesliga","Obite N'Dicka","FRA","DF","19",1999,19.1,27,13,13,11,3,15,28,53.6,13,28,6,22,29,56,57,0,"https://fbref.com/en/players/441197b8/Obite-NDicka"
2020,"Eint Frankfurt","Bundesliga","Gonçalo Paciência","POR","FW","24",1994,14.3,9,5,1,4,4,3,13,23.1,10,9,1,8,1,10,11,0,"https://fbref.com/en/players/962e54cb/Goncalo-Paciencia"
2020,"Eint Frankfurt","Bundesliga","Ante Rebić","CRO","FW,MF","25",1993,1,1,0,0,1,0,0,0,NA,0,0,0,0,0,1,1,0,"https://fbref.com/en/players/536cebe5/Ante-Rebic"
2020,"Eint Frankfurt","Bundesliga","Sebastian Rode","GER","MF","28",1990,21.5,58,33,27,27,4,17,59,28.8,42,32,5,27,34,92,13,0,"https://fbref.com/en/players/e12b0b5b/Sebastian-Rode"
2020,"Eint Frankfurt","Bundesliga","Frederik Rønnow","DEN","GK","26",1992,9,0,0,0,0,0,0,1,0,1,0,0,0,0,0,1,0,"https://fbref.com/en/players/a70b8345/Frederik-Ronnow"
2020,"Eint Frankfurt","Bundesliga","André Silva","POR","FW","23",1995,17.5,7,2,0,5,2,2,14,14.3,12,9,0,9,8,15,4,0,"https://fbref.com/en/players/3effaa34/Andre-Silva"
2020,"Eint Frankfurt","Bundesliga","Djibril Sow","SUI","MF","22",1997,19.4,56,33,26,17,13,16,47,34,31,15,3,12,30,86,9,0,"https://fbref.com/en/players/4c6facae/Djibril-Sow"
2020,"Eint Frankfurt","Bundesliga","Lucas Torró","ESP","MF","25",1994,3.7,12,7,6,6,0,8,16,50,8,2,1,1,8,20,3,0,"https://fbref.com/en/players/0e4fef6e/Lucas-Torro"
2020,"Eint Frankfurt","Bundesliga","Almamy Touré","MLI","DF","23",1996,16.6,32,19,18,11,3,11,22,50,11,18,7,11,23,55,54,1,"https://fbref.com/en/players/c8c60119/Almamy-Toure"
2020,"Eint Frankfurt","Bundesliga","Kevin Trapp","GER","GK","29",1990,22,0,0,0,0,0,0,1,0,1,0,0,0,3,3,5,0,"https://fbref.com/en/players/ce17b5eb/Kevin-Trapp"
2020,"Eint Frankfurt","Bundesliga","Felix Wiedwald","GER","GK","29",1990,3,0,0,0,0,0,0,0,NA,0,0,0,0,0,0,2,1,"https://fbref.com/en/players/e2d34771/Felix-Wiedwald"
2020,"Espanyol","La Liga","Leandro Cabrera","URU","DF","28",1991,17,27,11,17,9,1,17,28,60.7,11,19,12,7,21,48,78,1,"https://fbref.com/en/players/69cbc8b6/Leandro-Cabrera"
2020,"Espanyol","La Liga","Fernando Calero","ESP","DF","23",1995,11.6,14,9,10,4,0,7,15,46.7,8,13,5,8,8,22,42,1,"https://fbref.com/en/players/41b3069f/Fernando-Calero"
2020,"Espanyol","La Liga","Jonathan Calleri","ARG","FW","25",1993,20.1,12,8,6,4,2,3,24,12.5,21,11,3,8,7,19,22,0,"https://fbref.com/en/players/6922f806/Jonathan-Calleri"
2020,"Espanyol","La Liga","Víctor Campuzano","ESP","FW","22",1997,9.7,12,9,1,6,5,3,19,15.8,16,8,0,8,2,14,4,0,"https://fbref.com/en/players/06983922/Victor-Campuzano"
2020,"Espanyol","La Liga","Sébastien Corchia","FRA","DF","28",1990,3,2,1,2,0,0,2,4,50,2,5,2,3,5,7,8,0,"https://fbref.com/en/players/0e7ccfc4/Sebastien-Corchia"
2020,"Espanyol","La Liga","Sergi Darder","ESP","MF","25",1993,29.5,47,23,11,26,10,17,58,29.3,41,30,1,29,24,71,23,1,"https://fbref.com/en/players/070a3904/Sergi-Darder"
2020,"Espanyol","La Liga","Adri Embarba","ESP","MF,FW","27",1992,15.2,37,22,16,16,5,16,33,48.5,17,28,4,24,16,53,11,0,"https://fbref.com/en/players/db8f0eba/Adri-Embarba"
2020,"Espanyol","La Liga","Bernardo Espinosa","COL","DF","30",1989,25.1,24,16,18,4,2,16,28,57.1,12,19,11,8,24,48,108,2,"https://fbref.com/en/players/4242011c/Bernardo-Espinosa"
2020,"Espanyol","La Liga","Facundo Ferreyra","ARG","FW,MF","28",1991,6.4,9,4,4,5,0,3,10,30,7,4,0,4,2,11,5,0,"https://fbref.com/en/players/b39a793e/Facundo-Ferreyra"
2020,"Espanyol","La Liga","Esteban Granero","ESP","MF","32",1987,5.3,10,4,5,3,2,5,11,45.5,6,3,2,1,2,12,5,0,"https://fbref.com/en/players/1b17ed86/Esteban-Granero"
2020,"Espanyol","La Liga","Ander Iturraspe","ESP","MF","30",1989,2.7,2,0,1,1,0,2,5,40,3,0,0,0,1,3,7,0,"https://fbref.com/en/players/6dce77a5/Ander-Iturraspe"
2020,"Espanyol","La Liga","Wu Lei","CHN","FW,MF","27",1991,19.1,13,8,5,6,2,4,38,10.5,34,32,1,31,15,28,19,1,"https://fbref.com/en/players/e3fabb0a/Wu-Lei"
2020,"Espanyol","La Liga","David López","ESP","DF,MF","29",1989,27.3,38,20,15,20,3,13,41,31.7,28,28,13,15,35,73,63,3,"https://fbref.com/en/players/f03f284b/David-Lopez"
2020,"Espanyol","La Liga","Diego López","ESP","GK","37",1981,35.9,2,2,2,0,0,1,2,50,1,0,0,0,2,4,8,1,"https://fbref.com/en/players/73683fa9/Diego-Lopez"
2020,"Espanyol","La Liga","Javi López","ESP","DF","33",1986,15.4,47,34,23,18,6,19,40,47.5,21,12,6,6,21,68,38,2,"https://fbref.com/en/players/ffad706e/Javi-Lopez"
2020,"Espanyol","La Liga","Lluis López","ESP","DF","22",1997,3.3,4,2,3,1,0,2,2,100,0,4,0,4,1,5,6,1,"https://fbref.com/en/players/a685f013/Lluis-Lopez"
2020,"Espanyol","La Liga","Pol Lozano","ESP","MF","19",1999,1.9,5,3,3,2,0,3,7,42.9,4,3,0,3,1,6,2,0,"https://fbref.com/en/players/ea610f00/Pol-Lozano"
2020,"Espanyol","La Liga","Óscar Melendo","ESP","MF,FW","21",1997,12.4,10,4,4,4,2,4,12,33.3,8,7,2,5,2,12,3,0,"https://fbref.com/en/players/379652be/Oscar-Melendo"
2020,"Espanyol","La Liga","Naldo","BRA","DF","30",1988,14.8,24,13,15,9,0,7,15,46.7,8,11,7,4,21,45,50,1,"https://fbref.com/en/players/a2609621/Naldo"
2020,"Espanyol","La Liga","Oier Olazábal","ESP","GK","29",1989,2,0,0,0,0,0,0,0,NA,0,1,0,1,0,0,0,0,"https://fbref.com/en/players/b5bdf144/Oier-Olazabal"
2020,"Espanyol","La Liga","Pedrosa","ESP","DF,MF","21",1998,12.1,19,13,8,9,2,7,25,28,18,12,1,11,11,30,32,0,"https://fbref.com/en/players/112521d1/Pedrosa"
2020,"Espanyol","La Liga","Victor Perea","ESP","DF,FW","19",2000,14.1,13,5,8,4,1,7,20,35,13,10,0,10,21,34,31,0,"https://fbref.com/en/players/b7de5bad/Victor-Perea"
2020,"Espanyol","La Liga","Pablo Piatti","ARG","DF,MF","30",1989,0.6,2,2,1,1,0,1,2,50,1,1,0,1,0,2,1,0,"https://fbref.com/en/players/48e89655/Pablo-Piatti"
2020,"Espanyol","La Liga","Pipa","ESP","DF,FW","21",1998,5.3,9,8,5,4,0,4,6,66.7,2,8,0,8,6,15,17,0,"https://fbref.com/en/players/10f1cd17/Pipa"
2020,"Espanyol","La Liga","Nico Ribaudo","ESP","FW,MF","18",2001,2,3,1,1,0,2,2,6,33.3,4,1,0,1,1,4,0,0,"https://fbref.com/en/players/ce8039aa/Nico-Ribaudo"
2020,"Espanyol","La Liga","Marc Roca","ESP","MF","22",1996,33.4,82,52,29,44,9,29,82,35.4,53,28,10,18,31,113,53,2,"https://fbref.com/en/players/da27e268/Marc-Roca"
2020,"Espanyol","La Liga","Víctor Sánchez","ESP","MF","31",1987,18.8,66,36,36,23,7,30,71,42.3,41,31,8,23,27,93,23,1,"https://fbref.com/en/players/ad4d0985/Victor-Sanchez"
2020,"Espanyol","La Liga","Kévin Soni","CMR","FW","21",1998,0,0,0,0,0,0,0,0,NA,0,0,0,0,0,0,0,0,"https://fbref.com/en/players/6435143e/Kevin-Soni"
2020,"Espanyol","La Liga","Raúl de Tomás","ESP","FW","24",1994,11.9,9,7,3,4,2,4,13,30.8,9,8,1,7,10,19,4,0,"https://fbref.com/en/players/02ef8778/Raul-de-Tomas"
2020,"Espanyol","La Liga","Matías Vargas","ARG","FW,MF","22",1997,11.4,13,5,7,3,3,4,23,17.4,19,12,2,10,3,16,5,0,"https://fbref.com/en/players/ce82f116/Matias-Vargas"
2020,"Espanyol","La Liga","Dídac Vilà","ESP","DF","30",1989,27.7,73,42,44,23,6,25,61,41,36,31,5,26,40,113,63,0,"https://fbref.com/en/players/bad38a94/Didac-Vila"
2020,"Everton","Premier League","Leighton Baines","ENG","DF","34",1984,4.5,10,6,6,2,2,8,10,80,2,5,2,3,5,15,14,0,"https://fbref.com/en/players/b18095b6/Leighton-Baines"
2020,"Everton","Premier League","Bernard","BRA","MF,FW","26",1992,14.2,32,22,12,14,6,13,44,29.5,31,22,2,20,16,48,7,0,"https://fbref.com/en/players/ab4b3e35/Bernard"
2020,"Everton","Premier League","Jarrad Branthwaite","ENG","DF","17",2002,3.3,8,7,5,3,0,3,5,60,2,6,3,3,2,10,12,0,"https://fbref.com/en/players/c1949191/Jarrad-Branthwaite"
2020,"Everton","Premier League","Dominic Calvert-Lewin","ENG","FW","22",1997,29.2,7,5,1,4,2,1,10,10,9,15,2,13,6,13,36,0,"https://fbref.com/en/players/59e6e5bf/Dominic-Calvert-Lewin"
2020,"Everton","Premier League","Séamus Coleman","IRL","DF","30",1988,20.4,42,31,24,14,4,19,25,76,6,21,9,12,24,66,43,1,"https://fbref.com/en/players/0420d84f/Seamus-Coleman"
2020,"Everton","Premier League","Tom Davies","ENG","MF","21",1998,22.5,38,17,12,22,4,17,55,30.9,38,12,4,8,35,73,28,0,"https://fbref.com/en/players/9228b07c/Tom-Davies"
2020,"Everton","Premier League","Fabian Delph","ENG","MF","29",1989,13.2,26,12,10,13,3,9,22,40.9,13,12,3,9,15,41,19,1,"https://fbref.com/en/players/111c3236/Fabian-Delph"
2020,"Everton","Premier League","Lucas Digne","FRA","DF","26",1993,33.7,73,49,49,19,5,33,68,48.5,35,39,10,29,42,115,108,0,"https://fbref.com/en/players/1b84dbe1/Lucas-Digne"
2020,"Everton","Premier League","Jean-Philippe Gbamin","CIV","MF","23",1995,1.5,4,3,1,1,2,1,2,50,1,1,0,1,1,5,4,0,"https://fbref.com/en/players/6bd603db/Jean-Philippe-Gbamin"
2020,"Everton","Premier League","André Gomes","POR","MF","26",1993,16.2,22,15,7,11,4,8,62,12.9,54,20,3,17,7,29,7,0,"https://fbref.com/en/players/1961b2aa/Andre-Gomes"
2020,"Everton","Premier League","Anthony Gordon","ENG","MF,FW","18",2001,4.9,11,7,5,6,0,5,15,33.3,10,6,2,4,8,19,4,0,"https://fbref.com/en/players/2bd83368/Anthony-Gordon"
2020,"Everton","Premier League","Mason Holgate","ENG","DF","22",1996,22.8,44,26,30,13,1,21,31,67.7,10,26,13,13,34,78,97,0,"https://fbref.com/en/players/d0042ab9/Mason-Holgate"
2020,"Everton","Premier League","Alex Iwobi","NGA","MF,FW","23",1996,17.7,25,17,8,15,2,12,33,36.4,21,18,2,16,14,39,10,1,"https://fbref.com/en/players/6ca5ec4b/Alex-Iwobi"
2020,"Everton","Premier League","Moise Kean","ITA","FW","19",2000,9.5,6,6,5,1,0,0,0,NA,0,4,0,4,5,11,1,1,"https://fbref.com/en/players/3d50bcdb/Moise-Kean"
2020,"Everton","Premier League","Michael Keane","ENG","DF","26",1993,28.4,31,16,18,12,1,14,24,58.3,10,35,28,7,44,75,152,0,"https://fbref.com/en/players/c5b7c315/Michael-Keane"
2020,"Everton","Premier League","Yerry Mina","COL","DF","24",1994,25.4,39,22,25,12,2,18,24,75,6,20,14,6,28,67,102,1,"https://fbref.com/en/players/6d5701f2/Yerry-Mina"
2020,"Everton","Premier League","Oumar Niasse","SEN","FW","29",1990,0.2,4,0,0,2,2,0,0,NA,0,0,0,0,1,5,0,0,"https://fbref.com/en/players/af721f98/Oumar-Niasse"
2020,"Everton","Premier League","Jordan Pickford","ENG","GK","25",1994,38,0,0,0,0,0,0,4,0,4,0,0,0,3,3,12,6,"https://fbref.com/en/players/4806ec67/Jordan-Pickford"
2020,"Everton","Premier League","Richarlison","BRA","FW,MF","22",1997,34.1,70,47,28,28,14,27,56,48.2,29,34,4,30,12,82,42,0,"https://fbref.com/en/players/fa031b34/Richarlison"
2020,"Everton","Premier League","Morgan Schneiderlin","FRA","MF","29",1989,11.1,31,22,13,16,2,8,24,33.3,16,13,3,10,21,52,20,1,"https://fbref.com/en/players/51b41c5c/Morgan-Schneiderlin"
2020,"Everton","Premier League","Djibril Sidibé","FRA","DF,MF","27",1992,20.3,83,44,48,25,10,43,72,59.7,29,19,3,16,40,123,41,0,"https://fbref.com/en/players/4c5b714f/Djibril-Sidibe"
2020,"Everton","Premier League","Gylfi Sigurðsson","ISL","MF","29",1989,28.4,50,26,15,24,11,19,70,27.1,51,30,4,26,37,87,17,1,"https://fbref.com/en/players/76dd1480/Gylfi-Sigurdsson"
2020,"Everton","Premier League","Cenk Tosun","TUR","FW","28",1991,3.2,2,0,0,0,2,0,1,0,1,1,0,1,0,2,1,0,"https://fbref.com/en/players/9a104dee/Cenk-Tosun"
2020,"Everton","Premier League","Theo Walcott","ENG","MF,FW","30",1989,14.3,13,8,6,5,2,3,15,20,12,13,0,13,8,21,1,0,"https://fbref.com/en/players/1ecb65be/Theo-Walcott"
2020,"Fiorentina","Serie A","Kevin Agudelo","COL","MF,FW","20",1998,0.7,2,1,0,1,1,0,1,0,1,1,0,1,1,3,0,0,"https://fbref.com/en/players/46fa7204/Kevin-Agudelo"
2020,"Fiorentina","Serie A","Milan Badelj","CRO","MF","30",1989,17.6,29,17,10,16,3,15,50,30,35,21,3,18,45,74,34,1,"https://fbref.com/en/players/e8c930bb/Milan-Badelj"
2020,"Fiorentina","Serie A","Marco Benassi","ITA","MF","24",1994,10.9,18,12,9,5,4,10,24,41.7,14,11,1,10,4,22,9,0,"https://fbref.com/en/players/0000acda/Marco-Benassi"
2020,"Fiorentina","Serie A","Kevin-Prince Boateng","GHA","FW","32",1987,6.7,3,1,0,2,1,2,8,25,6,3,0,3,1,4,7,0,"https://fbref.com/en/players/f4ec4fd0/Kevin-Prince-Boateng"
2020,"Fiorentina","Serie A","Federico Brancolini","ITA","GK","18",2001,0.1,0,0,0,0,0,0,0,NA,0,0,0,0,0,0,0,0,"https://fbref.com/en/players/d4890c25/Federico-Brancolini"
2020,"Fiorentina","Serie A","Martín Cáceres","URU","DF","32",1987,26.2,47,31,34,11,2,16,34,47.1,18,29,13,16,31,78,74,2,"https://fbref.com/en/players/e94d79e3/Martin-Caceres"
2020,"Fiorentina","Serie A","Gaetano Castrovilli","ITA","MF","22",1997,29.7,59,31,25,23,11,18,53,34,35,29,2,27,15,74,31,1,"https://fbref.com/en/players/0728bebe/Gaetano-Castrovilli"
2020,"Fiorentina","Serie A","Federico Ceccherini","ITA","DF","27",1992,9.3,14,8,11,3,0,10,10,100,0,9,5,4,13,27,37,1,"https://fbref.com/en/players/d9624b51/Federico-Ceccherini"
2020,"Fiorentina","Serie A","Federico Chiesa","ITA","FW,DF","21",1997,29.3,38,22,13,15,10,10,52,19.2,42,19,0,19,6,44,6,0,"https://fbref.com/en/players/b0f7e36c/Federico-Chiesa"
2020,"Fiorentina","Serie A","Sebastián Cristóforo","URU","MF","25",1993,1,5,5,2,2,1,1,5,20,4,2,1,1,1,6,0,0,"https://fbref.com/en/players/3c05c659/Sebastian-Cristoforo"
2020,"Fiorentina","Serie A","Patrick Cutrone","ITA","FW","21",1998,9.3,4,2,2,1,1,1,15,6.7,14,6,1,5,2,6,6,0,"https://fbref.com/en/players/a4fe8cda/Patrick-Cutrone"
2020,"Fiorentina","Serie A","Christian Dalle Mura","ITA","FW","17",2002,0,0,0,0,0,0,0,0,NA,0,0,0,0,0,0,0,0,"https://fbref.com/en/players/f32df091/Christian-Dalle-Mura"
2020,"Fiorentina","Serie A","Bartłomiej Drągowski","POL","GK","21",1997,31,0,0,0,0,0,0,1,0,1,0,0,0,3,3,8,1,"https://fbref.com/en/players/085e71a7/Bartlomiej-Dragowski"
2020,"Fiorentina","Serie A","Alfred Duncan","GHA","MF","26",1993,9.9,12,9,11,1,0,2,19,10.5,17,4,0,4,5,17,12,0,"https://fbref.com/en/players/528492ea/Alfred-Duncan"
2020,"Fiorentina","Serie A","Valentin Eysseric","FRA","FW,MF","27",1992,0.5,0,0,0,0,0,0,0,NA,0,1,0,1,0,0,0,0,"https://fbref.com/en/players/ae82fa48/Valentin-Eysseric"
2020,"Fiorentina","Serie A","Rachid Ghezzal","ALG","MF,FW","27",1992,9.2,27,15,14,10,3,10,33,30.3,23,6,0,6,11,38,9,0,"https://fbref.com/en/players/dc3a9a0d/Rachid-Ghezzal"
2020,"Fiorentina","Serie A","Dalbert Henrique","BRA","DF,MF","25",1993,27.6,52,25,35,12,5,18,51,35.3,33,34,4,30,19,71,65,0,"https://fbref.com/en/players/f45f9427/Dalbert-Henrique"
2020,"Fiorentina","Serie A","Igor","BRA","DF","21",1998,6.8,12,10,8,2,2,6,7,85.7,1,10,4,6,7,19,16,0,"https://fbref.com/en/players/a4e85758/Igor"
2020,"Fiorentina","Serie A","Christian Kouamé","CIV","FW,MF","21",1997,3.3,3,2,0,3,0,0,1,0,1,5,1,4,1,4,1,0,"https://fbref.com/en/players/58e933d2/Christian-Kouame"
2020,"Fiorentina","Serie A","Pol Lirola","ESP","DF","21",1997,29.4,34,20,18,10,6,21,38,55.3,17,16,4,12,26,60,52,0,"https://fbref.com/en/players/ff800ed8/Pol-Lirola"
2020,"Fiorentina","Serie A","Nikola Milenković","SRB","DF","21",1997,36.2,46,25,30,16,0,11,31,35.5,20,39,21,18,29,75,129,1,"https://fbref.com/en/players/bee704fc/Nikola-Milenkovic"
2020,"Fiorentina","Serie A","Maximiliano Olivera","URU","MF","27",1992,0.1,1,0,1,0,0,0,0,NA,0,0,0,0,0,1,0,0,"https://fbref.com/en/players/32a33c68/Maximiliano-Olivera"
2020,"Fiorentina","Serie A","Pedro","BRA","FW","22",1997,0.7,1,1,0,0,1,0,0,NA,0,1,0,1,0,1,0,0,"https://fbref.com/en/players/1ab6fad3/Pedro"
2020,"Fiorentina","Serie A","Germán Pezzella","ARG","DF","28",1991,31.4,36,18,26,9,1,14,32,43.8,18,31,20,11,55,91,134,1,"https://fbref.com/en/players/8c725b43/German-Pezzella"
2020,"Fiorentina","Serie A","Erick Pulgar","CHI","MF","25",1994,32.8,73,46,25,41,7,22,96,22.9,74,45,15,30,49,122,53,1,"https://fbref.com/en/players/4611e028/Erick-Pulgar"
2020,"Fiorentina","Serie A","Luca Ranieri","ITA","DF","20",1999,2.6,2,2,2,0,0,2,3,66.7,1,1,0,1,2,4,7,0,"https://fbref.com/en/players/8c63fae5/Luca-Ranieri"
2020,"Fiorentina","Serie A","Franck Ribéry","FRA","FW","36",1983,15.7,20,14,7,10,3,4,20,20,16,9,0,9,3,23,3,0,"https://fbref.com/en/players/f61c7c4e/Franck-Ribery"
2020,"Fiorentina","Serie A","Riccardo Sottil","ITA","FW,DF","20",1999,5.7,6,4,4,2,0,3,10,30,7,4,0,4,0,6,0,0,"https://fbref.com/en/players/94816803/Riccardo-Sottil"
2020,"Fiorentina","Serie A","Pietro Terracciano","ITA","GK","29",1990,6.9,0,0,0,0,0,0,0,NA,0,0,0,0,0,0,4,0,"https://fbref.com/en/players/e1b0a70d/Pietro-Terracciano"
2020,"Fiorentina","Serie A","Aleksa Terzić","SRB","MF","19",1999,0.1,0,0,0,0,0,0,0,NA,0,0,0,0,0,0,0,0,"https://fbref.com/en/players/3ef0a2d7/Aleksa-Terzic"
2020,"Fiorentina","Serie A","Lorenzo Venuti","ITA","DF,MF","24",1995,9.5,20,10,12,6,2,13,19,68.4,6,5,1,4,11,31,15,0,"https://fbref.com/en/players/983ff2c7/Lorenzo-Venuti"
2020,"Fiorentina","Serie A","Dušan Vlahović","SRB","FW","19",2000,16.7,6,2,1,4,1,4,13,30.8,9,5,2,3,7,13,6,0,"https://fbref.com/en/players/79443529/Dusan-Vlahovic"
2020,"Fiorentina","Serie A","Szymon Żurkowski","POL","MF","21",1997,0.1,1,0,0,0,1,0,2,0,2,0,0,0,0,1,1,0,"https://fbref.com/en/players/4e1d5e59/Szymon-Zurkowski"
2020,"Freiburg","Bundesliga","Amir Abrashi","ALB","MF","29",1990,7.4,16,8,7,8,1,10,19,52.6,9,18,3,15,7,23,16,2,"https://fbref.com/en/players/1c08a3c8/Amir-Abrashi"
2020,"Freiburg","Bundesliga","Brandon Borrello","AUS","MF,FW","24",1995,3.3,10,4,6,4,0,4,10,40,6,7,1,6,1,11,1,0,"https://fbref.com/en/players/b4d90315/Brandon-Borrello"
2020,"Freiburg","Bundesliga","Kwon Chang-hoon","KOR","MF,FW","25",1994,7.5,7,4,2,3,2,1,10,10,9,5,1,4,7,14,14,0,"https://fbref.com/en/players/7961f7aa/Kwon-Chang-hoon"
2020,"Freiburg","Bundesliga","Mark Flekken","NED","GK","26",1993,10,0,0,0,0,0,0,1,0,1,0,0,0,0,0,2,2,"https://fbref.com/en/players/a92ab7be/Mark-Flekken"
2020,"Freiburg","Bundesliga","Mike Frantz","GER","MF","32",1986,3.9,4,2,1,3,0,2,9,22.2,7,5,3,2,1,5,4,0,"https://fbref.com/en/players/482b70ad/Mike-Frantz"
2020,"Freiburg","Bundesliga","Jérôme Gondorf","GER","MF","31",1988,1.3,9,6,7,1,1,3,6,50,3,3,2,1,0,9,2,0,"https://fbref.com/en/players/49ffe0f2/Jerome-Gondorf"
2020,"Freiburg","Bundesliga","Vincenzo Grifo","ITA","MF,FW","26",1993,18,15,10,9,3,3,6,25,24,19,13,1,12,14,29,18,1,"https://fbref.com/en/players/54e4866f/Vincenzo-Grifo"
2020,"Freiburg","Bundesliga","Manuel Gulde","GER","DF","28",1991,15.2,28,16,17,9,2,15,24,62.5,9,23,13,10,22,50,80,1,"https://fbref.com/en/players/25ab9c9c/Manuel-Gulde"
2020,"Freiburg","Bundesliga","Christian Günter","GER","DF","26",1993,33.7,25,11,17,7,1,12,35,34.3,23,29,13,16,14,39,40,0,"https://fbref.com/en/players/8593f88c/Christian-Gunter"
2020,"Freiburg","Bundesliga","Janik Haberer","GER","MF,FW","25",1994,19.1,26,18,8,14,4,12,45,26.7,33,25,4,21,25,51,23,0,"https://fbref.com/en/players/70dcf94d/Janik-Haberer"
2020,"Freiburg","Bundesliga","Dominique Heintz","GER","DF","25",1993,27,47,30,40,6,1,17,43,39.5,26,38,25,13,41,88,131,1,"https://fbref.com/en/players/699fb8db/Dominique-Heintz"
2020,"Freiburg","Bundesliga","Nicolas Höfler","GER","MF","29",1990,30.9,65,40,31,28,6,22,64,34.4,42,58,18,40,71,136,59,3,"https://fbref.com/en/players/5d8e331f/Nicolas-Hofler"
2020,"Freiburg","Bundesliga","Lucas Höler","GER","FW,MF","25",1994,27.6,35,15,11,16,8,11,46,23.9,35,30,9,21,12,47,38,0,"https://fbref.com/en/players/ca618d23/Lucas-Holer"
2020,"Freiburg","Bundesliga","Gian-Luca Itter","GER","DF,MF","20",1999,0.4,1,1,1,0,0,1,1,100,0,0,0,0,1,2,4,0,"https://fbref.com/en/players/e6c15f6e/Gian-Luca-Itter"
2020,"Freiburg","Bundesliga","Yannik Keitel","GER","MF","19",2000,1.9,2,1,1,1,0,0,6,0,6,3,1,2,4,6,4,0,"https://fbref.com/en/players/d2c580ce/Yannik-Keitel"
2020,"Freiburg","Bundesliga","Robin Koch","GER","DF,MF","23",1996,30.1,34,20,20,13,1,11,26,42.3,15,30,22,8,45,79,94,4,"https://fbref.com/en/players/ea6bc03a/Robin-Koch"
2020,"Freiburg","Bundesliga","Lukas Kübler","GER","DF","26",1992,2.3,1,1,0,1,0,1,5,20,4,2,0,2,1,2,6,0,"https://fbref.com/en/players/2a29eb9b/Lukas-Kubler"
2020,"Freiburg","Bundesliga","Philipp Lienhart","AUT","DF","23",1996,20.2,11,4,10,1,0,6,13,46.2,7,24,17,7,28,39,86,0,"https://fbref.com/en/players/302527b2/Philipp-Lienhart"
2020,"Freiburg","Bundesliga","Nils Petersen","GER","FW,MF","30",1988,27.1,19,14,7,9,3,10,28,35.7,18,32,6,26,10,29,67,0,"https://fbref.com/en/players/f93e6e94/Nils-Petersen"
2020,"Freiburg","Bundesliga","Roland Sallai","HUN","MF,FW","22",1997,12.9,17,10,4,9,4,7,20,35,13,12,2,10,7,24,4,0,"https://fbref.com/en/players/bf075f6b/Roland-Sallai"
2020,"Freiburg","Bundesliga","Nico Schlotterbeck","GER","DF","19",1999,4.1,6,3,4,2,0,2,5,40,3,7,5,2,3,9,20,1,"https://fbref.com/en/players/34e12499/Nico-Schlotterbeck"
2020,"Freiburg","Bundesliga","Jonathan Schmid","FRA","DF","29",1990,31.5,42,27,19,19,4,19,37,51.4,18,23,8,15,35,77,84,0,"https://fbref.com/en/players/088ca1bd/Jonathan-Schmid"
2020,"Freiburg","Bundesliga","Alexander Schwolow","GER","GK","27",1992,23.2,0,0,0,0,0,0,0,NA,0,2,0,2,1,1,8,3,"https://fbref.com/en/players/0d55d942/Alexander-Schwolow"
2020,"Freiburg","Bundesliga","Lino Tempelmann","GER","MF","20",1999,0.4,1,0,1,0,0,1,1,100,0,1,1,0,0,1,0,0,"https://fbref.com/en/players/4e3a947f/Lino-Tempelmann"
2020,"Freiburg","Bundesliga","Niclas Thiede","GER","GK","20",1999,0.8,0,0,0,0,0,0,0,NA,0,0,0,0,0,0,1,0,"https://fbref.com/en/players/cac55e10/Niclas-Thiede"
2020,"Freiburg","Bundesliga","Luca Waldschmidt","GER","FW,MF","23",1996,14.1,10,7,3,5,2,2,18,11.1,16,11,2,9,4,14,4,0,"https://fbref.com/en/players/e5a35ae9/Luca-Waldschmidt"
2020,"Genoa","Serie A","Kevin Agudelo","COL","MF,FW","20",1998,7.4,23,14,9,12,2,10,20,50,10,12,1,11,6,29,2,0,"https://fbref.com/en/players/46fa7204/Kevin-Agudelo"
2020,"Genoa","Serie A","Peter Ankersen","DEN","DF","28",1990,11.8,16,4,7,7,2,4,13,30.8,9,19,5,14,9,25,25,1,"https://fbref.com/en/players/df525574/Peter-Ankersen"
2020,"Genoa","Serie A","Antonio Barreca","ITA","DF,FW","24",1995,12.2,10,7,5,3,2,4,5,80,1,12,7,5,1,11,22,0,"https://fbref.com/en/players/6a189491/Antonio-Barreca"
2020,"Genoa","Serie A","Valon Behrami","SUI","MF","34",1985,12.3,34,26,13,17,4,8,32,25,24,25,10,15,9,43,16,0,"https://fbref.com/en/players/d3d758d8/Valon-Behrami"
2020,"Genoa","Serie A","Davide Biraschi","ITA","DF","25",1994,21.9,32,17,17,13,2,15,26,57.7,11,22,12,10,34,66,69,0,"https://fbref.com/en/players/64cd167d/Davide-Biraschi"
2020,"Genoa","Serie A","Francesco Cassata","ITA","MF","22",1997,16.2,20,10,12,5,3,9,30,30,21,12,2,10,11,31,11,0,"https://fbref.com/en/players/96960855/Francesco-Cassata"
2020,"Genoa","Serie A","Denilho Cleonise","NED","FW","17",2001,0.5,1,0,1,0,0,0,0,NA,0,0,0,0,1,2,0,0,"https://fbref.com/en/players/91c9de34/Denilho-Cleonise"
2020,"Genoa","Serie A","Domenico Criscito","ITA","DF","32",1986,22.8,53,33,34,12,7,24,56,42.9,32,25,13,12,53,106,81,1,"https://fbref.com/en/players/35dd6d80/Domenico-Criscito"
2020,"Genoa","Serie A","Mattia Destro","ITA","FW,MF","28",1991,1.7,0,0,0,0,0,0,0,NA,0,0,0,0,0,0,1,0,"https://fbref.com/en/players/d7d32194/Mattia-Destro"
2020,"Genoa","Serie A","Iago Falque","ESP","MF","29",1990,5.8,7,3,1,4,2,4,8,50,4,7,0,7,1,8,4,0,"https://fbref.com/en/players/440c84ed/Iago-Falque"
2020,"Genoa","Serie A","Andrea Favilli","ITA","FW","22",1997,7.3,8,7,2,3,3,4,11,36.4,7,5,1,4,0,8,7,0,"https://fbref.com/en/players/44510fde/Andrea-Favilli"
2020,"Genoa","Serie A","Paolo Ghiglione","ITA","DF,FW","22",1997,19.1,31,16,15,13,3,18,35,51.4,17,17,2,15,9,40,42,1,"https://fbref.com/en/players/71dc23da/Paolo-Ghiglione"
2020,"Genoa","Serie A","Edoardo Goldaniga","ITA","DF","25",1993,8.7,4,3,3,1,0,2,5,40,3,11,6,5,18,22,25,1,"https://fbref.com/en/players/4b029b31/Edoardo-Goldaniga"
2020,"Genoa","Serie A","Sinan Gümüş","TUR","FW,MF","25",1994,1.1,0,0,0,0,0,0,4,0,4,0,0,0,0,0,1,0,"https://fbref.com/en/players/ac1f056e/Sinan-Gumus"
2020,"Genoa","Serie A","Filip Jagiełło","POL","MF","21",1997,6.1,7,2,0,3,4,3,7,42.9,4,4,0,4,5,12,4,0,"https://fbref.com/en/players/4cdcbc14/Filip-Jagiello"
2020,"Genoa","Serie A","Christian Kouamé","CIV","FW","21",1997,10.2,2,1,0,1,1,0,8,0,8,8,2,6,1,3,13,0,"https://fbref.com/en/players/58e933d2/Christian-Kouame"
2020,"Genoa","Serie A","Lukas Lerager","DEN","MF","26",1993,15.4,29,19,13,12,4,10,34,29.4,24,20,5,15,8,37,15,1,"https://fbref.com/en/players/1b82f8df/Lukas-Lerager"
2020,"Genoa","Serie A","Andrea Masiello","ITA","DF","33",1986,14.7,26,15,17,8,1,16,32,50,16,8,2,6,26,52,55,2,"https://fbref.com/en/players/e0314d87/Andrea-Masiello"
2020,"Genoa","Serie A","Marko Pajač","CRO","DF,FW","26",1993,8.4,8,4,4,3,1,7,16,43.8,9,6,0,6,8,16,9,0,"https://fbref.com/en/players/5df4ef30/Marko-Pajac"
2020,"Genoa","Serie A","Goran Pandev","MKD","FW,MF","36",1983,18.7,12,8,2,7,3,3,25,12,22,4,1,3,0,12,5,1,"https://fbref.com/en/players/d711d04f/Goran-Pandev"
2020,"Genoa","Serie A","Mattia Perin","ITA","GK","26",1992,21,1,1,1,0,0,1,1,100,0,1,0,1,0,1,5,1,"https://fbref.com/en/players/4c62d0c8/Mattia-Perin"
2020,"Genoa","Serie A","Andrea Pinamonti","ITA","FW","20",1999,24.8,19,12,1,7,11,5,25,20,20,19,2,17,9,28,25,0,"https://fbref.com/en/players/08aa9cd1/Andrea-Pinamonti"
2020,"Genoa","Serie A","Ivan Radovanović","SRB","MF","30",1988,14.6,27,14,18,9,0,10,26,38.5,16,17,3,14,8,35,39,0,"https://fbref.com/en/players/023937a9/Ivan-Radovanovic"
2020,"Genoa","Serie A","Ionuț Radu","ROU","GK","22",1997,17,0,0,0,0,0,0,2,0,2,0,0,0,1,1,7,1,"https://fbref.com/en/players/67f649be/Ionut-Radu"
2020,"Genoa","Serie A","Cristian Romero","ARG","DF","21",1998,28.6,52,35,36,12,4,12,41,29.3,29,59,33,26,75,127,116,2,"https://fbref.com/en/players/a3d94a58/Cristian-Romero"
2020,"Genoa","Serie A","Rômulo","ITA","DF","32",1987,0.2,2,1,1,1,0,0,0,NA,0,0,0,0,0,2,1,0,"https://fbref.com/en/players/07abb358/Romulo"
2020,"Genoa","Serie A","Nicolò Rovella","ITA","MF","17",2001,1.2,0,0,0,0,0,0,1,0,1,0,0,0,4,4,0,0,"https://fbref.com/en/players/e58cbfd5/Nicolo-Rovella"
2020,"Genoa","Serie A","Antonio Sanabria","PAR","FW","23",1996,15.4,14,11,2,7,5,3,14,21.4,11,13,1,12,5,19,12,1,"https://fbref.com/en/players/0a447501/Antonio-Sanabria"
2020,"Genoa","Serie A","Riccardo Saponara","ITA","MF,FW","27",1991,1.9,4,3,2,2,0,0,2,0,2,2,1,1,0,4,2,0,"https://fbref.com/en/players/3bb7af3b/Riccardo-Saponara"
2020,"Genoa","Serie A","Lasse Schöne","DEN","MF","33",1986,27,42,26,16,22,4,15,48,31.3,33,22,6,16,37,79,25,2,"https://fbref.com/en/players/c3a8bcd8/Lasse-Schone"
2020,"Genoa","Serie A","Adama Soumaoro","FRA","DF","27",1992,7.1,3,2,3,0,0,1,3,33.3,2,12,12,0,11,14,32,0,"https://fbref.com/en/players/7b075c75/Adama-Soumaoro"
2020,"Genoa","Serie A","Stefano Sturaro","ITA","MF","26",1993,13.9,38,22,14,19,5,15,39,38.5,24,16,4,12,10,48,26,1,"https://fbref.com/en/players/2334478a/Stefano-Sturaro"
2020,"Genoa","Serie A","Jawad El Yamiq","MAR","DF","27",1992,2.2,3,2,3,0,0,1,4,25,3,3,2,1,1,4,3,0,"https://fbref.com/en/players/f6f6b6e8/Jawad-El-Yamiq"
2020,"Genoa","Serie A","Cristián Zapata","COL","DF","32",1986,19.1,23,17,16,7,0,8,16,50,8,29,17,12,24,47,75,0,"https://fbref.com/en/players/b1deecf8/Cristian-Zapata"
2020,"Getafe","La Liga","Amath","SEN","MF","23",1996,0.7,2,1,1,1,0,0,5,0,5,2,0,2,0,2,0,0,"https://fbref.com/en/players/f3b1d9a2/Amath"
2020,"Getafe","La Liga","Vitorino Antunes","POR","MF","32",1987,0.1,0,0,0,0,0,0,0,NA,0,0,0,0,0,0,1,0,"https://fbref.com/en/players/3e4f735d/Vitorino-Antunes"
2020,"Getafe","La Liga","Mauro Arambarri","URU","MF","23",1995,34.1,72,33,24,40,8,31,69,44.9,38,52,5,47,43,115,40,2,"https://fbref.com/en/players/58afe001/Mauro-Arambarri"
2020,"Getafe","La Liga","Markel Bergara","ESP","MF","33",1986,0.8,0,0,0,0,0,0,0,NA,0,0,0,0,0,0,2,0,"https://fbref.com/en/players/04a65a8f/Markel-Bergara"
2020,"Getafe","La Liga","Erick Cabaco","URU","DF","24",1995,3,3,2,1,2,0,0,3,0,3,1,1,0,3,6,11,0,"https://fbref.com/en/players/e7ab4179/Erick-Cabaco"
2020,"Getafe","La Liga","Leandro Cabrera","URU","DF","28",1991,17,10,6,5,5,0,5,12,41.7,7,10,4,6,21,31,66,0,"https://fbref.com/en/players/69cbc8b6/Leandro-Cabrera"
2020,"Getafe","La Liga","Chema","ESP","DF","27",1992,3.4,4,3,1,3,0,1,2,50,1,1,0,1,5,9,12,0,"https://fbref.com/en/players/7f203b54/Chema"
2020,"Getafe","La Liga","Marc Cucurella","ESP","MF,DF","21",1998,36,74,51,23,38,13,24,76,31.6,52,58,8,50,36,110,28,1,"https://fbref.com/en/players/1daec722/Marc-Cucurella"
2020,"Getafe","La Liga","Deyverson","BRA","FW","28",1991,2.3,0,0,0,0,0,0,1,0,1,2,1,1,0,0,5,0,"https://fbref.com/en/players/2e5e846d/Deyverson"
2020,"Getafe","La Liga","Djené","TOG","DF","27",1991,34,42,32,27,15,0,17,30,56.7,13,20,7,13,34,76,105,1,"https://fbref.com/en/players/a4971d84/Djene"
2020,"Getafe","La Liga","Hugo Duro","ESP","FW,MF","19",1999,4.2,6,5,2,2,2,4,8,50,4,3,0,3,1,7,3,0,"https://fbref.com/en/players/37e103f8/Hugo-Duro"
2020,"Getafe","La Liga","Oghenekaro Etebo","NGA","MF","23",1995,6.4,12,4,5,7,0,7,12,58.3,5,10,1,9,11,23,4,1,"https://fbref.com/en/players/b579e83d/Oghenekaro-Etebo"
2020,"Getafe","La Liga","Xabier Etxeita","ESP","DF","31",1987,16.1,20,11,11,9,0,12,23,52.2,11,9,5,4,17,37,68,0,"https://fbref.com/en/players/4a895384/Xabier-Etxeita"
2020,"Getafe","La Liga","Fayçal Fajr","MAR","MF","30",1988,4.5,1,1,0,1,0,0,3,0,3,4,0,4,4,5,1,0,"https://fbref.com/en/players/79135368/Faycal-Fajr"
2020,"Getafe","La Liga","Enric Gallego","ESP","FW","32",1986,1.8,3,1,1,1,1,2,4,50,2,2,0,2,2,5,1,0,"https://fbref.com/en/players/82e9b89d/Enric-Gallego"
2020,"Getafe","La Liga","Raúl García","ESP","DF","30",1989,2.7,5,3,2,3,0,3,6,50,3,3,1,2,4,9,10,0,"https://fbref.com/en/players/1a317a1b/Raul-Garcia"
2020,"Getafe","La Liga","Bruno González","ESP","DF","29",1990,2,3,2,3,0,0,1,1,100,0,2,0,2,0,3,3,0,"https://fbref.com/en/players/f11fe861/Bruno-Gonzalez"
2020,"Getafe","La Liga","Jason","ESP","MF","25",1994,13.1,29,20,8,16,5,15,33,45.5,18,18,3,15,18,47,9,0,"https://fbref.com/en/players/9038c2a1/Jason"
2020,"Getafe","La Liga","Kenedy","BRA","MF","23",1996,6.5,9,5,3,3,3,2,5,40,3,10,0,10,11,20,4,0,"https://fbref.com/en/players/5eebbfdf/Kenedy"
2020,"Getafe","La Liga","Nemanja Maksimović","SRB","MF","24",1995,32.2,49,28,12,31,6,10,44,22.7,34,37,7,30,56,105,30,1,"https://fbref.com/en/players/00b28772/Nemanja-Maksimovic"
2020,"Getafe","La Liga","Jaime Mata","ESP","FW","30",1988,30.5,21,13,3,11,7,3,20,15,17,16,1,15,7,28,15,0,"https://fbref.com/en/players/02319ad7/Jaime-Mata"
2020,"Getafe","La Liga","Jorge Molina","ESP","FW","37",1982,21,8,2,0,4,4,0,12,0,12,13,2,11,4,12,18,0,"https://fbref.com/en/players/43f71e77/Jorge-Molina"
2020,"Getafe","La Liga","Allan Nyom","CMR","DF,MF","31",1988,26.9,45,25,26,15,4,20,37,54.1,17,24,5,19,14,59,50,1,"https://fbref.com/en/players/97572117/Allan-Nyom"
2020,"Getafe","La Liga","Mathías Olivera","URU","DF","21",1997,20.8,64,40,34,16,14,27,45,60,18,32,3,29,23,87,44,0,"https://fbref.com/en/players/41c12f75/Mathias-Olivera"
2020,"Getafe","La Liga","Francisco Portillo","ESP","MF","29",1990,4.2,11,6,3,6,2,4,12,33.3,8,2,0,2,2,13,3,0,"https://fbref.com/en/players/8e010ff4/Francisco-Portillo"
2020,"Getafe","La Liga","Florent Poulolo","MTQ","DF","22",1997,0,0,0,0,0,0,0,0,NA,0,0,0,0,0,0,1,0,"https://fbref.com/en/players/07129f3c/Florent-Poulolo"
2020,"Getafe","La Liga","Ángel Rodríguez","ESP","FW","32",1987,15.6,14,8,2,8,4,2,18,11.1,16,10,1,9,3,17,10,0,"https://fbref.com/en/players/8cfc2f69/Angel-Rodriguez"
2020,"Getafe","La Liga","David Soria","ESP","GK","26",1993,38,2,1,2,0,0,2,4,50,2,0,0,0,3,5,17,5,"https://fbref.com/en/players/8f8c6934/David-Soria"
2020,"Getafe","La Liga","Damián Suárez","URU","DF","31",1988,28.8,62,32,32,21,9,38,72,52.8,34,25,2,23,27,89,41,0,"https://fbref.com/en/players/ba5004e1/Damian-Suarez"
2020,"Getafe","La Liga","David Timor","ESP","MF,DF","29",1989,10.5,9,6,4,5,0,5,16,31.3,11,8,3,5,18,27,23,0,"https://fbref.com/en/players/174651c8/David-Timor"
2020,"Granada","La Liga","Ramon Azeez","NGA","MF","26",1992,15.1,11,8,2,8,1,7,19,36.8,12,8,2,6,19,30,11,1,"https://fbref.com/en/players/0cc474e7/Ramon-Azeez"
2020,"Granada","La Liga","Gil Bastião Dias","POR","MF,DF","22",1996,4,19,14,10,6,3,7,17,41.2,10,4,1,3,3,22,7,0,"https://fbref.com/en/players/e61bdd69/Gil-Bastiao-Dias"
2020,"Granada","La Liga","Yan Brice Eteki","CMR","MF","21",1997,16.7,37,21,14,18,5,15,31,48.4,16,17,4,13,24,61,20,1,"https://fbref.com/en/players/3d688b46/Yan-Brice-Eteki"
2020,"Granada","La Liga","Antonio Cortés","ESP","FW,MF","19",2000,2,1,1,0,1,0,0,1,0,1,0,0,0,0,1,2,0,"https://fbref.com/en/players/31a1288d/Antonio-Cortes"
2020,"Granada","La Liga","Víctor Díaz","ESP","DF","31",1988,32,74,43,38,31,5,31,60,51.7,29,53,23,30,48,122,94,1,"https://fbref.com/en/players/3624ce4c/Victor-Diaz"
2020,"Granada","La Liga","Domingos Duarte","POR","DF","24",1995,34.3,30,19,24,5,1,11,20,55,9,34,24,10,34,64,153,1,"https://fbref.com/en/players/93090f69/Domingos-Duarte"
2020,"Granada","La Liga","Aarón Escandell","ESP","GK","23",1995,3,1,1,1,0,0,1,1,100,0,0,0,0,0,1,0,0,"https://fbref.com/en/players/67669ce7/Aaron-Escandell"
2020,"Granada","La Liga","Carlos Fernández","ESP","FW,MF","23",1996,24.5,24,15,7,11,6,3,32,9.4,29,25,2,23,11,35,30,0,"https://fbref.com/en/players/e08647d6/Carlos-Fernandez"
2020,"Granada","La Liga","Dimitri Foulquier","FRA","DF,MF","26",1993,12.4,25,11,13,9,3,11,20,55,9,8,3,5,16,41,32,0,"https://fbref.com/en/players/45e17712/Dimitri-Foulquier"
2020,"Granada","La Liga","Maxime Gonalons","FRA","MF","30",1989,16.7,62,38,25,35,2,22,54,40.7,32,27,3,24,20,82,20,1,"https://fbref.com/en/players/b8c1de25/Maxime-Gonalons"
2020,"Granada","La Liga","Yangel Herrera","VEN","MF","21",1998,26.3,88,49,25,53,10,36,80,45,44,38,9,29,34,122,28,0,"https://fbref.com/en/players/e778654a/Yangel-Herrera"
2020,"Granada","La Liga","İsmail Köybaşı","TUR","DF,FW","30",1989,2.6,4,4,3,1,0,0,2,0,2,4,0,4,5,9,2,0,"https://fbref.com/en/players/58640e66/Ismail-Koybasi"
2020,"Granada","La Liga","Darwin Machís","VEN","FW,MF","26",1993,23.7,23,13,11,8,4,8,23,34.8,15,22,4,18,31,54,9,0,"https://fbref.com/en/players/ed6ea4d9/Darwin-Machis"
2020,"Granada","La Liga","Álex Martínez","ESP","DF","28",1990,0.2,0,0,0,0,0,0,0,NA,0,0,0,0,0,0,0,0,"https://fbref.com/en/players/e1c805cf/Alex-Martinez"
2020,"Granada","La Liga","José Martínez","ESP","DF","26",1993,13.2,21,16,12,8,1,14,25,56,11,6,4,2,18,39,46,0,"https://fbref.com/en/players/8e049cbd/Jose-Martinez"
2020,"Granada","La Liga","Ángel Montoro","ESP","MF","31",1988,10.8,19,8,8,9,2,3,13,23.1,10,10,1,9,13,32,15,0,"https://fbref.com/en/players/719384c1/Angel-Montoro"
2020,"Granada","La Liga","Carlos Neva","ESP","DF","23",1996,24.5,16,11,12,3,1,9,21,42.9,12,15,2,13,28,44,60,0,"https://fbref.com/en/players/8d47bb39/Carlos-Neva"
2020,"Granada","La Liga","Antonio Puertas","ESP","FW,MF","27",1992,28.5,37,24,8,18,11,16,53,30.2,37,21,3,18,12,49,21,0,"https://fbref.com/en/players/c77a8043/Antonio-Puertas"
2020,"Granada","La Liga","Quini","ESP","DF","29",1989,8,25,14,16,7,2,13,22,59.1,9,5,1,4,10,35,14,0,"https://fbref.com/en/players/7a538238/Quini"
2020,"Granada","La Liga","Adrián Ramos","COL","FW,MF","33",1986,2.5,6,2,0,2,4,2,3,66.7,1,2,0,2,1,7,1,0,"https://fbref.com/en/players/c693cf7c/Adrian-Ramos"
2020,"Granada","La Liga","Mario Rodriguez","ESP","MF","22",1997,0,0,0,0,0,0,0,0,NA,0,0,0,0,0,0,0,0,"https://fbref.com/en/players/a5cdedc7/Mario-Rodriguez"
2020,"Granada","La Liga","Germán Sánchez","ESP","DF","32",1986,25.5,16,10,12,4,0,6,16,37.5,10,29,23,6,33,49,115,2,"https://fbref.com/en/players/ea9b2ef9/German-Sanchez"
2020,"Granada","La Liga","Rui Silva","POR","GK","25",1994,35,2,1,2,0,0,2,2,100,0,0,0,0,2,4,22,3,"https://fbref.com/en/players/ea83bfa6/Rui-Silva"
2020,"Granada","La Liga","Roberto Soldado","ESP","FW","34",1985,26.1,16,9,2,7,7,7,24,29.2,17,16,4,12,4,20,16,0,"https://fbref.com/en/players/9d66fbe3/Roberto-Soldado"
2020,"Granada","La Liga","Álvaro Vadillo","ESP","FW,MF","24",1994,13.5,16,11,6,8,2,9,16,56.3,7,12,0,12,7,23,2,0,"https://fbref.com/en/players/61b62b33/Alvaro-Vadillo"
2020,"Granada","La Liga","Jesús Vallejo","ESP","DF","22",1997,7,6,5,4,2,0,3,4,75,1,7,4,3,5,11,28,0,"https://fbref.com/en/players/c2111b45/Jesus-Vallejo"
2020,"Granada","La Liga","Fede Vico","ESP","MF,FW","25",1994,9.7,5,1,2,3,0,2,11,18.2,9,12,1,11,5,10,2,0,"https://fbref.com/en/players/f681a8ef/Fede-Vico"
2020,"Hellas Verona","Serie A","Claud Adjapong","ITA","DF","21",1998,2.6,5,3,4,1,0,2,3,66.7,1,4,3,1,3,8,7,0,"https://fbref.com/en/players/ce5b170a/Claud-Adjapong"
2020,"Hellas Verona","Serie A","Emmanuel Agyemang-Badu","GHA","MF","28",1990,2.6,1,1,0,1,0,1,2,50,1,2,2,0,1,2,6,0,"https://fbref.com/en/players/fe0b8f0e/Emmanuel-Agyemang-Badu"
2020,"Hellas Verona","Serie A","Sofyan Amrabat","MAR","MF","22",1996,32.4,58,36,26,21,11,26,55,47.3,29,29,10,19,31,89,15,1,"https://fbref.com/en/players/5a2cb25d/Sofyan-Amrabat"
2020,"Hellas Verona","Serie A","Salvatore Bocchetti","ITA","DF","32",1986,3.4,5,3,3,2,0,2,3,66.7,1,2,2,0,17,22,23,0,"https://fbref.com/en/players/faa1b07d/Salvatore-Bocchetti"
2020,"Hellas Verona","Serie A","Fabio Borini","ITA","MF,FW","28",1991,9,2,1,2,0,0,0,4,0,4,3,0,3,13,15,6,0,"https://fbref.com/en/players/ef5b337e/Fabio-Borini"
2020,"Hellas Verona","Serie A","Andrea Danzi","ITA","MF","20",1999,0,0,0,0,0,0,0,0,NA,0,0,0,0,0,0,0,0,"https://fbref.com/en/players/263b855a/Andrea-Danzi"
2020,"Hellas Verona","Serie A","Paweł Dawidowicz","POL","DF","24",1995,7.7,15,12,11,4,0,5,11,45.5,6,6,5,1,12,27,26,0,"https://fbref.com/en/players/16bb656a/Pawel-Dawidowicz"
2020,"Hellas Verona","Serie A","Samuel Di Carmine","ITA","FW,MF","30",1988,14.4,2,1,0,0,2,0,8,0,8,3,0,3,1,3,10,0,"https://fbref.com/en/players/ef94dc2f/Samuel-Di-Carmine"
2020,"Hellas Verona","Serie A","Federico Dimarco","ITA","DF","21",1997,5.8,11,5,4,4,3,6,10,60,4,3,2,1,4,15,11,0,"https://fbref.com/en/players/970b8574/Federico-Dimarco"
2020,"Hellas Verona","Serie A","Alan Empereur","BRA","DF","25",1994,9.5,16,8,11,4,1,6,10,60,4,19,12,7,22,38,36,0,"https://fbref.com/en/players/825b8997/Alan-Empereur"
2020,"Hellas Verona","Serie A","Valentin Eysseric","FRA","MF,FW","27",1992,3.9,4,4,1,2,1,0,4,0,4,3,0,3,1,5,2,0,"https://fbref.com/en/players/ae82fa48/Valentin-Eysseric"
2020,"Hellas Verona","Serie A","Davide Faraoni","ITA","DF","27",1991,35.9,67,37,43,19,5,30,67,44.8,37,50,15,35,36,103,115,0,"https://fbref.com/en/players/aae9d04a/Davide-Faraoni"
2020,"Hellas Verona","Serie A","Lucas Felippe","BRA","MF,DF","19",2000,0.3,1,1,1,0,0,1,1,100,0,0,0,0,0,1,0,0,"https://fbref.com/en/players/85e51909/Lucas-Felippe"
2020,"Hellas Verona","Serie A","Koray Günter","GER","DF","24",1994,30.4,39,25,22,15,2,19,29,65.5,10,45,39,6,55,94,131,1,"https://fbref.com/en/players/f1f1f238/Koray-Gunter"
2020,"Hellas Verona","Serie A","Liam Henderson","SCO","MF","23",1996,2.2,3,2,0,3,0,2,3,66.7,1,1,0,1,0,3,4,0,"https://fbref.com/en/players/d7918b13/Liam-Henderson"
2020,"Hellas Verona","Serie A","Marash Kumbulla","ALB","DF","19",2000,21.7,40,24,21,17,2,19,36,52.8,17,33,24,9,50,90,86,3,"https://fbref.com/en/players/a40819d9/Marash-Kumbulla"
2020,"Hellas Verona","Serie A","Darko Lazović","SRB","DF","28",1990,36,26,16,14,8,4,14,27,51.9,13,15,4,11,23,49,53,0,"https://fbref.com/en/players/5128bde4/Darko-Lazovic"
2020,"Hellas Verona","Serie A","Matteo Lovato","ITA","DF","19",2000,0.1,0,0,0,0,0,0,0,NA,0,0,0,0,0,0,1,0,"https://fbref.com/en/players/5fa57166/Matteo-Lovato"
2020,"Hellas Verona","Serie A","Giampaolo Pazzini","ITA","FW,MF","34",1984,3.4,1,0,0,1,0,0,4,0,4,2,0,2,1,2,4,0,"https://fbref.com/en/players/6ca663b4/Giampaolo-Pazzini"
2020,"Hellas Verona","Serie A","Matteo Pessina","ITA","MF","22",1997,27.7,35,21,9,20,6,12,33,36.4,21,28,8,20,25,60,40,2,"https://fbref.com/en/players/780e3631/Matteo-Pessina"
2020,"Hellas Verona","Serie A","Boris Radunović","SRB","GK","23",1996,3,0,0,0,0,0,0,0,NA,0,0,0,0,0,0,1,0,"https://fbref.com/en/players/0dfce079/Boris-Radunovic"
2020,"Hellas Verona","Serie A","Amir Rrahmani","KVX","DF","25",1994,35.9,50,31,26,19,5,26,46,56.5,20,50,31,19,30,80,151,1,"https://fbref.com/en/players/4b3e1a38/Amir-Rrahmani"
2020,"Hellas Verona","Serie A","Eddie Salcedo","ITA","FW,MF","17",2001,7.6,3,1,2,0,1,0,5,0,5,4,0,4,1,4,2,0,"https://fbref.com/en/players/0489bb30/Eddie-Salcedo"
2020,"Hellas Verona","Serie A","Marco Silvestri","ITA","GK","28",1991,35,1,0,1,0,0,1,2,50,1,0,0,0,4,5,11,1,"https://fbref.com/en/players/0d422df7/Marco-Silvestri"
2020,"Hellas Verona","Serie A","Mariusz Stępiński","POL","FW,MF","24",1995,7.8,5,3,2,1,2,1,2,50,1,3,1,2,1,6,7,0,"https://fbref.com/en/players/7b536033/Mariusz-Stepinski"
2020,"Hellas Verona","Serie A","Gennaro Tutino","ITA","FW,MF","22",1996,2.5,0,0,0,0,0,0,0,NA,0,0,0,0,2,2,1,0,"https://fbref.com/en/players/8b303bcb/Gennaro-Tutino"
2020,"Hellas Verona","Serie A","Miguel Veloso","POR","MF","33",1986,31.2,52,29,20,28,4,18,60,30,42,36,12,24,32,84,46,1,"https://fbref.com/en/players/ab1ca213/Miguel-Veloso"
2020,"Hellas Verona","Serie A","Valerio Verre","ITA","MF,FW","25",1994,19.7,25,15,4,11,10,9,23,39.1,14,5,0,5,13,38,9,0,"https://fbref.com/en/players/33ecf462/Valerio-Verre"
2020,"Hellas Verona","Serie A","Luigi Vitale","ITA","DF","31",1987,0.5,1,0,0,1,0,0,0,NA,0,1,0,1,0,1,0,0,"https://fbref.com/en/players/fe479e17/Luigi-Vitale"
2020,"Hellas Verona","Serie A","Mattia Zaccagni","ITA","MF,FW","24",1995,23.5,20,11,10,5,5,3,15,20,12,14,3,11,20,40,21,0,"https://fbref.com/en/players/d85c238b/Mattia-Zaccagni"
2020,"Hertha BSC","Bundesliga","Santiago Ascacíbar","ARG","MF","22",1997,7,26,13,15,11,0,11,28,39.3,17,13,2,11,16,42,13,0,"https://fbref.com/en/players/e26fcca3/Santiago-Ascacibar"
2020,"Hertha BSC","Bundesliga","Dedryck Boyata","BEL","DF","28",1990,27.1,24,18,17,5,2,4,12,33.3,8,39,32,7,62,86,158,1,"https://fbref.com/en/players/7c473e12/Dedryck-Boyata"
2020,"Hertha BSC","Bundesliga","Per Ciljan Skjelbred","NOR","MF","32",1987,18.1,50,30,18,29,3,17,41,41.5,24,14,3,11,23,73,17,0,"https://fbref.com/en/players/ecab64a0/Per-Ciljan-Skjelbred"
2020,"Hertha BSC","Bundesliga","Matheus Cunha","BRA","FW,MF","20",1999,8.3,10,5,6,4,0,4,11,36.4,7,11,1,10,10,20,1,0,"https://fbref.com/en/players/dc62b55d/Matheus-Cunha"
2020,"Hertha BSC","Bundesliga","Vladimír Darida","CZE","MF","28",1990,25.1,50,27,14,31,5,11,48,22.9,37,44,7,37,27,77,19,2,"https://fbref.com/en/players/3eb0f2df/Vladimir-Darida"
2020,"Hertha BSC","Bundesliga","Javairô Dilrosun","NED","MF,FW","21",1998,14.5,15,8,11,1,3,5,13,38.5,8,20,0,20,18,33,10,0,"https://fbref.com/en/players/34a0f5ff/Javairo-Dilrosun"
2020,"Hertha BSC","Bundesliga","Ondrej Duda","SVK","MF","24",1994,5,6,4,1,2,3,1,10,10,9,3,1,2,5,11,5,0,"https://fbref.com/en/players/79ca3e23/Ondrej-Duda"
2020,"Hertha BSC","Bundesliga","Alexander Esswein","GER","FW,MF","29",1990,2.4,6,4,4,2,0,3,8,37.5,5,8,1,7,7,13,7,1,"https://fbref.com/en/players/b48215cd/Alexander-Esswein"
2020,"Hertha BSC","Bundesliga","Marko Grujić","SRB","MF","23",1996,26.8,56,34,21,30,5,19,63,30.2,44,43,9,34,22,78,69,0,"https://fbref.com/en/players/8b8e759d/Marko-Grujic"
2020,"Hertha BSC","Bundesliga","Vedad Ibišević","BIH","FW","34",1984,14,4,3,0,1,3,0,3,0,3,4,0,4,1,5,15,0,"https://fbref.com/en/players/c3fd9887/Vedad-Ibisevic"
2020,"Hertha BSC","Bundesliga","Rune Jarstein","NOR","GK","34",1984,28.3,4,1,4,0,0,2,3,66.7,1,0,0,0,1,5,11,3,"https://fbref.com/en/players/27d2618c/Rune-Jarstein"
2020,"Hertha BSC","Bundesliga","Salomon Kalou","CIV","FW,MF","33",1985,1.6,1,0,1,0,0,0,2,0,2,2,0,2,0,1,1,0,"https://fbref.com/en/players/2042d931/Salomon-Kalou"
2020,"Hertha BSC","Bundesliga","Lukas Klünter","GER","DF","23",1996,20.9,44,31,26,16,2,20,30,66.7,10,16,4,12,27,71,61,1,"https://fbref.com/en/players/92948149/Lukas-Klunter"
2020,"Hertha BSC","Bundesliga","Pascal Köpke","GER","FW","23",1995,1.3,0,0,0,0,0,0,0,NA,0,0,0,0,0,0,0,0,"https://fbref.com/en/players/3861d9cc/Pascal-Kopke"
2020,"Hertha BSC","Bundesliga","Thomas Kraft","GER","GK","31",1988,4,0,0,0,0,0,0,0,NA,0,0,0,0,1,1,0,0,"https://fbref.com/en/players/bb25c778/Thomas-Kraft"
2020,"Hertha BSC","Bundesliga","Mathew Leckie","AUS","DF,FW","28",1991,2.2,3,1,1,2,0,2,3,66.7,1,6,0,6,2,5,2,1,"https://fbref.com/en/players/b93b7882/Mathew-Leckie"
2020,"Hertha BSC","Bundesliga","Eduard Löwen","GER","MF","22",1997,3.5,9,6,3,6,0,5,11,45.5,6,2,1,1,7,16,2,0,"https://fbref.com/en/players/70678132/Eduard-Lowen"
2020,"Hertha BSC","Bundesliga","Dodi Lukebakio","BEL","FW,MF","21",1997,22.6,25,18,13,8,4,10,28,35.7,18,22,4,18,10,35,14,0,"https://fbref.com/en/players/0c61c77c/Dodi-Lukebakio"
2020,"Hertha BSC","Bundesliga","Arne Maier","GER","MF","20",1999,5.9,9,7,6,1,2,1,10,10,9,5,0,5,7,16,2,1,"https://fbref.com/en/players/ab700320/Arne-Maier"
2020,"Hertha BSC","Bundesliga","Maximilian Mittelstädt","GER","DF,FW","22",1997,21,61,38,31,25,5,26,54,48.1,28,38,6,32,53,114,64,0,"https://fbref.com/en/players/88d4144a/Maximilian-Mittelstadt"
2020,"Hertha BSC","Bundesliga","Jessic Ngankam","GER","FW,MF","19",2000,0.9,2,2,1,1,0,2,2,100,0,2,0,2,0,2,1,0,"https://fbref.com/en/players/bc249af8/Jessic-Ngankam"
2020,"Hertha BSC","Bundesliga","Peter Pekarík","SVK","DF,FW","32",1986,8.5,14,7,7,3,4,8,20,40,12,11,4,7,7,21,31,0,"https://fbref.com/en/players/c18d22f5/Peter-Pekarik"
2020,"Hertha BSC","Bundesliga","Krzysztof Piątek","POL","FW","24",1995,10.1,5,4,1,1,3,0,11,0,11,7,0,7,5,10,3,0,"https://fbref.com/en/players/17f3620a/Krzysztof-Piatek"
2020,"Hertha BSC","Bundesliga","Marvin Plattenhardt","GER","DF","27",1992,15.5,18,12,13,4,1,12,17,70.6,5,18,7,11,11,29,47,0,"https://fbref.com/en/players/f7aa75bd/Marvin-Plattenhardt"
2020,"Hertha BSC","Bundesliga","Daishawn Redan","NED","MF","18",2001,0.2,0,0,0,0,0,0,1,0,1,0,0,0,0,0,0,0,"https://fbref.com/en/players/16b4260e/Daishawn-Redan"
2020,"Hertha BSC","Bundesliga","Karim Rekik","NED","DF","24",1994,14,16,10,10,6,0,3,6,50,3,23,15,8,18,34,44,0,"https://fbref.com/en/players/3376a776/Karim-Rekik"
2020,"Hertha BSC","Bundesliga","Lazar Samardzic","GER","MF,FW","17",2002,0.4,4,4,2,2,0,1,4,25,3,2,1,1,0,4,0,0,"https://fbref.com/en/players/217c93a1/Lazar-Samardzic"
2020,"Hertha BSC","Bundesliga","Davie Selke","GER","FW","24",1995,10.7,6,3,2,2,2,4,7,57.1,3,7,1,6,1,7,11,0,"https://fbref.com/en/players/1238a3f9/Davie-Selke"
2020,"Hertha BSC","Bundesliga","Dennis Smarsch","GER","GK","20",1999,1.7,0,0,0,0,0,0,0,NA,0,0,0,0,0,0,1,0,"https://fbref.com/en/players/45f6f52b/Dennis-Smarsch"
2020,"Hertha BSC","Bundesliga","Niklas Stark","GER","DF","24",1995,19.2,36,20,24,10,2,9,21,42.9,12,27,12,15,21,57,97,2,"https://fbref.com/en/players/aad48be9/Niklas-Stark"
2020,"Hertha BSC","Bundesliga","Jordan Torunarigha","GER","DF","21",1997,16.2,32,19,21,11,0,18,27,66.7,9,33,18,15,31,63,75,0,"https://fbref.com/en/players/f86cabbd/Jordan-Torunarigha"
2020,"Hertha BSC","Bundesliga","Marius Wolf","GER","FW,MF","24",1995,15.7,19,11,9,7,3,10,27,37,17,14,1,13,17,36,13,0,"https://fbref.com/en/players/fa661778/Marius-Wolf"
2020,"Hoffenheim","Bundesliga","Sargis Adamyan","ARM","FW,MF","26",1993,8.3,11,7,3,6,2,3,21,14.3,18,8,1,7,2,13,4,0,"https://fbref.com/en/players/22919e97/Sargis-Adamyan"
2020,"Hoffenheim","Bundesliga","Kevin Akpoguma","NGA","DF","24",1995,12.7,24,16,20,4,0,13,24,54.2,11,21,11,10,13,37,48,0,"https://fbref.com/en/players/6ec6fde0/Kevin-Akpoguma"
2020,"Hoffenheim","Bundesliga","Oliver Baumann","GER","GK","29",1990,30,0,0,0,0,0,0,0,NA,0,1,0,1,3,3,15,0,"https://fbref.com/en/players/47064058/Oliver-Baumann"
2020,"Hoffenheim","Bundesliga","Christoph Baumgartner","AUT","MF,FW","19",1999,16.6,32,17,15,16,1,10,37,27,27,25,1,24,8,40,13,0,"https://fbref.com/en/players/437f2b00/Christoph-Baumgartner"
2020,"Hoffenheim","Bundesliga","Ihlas Bebou","TOG","FW,MF","25",1994,23.4,27,15,9,13,5,8,23,34.8,15,25,4,21,11,38,25,0,"https://fbref.com/en/players/a53b661f/Ihlas-Bebou"
2020,"Hoffenheim","Bundesliga","Maximilian Beier","GER","FW","16",2002,1.2,5,2,0,1,4,1,2,50,1,2,0,2,0,5,0,0,"https://fbref.com/en/players/5db45ee5/Maximilian-Beier"
2020,"Hoffenheim","Bundesliga","Ishak Belfodil","ALG","FW,MF","27",1992,3,0,0,0,0,0,0,1,0,1,0,0,0,0,0,2,0,"https://fbref.com/en/players/ff182fdc/Ishak-Belfodil"
2020,"Hoffenheim","Bundesliga","Ermin Bičakčić","BIH","DF","29",1990,13.1,7,3,5,2,0,4,11,36.4,7,14,8,6,25,32,64,2,"https://fbref.com/en/players/7aac47fe/Ermin-Bicakcic"
2020,"Hoffenheim","Bundesliga","Leonardo Bittencourt","GER","MF","25",1993,0,1,1,0,0,1,0,0,NA,0,0,0,0,0,1,0,0,"https://fbref.com/en/players/dc62fbee/Leonardo-Bittencourt"
2020,"Hoffenheim","Bundesliga","Melayro Bogarde","NED","DF","17",2002,0.6,2,1,2,0,0,2,2,100,0,0,0,0,0,2,3,0,"https://fbref.com/en/players/1fda91b3/Melayro-Bogarde"
2020,"Hoffenheim","Bundesliga","Jacob Bruun Larsen","DEN","FW,MF","20",1998,4.3,3,2,3,0,0,3,8,37.5,5,3,0,3,3,6,1,0,"https://fbref.com/en/players/4e204552/Jacob-Bruun-Larsen"
2020,"Hoffenheim","Bundesliga","Moanes Dabbur","ISR","FW","27",1992,8.5,8,5,1,3,4,3,10,30,7,6,2,4,4,12,1,0,"https://fbref.com/en/players/eac044ad/Moanes-Dabbur"
2020,"Hoffenheim","Bundesliga","Ilay Elmkies","ISR","MF","19",2000,0,1,1,1,0,0,0,0,NA,0,0,0,0,0,1,0,0,"https://fbref.com/en/players/6cb0211b/Ilay-Elmkies"
2020,"Hoffenheim","Bundesliga","Dennis Geiger","GER","MF","21",1998,12.6,12,5,4,6,2,2,16,12.5,14,9,2,7,6,18,4,0,"https://fbref.com/en/players/37f606f0/Dennis-Geiger"
2020,"Hoffenheim","Bundesliga","Vincenzo Grifo","ITA","MF","26",1993,0.2,0,0,0,0,0,0,0,NA,0,0,0,0,0,0,0,0,"https://fbref.com/en/players/54e4866f/Vincenzo-Grifo"
2020,"Hoffenheim","Bundesliga","Florian Grillitsch","AUT","MF,DF","23",1995,26.8,59,29,34,24,1,29,61,47.5,32,33,6,27,49,108,41,1,"https://fbref.com/en/players/ffbbc83b/Florian-Grillitsch"
2020,"Hoffenheim","Bundesliga","Benjamin Hübner","GER","DF","30",1989,23,42,26,33,9,0,23,45,51.1,22,18,13,5,30,72,98,2,"https://fbref.com/en/players/99de6b6f/Benjamin-Hubner"
2020,"Hoffenheim","Bundesliga","Pavel Kadeřábek","CZE","DF,FW","27",1992,27.5,32,22,17,13,2,13,30,43.3,17,29,7,22,27,59,55,1,"https://fbref.com/en/players/79c90e45/Pavel-Kaderabek"
2020,"Hoffenheim","Bundesliga","Andrej Kramarić","CRO","FW,MF","28",1991,15.8,2,1,1,0,1,1,7,14.3,6,6,0,6,3,5,4,0,"https://fbref.com/en/players/603cb947/Andrej-Kramaric"
2020,"Hoffenheim","Bundesliga","Jürgen Locadia","NED","FW","25",1993,5.9,5,4,0,4,1,1,4,25,3,1,0,1,0,5,3,0,"https://fbref.com/en/players/6cc47ae1/Jurgen-Locadia"
2020,"Hoffenheim","Bundesliga","Håvard Nordtveit","NOR","DF","29",1990,7.8,4,1,3,1,0,3,7,42.9,4,17,12,5,13,17,45,0,"https://fbref.com/en/players/6cafd68d/Havard-Nordtveit"
2020,"Hoffenheim","Bundesliga","Philipp Pentke","GER","GK","34",1985,4,0,0,0,0,0,0,0,NA,0,0,0,0,0,0,2,0,"https://fbref.com/en/players/c41f7379/Philipp-Pentke"
2020,"Hoffenheim","Bundesliga","Stefan Posch","AUT","DF","22",1997,25.6,63,34,35,27,1,35,63,55.6,28,57,25,32,40,103,101,1,"https://fbref.com/en/players/7f609bfc/Stefan-Posch"
2020,"Hoffenheim","Bundesliga","Lucas Ribeiro","BRA","MF","20",1999,0.7,1,0,1,0,0,0,3,0,3,1,0,1,1,2,1,0,"https://fbref.com/en/players/607d64c6/Lucas-Ribeiro"
2020,"Hoffenheim","Bundesliga","Sebastian Rudy","GER","MF,DF","29",1990,30.4,73,49,31,29,13,28,75,37.3,47,26,5,21,27,100,38,0,"https://fbref.com/en/players/80f36c88/Sebastian-Rudy"
2020,"Hoffenheim","Bundesliga","Lukas Rupp","GER","MF","28",1991,3.8,9,4,3,5,1,3,6,50,3,5,0,5,5,14,3,0,"https://fbref.com/en/players/3faa1780/Lukas-Rupp"
2020,"Hoffenheim","Bundesliga","Diadie Samassékou","MLI","MF","23",1996,14.6,37,18,14,17,6,12,34,35.3,22,25,8,17,40,77,27,1,"https://fbref.com/en/players/08593525/Diadie-Samassekou"
2020,"Hoffenheim","Bundesliga","Robert Skov","DEN","DF,FW","23",1996,29,41,28,30,9,2,26,50,52,24,26,6,20,20,61,40,0,"https://fbref.com/en/players/ff98492b/Robert-Skov"
2020,"Hoffenheim","Bundesliga","Kostas Stafylidis","GRE","DF","25",1993,4.4,10,3,7,2,1,4,10,40,6,10,3,7,2,12,17,0,"https://fbref.com/en/players/861e0116/Kostas-Stafylidis"
2020,"Hoffenheim","Bundesliga","Kevin Vogt","GER","DF","27",1991,10.7,7,5,4,3,0,3,9,33.3,6,12,6,6,8,15,52,1,"https://fbref.com/en/players/1d8e9add/Kevin-Vogt"
2020,"Hoffenheim","Bundesliga","Steven Zuber","SUI","DF,FW","27",1991,8.3,11,10,7,2,2,9,19,47.4,10,4,1,3,9,20,12,0,"https://fbref.com/en/players/b6a6e0a7/Steven-Zuber"
2020,"Inter","Serie A","Lucien Agoume","FRA","MF","17",2002,0.8,3,2,0,2,1,0,0,NA,0,3,1,2,0,3,0,0,"https://fbref.com/en/players/8bc8829a/Lucien-Agoume"
2020,"Inter","Serie A","Kwadwo Asamoah","GHA","DF,FW","30",1988,7.1,10,8,4,5,1,6,14,42.9,8,8,1,7,9,19,13,0,"https://fbref.com/en/players/089550f5/Kwadwo-Asamoah"
2020,"Inter","Serie A","Nicolò Barella","ITA","MF","22",1997,22.4,36,21,14,15,7,8,37,21.6,29,20,5,15,14,50,14,0,"https://fbref.com/en/players/6928979a/Nicolo-Barella"
2020,"Inter","Serie A","Alessandro Bastoni","ITA","DF","20",1999,21.3,32,17,14,11,7,15,24,62.5,9,18,9,9,26,58,54,0,"https://fbref.com/en/players/75b86fb3/Alessandro-Bastoni"
2020,"Inter","Serie A","Cristiano Biraghi","ITA","DF","26",1992,17.5,22,6,10,8,4,10,24,41.7,14,21,7,14,13,35,41,0,"https://fbref.com/en/players/9e1577aa/Cristiano-Biraghi"
2020,"Inter","Serie A","Marcelo Brozović","CRO","MF","26",1992,30,67,35,26,31,10,19,71,26.8,52,26,9,17,46,113,46,2,"https://fbref.com/en/players/33b8d077/Marcelo-Brozovic"
2020,"Inter","Serie A","Antonio Candreva","ITA","DF","32",1987,22.1,11,6,9,1,1,7,29,24.1,22,26,10,16,14,25,33,1,"https://fbref.com/en/players/356c9002/Antonio-Candreva"
2020,"Inter","Serie A","Danilo D'Ambrosio","ITA","DF","30",1988,15.6,30,16,16,12,2,16,33,48.5,17,15,4,11,14,44,25,0,"https://fbref.com/en/players/44eb9093/Danilo-DAmbrosio"
2020,"Inter","Serie A","Federico Dimarco","ITA","DF","21",1997,0.3,1,0,0,1,0,0,0,NA,0,0,0,0,1,2,1,0,"https://fbref.com/en/players/970b8574/Federico-Dimarco"
2020,"Inter","Serie A","Christian Eriksen","DEN","MF","27",1992,7.8,11,6,2,8,1,5,20,25,15,3,0,3,0,11,0,0,"https://fbref.com/en/players/980522ec/Christian-Eriksen"
2020,"Inter","Serie A","Sebastiano Esposito","ITA","FW","17",2002,2.2,3,2,0,2,1,0,5,0,5,3,0,3,3,6,1,0,"https://fbref.com/en/players/7ff93107/Sebastiano-Esposito"
2020,"Inter","Serie A","Roberto Gagliardini","ITA","MF","25",1994,20,38,19,12,18,8,14,41,34.1,27,28,8,20,30,68,20,1,"https://fbref.com/en/players/ce30bfc8/Roberto-Gagliardini"
2020,"Inter","Serie A","Diego Godín","URU","DF","33",1986,18.1,38,29,19,16,3,18,32,56.3,14,17,7,10,45,83,60,1,"https://fbref.com/en/players/fc4f85b1/Diego-Godin"
2020,"Inter","Serie A","Samir Handanović","SVN","GK","35",1984,35,1,1,1,0,0,0,1,0,1,0,0,0,0,1,8,3,"https://fbref.com/en/players/74419746/Samir-Handanovic"
2020,"Inter","Serie A","Valentino Lazaro","AUT","DF","23",1996,3.6,6,5,3,2,1,4,8,50,4,5,0,5,1,7,8,1,"https://fbref.com/en/players/016ff750/Valentino-Lazaro"
2020,"Inter","Serie A","Romelu Lukaku","BEL","FW","26",1993,33.1,13,7,4,7,2,3,10,30,7,14,6,8,1,14,28,0,"https://fbref.com/en/players/5eae500a/Romelu-Lukaku"
2020,"Inter","Serie A","Lautaro Martínez","ARG","FW","21",1997,27.2,22,7,2,8,12,4,34,11.8,30,30,2,28,15,37,11,0,"https://fbref.com/en/players/f7036e1c/Lautaro-Martinez"
2020,"Inter","Serie A","Victor Moses","NGA","DF","28",1990,4.7,4,3,1,2,1,2,8,25,6,4,0,4,0,4,4,0,"https://fbref.com/en/players/e726e11e/Victor-Moses"
2020,"Inter","Serie A","Daniele Padelli","ITA","GK","33",1985,3,0,0,0,0,0,0,0,NA,0,0,0,0,0,0,1,1,"https://fbref.com/en/players/cf1c23d8/Daniele-Padelli"
2020,"Inter","Serie A","Lorenzo Pirola","ITA","DF","17",2002,0.1,0,0,0,0,0,0,0,NA,0,0,0,0,1,1,0,0,"https://fbref.com/en/players/caec77da/Lorenzo-Pirola"
2020,"Inter","Serie A","Matteo Politano","ITA","FW,MF","25",1993,2.9,0,0,0,0,0,0,2,0,2,1,0,1,0,0,1,0,"https://fbref.com/en/players/5e861944/Matteo-Politano"
2020,"Inter","Serie A","Andrea Ranocchia","ITA","DF","31",1988,5.8,17,10,10,7,0,5,8,62.5,3,11,6,5,8,25,18,0,"https://fbref.com/en/players/539230cf/Andrea-Ranocchia"
2020,"Inter","Serie A","Alexis Sánchez","CHI","FW","30",1988,10.3,9,7,1,4,4,5,13,38.5,8,7,0,7,3,12,1,0,"https://fbref.com/en/players/2c0f8e9e/Alexis-Sanchez"
2020,"Inter","Serie A","Stefano Sensi","ITA","MF","23",1995,8,18,10,10,7,1,6,22,27.3,16,15,1,14,9,27,4,0,"https://fbref.com/en/players/b70bde8f/Stefano-Sensi"
2020,"Inter","Serie A","Milan Škriniar","SVK","DF","24",1995,29.2,39,20,24,14,1,14,33,42.4,19,19,11,8,28,67,85,1,"https://fbref.com/en/players/30f5ffa9/Milan-Skriniar"
2020,"Inter","Serie A","Borja Valero","ESP","MF","34",1985,10.3,18,7,9,3,6,6,24,25,18,12,3,9,8,26,9,0,"https://fbref.com/en/players/0e21fc3c/Borja-Valero"
2020,"Inter","Serie A","Matías Vecino","URU","MF","27",1991,14.2,31,20,14,11,6,9,36,25,27,20,3,17,15,46,26,0,"https://fbref.com/en/players/44ac04e9/Matias-Vecino"
2020,"Inter","Serie A","Stefan de Vrij","NED","DF","27",1992,31.4,33,18,20,12,1,14,27,51.9,13,34,24,10,52,85,121,1,"https://fbref.com/en/players/d0d8dd44/Stefan-de-Vrij"
2020,"Inter","Serie A","Ashley Young","ENG","DF","34",1985,13.2,11,5,3,5,3,6,19,31.6,13,11,3,8,14,25,24,0,"https://fbref.com/en/players/be927d03/Ashley-Young"
2020,"Juventus","Serie A","Rodrigo Bentancur","URU","MF","22",1997,24.4,58,32,27,18,13,31,66,47,35,44,9,35,32,90,34,1,"https://fbref.com/en/players/3b8674e6/Rodrigo-Bentancur"
2020,"Juventus","Serie A","Federico Bernardeschi","ITA","MF,FW","25",1994,17.5,13,5,4,5,4,5,25,20,20,11,0,11,13,26,12,1,"https://fbref.com/en/players/ee93c1a9/Federico-Bernardeschi"
2020,"Juventus","Serie A","Leonardo Bonucci","ITA","DF","32",1987,34.2,28,17,18,8,2,12,17,70.6,5,32,29,3,31,59,94,2,"https://fbref.com/en/players/52ec54d0/Leonardo-Bonucci"
2020,"Juventus","Serie A","Gianluigi Buffon","ITA","GK","41",1978,9,0,0,0,0,0,0,0,NA,0,0,0,0,0,0,3,1,"https://fbref.com/en/players/e40d028b/Gianluigi-Buffon"
2020,"Juventus","Serie A","Emre Can","GER","MF","25",1994,3.2,10,7,5,3,2,3,10,30,7,4,0,4,2,12,3,0,"https://fbref.com/en/players/a65ce836/Emre-Can"
2020,"Juventus","Serie A","Giorgio Chiellini","ITA","DF","34",1984,2.2,3,0,3,0,0,1,1,100,0,2,2,0,1,4,9,0,"https://fbref.com/en/players/e85fb9b8/Giorgio-Chiellini"
2020,"Juventus","Serie A","Douglas Costa","BRA","FW,MF","28",1990,8.9,2,1,1,1,0,1,12,8.3,11,7,0,7,5,7,5,0,"https://fbref.com/en/players/4fa7cb9b/Douglas-Costa"
2020,"Juventus","Serie A","Juan Cuadrado","COL","DF,FW","31",1988,29.5,67,43,32,28,7,35,62,56.5,27,22,8,14,35,102,47,0,"https://fbref.com/en/players/0ab1f153/Juan-Cuadrado"
2020,"Juventus","Serie A","Danilo","BRA","DF","28",1991,16,30,20,16,12,2,18,30,60,12,12,3,9,26,56,44,0,"https://fbref.com/en/players/94b2001f/Danilo"
2020,"Juventus","Serie A","Mattia De Sciglio","ITA","DF","26",1992,5.2,10,8,6,4,0,6,14,42.9,8,5,2,3,8,18,18,1,"https://fbref.com/en/players/ae4e2852/Mattia-De-Sciglio"
2020,"Juventus","Serie A","Merih Demiral","TUR","DF","21",1998,4.6,8,7,5,3,0,1,3,33.3,2,4,3,1,4,12,16,1,"https://fbref.com/en/players/e3cceee6/Merih-Demiral"
2020,"Juventus","Serie A","Paulo Dybala","ARG","FW,MF","25",1993,23.9,19,10,6,9,4,9,39,23.1,30,15,0,15,13,32,3,0,"https://fbref.com/en/players/e0921a4f/Paulo-Dybala"
2020,"Juventus","Serie A","Gianluca Frabotta","ITA","DF","20",1999,1,3,1,0,2,1,2,2,100,0,2,0,2,1,4,2,0,"https://fbref.com/en/players/d80b1835/Gianluca-Frabotta"
2020,"Juventus","Serie A","Gonzalo Higuaín","ARG","FW","31",1987,20.7,13,7,2,6,5,4,31,12.9,27,12,0,12,6,19,14,0,"https://fbref.com/en/players/8a08491a/Gonzalo-Higuain"
2020,"Juventus","Serie A","Sami Khedira","GER","MF","32",1987,7.6,14,7,3,8,3,4,19,21.1,15,12,1,11,3,17,13,0,"https://fbref.com/en/players/38ac43d3/Sami-Khedira"
2020,"Juventus","Serie A","Matthijs de Ligt","NED","DF","19",1999,27.2,25,15,14,10,1,13,23,56.5,10,30,23,7,25,50,101,2,"https://fbref.com/en/players/d6e53a3a/Matthijs-de-Ligt"
2020,"Juventus","Serie A","Blaise Matuidi","FRA","MF","32",1987,24.9,48,27,13,27,8,13,34,38.2,21,35,6,29,22,70,16,0,"https://fbref.com/en/players/c0cddebe/Blaise-Matuidi"
2020,"Juventus","Serie A","Simone Muratore","ITA","MF","21",1998,1.8,2,0,0,1,1,1,3,33.3,2,1,0,1,3,5,0,0,"https://fbref.com/en/players/04989945/Simone-Muratore"
2020,"Juventus","Serie A","Marco Olivieri","ITA","FW","20",1999,0.3,1,1,1,0,0,1,2,50,1,0,0,0,0,1,0,0,"https://fbref.com/en/players/f5ba8903/Marco-Olivieri"
2020,"Juventus","Serie A","Daouda Peeters","BEL","MF","20",1999,0.2,1,0,0,1,0,1,1,100,0,0,0,0,0,1,0,0,"https://fbref.com/en/players/e83f8ebb/Daouda-Peeters"
2020,"Juventus","Serie A","Carlo Pinsoglio","ITA","GK","29",1990,0.2,0,0,0,0,0,0,0,NA,0,0,0,0,0,0,0,0,"https://fbref.com/en/players/f6a06749/Carlo-Pinsoglio"
2020,"Juventus","Serie A","Miralem Pjanić","BIH","MF","29",1990,25.3,46,21,16,23,7,21,63,33.3,42,29,12,17,32,78,30,0,"https://fbref.com/en/players/ad6df2d5/Miralem-Pjanic"
2020,"Juventus","Serie A","Adrien Rabiot","FRA","MF","24",1995,21.2,47,31,16,19,12,15,41,36.6,26,36,6,30,32,79,19,0,"https://fbref.com/en/players/8794e251/Adrien-Rabiot"
2020,"Juventus","Serie A","Aaron Ramsey","WAL","MF","28",1990,11.7,20,15,6,8,6,6,24,25,18,18,3,15,11,31,12,0,"https://fbref.com/en/players/ef619b0b/Aaron-Ramsey"
2020,"Juventus","Serie A","Cristiano Ronaldo","POR","FW","34",1985,32.4,14,10,3,3,8,4,20,20,16,10,3,7,6,20,21,1,"https://fbref.com/en/players/dea698d9/Cristiano-Ronaldo"
2020,"Juventus","Serie A","Daniele Rugani","ITA","DF","25",1994,7.7,8,6,4,4,0,4,5,80,1,4,4,0,11,19,18,0,"https://fbref.com/en/players/14b8fcdf/Daniele-Rugani"
2020,"Juventus","Serie A","Alex Sandro","BRA","DF","28",1991,26.5,44,26,23,14,7,12,33,36.4,21,26,6,20,47,91,46,3,"https://fbref.com/en/players/0d82903c/Alex-Sandro"
2020,"Juventus","Serie A","Wojciech Szczęsny","POL","GK","29",1990,28.8,0,0,0,0,0,0,0,NA,0,0,0,0,1,1,10,1,"https://fbref.com/en/players/01b8a2b2/Wojciech-Szczesny"
2020,"Juventus","Serie A","Giacomo Vrioni","ALB","FW","20",1998,0.1,0,0,0,0,0,0,0,NA,0,0,0,0,0,0,0,0,"https://fbref.com/en/players/bf4d31d3/Giacomo-Vrioni"
2020,"Juventus","Serie A","Luca Zanimacchia","ITA","FW,MF","21",1998,1.3,5,1,1,2,2,1,2,50,1,1,0,1,0,5,0,0,"https://fbref.com/en/players/5e834dce/Luca-Zanimacchia"
2020,"Köln","Bundesliga","Matthias Bader","GER","DF","22",1997,0.1,1,1,1,0,0,1,2,50,1,0,0,0,0,1,1,0,"https://fbref.com/en/players/3489184e/Matthias-Bader"
2020,"Köln","Bundesliga","Sebastiaan Bornauw","BEL","DF","20",1999,27.2,37,24,24,12,1,20,39,51.3,19,32,12,20,42,79,99,0,"https://fbref.com/en/players/01834aa0/Sebastiaan-Bornauw"
2020,"Köln","Bundesliga","Darko Churlinov","MKD","MF","19",2000,0.2,1,1,1,0,0,1,2,50,1,0,0,0,1,2,0,0,"https://fbref.com/en/players/c6608135/Darko-Churlinov"
2020,"Köln","Bundesliga","Christian Clemens","GER","FW","27",1991,0.2,0,0,0,0,0,0,0,NA,0,1,1,0,0,0,0,0,"https://fbref.com/en/players/612cb8d3/Christian-Clemens"
2020,"Köln","Bundesliga","Jhon Córdoba","COL","FW","26",1993,22.2,9,6,1,5,3,3,13,23.1,10,19,1,18,5,14,17,0,"https://fbref.com/en/players/9f381d8b/Jhon-Cordoba"
2020,"Köln","Bundesliga","Rafael Czichos","GER","DF","29",1990,24.5,43,34,26,16,1,22,45,48.9,23,24,13,11,35,78,110,1,"https://fbref.com/en/players/b0a0698b/Rafael-Czichos"
2020,"Köln","Bundesliga","Dominick Drexler","GER","MF,FW","29",1990,17.6,34,25,12,19,3,8,32,25,24,11,5,6,26,60,11,0,"https://fbref.com/en/players/809940aa/Dominick-Drexler"
2020,"Köln","Bundesliga","Kingsley Ehizibue","NED","DF","24",1995,25.9,79,53,44,30,5,33,53,62.3,20,28,8,20,39,118,79,1,"https://fbref.com/en/players/76b2817e/Kingsley-Ehizibue"
2020,"Köln","Bundesliga","Jonas Hector","GER","MF,DF","29",1990,27,76,49,37,34,5,24,75,32,51,44,10,34,46,122,38,1,"https://fbref.com/en/players/c2009df3/Jonas-Hector"
2020,"Köln","Bundesliga","Marco Höger","GER","MF","29",1989,7.5,10,6,4,5,1,6,16,37.5,10,14,4,10,6,16,15,0,"https://fbref.com/en/players/4114f306/Marco-Hoger"
2020,"Köln","Bundesliga","Timo Horn","GER","GK","26",1993,34,0,0,0,0,0,0,5,0,5,0,0,0,2,2,15,1,"https://fbref.com/en/players/3cd9e95a/Timo-Horn"
2020,"Köln","Bundesliga","Ismail Jakobs","SEN","FW,DF","19",1999,18.6,34,23,18,9,7,10,23,43.5,13,25,3,22,24,58,30,0,"https://fbref.com/en/players/a0415710/Ismail-Jakobs"
2020,"Köln","Bundesliga","Florian Kainz","AUT","FW,MF","26",1992,17.3,21,13,12,6,3,15,33,45.5,18,26,2,24,13,34,11,0,"https://fbref.com/en/players/94c18565/Florian-Kainz"
2020,"Köln","Bundesliga","Noah Katterbach","GER","DF","18",2001,14.6,29,23,21,8,0,11,28,39.3,17,12,1,11,29,58,26,0,"https://fbref.com/en/players/e27de4fa/Noah-Katterbach"
2020,"Köln","Bundesliga","Toni Leistner","GER","DF","28",1990,11.2,19,12,10,9,0,5,13,38.5,8,16,7,9,32,51,57,0,"https://fbref.com/en/players/364445b2/Toni-Leistner"
2020,"Köln","Bundesliga","Tim Lemperle","GER","MF","17",2002,0.2,0,0,0,0,0,0,0,NA,0,0,0,0,0,0,0,0,"https://fbref.com/en/players/792ffa71/Tim-Lemperle"
2020,"Köln","Bundesliga","Jorge Meré","ESP","DF","22",1997,6.9,6,5,2,4,0,1,2,50,1,13,11,2,14,20,30,0,"https://fbref.com/en/players/9f979eb2/Jorge-Mere"
2020,"Köln","Bundesliga","Anthony Modeste","FRA","FW","31",1988,12.6,10,5,1,5,4,1,10,10,9,5,3,2,0,10,19,0,"https://fbref.com/en/players/34e4343c/Anthony-Modeste"
2020,"Köln","Bundesliga","Elvis Rexhbeçaj","GER","MF","21",1997,6.9,16,12,9,5,2,5,13,38.5,8,7,0,7,3,19,4,0,"https://fbref.com/en/players/1ae836b1/Elvis-Rexhbecaj"
2020,"Köln","Bundesliga","Marcel Risse","GER","MF,FW","29",1989,1.5,3,2,3,0,0,1,1,100,0,1,0,1,1,4,1,0,"https://fbref.com/en/players/140afefb/Marcel-Risse"
2020,"Köln","Bundesliga","Louis Schaub","AUT","MF","24",1994,6.9,15,12,2,9,4,5,14,35.7,9,10,1,9,3,18,2,0,"https://fbref.com/en/players/b50ec54b/Louis-Schaub"
2020,"Köln","Bundesliga","Kingsley Schindler","GER","FW,MF","26",1993,9.4,8,5,3,5,0,4,12,33.3,8,6,1,5,6,14,17,0,"https://fbref.com/en/players/bd527260/Kingsley-Schindler"
2020,"Köln","Bundesliga","Benno Schmitz","GER","DF","24",1994,12.9,28,17,13,11,4,16,36,44.4,20,11,1,10,16,44,27,0,"https://fbref.com/en/players/ad00b1a8/Benno-Schmitz"
2020,"Köln","Bundesliga","Ellyes Skhiri","TUN","MF","24",1995,29.7,74,52,30,37,7,29,77,37.7,48,47,9,38,67,141,33,0,"https://fbref.com/en/players/c2211709/Ellyes-Skhiri"
2020,"Köln","Bundesliga","Lasse Sobiech","GER","DF","28",1991,1,1,0,0,0,1,0,0,NA,0,0,0,0,4,5,6,0,"https://fbref.com/en/players/c46607bf/Lasse-Sobiech"
2020,"Köln","Bundesliga","Simon Terodde","GER","FW","31",1988,9,8,5,4,3,1,3,13,23.1,10,14,3,11,2,10,14,0,"https://fbref.com/en/players/863ff1ee/Simon-Terodde"
2020,"Köln","Bundesliga","Jan Thielmann","GER","FW,MF","17",2002,6.2,9,6,2,6,1,5,12,41.7,7,8,0,8,8,17,6,0,"https://fbref.com/en/players/fd53759d/Jan-Thielmann"
2020,"Köln","Bundesliga","Mark Uth","GER","MF,FW","27",1991,12.9,19,12,4,10,5,9,32,28.1,23,15,0,15,7,26,3,0,"https://fbref.com/en/players/a3ddb1b9/Mark-Uth"
2020,"Köln","Bundesliga","Birger Verstraete","BEL","MF","25",1994,7.4,20,11,9,10,1,11,21,52.4,10,8,1,7,4,24,10,1,"https://fbref.com/en/players/28eaa0f3/Birger-Verstraete"
2020,"Lazio","Serie A","Francesco Acerbi","ITA","DF","31",1988,35.1,59,29,42,12,5,14,20,70,6,40,27,13,42,101,109,1,"https://fbref.com/en/players/b96b595c/Francesco-Acerbi"
2020,"Lazio","Serie A","Bobby Adekanye","NED","FW","20",1999,2.1,3,2,0,3,0,0,5,0,5,0,0,0,2,5,1,0,"https://fbref.com/en/players/3ed84b2c/Bobby-Adekanye"
2020,"Lazio","Serie A","Luis Alberto","ESP","MF","26",1992,34.6,50,30,21,19,10,27,82,32.9,55,32,1,31,21,71,9,1,"https://fbref.com/en/players/5294a83f/Luis-Alberto"
2020,"Lazio","Serie A","Djavan Anderson","NED","FW,DF","24",1995,1.9,0,0,0,0,0,0,0,NA,0,1,0,1,3,3,3,0,"https://fbref.com/en/players/ca241ad3/Djavan-Anderson"
2020,"Lazio","Serie A","Nicolò Armini","ITA","DF","18",2001,0,1,1,1,0,0,1,1,100,0,0,0,0,0,1,1,0,"https://fbref.com/en/players/2f7407fa/Nicolo-Armini"
2020,"Lazio","Serie A","Bastos","ANG","DF","28",1991,8.5,9,5,6,3,0,4,11,36.4,7,13,8,5,13,22,26,0,"https://fbref.com/en/players/c01c66d9/Bastos"
2020,"Lazio","Serie A","Valon Berisha","KVX","MF","26",1993,0.4,1,1,0,1,0,1,2,50,1,0,0,0,0,1,1,0,"https://fbref.com/en/players/d5575935/Valon-Berisha"
2020,"Lazio","Serie A","Felipe Caicedo","ECU","FW","30",1988,15.6,17,10,4,7,6,2,11,18.2,9,9,1,8,4,21,2,0,"https://fbref.com/en/players/93b891d1/Felipe-Caicedo"
2020,"Lazio","Serie A","Danilo Cataldi","ITA","MF","24",1994,6.6,17,11,10,5,2,10,20,50,10,7,1,6,13,30,10,0,"https://fbref.com/en/players/ba3d3bea/Danilo-Cataldi"
2020,"Lazio","Serie A","Joaquín Correa","ARG","FW","24",1994,22.2,13,7,3,7,3,5,24,20.8,19,5,1,4,7,20,10,0,"https://fbref.com/en/players/45b9b619/Joaquin-Correa"
2020,"Lazio","Serie A","Luca Falbo","ITA","DF","19",2000,0,0,0,0,0,0,0,0,NA,0,0,0,0,0,0,0,0,"https://fbref.com/en/players/ca8fa0c0/Luca-Falbo"
2020,"Lazio","Serie A","Luiz Felipe","ITA","DF","22",1997,22.5,42,24,24,15,3,19,32,59.4,13,39,30,9,41,83,69,2,"https://fbref.com/en/players/15d0c248/Luiz-Felipe"
2020,"Lazio","Serie A","Ciro Immobile","ITA","FW","29",1990,35.2,8,6,2,4,2,0,24,0,24,10,2,8,11,19,7,0,"https://fbref.com/en/players/4431aed2/Ciro-Immobile"
2020,"Lazio","Serie A","Jony","ESP","DF,FW","28",1991,13.1,13,9,7,4,2,5,23,21.7,18,11,2,9,14,27,17,0,"https://fbref.com/en/players/244f57b9/Jony"
2020,"Lazio","Serie A","Manuel Lazzari","ITA","DF","25",1993,28.3,20,11,10,7,3,10,31,32.3,21,11,1,10,8,28,34,0,"https://fbref.com/en/players/02caf6e0/Manuel-Lazzari"
2020,"Lazio","Serie A","Lucas Leiva","BRA","MF","32",1987,20.1,60,35,25,31,4,28,72,38.9,44,29,6,23,47,107,34,1,"https://fbref.com/en/players/4c78b5ed/Lucas-Leiva"
2020,"Lazio","Serie A","Anderson Lima","BRA","MF,DF","19",1999,0.7,4,0,3,1,0,1,1,100,0,4,0,4,0,4,0,0,"https://fbref.com/en/players/59be3a74/Anderson-Lima"
2020,"Lazio","Serie A","Jordan Lukaku","BEL","DF","25",1994,4.4,4,2,1,1,2,2,4,50,2,2,1,1,0,4,9,0,"https://fbref.com/en/players/0cd0e21b/Jordan-Lukaku"
2020,"Lazio","Serie A","Senad Lulić","BIH","DF","33",1986,17.5,21,13,10,7,4,11,41,26.8,30,20,4,16,21,42,28,1,"https://fbref.com/en/players/7fd58fe3/Senad-Lulic"
2020,"Lazio","Serie A","Adam Marušić","MNE","DF","26",1992,10.5,11,6,7,4,0,4,11,36.4,7,14,2,12,14,25,16,0,"https://fbref.com/en/players/d4535821/Adam-Marusic"
2020,"Lazio","Serie A","Sergej Milinković-Savić","SRB","MF","24",1995,33.7,60,35,25,24,11,15,79,19,64,67,16,51,37,97,60,1,"https://fbref.com/en/players/4e6dbac4/Sergej-Milinkovic-Savic"
2020,"Lazio","Serie A","Raúl Moro","ESP","FW","16",2002,0,0,0,0,0,0,0,0,NA,0,0,0,0,0,0,0,0,"https://fbref.com/en/players/919dd4b1/Raul-Moro"
2020,"Lazio","Serie A","Marco Parolo","ITA","MF","34",1985,18.9,54,26,19,27,8,18,46,39.1,28,44,15,29,26,80,49,0,"https://fbref.com/en/players/ed5886d2/Marco-Parolo"
2020,"Lazio","Serie A","Patric","ESP","DF","26",1993,18.6,34,20,24,7,3,18,25,72,7,19,9,10,15,49,45,0,"https://fbref.com/en/players/f7223718/Patric"
2020,"Lazio","Serie A","Ștefan Radu","ROU","DF","32",1986,25.6,43,25,24,15,4,28,43,65.1,15,19,9,10,34,77,85,0,"https://fbref.com/en/players/53de807a/Stefan-Radu"
2020,"Lazio","Serie A","Thomas Strakosha","ALB","GK","24",1995,38,0,0,0,0,0,0,1,0,1,0,0,0,0,0,7,2,"https://fbref.com/en/players/339fe0e8/Thomas-Strakosha"
2020,"Lazio","Serie A","Denis Vavro","SVK","DF","23",1996,3.6,3,3,2,1,0,1,3,33.3,2,8,6,2,5,8,10,0,"https://fbref.com/en/players/08990838/Denis-Vavro"
2020,"Lecce","Serie A","Khouma Babacar","SEN","FW","26",1993,15.8,12,8,2,6,4,1,7,14.3,6,12,3,9,3,15,34,0,"https://fbref.com/en/players/422ec08a/Khouma-Babacar"
2020,"Lecce","Serie A","Antonín Barák","CZE","MF","24",1994,15.2,19,10,9,10,0,6,24,25,18,18,1,17,9,28,20,2,"https://fbref.com/en/players/01efac19/Antonin-Barak"
2020,"Lecce","Serie A","Romario Benzar","ROU","DF","27",1992,1.1,2,2,1,1,0,2,3,66.7,1,1,0,1,0,2,2,0,"https://fbref.com/en/players/2e3596d1/Romario-Benzar"
2020,"Lecce","Serie A","Marco Calderoni","ITA","DF","30",1989,22.9,38,25,22,13,3,20,39,51.3,19,27,10,17,37,75,54,1,"https://fbref.com/en/players/652811aa/Marco-Calderoni"
2020,"Lecce","Serie A","Alessandro Deiola","ITA","MF","23",1995,8,16,9,9,7,0,9,24,37.5,15,12,4,8,8,24,14,1,"https://fbref.com/en/players/7f267d66/Alessandro-Deiola"
2020,"Lecce","Serie A","Cristian Dell'Orco","ITA","DF","25",1994,11.2,22,12,14,7,1,8,14,57.1,6,11,7,4,16,38,33,0,"https://fbref.com/en/players/b0243215/Cristian-DellOrco"
2020,"Lecce","Serie A","Giulio Donati","ITA","DF","29",1990,19.6,32,21,22,8,2,15,28,53.6,13,19,10,9,25,57,42,0,"https://fbref.com/en/players/22051fbe/Giulio-Donati"
2020,"Lecce","Serie A","Edgaras Dubickas","LTU","DF","21",1998,0,0,0,0,0,0,0,0,NA,0,0,0,0,0,0,0,0,"https://fbref.com/en/players/c59f90b0/Edgaras-Dubickas"
2020,"Lecce","Serie A","Filippo Falco","ITA","FW,MF","27",1992,22.4,13,7,4,5,4,5,18,27.8,13,11,1,10,2,15,1,0,"https://fbref.com/en/players/e23f56c1/Filippo-Falco"
2020,"Lecce","Serie A","Diego Farias","BRA","MF,FW","29",1990,9.2,9,6,3,5,1,5,18,27.8,13,7,0,7,4,13,4,0,"https://fbref.com/en/players/157d29b6/Diego-Farias"
2020,"Lecce","Serie A","Gabriel","BRA","GK","26",1992,33.3,2,1,2,0,0,2,3,66.7,1,0,0,0,0,2,11,10,"https://fbref.com/en/players/f93ed0df/Gabriel"
2020,"Lecce","Serie A","Giannelli Imbula","COD","MF","26",1992,1.4,2,0,2,0,0,0,1,0,1,4,1,3,2,4,0,0,"https://fbref.com/en/players/b86fe156/Giannelli-Imbula"
2020,"Lecce","Serie A","Andrea La Mantia","ITA","FW","28",1991,6.1,1,0,1,0,0,1,5,20,4,3,0,3,7,8,11,0,"https://fbref.com/en/players/c375dfa5/Andrea-La-Mantia"
2020,"Lecce","Serie A","Gianluca Lapadula","PER","FW","29",1990,19.8,15,8,6,8,1,5,16,31.3,11,2,0,2,1,16,14,0,"https://fbref.com/en/players/2ead2809/Gianluca-Lapadula"
2020,"Lecce","Serie A","Fabio Lucioni","ITA","DF","31",1987,34.8,29,13,20,9,0,14,32,43.8,18,48,38,10,36,65,169,5,"https://fbref.com/en/players/8efa621b/Fabio-Lucioni"
2020,"Lecce","Serie A","Žan Majer","SVN","MF","27",1992,18.5,39,18,19,12,8,17,56,30.4,39,27,6,21,26,65,18,1,"https://fbref.com/en/players/bf13975c/Zan-Majer"
2020,"Lecce","Serie A","Marco Mancosu","ITA","MF,FW","30",1988,27.1,32,18,11,16,5,10,46,21.7,36,34,9,25,16,48,15,1,"https://fbref.com/en/players/2c3a6c21/Marco-Mancosu"
2020,"Lecce","Serie A","Biagio Meccariello","ITA","DF","28",1991,8.5,23,13,15,6,2,12,29,41.4,17,14,2,12,10,33,25,0,"https://fbref.com/en/players/1eeeff8a/Biagio-Meccariello"
2020,"Lecce","Serie A","Ilario Monterisi","ITA","DF","17",2001,0,0,0,0,0,0,0,0,NA,0,0,0,0,0,0,0,0,"https://fbref.com/en/players/31b252fc/Ilario-Monterisi"
2020,"Lecce","Serie A","Nehuén Paz","ARG","DF","26",1993,9.4,14,5,11,3,0,10,12,83.3,2,12,6,6,20,34,38,1,"https://fbref.com/en/players/42b1a58a/Nehuen-Paz"
2020,"Lecce","Serie A","Jacopo Petriccione","ITA","MF","24",1995,23.8,38,20,29,9,0,15,57,26.3,42,20,7,13,28,66,25,2,"https://fbref.com/en/players/909bce7f/Jacopo-Petriccione"
2020,"Lecce","Serie A","Davide Riccardi","ITA","DF","23",1996,0.2,0,0,0,0,0,0,1,0,1,0,0,0,0,0,1,0,"https://fbref.com/en/players/7b4b9221/Davide-Riccardi"
2020,"Lecce","Serie A","Andrea Rispoli","ITA","DF","30",1988,21.2,24,18,14,9,1,15,30,50,15,28,7,21,32,56,62,1,"https://fbref.com/en/players/39ee6cb6/Andrea-Rispoli"
2020,"Lecce","Serie A","Luca Rossettini","ITA","DF","34",1985,25.1,25,14,18,7,0,17,34,50,17,31,22,9,35,60,126,1,"https://fbref.com/en/players/47a500ae/Luca-Rossettini"
2020,"Lecce","Serie A","Riccardo Saponara","ITA","MF,FW","27",1991,10.5,12,8,4,8,0,6,13,46.2,7,2,0,2,5,17,7,0,"https://fbref.com/en/players/3bb7af3b/Riccardo-Saponara"
2020,"Lecce","Serie A","Yevhen Shakhov","UKR","MF,FW","28",1990,12.1,28,16,12,13,3,8,27,29.6,19,11,3,8,14,42,9,1,"https://fbref.com/en/players/ff764de3/Yevhen-Shakhov"
2020,"Lecce","Serie A","Andrea Tabanelli","ITA","MF","29",1990,10.7,22,13,10,9,3,8,28,28.6,20,13,2,11,11,33,19,0,"https://fbref.com/en/players/b59e02da/Andrea-Tabanelli"
2020,"Lecce","Serie A","Panagiotis Tachtsidis","GRE","MF","28",1991,22.3,52,27,26,20,6,20,56,35.7,36,27,11,16,35,87,32,2,"https://fbref.com/en/players/e26bd2f4/Panagiotis-Tachtsidis"
2020,"Lecce","Serie A","Brayan Vera","COL","DF,FW","20",1999,1.7,4,1,2,1,1,3,7,42.9,4,1,0,1,1,5,4,0,"https://fbref.com/en/players/80c718dd/Brayan-Vera"
2020,"Lecce","Serie A","Mauro Vigorito","ITA","GK","29",1990,4.7,0,0,0,0,0,0,0,NA,0,0,0,0,0,0,3,1,"https://fbref.com/en/players/582a251c/Mauro-Vigorito"
2020,"Leganés","La Liga","Ibrahim Amadou","FRA","MF","26",1993,8.6,16,9,5,9,2,4,11,36.4,7,5,0,5,12,28,6,0,"https://fbref.com/en/players/9260926b/Ibrahim-Amadou"
2020,"Leganés","La Liga","Miguel Ángel Guerrero","ESP","FW","29",1990,8.8,1,0,0,1,0,1,10,10,9,4,0,4,2,3,4,0,"https://fbref.com/en/players/b35db3f6/Miguel-Angel-Guerrero"
2020,"Leganés","La Liga","José Arnaiz","ESP","MF","24",1995,3.7,3,0,1,2,0,2,5,40,3,4,0,4,2,5,1,0,"https://fbref.com/en/players/46e07328/Jose-Arnaiz"
2020,"Leganés","La Liga","Roger Assalé","CIV","FW,MF","25",1993,5.9,3,2,1,0,2,1,9,11.1,8,8,0,8,0,3,1,0,"https://fbref.com/en/players/5d5219b1/Roger-Assale"
2020,"Leganés","La Liga","Javier Avilés","ESP","MF,FW","21",1997,2,9,7,2,7,0,2,4,50,2,3,0,3,3,12,1,0,"https://fbref.com/en/players/53ddba36/Javier-Aviles"
2020,"Leganés","La Liga","Chidozie Awaziem","NGA","DF","22",1997,22.2,34,22,29,5,0,16,27,59.3,11,26,15,11,28,62,73,1,"https://fbref.com/en/players/70d8e84c/Chidozie-Awaziem"
2020,"Leganés","La Liga","Martin Braithwaite","DEN","FW,MF","28",1991,21.5,13,7,4,5,4,4,12,33.3,8,10,2,8,4,17,9,0,"https://fbref.com/en/players/fd771f95/Martin-Braithwaite"
2020,"Leganés","La Liga","Bryan","ESP","MF,FW","18",2001,6.2,8,4,3,4,1,1,8,12.5,7,6,0,6,3,11,1,0,"https://fbref.com/en/players/7b5ab7f2/Bryan"
2020,"Leganés","La Liga","Unai Bustinza","ESP","DF","27",1992,29.8,66,40,40,19,7,32,53,60.4,21,30,9,21,65,131,77,0,"https://fbref.com/en/players/f3112790/Unai-Bustinza"
2020,"Leganés","La Liga","Guido Carrillo","ARG","FW","28",1991,13.5,13,10,3,6,4,2,14,14.3,12,9,1,8,3,16,22,0,"https://fbref.com/en/players/8f898ba8/Guido-Carrillo"
2020,"Leganés","La Liga","Iván Cuéllar","ESP","GK","35",1984,27,0,0,0,0,0,0,2,0,2,0,0,0,0,0,28,2,"https://fbref.com/en/players/75751c99/Ivan-Cuellar"
2020,"Leganés","La Liga","Youssef En-Nesyri","MAR","FW","22",1997,15.4,9,7,1,2,6,3,17,17.6,14,15,2,13,5,14,22,0,"https://fbref.com/en/players/04e17fd5/Youssef-En-Nesyri"
2020,"Leganés","La Liga","Javier Eraso","ESP","MF","29",1990,9.1,11,5,4,5,2,5,15,33.3,10,5,0,5,7,18,5,0,"https://fbref.com/en/players/aec0fb6f/Javier-Eraso"
2020,"Leganés","La Liga","Manuel Garrido","ESP","FW","18",2000,1.3,0,0,0,0,0,0,6,0,6,3,1,2,1,1,0,0,"https://fbref.com/en/players/f814eccb/Manuel-Garrido"
2020,"Leganés","La Liga","Sabin Merino","ESP","FW","27",1992,0.9,0,0,0,0,0,0,0,NA,0,0,0,0,0,0,0,0,"https://fbref.com/en/players/1d5f96d9/Sabin-Merino"
2020,"Leganés","La Liga","Roque Mesa","ESP","MF","30",1989,22.4,40,21,17,18,5,13,44,29.5,31,13,4,9,11,51,8,0,"https://fbref.com/en/players/7c4243d4/Roque-Mesa"
2020,"Leganés","La Liga","Marc Navarro","ESP","FW,DF","24",1995,2.4,3,3,2,1,0,1,1,100,0,2,1,1,0,3,3,0,"https://fbref.com/en/players/c2846353/Marc-Navarro"
2020,"Leganés","La Liga","Kenneth Omeruo","NGA","DF","25",1993,20.8,28,17,25,3,0,11,18,61.1,7,21,12,9,36,64,112,2,"https://fbref.com/en/players/0f0aa5b4/Kenneth-Omeruo"
2020,"Leganés","La Liga","Rubén Pérez","ESP","MF","30",1989,24.4,50,27,21,23,6,16,47,34,31,21,4,17,38,88,33,0,"https://fbref.com/en/players/3c7bc9bd/Ruben-Perez"
2020,"Leganés","La Liga","Recio","ESP","MF","28",1991,17.4,30,19,13,12,5,10,40,25,30,14,3,11,22,52,9,0,"https://fbref.com/en/players/54073b28/Recio"
2020,"Leganés","La Liga","Cristian Rivera","ESP","MF","22",1997,3.5,6,4,3,2,1,2,4,50,2,4,3,1,4,10,7,0,"https://fbref.com/en/players/8ef81d2d/Cristian-Rivera"
2020,"Leganés","La Liga","Kévin Rodrigues","POR","DF,MF","25",1994,21.5,56,31,31,17,8,25,46,54.3,21,30,3,27,31,87,26,1,"https://fbref.com/en/players/f1bed920/Kevin-Rodrigues"
2020,"Leganés","La Liga","Óscar Rodríguez Arnaiz","ESP","MF,FW","21",1998,21.3,23,10,11,7,5,13,41,31.7,28,19,0,19,14,37,13,0,"https://fbref.com/en/players/19709006/Oscar-Rodriguez-Arnaiz"
2020,"Leganés","La Liga","Roberto Rosales","VEN","DF","30",1988,20.8,42,23,23,17,2,19,43,44.2,24,17,4,13,30,72,48,0,"https://fbref.com/en/players/81069528/Roberto-Rosales"
2020,"Leganés","La Liga","Aitor Ruibal","ESP","DF,MF","23",1996,13.6,27,17,14,11,2,16,39,41,23,18,1,17,8,35,11,0,"https://fbref.com/en/players/a55d8df5/Aitor-Ruibal"
2020,"Leganés","La Liga","Jonathan Silva","ARG","DF","25",1994,30.9,60,34,32,22,6,27,52,51.9,25,12,4,8,34,94,46,0,"https://fbref.com/en/players/f2308b33/Jonathan-Silva"
2020,"Leganés","La Liga","Dimitris Siovas","GRE","DF","30",1988,21.3,42,31,24,15,3,19,28,67.9,9,14,1,13,46,88,69,0,"https://fbref.com/en/players/92d38e6c/Dimitris-Siovas"
2020,"Leganés","La Liga","Juan Soriano","ESP","GK","21",1997,11,0,0,0,0,0,0,0,NA,0,0,0,0,0,0,1,1,"https://fbref.com/en/players/5512b1a9/Juan-Soriano"
2020,"Leganés","La Liga","Rodrigo Tarín","ESP","DF","23",1996,10.6,10,7,8,2,0,9,14,64.3,5,7,3,4,9,19,51,0,"https://fbref.com/en/players/a03c82b2/Rodrigo-Tarin"
2020,"Leicester City","Premier League","Marc Albrighton","ENG","MF,DF","29",1989,9.6,24,17,10,13,1,9,30,30,21,19,2,17,10,34,8,0,"https://fbref.com/en/players/b827d5b3/Marc-Albrighton"
2020,"Leicester City","Premier League","Harvey Barnes","ENG","MF,FW","21",1997,23.1,16,11,7,7,2,5,23,21.7,18,13,3,10,8,24,6,1,"https://fbref.com/en/players/3ea50f67/Harvey-Barnes"
2020,"Leicester City","Premier League","Ryan Bennett","ENG","DF","29",1990,3.7,5,4,3,2,0,4,6,66.7,2,3,1,2,7,12,8,0,"https://fbref.com/en/players/0bad4516/Ryan-Bennett"
2020,"Leicester City","Premier League","Ben Chilwell","ENG","DF","22",1996,26.4,43,26,28,13,2,23,52,44.2,29,30,6,24,28,71,68,2,"https://fbref.com/en/players/d2424d1b/Ben-Chilwell"
2020,"Leicester City","Premier League","Hamza Choudhury","ENG","MF","21",1997,9.9,17,8,7,8,2,3,25,12,22,15,6,9,24,41,13,0,"https://fbref.com/en/players/7d2d3329/Hamza-Choudhury"
2020,"Leicester City","Premier League","Jonny Evans","NIR","DF","31",1988,37.6,48,34,33,14,1,28,39,71.8,11,33,18,15,57,105,174,4,"https://fbref.com/en/players/f8fcd2a5/Jonny-Evans"
2020,"Leicester City","Premier League","Christian Fuchs","AUT","DF","33",1986,8.6,14,9,8,6,0,8,19,42.1,11,8,3,5,17,31,33,1,"https://fbref.com/en/players/a67a09fb/Christian-Fuchs"
2020,"Leicester City","Premier League","Demarai Gray","ENG","MF,FW","23",1996,6.9,12,6,6,6,0,6,12,50,6,7,0,7,5,17,4,0,"https://fbref.com/en/players/4468ec10/Demarai-Gray"
2020,"Leicester City","Premier League","George Hirst","ENG","MF,DF","20",1999,0.1,0,0,0,0,0,0,0,NA,0,0,0,0,0,0,0,0,"https://fbref.com/en/players/78e87179/George-Hirst"
2020,"Leicester City","Premier League","Kelechi Iheanacho","NGA","FW","22",1996,10.7,3,1,1,2,0,1,9,11.1,8,8,1,7,3,6,8,0,"https://fbref.com/en/players/c92e1a31/Kelechi-Iheanacho"
2020,"Leicester City","Premier League","Matty James","ENG","MF","28",1991,0.1,0,0,0,0,0,0,0,NA,0,0,0,0,0,0,0,0,"https://fbref.com/en/players/ebd0a048/Matty-James"
2020,"Leicester City","Premier League","James Justin","ENG","DF,MF","21",1998,11.2,36,17,22,14,0,15,25,60,10,15,7,8,11,47,30,0,"https://fbref.com/en/players/fb614c44/James-Justin"
2020,"Leicester City","Premier League","James Maddison","ENG","MF","22",1996,29.2,59,30,13,31,15,23,68,33.8,45,16,0,16,9,68,7,1,"https://fbref.com/en/players/ee38d9c5/James-Maddison"
2020,"Leicester City","Premier League","Nampalys Mendy","SEN","MF","27",1992,3.2,7,5,4,1,2,4,5,80,1,4,1,3,6,13,6,0,"https://fbref.com/en/players/1598599e/Nampalys-Mendy"
2020,"Leicester City","Premier League","Wes Morgan","JAM","DF","35",1984,4.8,4,1,3,1,0,0,3,0,3,5,3,2,7,11,19,0,"https://fbref.com/en/players/80c31c97/Wes-Morgan"
2020,"Leicester City","Premier League","Wilfred Ndidi","NGA","MF","22",1996,29.7,128,67,56,61,11,45,91,49.5,46,52,6,46,80,208,69,3,"https://fbref.com/en/players/6b47c5db/Wilfred-Ndidi"
2020,"Leicester City","Premier League","Ricardo Pereira","POR","DF","25",1993,28,119,68,65,36,18,53,106,50,53,38,6,32,49,168,86,0,"https://fbref.com/en/players/75a72a99/Ricardo-Pereira"
2020,"Leicester City","Premier League","Ayoze Pérez","ESP","MF,FW","26",1993,22.3,45,28,14,26,5,8,54,14.8,46,33,1,32,14,59,9,1,"https://fbref.com/en/players/819aa8e7/Ayoze-Perez"
2020,"Leicester City","Premier League","Dennis Praet","BEL","MF","25",1994,12.6,33,18,8,21,4,9,29,31,20,19,1,18,17,50,12,0,"https://fbref.com/en/players/86695068/Dennis-Praet"
2020,"Leicester City","Premier League","Kasper Schmeichel","DEN","GK","32",1986,38,1,1,1,0,0,1,2,50,1,0,0,0,1,2,4,2,"https://fbref.com/en/players/53af52f3/Kasper-Schmeichel"
2020,"Leicester City","Premier League","Çağlar Söyüncü","TUR","DF","23",1996,33.7,60,40,41,18,1,27,46,58.7,19,35,19,16,43,103,156,1,"https://fbref.com/en/players/21166ff4/Caglar-Soyuncu"
2020,"Leicester City","Premier League","Luke Thomas","ENG","MF,DF","18",2001,3,1,0,0,1,0,0,3,0,3,2,0,2,3,4,7,0,"https://fbref.com/en/players/fc027d02/Luke-Thomas"
2020,"Leicester City","Premier League","Youri Tielemans","BEL","MF","22",1997,31.4,52,29,17,30,5,24,74,32.4,50,43,4,39,22,74,18,0,"https://fbref.com/en/players/56f7a928/Youri-Tielemans"
2020,"Leicester City","Premier League","Jamie Vardy","ENG","FW","32",1987,33.7,15,12,0,9,6,2,4,50,2,22,4,18,2,17,22,0,"https://fbref.com/en/players/45963054/Jamie-Vardy"
2020,"Levante","La Liga","Enis Bardhi","MKD","MF","24",1995,23.5,24,11,7,15,2,8,35,22.9,27,15,4,11,15,39,19,0,"https://fbref.com/en/players/cac2537b/Enis-Bardhi"
2020,"Levante","La Liga","Alejandro Blesa","ESP","MF","17",2002,0,0,0,0,0,0,0,1,0,1,0,0,0,0,0,0,0,"https://fbref.com/en/players/d2ed99b4/Alejandro-Blesa"
2020,"Levante","La Liga","Erick Cabaco","URU","DF","24",1995,9,12,9,9,3,0,4,6,66.7,2,12,7,5,12,24,50,1,"https://fbref.com/en/players/e7ab4179/Erick-Cabaco"
2020,"Levante","La Liga","José Campaña","ESP","MF","26",1993,35.1,38,25,15,13,10,13,53,24.5,40,30,5,25,44,82,42,2,"https://fbref.com/en/players/61220da2/Jose-Campana"
2020,"Levante","La Liga","Carlos Clerc","ESP","DF","27",1992,20.5,28,16,14,13,1,12,20,60,8,22,9,13,22,50,61,0,"https://fbref.com/en/players/33a61a52/Carlos-Clerc"
2020,"Levante","La Liga","Coke","ESP","DF","32",1987,11,25,18,14,8,3,14,30,46.7,16,9,2,7,13,38,19,0,"https://fbref.com/en/players/6d8f8441/Coke"
2020,"Levante","La Liga","Óscar Duarte","CRC","DF","30",1989,5.4,12,3,11,1,0,3,4,75,1,7,6,1,6,18,29,0,"https://fbref.com/en/players/aa0ac32d/Oscar-Duarte"
2020,"Levante","La Liga","Eliseo Falcon","ESP","DF","22",1997,0.8,0,0,0,0,0,0,0,NA,0,0,0,0,0,0,2,0,"https://fbref.com/en/players/904cd50d/Eliseo-Falcon"
2020,"Levante","La Liga","Aitor Fernández","ESP","GK","28",1991,36,1,1,1,0,0,1,1,100,0,0,0,0,2,3,18,3,"https://fbref.com/en/players/a01c3d54/Aitor-Fernandez"
2020,"Levante","La Liga","Hernâni Fortes","POR","MF,FW","27",1991,7.3,5,2,4,0,1,1,3,33.3,2,3,0,3,4,9,9,0,"https://fbref.com/en/players/2327c29e/Hernani-Fortes"
2020,"Levante","La Liga","Bruno González","ESP","DF","29",1990,5.1,10,8,7,2,1,2,4,50,2,7,4,3,2,12,32,0,"https://fbref.com/en/players/f11fe861/Bruno-Gonzalez"
2020,"Levante","La Liga","Gonzalo","ESP","DF","22",1997,0.1,1,0,0,1,0,0,0,NA,0,0,0,0,0,1,0,0,"https://fbref.com/en/players/cca05da8/Gonzalo"
2020,"Levante","La Liga","Giorgi Kochorashvili","GEO","MF","20",1999,0,0,0,0,0,0,0,0,NA,0,0,0,0,0,0,0,0,"https://fbref.com/en/players/3da1b6ed/Giorgi-Kochorashvili"
2020,"Levante","La Liga","Sergio León","ESP","FW","30",1989,7.5,3,3,0,3,0,2,4,50,2,3,0,3,1,4,2,0,"https://fbref.com/en/players/0a0cc13c/Sergio-Leon"
2020,"Levante","La Liga","José Luis Morales","ESP","FW,MF","32",1987,28,17,8,5,9,3,6,34,17.6,28,14,1,13,6,23,5,1,"https://fbref.com/en/players/4a478107/Jose-Luis-Morales"
2020,"Levante","La Liga","Roger Martí","ESP","FW","28",1991,25.2,18,11,8,7,3,7,29,24.1,22,14,0,14,6,24,17,0,"https://fbref.com/en/players/0ae4e09a/Roger-Marti"
2020,"Levante","La Liga","Pablo Martínez","ESP","MF","21",1998,0.4,2,0,1,1,0,0,1,0,1,0,0,0,0,2,2,0,"https://fbref.com/en/players/ecc77652/Pablo-Martinez"
2020,"Levante","La Liga","Borja Mayoral","ESP","FW","22",1997,23.8,12,3,4,6,2,2,13,15.4,11,11,0,11,4,16,6,0,"https://fbref.com/en/players/64e8ed6d/Borja-Mayoral"
2020,"Levante","La Liga","Gonzalo Melero","ESP","MF","25",1994,13.7,20,13,9,9,2,7,27,25.9,20,12,3,9,9,29,15,1,"https://fbref.com/en/players/3902e91b/Gonzalo-Melero"
2020,"Levante","La Liga","Jorge Miramón","ESP","DF","30",1989,27,52,27,35,13,4,26,45,57.8,19,30,8,22,46,98,61,1,"https://fbref.com/en/players/7f4c7c9f/Jorge-Miramon"
2020,"Levante","La Liga","Joan Monterde","ESP","MF","21",1997,0.1,0,0,0,0,0,0,0,NA,0,0,0,0,0,0,0,0,"https://fbref.com/en/players/0ff67313/Joan-Monterde"
2020,"Levante","La Liga","Sergio Postigo","ESP","DF","30",1988,26.4,32,15,23,7,2,11,18,61.1,7,24,15,9,34,66,132,1,"https://fbref.com/en/players/474ecac8/Sergio-Postigo"
2020,"Levante","La Liga","Nemanja Radoja","SRB","MF","26",1993,22.1,43,19,27,16,0,15,46,32.6,31,21,4,17,23,66,24,0,"https://fbref.com/en/players/b5dd3469/Nemanja-Radoja"
2020,"Levante","La Liga","Rober","ESP","DF","24",1995,2.1,3,1,2,0,1,2,2,100,0,0,0,0,3,6,2,0,"https://fbref.com/en/players/c00097d2/Rober"
2020,"Levante","La Liga","Rubén Rochina","ESP","MF","28",1991,20.8,41,26,22,9,10,19,52,36.5,33,16,0,16,12,53,19,1,"https://fbref.com/en/players/ecd8c01e/Ruben-Rochina"
2020,"Levante","La Liga","Toño","ESP","DF","29",1989,17.7,26,19,18,7,1,15,28,53.6,13,11,3,8,13,39,34,1,"https://fbref.com/en/players/d4ef9ac5/Tono"
2020,"Levante","La Liga","Koke Vegas","ESP","GK","23",1995,2,0,0,0,0,0,0,1,0,1,0,0,0,0,0,3,0,"https://fbref.com/en/players/bfb15d99/Koke-Vegas"
2020,"Levante","La Liga","Rúben Vezo","POR","DF","25",1994,29,41,24,28,13,0,19,35,54.3,16,37,29,8,42,83,144,2,"https://fbref.com/en/players/c67cd65c/Ruben-Vezo"
2020,"Levante","La Liga","Nikola Vukčević","MNE","MF","27",1991,17.4,41,26,17,17,7,15,40,37.5,25,19,7,12,12,53,16,0,"https://fbref.com/en/players/4442fbcd/Nikola-Vukcevic"
2020,"Leverkusen","Bundesliga","Lucas Alario","ARG","FW","26",1992,13,6,3,0,4,2,1,8,12.5,7,12,2,10,1,7,9,0,"https://fbref.com/en/players/834d0be5/Lucas-Alario"
2020,"Leverkusen","Bundesliga","Nadiem Amiri","GER","MF,FW","22",1996,20.6,26,16,7,15,4,16,34,47.1,18,12,2,10,14,40,8,1,"https://fbref.com/en/players/555d5edd/Nadiem-Amiri"
2020,"Leverkusen","Bundesliga","Charles Aránguiz","CHI","MF","30",1989,23.5,56,37,19,29,8,27,74,36.5,47,27,6,21,22,78,21,1,"https://fbref.com/en/players/56413b1f/Charles-Aranguiz"
2020,"Leverkusen","Bundesliga","Leon Bailey","JAM","FW,MF","21",1997,12.1,6,3,1,5,0,6,16,37.5,10,9,0,9,8,14,3,0,"https://fbref.com/en/players/3a233281/Leon-Bailey"
2020,"Leverkusen","Bundesliga","Julian Baumgartlinger","AUT","MF","31",1988,19.9,42,21,15,21,6,18,42,42.9,24,37,4,33,20,62,16,1,"https://fbref.com/en/players/69374ff5/Julian-Baumgartlinger"
2020,"Leverkusen","Bundesliga","Karim Bellarabi","GER","FW,DF","29",1990,15.8,19,11,9,7,3,9,28,32.1,19,16,0,16,10,29,4,0,"https://fbref.com/en/players/bee0bab1/Karim-Bellarabi"
2020,"Leverkusen","Bundesliga","Lars Bender","GER","DF,MF","30",1989,15.3,42,26,17,20,5,19,38,50,19,32,6,26,24,66,30,0,"https://fbref.com/en/players/c50281a0/Lars-Bender"
2020,"Leverkusen","Bundesliga","Sven Bender","GER","DF","30",1989,30.3,53,34,29,17,7,23,48,47.9,25,42,13,29,67,120,88,2,"https://fbref.com/en/players/070ec0b1/Sven-Bender"
2020,"Leverkusen","Bundesliga","Kerem Demirbay","GER","MF","26",1993,17.5,35,19,10,21,4,12,31,38.7,19,19,5,14,22,57,7,1,"https://fbref.com/en/players/54b4dc4e/Kerem-Demirbay"
2020,"Leverkusen","Bundesliga","Moussa Diaby","FRA","FW,MF","20",1999,19.7,10,8,3,7,0,5,15,33.3,10,6,0,6,9,19,4,0,"https://fbref.com/en/players/aeed5c06/Moussa-Diaby"
2020,"Leverkusen","Bundesliga","Aleksandar Dragović","AUT","DF","28",1991,11.4,18,11,11,6,1,10,21,47.6,11,9,3,6,15,33,39,0,"https://fbref.com/en/players/6fd8a334/Aleksandar-Dragovic"
2020,"Leverkusen","Bundesliga","Kai Havertz","GER","MF,FW","20",1999,27.3,21,15,5,10,6,6,39,15.4,33,22,0,22,2,23,22,0,"https://fbref.com/en/players/fed7cb61/Kai-Havertz"
2020,"Leverkusen","Bundesliga","Lukáš Hrádecký","FIN","GK","29",1989,34,0,0,0,0,0,0,1,0,1,0,0,0,2,2,19,2,"https://fbref.com/en/players/ad3389d5/Lukas-Hradecky"
2020,"Leverkusen","Bundesliga","Exequiel Palacios","ARG","MF","20",1998,2,8,7,4,4,0,2,5,40,3,2,0,2,1,9,0,0,"https://fbref.com/en/players/e82adcab/Exequiel-Palacios"
2020,"Leverkusen","Bundesliga","Paulinho","BRA","MF,FW","19",2000,3.4,4,3,3,1,0,1,2,50,1,5,1,4,1,5,0,0,"https://fbref.com/en/players/53070b63/Paulinho"
2020,"Leverkusen","Bundesliga","Joel Pohjanpalo","FIN","MF","24",1994,0,0,0,0,0,0,0,0,NA,0,0,0,0,0,0,0,0,"https://fbref.com/en/players/ea003d07/Joel-Pohjanpalo"
2020,"Leverkusen","Bundesliga","Panagiotis Retsos","GRE","DF","20",1998,1.3,6,3,4,2,0,1,4,25,3,2,0,2,2,8,2,0,"https://fbref.com/en/players/4bd00a50/Panagiotis-Retsos"
2020,"Leverkusen","Bundesliga","Daley Sinkgraven","NED","DF,MF","24",1995,10.1,20,16,11,6,3,8,24,33.3,16,12,3,9,10,30,16,0,"https://fbref.com/en/players/73000a79/Daley-Sinkgraven"
2020,"Leverkusen","Bundesliga","Jonathan Tah","GER","DF","23",1996,23.2,36,26,23,11,2,18,29,62.1,11,25,13,12,27,63,98,2,"https://fbref.com/en/players/bd142efb/Jonathan-Tah"
2020,"Leverkusen","Bundesliga","Edmond Tapsoba","BFA","DF","20",1999,11.8,24,15,17,5,2,15,25,60,10,9,5,4,9,33,44,0,"https://fbref.com/en/players/a73c8f95/Edmond-Tapsoba"
2020,"Leverkusen","Bundesliga","Kevin Volland","GER","FW","27",1992,22.7,16,6,5,6,5,5,16,31.3,11,14,2,12,5,21,7,0,"https://fbref.com/en/players/64f69877/Kevin-Volland"
2020,"Leverkusen","Bundesliga","Mitchell Weiser","GER","DF,MF","25",1994,13,41,29,20,17,4,18,30,60,12,19,2,17,24,65,22,1,"https://fbref.com/en/players/30c220c3/Mitchell-Weiser"
2020,"Leverkusen","Bundesliga","Wendell","BRA","DF,MF","26",1993,21.1,64,42,26,26,12,41,66,62.1,25,30,4,26,36,100,36,0,"https://fbref.com/en/players/f9acca3a/Wendell"
2020,"Leverkusen","Bundesliga","Florian Wirtz","GER","FW","16",2003,4.1,4,2,0,4,0,2,4,50,2,4,0,4,2,6,1,0,"https://fbref.com/en/players/e7fcf289/Florian-Wirtz"
2020,"Lille","Ligue 1","Benjamin André","FRA","MF","28",1990,22.8,72,44,31,35,6,29,74,39.2,45,32,9,23,59,131,40,1,"https://fbref.com/en/players/ef9c1c95/Benjamin-Andre"
2020,"Lille","Ligue 1","Luiz Araújo","BRA","FW,MF","23",1996,9.2,20,11,3,8,9,5,31,16.1,26,14,0,14,4,24,6,0,"https://fbref.com/en/players/fa18c72e/Luiz-Araujo"
2020,"Lille","Ligue 1","Jonathan Bamba","FRA","FW,MF","23",1996,21.5,12,6,5,5,2,7,29,24.1,22,19,3,16,16,28,8,2,"https://fbref.com/en/players/b2bd0f6c/Jonathan-Bamba"
2020,"Lille","Ligue 1","Domagoj Bradarić","CRO","DF","19",1999,15.8,28,11,9,17,2,12,27,44.4,15,16,3,13,22,50,28,0,"https://fbref.com/en/players/8bbe2df5/Domagoj-Bradaric"
2020,"Lille","Ligue 1","Zeki Çelik","TUR","DF","22",1997,23,53,28,18,28,7,27,60,45,33,24,4,20,26,79,39,0,"https://fbref.com/en/players/31a62dc7/Zeki-Celik"
2020,"Lille","Ligue 1","Tiago Djaló","POR","DF","19",2000,7.3,9,4,5,3,1,2,7,28.6,5,3,2,1,11,20,28,0,"https://fbref.com/en/players/b2336681/Tiago-Djalo"
2020,"Lille","Ligue 1","Gabriel Dos Santos","BRA","DF","21",1997,23.2,41,29,27,11,3,15,22,68.2,7,27,18,9,22,63,86,2,"https://fbref.com/en/players/67ac5bb8/Gabriel-Dos-Santos"
2020,"Lille","Ligue 1","José Fonte","POR","DF","35",1983,24.5,19,11,11,7,1,11,22,50,11,19,11,8,28,47,90,1,"https://fbref.com/en/players/90f87966/Jose-Fonte"
2020,"Lille","Ligue 1","Nicolás Gaitán","ARG","MF,FW","31",1988,0.6,1,0,0,1,0,1,1,100,0,1,0,1,0,1,1,0,"https://fbref.com/en/players/7ebfac0f/Nicolas-Gaitan"
2020,"Lille","Ligue 1","Jonathan Ikone","FRA","MF,FW","21",1998,22.9,15,7,3,7,5,6,24,25,18,26,2,24,5,20,3,0,"https://fbref.com/en/players/42eaa028/Jonathan-Ikone"
2020,"Lille","Ligue 1","Thiago Maia","BRA","MF","22",1997,0.5,4,4,1,3,0,0,1,0,1,0,0,0,1,5,1,0,"https://fbref.com/en/players/91e58f66/Thiago-Maia"
2020,"Lille","Ligue 1","Mike Maignan","FRA","GK","24",1995,28,0,0,0,0,0,0,0,NA,0,0,0,0,2,2,5,0,"https://fbref.com/en/players/fcb38f57/Mike-Maignan"
2020,"Lille","Ligue 1","Reinildo Mandava","MOZ","DF,MF","25",1994,12.3,37,21,23,11,3,25,41,61,16,16,1,15,19,56,20,0,"https://fbref.com/en/players/c20bdcd7/Reinildo-Mandava"
2020,"Lille","Ligue 1","Cheikh Niasse","SEN","MF","19",2000,0.2,0,0,0,0,0,0,0,NA,0,0,0,0,0,0,0,0,"https://fbref.com/en/players/ff20acfe/Cheikh-Niasse"
2020,"Lille","Ligue 1","Jean Onana","CMR","MF","19",2000,0.9,0,0,0,0,0,0,2,0,2,1,0,1,1,1,0,0,"https://fbref.com/en/players/b5bb8188/Jean-Onana"
2020,"Lille","Ligue 1","Victor Osimhen","NGA","FW","20",1998,25.4,8,4,1,0,7,1,11,9.1,10,8,0,8,11,19,32,0,"https://fbref.com/en/players/8c90fd7a/Victor-Osimhen"
2020,"Lille","Ligue 1","Abou Ouattara","BFA","FW","19",1999,0.1,0,0,0,0,0,0,0,NA,0,0,0,0,0,0,1,0,"https://fbref.com/en/players/6578600f/Abou-Ouattara"
2020,"Lille","Ligue 1","Jérémy Pied","FRA","DF","30",1989,5,18,10,6,11,1,11,16,68.8,5,8,0,8,7,25,10,0,"https://fbref.com/en/players/a634b9d2/Jeremy-Pied"
2020,"Lille","Ligue 1","Loïc Rémy","FRA","FW","32",1987,10.7,4,1,0,3,1,0,4,0,4,1,1,0,0,4,7,0,"https://fbref.com/en/players/5c2da10f/Loic-Remy"
2020,"Lille","Ligue 1","Renato Sanches","POR","MF,FW","21",1997,16.5,28,15,9,15,4,8,33,24.2,25,19,1,18,15,43,10,1,"https://fbref.com/en/players/032f894e/Renato-Sanches"
2020,"Lille","Ligue 1","Adama Soumaoro","FRA","DF","27",1992,4.6,1,1,0,1,0,0,0,NA,0,6,5,1,4,5,17,0,"https://fbref.com/en/players/7b075c75/Adama-Soumaoro"
2020,"Lille","Ligue 1","Boubakary Soumaré","FRA","MF","20",1999,13.5,19,12,6,13,0,9,19,47.4,10,6,0,6,16,35,9,0,"https://fbref.com/en/players/ae59b359/Boubakary-Soumare"
2020,"Lille","Ligue 1","Timothy Weah","USA","MF,FW","19",2000,0.9,0,0,0,0,0,0,1,0,1,0,0,0,0,0,1,0,"https://fbref.com/en/players/8eec784d/Timothy-Weah"
2020,"Lille","Ligue 1","Xeka","POR","MF","24",1994,7.9,18,10,3,13,2,9,29,31,20,11,1,10,4,22,7,1,"https://fbref.com/en/players/f3600c02/Xeka"
2020,"Lille","Ligue 1","Yusuf Yazıcı","TUR","MF,FW","22",1997,9.4,17,8,2,11,4,5,13,38.5,8,6,1,5,5,22,1,1,"https://fbref.com/en/players/f5c8b425/Yusuf-Yazici"
2020,"Liverpool","Premier League","Adrián","ESP","GK","32",1987,9.7,1,1,1,0,0,1,1,100,0,0,0,0,0,1,8,3,"https://fbref.com/en/players/f76e6b4e/Adrian"
2020,"Liverpool","Premier League","Trent Alexander-Arnold","ENG","DF","20",1998,35.3,55,34,35,17,3,36,78,46.2,42,27,9,18,45,100,84,3,"https://fbref.com/en/players/cd1acf9d/Trent-Alexander-Arnold"
2020,"Liverpool","Premier League","Alisson","BRA","GK","26",1992,28.3,0,0,0,0,0,0,2,0,2,0,0,0,1,1,13,3,"https://fbref.com/en/players/7a2e46a8/Alisson"
2020,"Liverpool","Premier League","Harvey Elliott","ENG","DF","16",2003,0.1,0,0,0,0,0,0,0,NA,0,0,0,0,0,0,0,0,"https://fbref.com/en/players/c8387671/Harvey-Elliott"
2020,"Liverpool","Premier League","Fabinho","BRA","MF","25",1993,23.1,62,35,20,35,7,26,67,38.8,41,25,2,23,34,96,19,1,"https://fbref.com/en/players/7f3b388c/Fabinho"
2020,"Liverpool","Premier League","Roberto Firmino","BRA","FW","27",1991,33.2,37,19,8,14,15,10,43,23.3,33,34,3,31,7,44,11,1,"https://fbref.com/en/players/4c370d81/Roberto-Firmino"
2020,"Liverpool","Premier League","Joe Gomez","ENG","DF","22",1997,22.3,23,16,17,6,0,9,20,45,11,15,8,7,38,61,64,2,"https://fbref.com/en/players/7a11550b/Joe-Gomez"
2020,"Liverpool","Premier League","Jordan Henderson","ENG","MF","29",1990,24.9,63,41,18,33,12,22,55,40,33,22,4,18,30,93,21,2,"https://fbref.com/en/players/935e6b8f/Jordan-Henderson"
2020,"Liverpool","Premier League","Curtis Jones","ENG","MF","18",2001,1.4,4,4,0,1,3,3,4,75,1,2,0,2,2,6,1,0,"https://fbref.com/en/players/4fb9c88f/Curtis-Jones"
2020,"Liverpool","Premier League","Naby Keïta","GUI","MF","24",1995,9.1,30,14,8,16,6,11,26,42.3,15,18,0,18,10,40,4,0,"https://fbref.com/en/players/f25c8e3a/Naby-Keita"
2020,"Liverpool","Premier League","Adam Lallana","ENG","MF,FW","31",1988,4.2,19,9,7,9,3,6,21,28.6,15,7,0,7,5,24,3,0,"https://fbref.com/en/players/99813635/Adam-Lallana"
2020,"Liverpool","Premier League","Dejan Lovren","CRO","DF","30",1989,8.6,13,8,10,3,0,7,12,58.3,5,9,6,3,10,23,42,0,"https://fbref.com/en/players/1a2935f6/Dejan-Lovren"
2020,"Liverpool","Premier League","Sadio Mané","SEN","FW","27",1992,30.5,44,32,9,20,15,13,40,32.5,27,19,0,19,13,57,11,2,"https://fbref.com/en/players/c691bfe2/Sadio-Mane"
2020,"Liverpool","Premier League","Joël Matip","CMR","DF","27",1991,7.8,13,9,4,7,2,4,11,36.4,7,8,4,4,12,25,38,0,"https://fbref.com/en/players/b217ef29/Joel-Matip"
2020,"Liverpool","Premier League","James Milner","ENG","MF,DF","33",1986,10.4,16,10,3,10,3,6,26,23.1,20,12,3,9,7,23,17,1,"https://fbref.com/en/players/2f90f6b8/James-Milner"
2020,"Liverpool","Premier League","Takumi Minamino","JPN","FW,MF","24",1995,2.8,3,3,0,2,1,2,10,20,8,3,0,3,0,3,3,0,"https://fbref.com/en/players/f833a830/Takumi-Minamino"
2020,"Liverpool","Premier League","Divock Origi","BEL","FW","24",1995,8,12,9,2,5,5,4,9,44.4,5,2,0,2,4,16,5,0,"https://fbref.com/en/players/43a166b4/Divock-Origi"
2020,"Liverpool","Premier League","Alex Oxlade-Chamberlain","ENG","MF,FW","25",1993,16.5,18,9,4,6,8,5,21,23.8,16,26,1,25,22,40,10,0,"https://fbref.com/en/players/38c7feef/Alex-Oxlade-Chamberlain"
2020,"Liverpool","Premier League","Andrew Robertson","SCO","DF","25",1994,34.6,54,31,17,25,12,27,61,44.3,34,29,7,22,38,92,72,1,"https://fbref.com/en/players/2e4f5f03/Andrew-Robertson"
2020,"Liverpool","Premier League","Mohamed Salah","EGY","FW","27",1992,32,16,6,1,4,11,5,22,22.7,17,3,1,2,8,24,2,1,"https://fbref.com/en/players/e342ad68/Mohamed-Salah"
2020,"Liverpool","Premier League","Xherdan Shaqiri","SUI","FW,MF","27",1991,2.1,1,0,0,1,0,0,1,0,1,0,0,0,0,1,0,0,"https://fbref.com/en/players/6421ec64/Xherdan-Shaqiri"
2020,"Liverpool","Premier League","Virgil van Dijk","NED","DF","28",1991,38,23,12,18,5,0,6,13,46.2,7,20,15,5,40,63,166,2,"https://fbref.com/en/players/e06683ca/Virgil-van-Dijk"
2020,"Liverpool","Premier League","Georginio Wijnaldum","NED","MF","28",1990,32.6,38,20,12,21,5,10,40,25,30,18,4,14,17,55,34,3,"https://fbref.com/en/players/eb58eef0/Georginio-Wijnaldum"
2020,"Liverpool","Premier League","Neco Williams","WAL","DF","18",2001,2.6,5,3,1,3,1,4,5,80,1,3,1,2,9,14,6,0,"https://fbref.com/en/players/dd323728/Neco-Williams"
2020,"Lyon","Ligue 1","Joachim Andersen","DEN","DF","23",1996,17,17,9,15,2,0,7,19,36.8,12,16,12,4,10,27,74,2,"https://fbref.com/en/players/e34fc66d/Joachim-Andersen"
2020,"Lyon","Ligue 1","Houssem Aouar","FRA","MF,FW","21",1998,21.7,28,12,6,18,4,10,35,28.6,25,15,1,14,13,41,11,0,"https://fbref.com/en/players/a5db0bec/Houssem-Aouar"
2020,"Lyon","Ligue 1","Melvin Bard","FRA","DF","18",2000,0.5,0,0,0,0,0,0,0,NA,0,0,0,0,1,1,0,0,"https://fbref.com/en/players/1ddbc7ca/Melvin-Bard"
2020,"Lyon","Ligue 1","Maxence Caqueret","FRA","MF","19",2000,6.3,24,15,10,13,1,11,25,44,14,14,2,12,9,33,6,1,"https://fbref.com/en/players/f81ef10d/Maxence-Caqueret"
2020,"Lyon","Ligue 1","Rayan Cherki","FRA","MF,FW","15",2003,1.6,3,2,0,1,2,3,4,75,1,3,0,3,0,3,0,0,"https://fbref.com/en/players/b34c63a5/Rayan-Cherki"
2020,"Lyon","Ligue 1","Maxwel Cornet","CIV","FW,DF","22",1996,14.8,30,19,18,8,4,13,23,56.5,10,16,1,15,21,51,19,1,"https://fbref.com/en/players/beb391dd/Maxwel-Cornet"
2020,"Lyon","Ligue 1","Moussa Dembélé","FRA","FW","23",1996,24.3,12,7,2,5,5,4,14,28.6,10,14,3,11,5,17,31,0,"https://fbref.com/en/players/e7986081/Moussa-Dembele"
2020,"Lyon","Ligue 1","Jason Denayer","BEL","DF","24",1995,23.7,17,13,12,5,0,10,14,71.4,4,32,29,3,20,37,83,0,"https://fbref.com/en/players/47af88b8/Jason-Denayer"
2020,"Lyon","Ligue 1","Leo Dubois","FRA","DF","24",1994,15,32,23,20,9,3,13,22,59.1,9,12,4,8,18,50,34,1,"https://fbref.com/en/players/ff0ab48c/Leo-Dubois"
2020,"Lyon","Ligue 1","Amine Gouiri","FRA","FW","19",2000,0,0,0,0,0,0,0,0,NA,0,0,0,0,0,0,0,0,"https://fbref.com/en/players/aad56ca3/Amine-Gouiri"
2020,"Lyon","Ligue 1","Bruno Guimarães","BRA","MF","21",1997,3,12,7,5,6,1,5,10,50,5,1,0,1,4,16,1,0,"https://fbref.com/en/players/82518f62/Bruno-Guimaraes"
2020,"Lyon","Ligue 1","Youssouf Koné","MLI","DF","24",1995,9.1,22,14,17,3,2,12,20,60,8,2,1,1,8,30,15,0,"https://fbref.com/en/players/e6eadfb8/Youssouf-Kone"
2020,"Lyon","Ligue 1","Anthony Lopes","POR","GK","28",1990,26,0,0,0,0,0,0,0,NA,0,0,0,0,1,1,11,0,"https://fbref.com/en/players/f00de885/Anthony-Lopes"
2020,"Lyon","Ligue 1","Jean Lucas","BRA","MF","21",1998,2.2,16,7,8,5,3,2,9,22.2,7,2,2,0,2,18,0,0,"https://fbref.com/en/players/a99138af/Jean-Lucas"
2020,"Lyon","Ligue 1","Fernando Marçal","BRA","DF","30",1989,9.2,28,18,18,7,3,13,26,50,13,7,3,4,26,54,32,0,"https://fbref.com/en/players/9ae9eaea/Fernando-Marcal"
2020,"Lyon","Ligue 1","Marcelo","BRA","DF","32",1987,16.7,27,18,18,8,1,16,23,69.6,7,12,11,1,22,49,77,0,"https://fbref.com/en/players/e3d0b0c4/Marcelo"
2020,"Lyon","Ligue 1","Memphis","NED","FW,MF","25",1994,11.3,4,3,2,0,2,0,5,0,5,0,0,0,2,6,2,0,"https://fbref.com/en/players/8f696594/Memphis"
2020,"Lyon","Ligue 1","Thiago Mendes","BRA","MF","27",1992,20.1,43,29,20,19,4,21,45,46.7,24,21,7,14,46,89,36,0,"https://fbref.com/en/players/c6e5d20f/Thiago-Mendes"
2020,"Lyon","Ligue 1","Rafael","BRA","DF","29",1990,7.8,24,16,12,8,4,10,18,55.6,8,6,3,3,10,34,14,0,"https://fbref.com/en/players/9a1f2e1c/Rafael"
2020,"Lyon","Ligue 1","Jeff Reine-Adélaïde","FRA","MF,FW","21",1998,8.7,10,8,3,3,4,5,13,38.5,8,3,1,2,7,17,4,0,"https://fbref.com/en/players/d504b3e1/Jeff-Reine-Adelaide"
2020,"Lyon","Ligue 1","Oumar Solet","FRA","DF","19",2000,0.1,0,0,0,0,0,0,0,NA,0,1,1,0,0,0,1,0,"https://fbref.com/en/players/0670ee51/Oumar-Solet"
2020,"Lyon","Ligue 1","Ciprian Tătărușanu","ROU","GK","33",1986,2,0,0,0,0,0,0,0,NA,0,0,0,0,0,0,0,1,"https://fbref.com/en/players/b056e3da/Ciprian-Tatarusanu"
2020,"Lyon","Ligue 1","Martin Terrier","FRA","FW,MF","22",1997,13.3,20,15,7,10,3,3,14,21.4,11,14,1,13,10,30,11,0,"https://fbref.com/en/players/5148dcc5/Martin-Terrier"
2020,"Lyon","Ligue 1","Kenny Tete","NED","DF","23",1995,11.9,33,21,12,16,5,15,23,65.2,8,12,3,9,19,52,34,0,"https://fbref.com/en/players/77d7c96f/Kenny-Tete"
2020,"Lyon","Ligue 1","Karl Toko Ekambi","CMR","FW,MF","26",1992,6,5,2,0,1,4,3,5,60,2,2,0,2,5,10,1,0,"https://fbref.com/en/players/5ceba7fc/Karl-Toko-Ekambi"
2020,"Lyon","Ligue 1","Lucas Tousart","FRA","MF","22",1997,19.6,58,32,19,34,5,17,56,30.4,39,19,7,12,31,89,27,1,"https://fbref.com/en/players/71ec39ef/Lucas-Tousart"
2020,"Lyon","Ligue 1","Bertrand Traoré","BFA","FW,MF","23",1995,13.9,27,14,8,12,7,8,19,42.1,11,17,2,15,21,48,16,0,"https://fbref.com/en/players/c47541e0/Bertrand-Traore"
2020,"M'Gladbach","Bundesliga","László Bénes","SVK","MF","21",1997,10,15,8,3,5,7,6,19,31.6,13,6,2,4,8,23,3,1,"https://fbref.com/en/players/fe888e39/Laszlo-Benes"
2020,"M'Gladbach","Bundesliga","Keanan Bennetts","ENG","MF","20",1999,0,0,0,0,0,0,0,1,0,1,0,0,0,0,0,0,0,"https://fbref.com/en/players/f4c7c708/Keanan-Bennetts"
2020,"M'Gladbach","Bundesliga","Ramy Bensebaini","ALG","DF","24",1995,16.1,33,17,17,12,4,18,31,58.1,13,24,4,20,38,71,49,0,"https://fbref.com/en/players/378825c7/Ramy-Bensebaini"
2020,"M'Gladbach","Bundesliga","Louis Beyer","GER","DF","19",2000,1.2,3,1,3,0,0,0,1,0,1,4,2,2,1,4,4,0,"https://fbref.com/en/players/9af1f9ff/Louis-Beyer"
2020,"M'Gladbach","Bundesliga","Mamadou Doucouré","FRA","MF","21",1998,0,0,0,0,0,0,0,0,NA,0,0,0,0,0,0,0,0,"https://fbref.com/en/players/7bd5b8fd/Mamadou-Doucoure"
2020,"M'Gladbach","Bundesliga","Nico Elvedi","SUI","DF","22",1996,29.1,45,27,37,8,0,19,38,50,19,32,15,17,62,107,112,0,"https://fbref.com/en/players/48035304/Nico-Elvedi"
2020,"M'Gladbach","Bundesliga","Breel Embolo","SUI","FW,MF","22",1997,17.2,22,11,2,15,5,4,15,26.7,11,12,1,11,8,30,5,0,"https://fbref.com/en/players/0b4f388a/Breel-Embolo"
2020,"M'Gladbach","Bundesliga","Matthias Ginter","GER","DF","25",1994,30.9,34,20,19,14,1,17,31,54.8,14,27,22,5,34,68,125,3,"https://fbref.com/en/players/f521b80a/Matthias-Ginter"
2020,"M'Gladbach","Bundesliga","Patrick Herrmann","GER","FW,MF","28",1991,16.1,24,11,8,10,6,5,16,31.3,11,21,4,17,11,35,8,0,"https://fbref.com/en/players/dfb6490a/Patrick-Herrmann"
2020,"M'Gladbach","Bundesliga","Jonas Hofmann","GER","MF,FW","27",1992,18.1,43,27,22,12,9,22,76,28.9,54,28,3,25,18,61,14,0,"https://fbref.com/en/players/2903a856/Jonas-Hofmann"
2020,"M'Gladbach","Bundesliga","Tony Jantschke","GER","DF","29",1990,11.2,33,21,23,10,0,15,24,62.5,9,20,11,9,27,60,48,0,"https://fbref.com/en/players/34b54da7/Tony-Jantschke"
2020,"M'Gladbach","Bundesliga","Fabian Johnson","USA","MF,DF","31",1987,3,5,3,2,2,1,2,4,50,2,4,1,3,2,7,3,0,"https://fbref.com/en/players/76e5da9d/Fabian-Johnson"
2020,"M'Gladbach","Bundesliga","Christoph Kramer","GER","MF","28",1991,16.3,45,29,19,21,5,19,49,38.8,30,22,3,19,14,59,19,0,"https://fbref.com/en/players/496aeede/Christoph-Kramer"
2020,"M'Gladbach","Bundesliga","Stefan Lainer","AUT","DF","26",1992,30.1,51,30,25,19,7,24,54,44.4,30,38,7,31,29,80,71,0,"https://fbref.com/en/players/4aea5077/Stefan-Lainer"
2020,"M'Gladbach","Bundesliga","Torben Müsel","GER","FW","20",1999,0,0,0,0,0,0,0,0,NA,0,0,0,0,1,1,0,0,"https://fbref.com/en/players/d01b9ad6/Torben-Musel"
2020,"M'Gladbach","Bundesliga","Florian Neuhaus","GER","MF","22",1997,26.2,42,23,13,22,7,12,54,22.2,42,24,4,20,27,69,8,0,"https://fbref.com/en/players/36a59ba4/Florian-Neuhaus"
2020,"M'Gladbach","Bundesliga","Alassane Pléa","FRA","FW","26",1993,23.8,16,7,5,6,5,8,28,28.6,20,21,2,19,9,25,7,0,"https://fbref.com/en/players/bc6bd723/Alassane-Plea"
2020,"M'Gladbach","Bundesliga","Raffael","BRA","MF,FW","34",1985,0.7,0,0,0,0,0,0,2,0,2,2,0,2,0,0,0,0,"https://fbref.com/en/players/791af558/Raffael"
2020,"M'Gladbach","Bundesliga","Yann Sommer","SUI","GK","30",1988,34,0,0,0,0,0,0,1,0,1,0,0,0,1,1,11,6,"https://fbref.com/en/players/420c18a1/Yann-Sommer"
2020,"M'Gladbach","Bundesliga","Lars Stindl","GER","MF,FW","30",1988,15.9,27,16,4,15,8,10,28,35.7,18,18,2,16,10,37,7,0,"https://fbref.com/en/players/7cd6badb/Lars-Stindl"
2020,"M'Gladbach","Bundesliga","Tobias Strobl","GER","MF,DF","29",1990,6.8,9,6,5,4,0,3,8,37.5,5,8,4,4,11,20,5,0,"https://fbref.com/en/players/17780d2b/Tobias-Strobl"
2020,"M'Gladbach","Bundesliga","Marcus Thuram","FRA","FW","21",1997,24.5,26,18,7,8,11,11,29,37.9,18,20,1,19,12,38,18,0,"https://fbref.com/en/players/6f8cd6d0/Marcus-Thuram"
2020,"M'Gladbach","Bundesliga","Ibrahima Traoré","GUI","FW,MF","31",1988,1.7,4,3,1,1,2,1,7,14.3,6,1,0,1,1,5,3,0,"https://fbref.com/en/players/096a77c4/Ibrahima-Traore"
2020,"M'Gladbach","Bundesliga","Oscar Wendt","SWE","DF","33",1985,18.7,26,14,16,8,2,12,31,38.7,19,27,6,21,20,46,45,0,"https://fbref.com/en/players/b69261a0/Oscar-Wendt"
2020,"M'Gladbach","Bundesliga","Denis Zakaria","SUI","MF,DF","22",1996,21.6,49,30,23,23,3,20,39,51.3,19,39,12,27,37,86,31,1,"https://fbref.com/en/players/384d58d9/Denis-Zakaria"
2020,"Mainz 05","Bundesliga","Taiwo Awoniyi","NGA","FW,MF","21",1997,5.4,2,0,0,2,0,0,4,0,4,4,2,2,2,4,3,0,"https://fbref.com/en/players/e5478b87/Taiwo-Awoniyi"
2020,"Mainz 05","Bundesliga","Ridle Baku","GER","DF,MF","21",1998,26.1,54,31,25,22,7,26,53,49.1,27,45,7,38,42,96,57,0,"https://fbref.com/en/players/442b56fa/Ridle-Baku"
2020,"Mainz 05","Bundesliga","Leandro Barreiro Martins","LUX","MF","19",2000,10.4,38,21,16,19,3,14,29,48.3,15,18,3,15,9,47,18,1,"https://fbref.com/en/players/00242b75/Leandro-Barreiro-Martins"
2020,"Mainz 05","Bundesliga","Jean-Paul Boëtius","NED","MF","25",1994,25.2,63,33,21,31,11,20,57,35.1,37,38,1,37,26,89,6,0,"https://fbref.com/en/players/635f2732/Jean-Paul-Boetius"
2020,"Mainz 05","Bundesliga","Daniel Brosinski","GER","DF","31",1988,19,40,27,13,23,4,15,34,44.1,19,16,2,14,14,54,58,0,"https://fbref.com/en/players/a7813ac4/Daniel-Brosinski"
2020,"Mainz 05","Bundesliga","Jeffrey Bruma","NED","DF","27",1991,7.5,12,8,8,4,0,4,6,66.7,2,11,5,6,6,18,34,1,"https://fbref.com/en/players/fbffc4b1/Jeffrey-Bruma"
2020,"Mainz 05","Bundesliga","Jonathan Burkardt","GER","FW,MF","19",2000,2.8,9,4,2,5,2,3,8,37.5,5,6,1,5,0,9,1,0,"https://fbref.com/en/players/05f99a4a/Jonathan-Burkardt"
2020,"Mainz 05","Bundesliga","Ji Dong-won","KOR","FW,MF","28",1991,1.1,0,0,0,0,0,0,1,0,1,1,0,1,0,0,0,0,"https://fbref.com/en/players/7d841904/Ji-Dong-won"
2020,"Mainz 05","Bundesliga","Edimilson Fernandes","SUI","MF,DF","23",1996,16.5,33,20,12,15,6,15,33,45.5,18,17,9,8,32,65,47,1,"https://fbref.com/en/players/3bb625ac/Edimilson-Fernandes"
2020,"Mainz 05","Bundesliga","Alexander Hack","GER","DF","25",1993,8.9,26,10,19,6,1,16,27,59.3,11,20,9,11,23,49,60,1,"https://fbref.com/en/players/a5ec3ede/Alexander-Hack"
2020,"Mainz 05","Bundesliga","Pierre Kunde","CMR","MF","24",1995,20.7,34,17,15,18,1,12,30,40,18,16,4,12,26,60,55,0,"https://fbref.com/en/players/9ceb7642/Pierre-Kunde"
2020,"Mainz 05","Bundesliga","Danny Latza","GER","MF","29",1989,15.3,33,19,15,17,1,16,49,32.7,33,22,5,17,17,50,24,0,"https://fbref.com/en/players/33b554b7/Danny-Latza"
2020,"Mainz 05","Bundesliga","Aarón Martín","ESP","DF","22",1997,19.9,29,15,17,8,4,9,22,40.9,13,11,5,6,30,59,36,0,"https://fbref.com/en/players/2f3e911a/Aaron-Martin"
2020,"Mainz 05","Bundesliga","Jean-Philippe Mateta","FRA","FW","22",1997,11.7,2,2,0,2,0,0,6,0,6,3,2,1,1,3,11,0,"https://fbref.com/en/players/50e6dc35/Jean-Philippe-Mateta"
2020,"Mainz 05","Bundesliga","Alexandru Maxim","ROU","MF,DF","29",1990,1.3,4,2,1,2,1,1,3,33.3,2,0,0,0,1,5,1,0,"https://fbref.com/en/players/61fc9685/Alexandru-Maxim"
2020,"Mainz 05","Bundesliga","Florian Müller","GER","GK","21",1997,12.5,0,0,0,0,0,0,0,NA,0,0,0,0,2,2,3,1,"https://fbref.com/en/players/cbac6ec9/Florian-Muller"
2020,"Mainz 05","Bundesliga","Phillipp Mwene","AUT","DF","25",1994,3.5,11,5,9,2,0,7,12,58.3,5,10,1,9,3,14,11,0,"https://fbref.com/en/players/2ff76adc/Phillipp-Mwene"
2020,"Mainz 05","Bundesliga","Moussa Niakhate","FRA","DF","23",1996,33,35,22,29,6,0,16,29,55.2,13,40,26,14,40,75,124,4,"https://fbref.com/en/players/00242715/Moussa-Niakhate"
2020,"Mainz 05","Bundesliga","Karim Onisiwo","AUT","FW","27",1992,19.2,27,19,6,10,11,5,13,38.5,8,20,3,17,7,34,11,0,"https://fbref.com/en/players/f26834c7/Karim-Onisiwo"
2020,"Mainz 05","Bundesliga","Levin Öztunalı","GER","MF,FW","23",1996,19.8,28,19,13,12,3,12,35,34.3,23,27,1,26,9,37,14,2,"https://fbref.com/en/players/66385c46/Levin-Oztunali"
2020,"Mainz 05","Bundesliga","Ronaël Pierre-Gabriel","FRA","DF","21",1998,6.4,16,10,9,6,1,7,13,53.8,6,7,0,7,8,24,31,1,"https://fbref.com/en/players/64ba07c0/Ronael-Pierre-Gabriel"
2020,"Mainz 05","Bundesliga","Robin Quaison","SWE","FW,MF","25",1993,28.9,25,17,15,7,3,11,32,34.4,21,27,5,22,11,36,8,0,"https://fbref.com/en/players/74c7c2db/Robin-Quaison"
2020,"Mainz 05","Bundesliga","Jerry St. Juste","NED","DF","22",1996,23.5,46,25,34,10,2,14,34,41.2,20,35,19,16,52,98,86,1,"https://fbref.com/en/players/90339309/Jerry-St-Juste"
2020,"Mainz 05","Bundesliga","Ádám Szalai","HUN","FW","31",1987,12.7,8,4,0,6,2,1,11,9.1,10,9,0,9,2,10,14,0,"https://fbref.com/en/players/53e07d0b/Adam-Szalai"
2020,"Mainz 05","Bundesliga","Robin Zentner","GER","GK","24",1994,21.5,1,1,1,0,0,1,1,100,0,0,0,0,0,1,11,0,"https://fbref.com/en/players/5c4bf6ba/Robin-Zentner"
2020,"Mallorca","La Liga","Lumor Agbenyenu","GHA","DF","22",1996,20.1,31,21,19,9,3,16,35,45.7,19,13,2,11,21,52,66,1,"https://fbref.com/en/players/073b1b37/Lumor-Agbenyenu"
2020,"Mallorca","La Liga","Álex Alegría","ESP","FW","26",1992,1.2,1,0,1,0,0,0,0,NA,0,2,0,2,0,1,0,0,"https://fbref.com/en/players/46166b49/Alex-Alegria"
2020,"Mallorca","La Liga","Iddrisu Baba","GHA","MF","23",1996,32.3,59,37,26,29,4,20,70,28.6,50,31,8,23,39,98,42,0,"https://fbref.com/en/players/bfd381b3/Iddrisu-Baba"
2020,"Mallorca","La Liga","Ante Budimir","CRO","FW","28",1991,30.7,31,15,4,22,5,7,29,24.1,22,21,4,17,8,39,29,0,"https://fbref.com/en/players/8f3565b3/Ante-Budimir"
2020,"Mallorca","La Liga","Ariday Cabrera","ESP","MF","30",1988,0.4,1,1,1,0,0,0,1,0,1,2,0,2,0,1,0,0,"https://fbref.com/en/players/206b11c5/Ariday-Cabrera"
2020,"Mallorca","La Liga","Xisco Campos","ESP","DF","37",1982,5.3,7,4,5,2,0,5,9,55.6,4,8,5,3,11,18,23,0,"https://fbref.com/en/players/bd3b9a9f/Xisco-Campos"
2020,"Mallorca","La Liga","Pablo Chavarría","ARG","FW,MF","31",1988,2.3,1,1,0,1,0,0,4,0,4,1,1,0,1,2,2,0,"https://fbref.com/en/players/4207e578/Pablo-Chavarria"
2020,"Mallorca","La Liga","Cucho","COL","FW,MF","20",1999,16.5,15,8,6,8,1,6,21,28.6,15,14,1,13,10,25,15,0,"https://fbref.com/en/players/71b47ab9/Cucho"
2020,"Mallorca","La Liga","Fabricio","ESP","GK","31",1987,1,0,0,0,0,0,0,0,NA,0,0,0,0,0,0,0,1,"https://fbref.com/en/players/af245161/Fabricio"
2020,"Mallorca","La Liga","Aleix Febas","ESP","MF,FW","23",1996,18.8,36,24,13,19,4,12,36,33.3,24,15,0,15,17,53,6,0,"https://fbref.com/en/players/38126309/Aleix-Febas"
2020,"Mallorca","La Liga","Fran Gámez","ESP","DF","28",1991,19.6,64,42,32,27,5,33,74,44.6,41,31,11,20,29,93,41,0,"https://fbref.com/en/players/2e3406ae/Fran-Gamez"
2020,"Mallorca","La Liga","Lago Junior","CIV","MF,FW","28",1990,24.3,32,19,12,11,9,12,29,41.4,17,23,5,18,14,46,25,0,"https://fbref.com/en/players/360d70f8/Lago-Junior"
2020,"Mallorca","La Liga","Leonardo Koutris","GRE","DF","24",1995,1,1,1,0,0,1,1,2,50,1,1,1,0,1,2,6,0,"https://fbref.com/en/players/114b510e/Leonardo-Koutris"
2020,"Mallorca","La Liga","Takefusa Kubo","JPN","MF,FW","18",2001,25.7,34,22,16,12,6,15,44,34.1,29,19,1,18,23,57,10,0,"https://fbref.com/en/players/16aa3654/Takefusa-Kubo"
2020,"Mallorca","La Liga","Rafel Obrador","ESP","DF","15",2004,0,0,0,0,0,0,0,1,0,1,0,0,0,0,0,1,0,"https://fbref.com/en/players/949c3655/Rafel-Obrador"
2020,"Mallorca","La Liga","Miquel Parera","ESP","GK","23",1996,1,0,0,0,0,0,0,0,NA,0,0,0,0,0,0,0,0,"https://fbref.com/en/players/f9b42381/Miquel-Parera"
2020,"Mallorca","La Liga","Marc Pedraza","ESP","MF","32",1987,1.4,1,1,1,0,0,1,5,20,4,0,0,0,4,5,1,0,"https://fbref.com/en/players/ff8f26ef/Marc-Pedraza"
2020,"Mallorca","La Liga","Alejandro Pozo Pozo","ESP","DF","20",1999,16.6,38,24,30,6,2,19,38,50,19,23,2,21,23,61,29,1,"https://fbref.com/en/players/3c16d927/Alejandro-Pozo-Pozo"
2020,"Mallorca","La Liga","Abdón Prats","ESP","FW","26",1992,3.1,1,1,0,0,1,0,1,0,1,1,0,1,0,1,1,0,"https://fbref.com/en/players/d1b060e2/Abdon-Prats"
2020,"Mallorca","La Liga","Baba Rahman","GHA","DF","25",1994,1.2,3,2,2,0,1,0,0,NA,0,2,1,1,1,4,2,0,"https://fbref.com/en/players/e4086af3/Baba-Rahman"
2020,"Mallorca","La Liga","Antonio Raillo","ESP","DF","27",1991,30.8,31,21,24,7,0,13,19,68.4,6,31,26,5,22,53,112,1,"https://fbref.com/en/players/b857bd29/Antonio-Raillo"
2020,"Mallorca","La Liga","Manolo Reina","ESP","GK","34",1985,36,0,0,0,0,0,0,1,0,1,2,0,2,5,5,9,1,"https://fbref.com/en/players/605eb473/Manolo-Reina"
2020,"Mallorca","La Liga","Dani Rodríguez","ESP","MF,FW","31",1988,33.8,59,32,24,28,7,18,61,29.5,43,35,3,32,38,97,27,1,"https://fbref.com/en/players/70f8e0bd/Dani-Rodriguez"
2020,"Mallorca","La Liga","Luka Romero","ARG","FW","14",2004,0.1,0,0,0,0,0,0,0,NA,0,0,0,0,0,0,0,0,"https://fbref.com/en/players/ca6edaa0/Luka-Romero"
2020,"Mallorca","La Liga","Yannis Salibur","FRA","MF,FW","28",1991,0.9,0,0,0,0,0,0,4,0,4,0,0,0,1,1,1,0,"https://fbref.com/en/players/bb4a42be/Yannis-Salibur"
2020,"Mallorca","La Liga","Joan Sastre Vanrell","ESP","DF","22",1997,15.1,30,17,26,3,1,17,39,43.6,22,8,2,6,23,53,27,1,"https://fbref.com/en/players/f9acf8bf/Joan-Sastre-Vanrell"
2020,"Mallorca","La Liga","Aleksandar Sedlar","SRB","DF","27",1991,9,13,6,10,2,1,7,11,63.6,4,17,11,6,16,29,31,0,"https://fbref.com/en/players/a35134ae/Aleksandar-Sedlar"
2020,"Mallorca","La Liga","Josep Señé","ESP","MF","27",1991,1.7,2,1,2,0,0,2,5,40,3,2,1,1,0,2,2,0,"https://fbref.com/en/players/8fc259d7/Josep-Sene"
2020,"Mallorca","La Liga","Salva Sevilla","ESP","MF","35",1984,28.5,27,21,11,16,0,9,30,30,21,17,5,12,29,56,17,1,"https://fbref.com/en/players/75bd85ea/Salva-Sevilla"
2020,"Mallorca","La Liga","Ki Sung-yueng","KOR","MF","30",1989,0.1,0,0,0,0,0,0,1,0,1,0,0,0,0,0,0,0,"https://fbref.com/en/players/1d8c99b0/Ki-Sung-yueng"
2020,"Mallorca","La Liga","Aleksandar Trajkovski","MKD","MF,FW","26",1992,3.7,2,0,1,1,0,1,7,14.3,6,2,0,2,3,5,1,0,"https://fbref.com/en/players/84bba8b6/Aleksandar-Trajkovski"
2020,"Mallorca","La Liga","Martin Valjent","SVK","DF","23",1995,35.4,25,17,14,10,1,13,25,52,12,39,27,12,37,62,146,1,"https://fbref.com/en/players/f2c6ac01/Martin-Valjent"
2020,"Manchester City","Premier League","Sergio Agüero","ARG","FW","31",1988,16.1,7,4,0,4,3,1,8,12.5,7,9,1,8,3,10,2,0,"https://fbref.com/en/players/4d034881/Sergio-Aguero"
2020,"Manchester City","Premier League","Angeliño","ESP","DF","22",1997,4.7,5,2,3,1,1,5,7,71.4,2,1,0,1,9,14,15,0,"https://fbref.com/en/players/30941e96/Angelino"
2020,"Manchester City","Premier League","Claudio Bravo","CHI","GK","36",1983,3.9,0,0,0,0,0,0,0,NA,0,0,0,0,0,0,1,1,"https://fbref.com/en/players/10072610/Claudio-Bravo"
2020,"Manchester City","Premier League","João Cancelo","POR","DF","25",1994,13.4,40,24,21,12,7,24,40,60,16,9,2,7,21,61,18,0,"https://fbref.com/en/players/bd6351cd/Joao-Cancelo"
2020,"Manchester City","Premier League","Kevin De Bruyne","BEL","MF","28",1991,31,45,24,8,20,17,18,66,27.3,48,26,4,22,18,63,24,2,"https://fbref.com/en/players/e46012d4/Kevin-De-Bruyne"
2020,"Manchester City","Premier League","Thomas Doyle","ENG","MF","17",2001,0.2,0,0,0,0,0,0,1,0,1,0,0,0,0,0,0,0,"https://fbref.com/en/players/5526deb1/Thomas-Doyle"
2020,"Manchester City","Premier League","Ederson","BRA","GK","25",1993,34.1,2,2,2,0,0,2,5,40,3,0,0,0,3,5,16,6,"https://fbref.com/en/players/3bb7b8b4/Ederson"
2020,"Manchester City","Premier League","Fernandinho","BRA","DF","34",1985,26.6,50,35,32,16,2,29,48,60.4,19,28,16,12,25,75,82,0,"https://fbref.com/en/players/101da2b5/Fernandinho"
2020,"Manchester City","Premier League","Phil Foden","ENG","FW,MF","19",2000,10,14,10,4,6,4,6,19,31.6,13,5,0,5,6,20,2,0,"https://fbref.com/en/players/ed1e53f3/Phil-Foden"
2020,"Manchester City","Premier League","Eric García","ESP","DF","18",2001,8.8,6,1,4,2,0,5,9,55.6,4,2,0,2,18,24,33,0,"https://fbref.com/en/players/2bed3eab/Eric-Garcia"
2020,"Manchester City","Premier League","İlkay Gündoğan","GER","MF","28",1990,22.4,27,16,9,11,7,9,41,22,32,17,5,12,31,58,13,0,"https://fbref.com/en/players/819b3158/Ilkay-Gundogan"
2020,"Manchester City","Premier League","Gabriel Jesus","BRA","FW","22",1997,22.6,17,10,4,5,8,7,25,28,18,26,1,25,11,28,6,0,"https://fbref.com/en/players/b66315ae/Gabriel-Jesus"
2020,"Manchester City","Premier League","Aymeric Laporte","ESP","DF","25",1994,12.2,13,6,6,7,0,4,9,44.4,5,6,5,1,20,33,26,1,"https://fbref.com/en/players/119b9a8e/Aymeric-Laporte"
2020,"Manchester City","Premier League","Riyad Mahrez","ALG","FW,MF","28",1991,21.6,28,14,11,9,8,11,38,28.9,27,31,1,30,18,46,8,2,"https://fbref.com/en/players/892d5bb1/Riyad-Mahrez"
2020,"Manchester City","Premier League","Benjamin Mendy","FRA","DF","25",1994,16.6,18,15,7,7,4,9,27,33.3,18,10,2,8,16,34,21,3,"https://fbref.com/en/players/5271c8f1/Benjamin-Mendy"
2020,"Manchester City","Premier League","Nicolás Otamendi","ARG","DF","31",1988,19.1,28,14,21,6,1,16,33,48.5,17,15,9,6,21,49,76,2,"https://fbref.com/en/players/0d267745/Nicolas-Otamendi"
2020,"Manchester City","Premier League","Rodri","ESP","MF","23",1996,27.6,50,30,17,25,8,23,63,36.5,40,19,5,14,26,76,35,0,"https://fbref.com/en/players/6434f10d/Rodri"
2020,"Manchester City","Premier League","Leroy Sané","GER","FW","23",1996,0.1,0,0,0,0,0,0,0,NA,0,0,0,0,0,0,0,0,"https://fbref.com/en/players/2b114be3/Leroy-Sane"
2020,"Manchester City","Premier League","Bernardo Silva","POR","FW,MF","24",1994,22.6,36,18,8,21,7,13,44,29.5,31,25,1,24,24,60,13,0,"https://fbref.com/en/players/3eb22ec9/Bernardo-Silva"
2020,"Manchester City","Premier League","David Silva","ESP","MF","33",1986,20.3,26,14,3,15,8,10,28,35.7,18,18,3,15,13,39,5,0,"https://fbref.com/en/players/e2716bd0/David-Silva"
2020,"Manchester City","Premier League","Raheem Sterling","ENG","FW","24",1994,29.5,27,15,8,10,9,6,28,21.4,22,16,2,14,15,42,4,0,"https://fbref.com/en/players/b400bde0/Raheem-Sterling"
2020,"Manchester City","Premier League","John Stones","ENG","DF","25",1994,12.5,16,10,8,7,1,3,5,60,2,5,3,2,9,25,32,2,"https://fbref.com/en/players/5eecec3d/John-Stones"
2020,"Manchester City","Premier League","Kyle Walker","ENG","DF","29",1990,26.6,28,18,12,15,1,12,29,41.4,17,15,6,9,28,56,42,1,"https://fbref.com/en/players/86dd77d1/Kyle-Walker"
2020,"Manchester City","Premier League","Oleksandr Zinchenko","UKR","DF","22",1996,14.2,31,19,16,11,4,17,32,53.1,15,9,0,9,17,48,21,1,"https://fbref.com/en/players/51cf8561/Oleksandr-Zinchenko"
2020,"Manchester Utd","Premier League","Eric Bailly","CIV","DF","25",1994,1.7,0,0,0,0,0,0,1,0,1,3,3,0,4,4,7,1,"https://fbref.com/en/players/a1232f4e/Eric-Bailly"
2020,"Manchester Utd","Premier League","Tahith Chong","NED","FW,DF","19",1999,0.4,0,0,0,0,0,0,0,NA,0,0,0,0,0,0,0,0,"https://fbref.com/en/players/2696b6a9/Tahith-Chong"
2020,"Manchester Utd","Premier League","Diogo Dalot","POR","DF,MF","20",1999,0.7,3,2,3,0,0,3,4,75,1,1,0,1,2,5,1,0,"https://fbref.com/en/players/d9565625/Diogo-Dalot"
2020,"Manchester Utd","Premier League","Bruno Fernandes","POR","MF","24",1994,13.2,22,12,9,9,4,5,38,13.2,33,6,0,6,11,33,16,0,"https://fbref.com/en/players/507c7bdf/Bruno-Fernandes"
2020,"Manchester Utd","Premier League","Timothy Fosu-Mensah","NED","DF","21",1998,1.5,1,1,0,1,0,1,4,25,3,0,0,0,4,5,1,0,"https://fbref.com/en/players/a9142dc3/Timothy-Fosu-Mensah"
2020,"Manchester Utd","Premier League","Fred","BRA","MF","26",1993,24,60,32,33,22,5,25,100,25,75,44,8,36,38,98,32,0,"https://fbref.com/en/players/b853e0ad/Fred"
2020,"Manchester Utd","Premier League","James Garner","ENG","MF","18",2001,0.1,0,0,0,0,0,0,1,0,1,0,0,0,0,0,1,0,"https://fbref.com/en/players/4e015693/James-Garner"
2020,"Manchester Utd","Premier League","David de Gea","ESP","GK","28",1990,38,0,0,0,0,0,0,0,NA,0,0,0,0,0,0,7,4,"https://fbref.com/en/players/7ba6d84e/David-de-Gea"
2020,"Manchester Utd","Premier League","Angel Gomes","ENG","MF","18",2000,0.2,0,0,0,0,0,0,0,NA,0,1,0,1,0,0,0,0,"https://fbref.com/en/players/645a3363/Angel-Gomes"
2020,"Manchester Utd","Premier League","Mason Greenwood","ENG","FW","17",2001,14.7,17,11,5,6,6,5,20,25,15,9,0,9,6,23,6,1,"https://fbref.com/en/players/58eee997/Mason-Greenwood"
2020,"Manchester Utd","Premier League","Odion Ighalo","NGA","FW","30",1989,1.1,2,2,0,2,0,1,3,33.3,2,1,1,0,0,2,0,0,"https://fbref.com/en/players/03622183/Odion-Ighalo"
2020,"Manchester Utd","Premier League","Daniel James","WAL","FW","21",1997,25.4,20,10,5,10,5,7,45,15.6,38,23,4,19,7,27,12,0,"https://fbref.com/en/players/c931d9f9/Daniel-James"
2020,"Manchester Utd","Premier League","Phil Jones","ENG","DF","27",1992,1.5,2,2,1,1,0,1,1,100,0,2,0,2,2,4,9,1,"https://fbref.com/en/players/def899bd/Phil-Jones"
2020,"Manchester Utd","Premier League","Victor Lindelöf","SWE","DF","25",1994,34.4,29,15,16,12,1,17,20,85,3,25,16,9,26,55,129,0,"https://fbref.com/en/players/f5deef4c/Victor-Lindelof"
2020,"Manchester Utd","Premier League","Jesse Lingard","ENG","MF,FW","26",1992,10.4,15,8,6,4,5,5,18,27.8,13,5,0,5,3,18,0,0,"https://fbref.com/en/players/810e3c74/Jesse-Lingard"
2020,"Manchester Utd","Premier League","Harry Maguire","ENG","DF","26",1993,38,37,23,23,14,0,18,34,52.9,16,31,22,9,72,109,159,0,"https://fbref.com/en/players/d8931174/Harry-Maguire"
2020,"Manchester Utd","Premier League","Anthony Martial","FRA","FW","23",1995,29.2,15,12,1,4,10,1,16,6.3,15,18,1,17,5,20,17,0,"https://fbref.com/en/players/8b788c01/Anthony-Martial"
2020,"Manchester Utd","Premier League","Juan Mata","ESP","MF,FW","31",1988,8.4,7,3,1,5,1,2,7,28.6,5,5,1,4,0,7,2,0,"https://fbref.com/en/players/29733c72/Juan-Mata"
2020,"Manchester Utd","Premier League","Nemanja Matić","SRB","MF","30",1988,17.6,46,24,23,19,4,20,43,46.5,23,21,8,13,22,68,28,1,"https://fbref.com/en/players/eb7822d7/Nemanja-Matic"
2020,"Manchester Utd","Premier League","Scott McTominay","SCO","MF","22",1996,19.7,43,22,14,25,4,17,32,53.1,15,25,5,20,31,74,34,2,"https://fbref.com/en/players/d93c2511/Scott-McTominay"
2020,"Manchester Utd","Premier League","Andreas Pereira","BRA","MF,FW","23",1996,16.5,24,13,8,9,7,10,39,25.6,29,13,0,13,7,31,7,0,"https://fbref.com/en/players/6639e500/Andreas-Pereira"
2020,"Manchester Utd","Premier League","Paul Pogba","FRA","MF","26",1993,13.4,20,9,8,8,4,8,16,50,8,12,4,8,7,27,10,2,"https://fbref.com/en/players/867239d3/Paul-Pogba"
2020,"Manchester Utd","Premier League","Marcus Rashford","ENG","FW","21",1997,29.4,13,9,1,6,6,9,23,39.1,14,23,0,23,10,23,19,0,"https://fbref.com/en/players/a1d5bd30/Marcus-Rashford"
2020,"Manchester Utd","Premier League","Marcos Rojo","ARG","DF","29",1990,1.4,3,1,2,1,0,1,2,50,1,2,1,1,0,3,6,0,"https://fbref.com/en/players/e0991c04/Marcos-Rojo"
2020,"Manchester Utd","Premier League","Luke Shaw","ENG","DF","24",1995,19.3,34,18,19,11,4,19,33,57.6,14,26,6,20,24,58,56,1,"https://fbref.com/en/players/9c94165b/Luke-Shaw"
2020,"Manchester Utd","Premier League","Axel Tuanzebe","ENG","DF","21",1997,2.1,2,2,0,2,0,1,2,50,1,1,0,1,5,7,5,1,"https://fbref.com/en/players/2baec6ce/Axel-Tuanzebe"
2020,"Manchester Utd","Premier League","Aaron Wan-Bissaka","ENG","DF","21",1997,34.1,129,80,71,50,8,64,86,74.4,22,46,13,33,66,195,83,0,"https://fbref.com/en/players/9e525177/Aaron-Wan-Bissaka"
2020,"Manchester Utd","Premier League","Brandon Williams","ENG","DF","18",2000,11.2,21,15,11,6,4,9,29,31,20,9,4,5,16,37,27,0,"https://fbref.com/en/players/5e74d6c8/Brandon-Williams"
2020,"Manchester Utd","Premier League","Ashley Young","ENG","DF","34",1985,10.6,14,7,7,4,3,5,17,29.4,12,8,2,6,11,25,29,0,"https://fbref.com/en/players/be927d03/Ashley-Young"
2020,"Marseille","Ligue 1","Marley Aké","FRA","FW,MF","18",2001,1.1,2,2,1,1,0,1,3,33.3,2,0,0,0,1,3,1,0,"https://fbref.com/en/players/414e1f69/Marley-Ake"
2020,"Marseille","Ligue 1","Jordan Amavi","FRA","DF","25",1994,24,55,29,31,19,5,31,64,48.4,33,27,6,21,56,111,97,0,"https://fbref.com/en/players/22721b88/Jordan-Amavi"
2020,"Marseille","Ligue 1","Darío Benedetto","ARG","FW","29",1990,23.3,12,9,0,9,3,3,18,16.7,15,15,2,13,3,15,23,1,"https://fbref.com/en/players/bef0a7ac/Dario-Benedetto"
2020,"Marseille","Ligue 1","Duje Ćaleta-Car","CRO","DF","22",1996,21,29,15,17,11,1,18,26,69.2,8,17,6,11,26,55,98,0,"https://fbref.com/en/players/94f8d10c/Duje-Caleta-Car"
2020,"Marseille","Ligue 1","Florian Chabrolle","FRA","MF","21",1998,0.2,0,0,0,0,0,0,0,NA,0,0,0,0,0,0,0,0,"https://fbref.com/en/players/5d9577aa/Florian-Chabrolle"
2020,"Marseille","Ligue 1","Valère Germain","FRA","FW","29",1990,15,22,12,6,11,5,6,31,19.4,25,16,3,13,8,30,26,0,"https://fbref.com/en/players/ea0ff634/Valere-Germain"
2020,"Marseille","Ligue 1","Álvaro González","ESP","DF","29",1990,18.1,19,13,14,4,1,9,13,69.2,4,7,4,3,18,37,65,0,"https://fbref.com/en/players/42dcf26d/Alvaro-Gonzalez"
2020,"Marseille","Ligue 1","Luiz Gustavo","BRA","MF","32",1987,2.1,6,3,3,3,0,3,5,60,2,5,2,3,5,11,6,0,"https://fbref.com/en/players/82671804/Luiz-Gustavo"
2020,"Marseille","Ligue 1","Boubacar Kamara","FRA","DF,MF","19",1999,23.8,67,34,37,27,3,27,57,47.4,30,27,14,13,34,101,53,1,"https://fbref.com/en/players/cc77354e/Boubacar-Kamara"
2020,"Marseille","Ligue 1","Saîf-Eddine Khaoui","TUN","MF,FW","24",1995,1.2,3,1,0,3,0,2,5,40,3,2,0,2,1,4,4,0,"https://fbref.com/en/players/796b1c41/Saif-Eddine-Khaoui"
2020,"Marseille","Ligue 1","Isaac Lihadji","FRA","MF","17",2002,0.3,0,0,0,0,0,0,0,NA,0,0,0,0,0,0,0,0,"https://fbref.com/en/players/57a46f3f/Isaac-Lihadji"
2020,"Marseille","Ligue 1","Maxime Lopez","FRA","MF,FW","21",1997,12.3,16,10,5,8,3,4,26,15.4,22,8,2,6,8,24,1,0,"https://fbref.com/en/players/20094685/Maxime-Lopez"
2020,"Marseille","Ligue 1","Steve Mandanda","FRA","GK","34",1985,26.3,3,1,3,0,0,3,4,75,1,0,0,0,1,4,2,4,"https://fbref.com/en/players/1d2d5cc8/Steve-Mandanda"
2020,"Marseille","Ligue 1","Dimitri Payet","FRA","FW,MF","32",1987,21.4,22,12,8,8,6,10,26,38.5,16,8,1,7,8,30,12,0,"https://fbref.com/en/players/58ae47b2/Dimitri-Payet"
2020,"Marseille","Ligue 1","Yohann Pelé","FRA","GK","36",1982,1.7,0,0,0,0,0,0,0,NA,0,0,0,0,0,0,0,0,"https://fbref.com/en/players/76806215/Yohann-Pele"
2020,"Marseille","Ligue 1","Lucas Perrin","FRA","DF","20",1998,4,5,2,3,2,0,2,7,28.6,5,3,2,1,10,15,17,0,"https://fbref.com/en/players/49070d66/Lucas-Perrin"
2020,"Marseille","Ligue 1","Nemanja Radonjić","SRB","FW,MF","23",1996,9.8,10,3,4,3,3,6,17,35.3,11,7,0,7,2,12,7,0,"https://fbref.com/en/players/0630eb63/Nemanja-Radonjic"
2020,"Marseille","Ligue 1","Valentin Rongier","FRA","MF","24",1994,19.9,76,51,25,41,10,22,63,34.9,41,30,4,26,36,112,16,2,"https://fbref.com/en/players/ed45c4a5/Valentin-Rongier"
2020,"Marseille","Ligue 1","Hiroki Sakai","JPN","DF","29",1990,18,57,36,26,24,7,25,40,62.5,15,20,5,15,23,80,34,1,"https://fbref.com/en/players/d63e2912/Hiroki-Sakai"
2020,"Marseille","Ligue 1","Morgan Sanson","FRA","MF","24",1994,24.1,60,28,20,29,11,13,52,25,39,39,5,34,23,83,9,0,"https://fbref.com/en/players/6e7f1353/Morgan-Sanson"
2020,"Marseille","Ligue 1","Bouna Sarr","SEN","DF,FW","27",1992,24,60,37,30,19,11,30,53,56.6,23,17,1,16,32,92,38,0,"https://fbref.com/en/players/1a4b9094/Bouna-Sarr"
2020,"Marseille","Ligue 1","Kevin Strootman","NED","MF","29",1990,15.7,39,27,13,23,3,20,49,40.8,29,16,1,15,17,56,24,0,"https://fbref.com/en/players/ef2e5e1a/Kevin-Strootman"
2020,"Marseille","Ligue 1","Florian Thauvin","FRA","FW","26",1993,0.2,1,0,0,1,0,0,1,0,1,0,0,0,0,1,0,0,"https://fbref.com/en/players/2b9fdeea/Florian-Thauvin"
2020,"Metz","Ligue 1","Thierry Ambrose","GLP","FW","22",1997,6.1,7,5,2,2,3,2,7,28.6,5,3,0,3,3,10,3,0,"https://fbref.com/en/players/2945f4b7/Thierry-Ambrose"
2020,"Metz","Ligue 1","Victorien Angban","CIV","MF","22",1996,11.4,23,18,11,11,1,11,24,45.8,13,9,2,7,8,31,5,0,"https://fbref.com/en/players/d8992b84/Victorien-Angban"
2020,"Metz","Ligue 1","Farid Boulaya","ALG","FW","26",1993,9.1,14,10,7,4,3,7,19,36.8,12,5,0,5,6,20,3,0,"https://fbref.com/en/players/a0791826/Farid-Boulaya"
2020,"Metz","Ligue 1","John Boye","GHA","DF","32",1987,23.5,30,19,25,5,0,19,32,59.4,13,31,18,13,31,61,116,0,"https://fbref.com/en/players/861227d2/John-Boye"
2020,"Metz","Ligue 1","Dylan Bronn","TUN","DF","24",1995,9,7,5,6,1,0,4,7,57.1,3,11,9,2,6,13,42,0,"https://fbref.com/en/players/edd81e2a/Dylan-Bronn"
2020,"Metz","Ligue 1","Manuel Cabit","MTQ","DF","26",1993,3,3,1,1,2,0,2,10,20,8,5,0,5,4,7,5,0,"https://fbref.com/en/players/38568467/Manuel-Cabit"
2020,"Metz","Ligue 1","Fabien Centonze","FRA","DF","23",1996,28,76,49,53,22,1,34,57,59.6,23,30,11,19,59,135,98,0,"https://fbref.com/en/players/3c6bbbab/Fabien-Centonze"
2020,"Metz","Ligue 1","Renaud Cohade","FRA","MF","34",1984,8.5,28,20,11,12,5,12,28,42.9,16,14,3,11,8,36,6,0,"https://fbref.com/en/players/4e7d66f8/Renaud-Cohade"
2020,"Metz","Ligue 1","Thomas Delaine","FRA","DF","27",1992,13.9,25,16,18,6,1,12,21,57.1,9,17,1,16,15,40,28,0,"https://fbref.com/en/players/8332db56/Thomas-Delaine"
2020,"Metz","Ligue 1","Paul Delecroix","GNB","GK","30",1988,1.5,0,0,0,0,0,0,0,NA,0,0,0,0,0,0,0,0,"https://fbref.com/en/players/2ee1b96b/Paul-Delecroix"
2020,"Metz","Ligue 1","Habib Diallo","SEN","FW","24",1995,24.4,2,1,0,2,0,0,6,0,6,6,5,1,4,6,43,0,"https://fbref.com/en/players/6605d143/Habib-Diallo"
2020,"Metz","Ligue 1","Mamadou Fofana","MLI","DF,MF","21",1998,17.6,57,35,38,15,4,21,41,51.2,20,22,10,12,22,79,61,1,"https://fbref.com/en/players/4c4ffacc/Mamadou-Fofana"
2020,"Metz","Ligue 1","Marvin Gakpa","FRA","MF,FW","25",1993,5.2,10,6,3,4,3,4,8,50,4,3,0,3,5,15,1,0,"https://fbref.com/en/players/c1b16364/Marvin-Gakpa"
2020,"Metz","Ligue 1","Habib Maïga","CIV","MF","23",1996,25.2,84,50,36,38,10,24,64,37.5,40,39,4,35,34,118,39,2,"https://fbref.com/en/players/e768de1f/Habib-Maiga"
2020,"Metz","Ligue 1","Georges Mikautadze","GEO","FW","18",2000,0.1,1,0,0,0,1,0,0,NA,0,0,0,0,0,1,0,0,"https://fbref.com/en/players/4788cb6b/Georges-Mikautadze"
2020,"Metz","Ligue 1","Kévin N'Doram","FRA","MF","23",1996,18.3,43,28,19,21,3,17,40,42.5,23,20,8,12,26,69,23,0,"https://fbref.com/en/players/e50623a0/Kevin-NDoram"
2020,"Metz","Ligue 1","Papa Ndiaga Yade","SEN","FW","19",2000,0,0,0,0,0,0,0,0,NA,0,0,0,0,0,0,0,0,"https://fbref.com/en/players/87e9c7cd/Papa-Ndiaga-Yade"
2020,"Metz","Ligue 1","Opa Nguette","SEN","FW","25",1994,20.3,44,28,23,15,6,11,39,28.2,28,17,3,14,12,56,12,0,"https://fbref.com/en/players/75a63397/Opa-Nguette"
2020,"Metz","Ligue 1","Ibrahima Niane","SEN","FW","20",1999,10.6,8,7,2,5,1,5,16,31.3,11,5,1,4,10,18,11,1,"https://fbref.com/en/players/46faabfa/Ibrahima-Niane"
2020,"Metz","Ligue 1","Alexandre Oukidja","ALG","GK","31",1988,26.5,0,0,0,0,0,0,1,0,1,1,0,1,0,0,15,1,"https://fbref.com/en/players/ae7d0ecd/Alexandre-Oukidja"
2020,"Metz","Ligue 1","Vincent Pajot","FRA","MF","28",1990,5.8,16,11,8,7,1,2,4,50,2,5,1,4,9,25,13,0,"https://fbref.com/en/players/f86ca403/Vincent-Pajot"
2020,"Metz","Ligue 1","Stoppila Sunzu","ZAM","DF","30",1989,15,16,8,12,4,0,10,15,66.7,5,22,15,7,24,40,63,0,"https://fbref.com/en/players/1bab7b66/Stoppila-Sunzu"
2020,"Metz","Ligue 1","Adama Traoré","MLI","FW,MF","24",1995,11.2,3,1,1,2,0,3,12,25,9,7,2,5,3,6,5,0,"https://fbref.com/en/players/1a6f2a66/Adama-Traore"
2020,"Metz","Ligue 1","Matthieu Udol","FRA","DF","23",1996,12.2,29,19,19,8,2,13,24,54.2,11,21,4,17,23,52,43,0,"https://fbref.com/en/players/cc41f558/Matthieu-Udol"
2020,"Milan","Serie A","Asmir Begović","BIH","GK","32",1987,1.4,0,0,0,0,0,0,0,NA,0,0,0,0,0,0,0,0,"https://fbref.com/en/players/7b4de647/Asmir-Begovic"
2020,"Milan","Serie A","Ismaël Bennacer","ALG","MF","21",1997,27.6,67,47,21,34,12,29,73,39.7,44,25,7,18,54,121,15,2,"https://fbref.com/en/players/db092d3b/Ismael-Bennacer"
2020,"Milan","Serie A","Lucas Biglia","ARG","MF","33",1986,7.6,13,7,7,6,0,4,15,26.7,11,12,4,8,7,20,10,1,"https://fbref.com/en/players/5710a281/Lucas-Biglia"
2020,"Milan","Serie A","Giacomo Bonaventura","ITA","MF,FW","29",1989,14.9,16,9,5,6,5,5,17,29.4,12,8,3,5,7,23,10,0,"https://fbref.com/en/players/d995ed27/Giacomo-Bonaventura"
2020,"Milan","Serie A","Fabio Borini","ITA","MF","28",1991,0.8,2,2,0,0,2,0,2,0,2,1,0,1,0,2,3,0,"https://fbref.com/en/players/ef5b337e/Fabio-Borini"
2020,"Milan","Serie A","Marco Brescianini","ITA","MF","19",2000,0.3,1,1,1,0,0,0,0,NA,0,0,0,0,2,3,0,0,"https://fbref.com/en/players/dfd56738/Marco-Brescianini"
2020,"Milan","Serie A","Davide Calabria","ITA","DF","22",1996,18,52,33,28,22,2,17,41,41.5,24,23,5,18,21,73,47,1,"https://fbref.com/en/players/2146785a/Davide-Calabria"
2020,"Milan","Serie A","Hakan Çalhanoğlu","TUR","MF,FW","25",1994,30,42,21,15,21,6,12,35,34.3,23,26,2,24,26,68,26,1,"https://fbref.com/en/players/cd0fa27b/Hakan-Calhanoglu"
2020,"Milan","Serie A","Samu Castillejo","ESP","FW,MF","24",1995,13.4,24,15,10,11,3,9,42,21.4,33,17,2,15,24,48,5,0,"https://fbref.com/en/players/130a7a3f/Samu-Castillejo"
2020,"Milan","Serie A","Lorenzo Colombo","ITA","FW","17",2002,0.1,0,0,0,0,0,0,0,NA,0,0,0,0,0,0,0,0,"https://fbref.com/en/players/04df29a5/Lorenzo-Colombo"
2020,"Milan","Serie A","Andrea Conti","ITA","DF","25",1994,19.2,41,25,23,15,3,21,49,42.9,28,21,8,13,43,84,42,1,"https://fbref.com/en/players/8fef5412/Andrea-Conti"
2020,"Milan","Serie A","Gianluigi Donnarumma","ITA","GK","20",1999,35.6,1,0,1,0,0,1,2,50,1,0,0,0,3,4,25,7,"https://fbref.com/en/players/08f5afaa/Gianluigi-Donnarumma"
2020,"Milan","Serie A","Léo Duarte","BRA","DF","23",1996,4.5,4,3,0,3,1,1,4,25,3,9,6,3,3,7,9,0,"https://fbref.com/en/players/73ddc40c/Leo-Duarte"
2020,"Milan","Serie A","Matteo Gabbia","ITA","DF","19",1999,7.6,7,5,5,2,0,5,8,62.5,3,6,6,0,9,16,21,0,"https://fbref.com/en/players/c235e803/Matteo-Gabbia"
2020,"Milan","Serie A","Theo Hernández","FRA","DF","21",1997,31.3,56,39,32,18,6,33,53,62.3,20,34,6,28,43,99,62,2,"https://fbref.com/en/players/d4c9725f/Theo-Hernandez"
2020,"Milan","Serie A","Zlatan Ibrahimović","SWE","FW","37",1981,15.1,5,1,0,2,3,1,13,7.7,12,4,3,1,5,10,21,0,"https://fbref.com/en/players/4cde5509/Zlatan-Ibrahimovic"
2020,"Milan","Serie A","Franck Kessié","CIV","MF","22",1996,32.3,54,29,28,18,8,16,52,30.8,36,34,5,29,34,88,32,2,"https://fbref.com/en/players/05e19d6a/Franck-Kessie"
2020,"Milan","Serie A","Simon Kjær","DEN","DF","30",1989,13.8,22,13,17,5,0,10,18,55.6,8,20,16,4,15,37,52,0,"https://fbref.com/en/players/8b8a56ce/Simon-Kjaer"
2020,"Milan","Serie A","Rade Krunić","BIH","MF,FW","25",1993,6,16,8,8,5,3,9,16,56.3,7,5,0,5,9,25,5,0,"https://fbref.com/en/players/817c6964/Rade-Krunic"
2020,"Milan","Serie A","Diego Laxalt","URU","DF","26",1993,1.9,3,3,3,0,0,1,3,33.3,2,4,0,4,0,3,3,0,"https://fbref.com/en/players/f26e3c59/Diego-Laxalt"
2020,"Milan","Serie A","Rafael Leão","POR","FW","20",1999,15.6,7,4,2,5,0,3,9,33.3,6,4,0,4,0,7,5,0,"https://fbref.com/en/players/20730eae/Rafael-Leao"
2020,"Milan","Serie A","Daniel Maldini","ITA","FW,MF","17",2001,0.3,0,0,0,0,0,0,2,0,2,1,0,1,1,1,0,0,"https://fbref.com/en/players/801831fe/Daniel-Maldini"
2020,"Milan","Serie A","Mateo Musacchio","ARG","DF","28",1990,16.3,15,8,11,4,0,7,20,35,13,10,7,3,22,37,50,0,"https://fbref.com/en/players/91899ca8/Mateo-Musacchio"
2020,"Milan","Serie A","Lucas Paquetá","BRA","MF,FW","21",1997,12.3,33,19,12,17,4,14,37,37.8,23,17,2,15,8,41,9,0,"https://fbref.com/en/players/9b6f7fd5/Lucas-Paqueta"
2020,"Milan","Serie A","Krzysztof Piątek","POL","FW","24",1995,13.1,9,4,0,7,2,3,11,27.3,8,5,2,3,3,12,10,0,"https://fbref.com/en/players/17f3620a/Krzysztof-Piatek"
2020,"Milan","Serie A","Ante Rebić","CRO","FW,MF","25",1993,15.5,16,11,4,9,3,7,34,20.6,27,14,1,13,3,19,12,0,"https://fbref.com/en/players/536cebe5/Ante-Rebic"
2020,"Milan","Serie A","Pepe Reina","ESP","GK","36",1982,1,0,0,0,0,0,0,0,NA,0,0,0,0,0,0,0,1,"https://fbref.com/en/players/e358587b/Pepe-Reina"
2020,"Milan","Serie A","Ricardo Rodríguez","SUI","DF","26",1992,4.3,6,1,2,2,2,2,6,33.3,4,3,2,1,5,11,17,0,"https://fbref.com/en/players/7f78ad23/Ricardo-Rodriguez"
2020,"Milan","Serie A","Alessio Romagnoli","ITA","DF","24",1995,34.3,46,25,28,15,3,16,27,59.3,11,32,18,14,56,102,157,1,"https://fbref.com/en/players/3ead85f9/Alessio-Romagnoli"
2020,"Milan","Serie A","Alexis Saelemaekers","BEL","FW,DF","20",1999,7.6,14,8,5,7,2,6,20,30,14,13,1,12,8,22,1,0,"https://fbref.com/en/players/ee251371/Alexis-Saelemaekers"
2020,"Milan","Serie A","André Silva","POR","FW","23",1995,0.7,2,1,0,0,2,0,1,0,1,0,0,0,0,2,0,0,"https://fbref.com/en/players/3effaa34/Andre-Silva"
2020,"Milan","Serie A","Suso","ESP","FW,MF","25",1993,15.1,7,3,2,3,2,2,10,20,8,5,0,5,8,15,3,0,"https://fbref.com/en/players/4e219ad2/Suso"
2020,"Monaco","Ligue 1","Ruben Aguilar","FRA","DF","26",1993,11.9,36,22,19,15,2,19,28,67.9,9,6,2,4,11,47,21,0,"https://fbref.com/en/players/3dd738a1/Ruben-Aguilar"
2020,"Monaco","Ligue 1","Jean-Kévin Augustin","FRA","FW","22",1997,3,3,0,1,2,0,1,6,16.7,5,2,0,2,3,6,0,0,"https://fbref.com/en/players/97bfa797/Jean-Kevin-Augustin"
2020,"Monaco","Ligue 1","Benoît Badiashile","FRA","DF","18",2001,15.7,18,12,12,5,1,6,12,50,6,20,11,9,27,45,57,1,"https://fbref.com/en/players/06df8256/Benoit-Badiashile"
2020,"Monaco","Ligue 1","Tiemoué Bakayoko","FRA","MF","24",1994,19.1,48,24,16,27,5,29,54,53.7,25,12,4,8,29,77,17,0,"https://fbref.com/en/players/59bf127b/Tiemoue-Bakayoko"
2020,"Monaco","Ligue 1","Keita Baldé","SEN","FW,MF","24",1995,9.5,6,5,1,1,4,3,9,33.3,6,4,1,3,2,8,7,1,"https://fbref.com/en/players/509a4ccb/Keita-Balde"
2020,"Monaco","Ligue 1","Fodé Ballo-Touré","SEN","DF","22",1997,18.7,36,25,21,11,4,17,32,53.1,15,10,1,9,24,60,45,0,"https://fbref.com/en/players/f449640d/Fode-Ballo-Toure"
2020,"Monaco","Ligue 1","Gil Bastião Dias","POR","DF,MF","22",1996,11.7,53,33,30,21,2,29,58,50,29,15,1,14,13,66,22,1,"https://fbref.com/en/players/e61bdd69/Gil-Bastiao-Dias"
2020,"Monaco","Ligue 1","Wissam Ben Yedder","FRA","FW","28",1990,24,22,16,2,12,8,8,19,42.1,11,12,0,12,4,26,1,0,"https://fbref.com/en/players/942b4f90/Wissam-Ben-Yedder"
2020,"Monaco","Ligue 1","Gabriel Boschilia","BRA","MF,FW","23",1996,1.4,3,1,0,3,0,1,5,20,4,1,1,0,2,5,2,0,"https://fbref.com/en/players/e90af77c/Gabriel-Boschilia"
2020,"Monaco","Ligue 1","Cesc Fàbregas","ESP","MF","32",1987,10.3,11,4,6,3,2,6,29,20.7,23,8,1,7,7,18,3,0,"https://fbref.com/en/players/33508c78/Cesc-Fabregas"
2020,"Monaco","Ligue 1","Youssouf Fofana","FRA","MF","20",1999,6.8,16,9,6,10,0,8,15,53.3,7,12,2,10,8,24,9,0,"https://fbref.com/en/players/822d51d7/Youssouf-Fofana"
2020,"Monaco","Ligue 1","Lyle Foster","RSA","FW","18",2000,0.7,0,0,0,0,0,0,1,0,1,0,0,0,0,0,1,0,"https://fbref.com/en/players/f84a807c/Lyle-Foster"
2020,"Monaco","Ligue 1","Kamil Glik","POL","DF","31",1988,23,26,14,15,11,0,13,21,61.9,8,23,17,6,27,53,118,0,"https://fbref.com/en/players/c6056d58/Kamil-Glik"
2020,"Monaco","Ligue 1","Aleksandr Golovin","RUS","MF","23",1996,22.9,49,27,17,26,6,14,69,20.3,55,28,0,28,31,80,22,0,"https://fbref.com/en/players/3708e9fa/Aleksandr-Golovin"
2020,"Monaco","Ligue 1","Benjamin Henrichs","GER","DF,MF","22",1997,9.9,26,20,16,9,1,14,33,42.4,19,19,4,15,14,40,18,0,"https://fbref.com/en/players/0a89e877/Benjamin-Henrichs"
2020,"Monaco","Ligue 1","Jemerson","BRA","DF,MF","26",1992,11.7,28,17,13,14,1,10,21,47.6,11,8,3,5,16,44,24,0,"https://fbref.com/en/players/7cab69b5/Jemerson"
2020,"Monaco","Ligue 1","Stevan Jovetić","MNE","FW,MF","29",1989,5.3,2,1,0,1,1,1,5,20,4,1,0,1,1,3,5,0,"https://fbref.com/en/players/f36c432f/Stevan-Jovetic"
2020,"Monaco","Ligue 1","Benjamin Lecomte","FRA","GK","28",1991,28,0,0,0,0,0,0,1,0,1,1,0,1,0,0,10,5,"https://fbref.com/en/players/2fa2a875/Benjamin-Lecomte"
2020,"Monaco","Ligue 1","Rony Lopes","POR","FW","23",1995,0.9,1,0,0,1,0,0,0,NA,0,0,0,0,0,1,0,0,"https://fbref.com/en/players/7c2965bb/Rony-Lopes"
2020,"Monaco","Ligue 1","Guillermo Maripán","CHI","DF","25",1994,19.5,42,26,28,13,1,24,41,58.5,17,30,13,17,25,67,69,2,"https://fbref.com/en/players/d9764034/Guillermo-Maripan"
2020,"Monaco","Ligue 1","Gelson Martins","POR","DF,FW","24",1995,18.6,30,22,11,15,4,17,42,40.5,25,9,2,7,19,49,10,1,"https://fbref.com/en/players/3ef0fa48/Gelson-Martins"
2020,"Monaco","Ligue 1","Henry Onyekuru","NGA","MF,FW","22",1997,1.8,1,1,1,0,0,0,0,NA,0,1,0,1,1,2,0,0,"https://fbref.com/en/players/e90dc1d5/Henry-Onyekuru"
2020,"Monaco","Ligue 1","Jonathan Panzo","ENG","DF","18",2000,1.2,2,2,2,0,0,1,1,100,0,3,1,2,3,5,7,0,"https://fbref.com/en/players/c795c408/Jonathan-Panzo"
2020,"Monaco","Ligue 1","Adrien Silva","POR","MF","30",1989,13.6,37,22,14,19,4,10,37,27,27,19,6,13,12,49,14,2,"https://fbref.com/en/players/d6f88a1d/Adrien-Silva"
2020,"Monaco","Ligue 1","Islam Slimani","ALG","FW","31",1988,14.3,8,4,0,2,6,4,15,26.7,11,5,0,5,1,9,11,1,"https://fbref.com/en/players/ffec9769/Islam-Slimani"
2020,"Monaco","Ligue 1","Moussa Sylla","FRA","FW","19",1999,0.1,0,0,0,0,0,0,0,NA,0,0,0,0,0,0,0,0,"https://fbref.com/en/players/d8b97bb3/Moussa-Sylla"
2020,"Monaco","Ligue 1","Aurélien Tchouaméni","FRA","MF","19",2000,0.7,0,0,0,0,0,0,2,0,2,0,0,0,0,0,2,1,"https://fbref.com/en/players/4f255115/Aurelien-Tchouameni"
2020,"Monaco","Ligue 1","Adama Traoré","MLI","MF","24",1995,0.3,0,0,0,0,0,0,0,NA,0,0,0,0,1,1,0,0,"https://fbref.com/en/players/1a6f2a66/Adama-Traore"
2020,"Montpellier","Ligue 1","Bastian Badu","FRA","FW","19",2000,0.1,0,0,0,0,0,0,0,NA,0,0,0,0,0,0,0,0,"https://fbref.com/en/players/3deb2342/Bastian-Badu"
2020,"Montpellier","Ligue 1","Dimitry Bertaud","FRA","GK","21",1998,2.2,0,0,0,0,0,0,0,NA,0,0,0,0,0,0,0,0,"https://fbref.com/en/players/380a15e2/Dimitry-Bertaud"
2020,"Montpellier","Ligue 1","Bilal Boutobba","FRA","MF","20",1998,0.1,0,0,0,0,0,0,1,0,1,0,0,0,0,0,0,0,"https://fbref.com/en/players/e8a65bc8/Bilal-Boutobba"
2020,"Montpellier","Ligue 1","Souleymane Camara","SEN","FW","36",1982,1.8,0,0,0,0,0,0,2,0,2,0,0,0,0,0,1,0,"https://fbref.com/en/players/c58270f8/Souleymane-Camara"
2020,"Montpellier","Ligue 1","Matis Carvalho","POR","GK","20",1999,0.8,0,0,0,0,0,0,1,0,1,0,0,0,0,0,1,0,"https://fbref.com/en/players/8608f269/Matis-Carvalho"
2020,"Montpellier","Ligue 1","Joris Chotard","FRA","MF","17",2001,13.9,30,18,13,17,0,15,35,42.9,20,12,5,7,20,50,12,1,"https://fbref.com/en/players/7909ffa4/Joris-Chotard"
2020,"Montpellier","Ligue 1","Daniel Congré","FRA","DF","34",1985,21.6,37,27,20,16,1,18,38,47.4,20,8,7,1,47,84,66,1,"https://fbref.com/en/players/3f5b4635/Daniel-Congre"
2020,"Montpellier","Ligue 1","Nicolas Cozza","FRA","DF","20",1999,6.2,5,5,3,2,0,2,3,66.7,1,8,6,2,9,14,18,0,"https://fbref.com/en/players/8f325097/Nicolas-Cozza"
2020,"Montpellier","Ligue 1","Andy Delort","ALG","FW","27",1991,25.3,28,18,11,9,8,7,27,25.9,20,21,6,15,3,31,10,0,"https://fbref.com/en/players/d33c706e/Andy-Delort"
2020,"Montpellier","Ligue 1","Keagan Dolly","RSA","MF","26",1993,1.6,6,3,1,3,2,2,5,40,3,1,0,1,1,7,0,0,"https://fbref.com/en/players/ccb1c3af/Keagan-Dolly"
2020,"Montpellier","Ligue 1","Jordan Ferri","FRA","MF","27",1992,12.8,22,13,7,12,3,13,44,29.5,31,9,0,9,10,32,10,0,"https://fbref.com/en/players/375622c5/Jordan-Ferri"
2020,"Montpellier","Ligue 1","Vitorino Hilton","BRA","DF","41",1977,27.9,27,17,20,7,0,13,28,46.4,15,22,18,4,49,76,121,1,"https://fbref.com/en/players/c4bbea9f/Vitorino-Hilton"
2020,"Montpellier","Ligue 1","Yun Il-lok","KOR","MF,FW","27",1992,1.3,1,1,0,1,0,0,4,0,4,0,0,0,0,1,0,0,"https://fbref.com/en/players/23bf644d/Yun-Il-lok"
2020,"Montpellier","Ligue 1","Gaëtan Laborde","FRA","FW","25",1994,24.9,21,12,4,10,7,9,38,23.7,29,21,0,21,7,28,32,1,"https://fbref.com/en/players/7cdda3bf/Gaetan-Laborde"
2020,"Montpellier","Ligue 1","Damien Le Tallec","FRA","MF,DF","29",1990,27.3,52,27,20,28,4,24,69,34.8,45,38,18,20,38,90,59,0,"https://fbref.com/en/players/8f4d116f/Damien-Le-Tallec"
2020,"Montpellier","Ligue 1","Pedro Mendes","POR","DF","28",1990,15.3,28,17,15,13,0,15,24,62.5,9,19,12,7,28,56,42,1,"https://fbref.com/en/players/6690ef25/Pedro-Mendes"
2020,"Montpellier","Ligue 1","Florent Mollet","FRA","MF,FW","27",1991,18.7,13,11,3,8,2,7,28,25,21,9,1,8,9,22,2,0,"https://fbref.com/en/players/7e82a78f/Florent-Mollet"
2020,"Montpellier","Ligue 1","Ambroise Oyongo","CMR","DF,FW","28",1991,20.2,25,10,16,6,3,16,28,57.1,12,8,0,8,17,42,35,0,"https://fbref.com/en/players/e3e05edf/Ambroise-Oyongo"
2020,"Montpellier","Ligue 1","Mihailo Ristić","SRB","DF,MF","23",1995,9,18,14,7,11,0,9,20,45,11,7,2,5,7,25,18,0,"https://fbref.com/en/players/ea0aa7e0/Mihailo-Ristic"
2020,"Montpellier","Ligue 1","Gerónimo Rulli","ARG","GK","27",1992,25,3,1,3,0,0,3,4,75,1,1,0,1,2,5,9,1,"https://fbref.com/en/players/625c144a/Geronimo-Rulli"
2020,"Montpellier","Ligue 1","Junior Sambia","FRA","DF,MF","22",1996,6.5,8,6,4,2,2,3,13,23.1,10,4,0,4,8,16,6,0,"https://fbref.com/en/players/24eb7ed6/Junior-Sambia"
2020,"Montpellier","Ligue 1","Téji Savanier","FRA","MF","27",1991,16.9,52,39,16,30,6,25,77,32.5,52,10,0,10,35,87,21,1,"https://fbref.com/en/players/6bde367b/Teji-Savanier"
2020,"Montpellier","Ligue 1","Petar Škuletić","SRB","FW,MF","29",1990,1.2,6,4,2,2,2,2,4,50,2,0,0,0,0,6,1,0,"https://fbref.com/en/players/d9a66c60/Petar-Skuletic"
2020,"Montpellier","Ligue 1","Arnaud Souquet","FRA","DF,FW","27",1992,22.4,62,40,45,13,4,30,67,44.8,37,20,6,14,17,79,44,0,"https://fbref.com/en/players/4e0afc5d/Arnaud-Souquet"
2020,"Montpellier","Ligue 1","Mathías Suárez","URU","DF","23",1996,0.7,2,2,2,0,0,2,3,66.7,1,0,0,0,1,3,3,0,"https://fbref.com/en/players/0c291a1a/Mathias-Suarez"
2020,"Montpellier","Ligue 1","Thibaut Vargas","FRA","DF,MF","19",2000,1.7,3,1,3,0,0,2,5,40,3,1,1,0,0,3,3,0,"https://fbref.com/en/players/e9743d8a/Thibaut-Vargas"
2020,"Montpellier","Ligue 1","Clément Vidal","FRA","DF","19",2000,1,0,0,0,0,0,0,2,0,2,1,1,0,0,0,6,0,"https://fbref.com/en/players/b2791a55/Clement-Vidal"
2020,"Nantes","Ligue 1","Mehdi Abeid","ALG","MF","26",1992,20.2,55,29,18,32,5,20,53,37.7,33,16,3,13,23,78,8,1,"https://fbref.com/en/players/a4c3f7af/Mehdi-Abeid"
2020,"Nantes","Ligue 1","Dennis Appiah","FRA","DF","27",1992,17.8,58,35,32,20,6,28,52,53.8,24,9,3,6,23,81,34,0,"https://fbref.com/en/players/feb5d3ab/Dennis-Appiah"
2020,"Nantes","Ligue 1","Thomas Basila","FRA","DF","20",1999,4.6,6,3,2,4,0,4,4,100,0,0,0,0,4,10,14,0,"https://fbref.com/en/players/65391fa7/Thomas-Basila"
2020,"Nantes","Ligue 1","Cristian Benavente","PER","MF,FW","25",1994,3.9,8,5,2,5,1,2,8,25,6,1,0,1,3,11,0,0,"https://fbref.com/en/players/3b5cd50d/Cristian-Benavente"
2020,"Nantes","Ligue 1","Ludovic Blas","FRA","FW,MF","21",1997,20.5,26,18,7,15,4,5,26,19.2,21,17,1,16,14,40,11,0,"https://fbref.com/en/players/6191093d/Ludovic-Blas"
2020,"Nantes","Ligue 1","Marcus Coco","FRA","FW","23",1996,0.2,1,0,1,0,0,1,1,100,0,0,0,0,0,1,0,0,"https://fbref.com/en/players/3010aefb/Marcus-Coco"
2020,"Nantes","Ligue 1","Kalifa Coulibaly","MLI","FW","27",1991,18,11,7,0,5,6,3,5,60,2,3,1,2,6,17,32,0,"https://fbref.com/en/players/9980269a/Kalifa-Coulibaly"
2020,"Nantes","Ligue 1","Renaud Emond","BEL","FW","27",1991,3.2,3,1,0,2,1,1,5,20,4,0,0,0,0,3,7,0,"https://fbref.com/en/players/5c9ac7f0/Renaud-Emond"
2020,"Nantes","Ligue 1","Fábio","BRA","DF","29",1990,9.3,38,22,18,20,0,25,35,71.4,10,10,5,5,18,56,19,0,"https://fbref.com/en/players/bc7b4580/Fabio"
2020,"Nantes","Ligue 1","Andrei Girotto","BRA","DF","27",1992,24.2,76,53,45,29,2,39,71,54.9,32,32,17,15,34,110,111,1,"https://fbref.com/en/players/3befc2b6/Andrei-Girotto"
2020,"Nantes","Ligue 1","Josué Homawoo","FRA","DF","21",1997,0.5,6,2,3,3,0,2,2,100,0,3,2,1,2,8,2,0,"https://fbref.com/en/players/fa060e71/Josue-Homawoo"
2020,"Nantes","Ligue 1","Abdoul Kader Bamba","FRA","FW,MF","25",1994,16.3,19,15,5,9,5,9,30,30,21,8,2,6,16,35,8,0,"https://fbref.com/en/players/32f3d97e/Abdoul-Kader-Bamba"
2020,"Nantes","Ligue 1","Rene Krhin","SVN","DF,MF","29",1990,3.6,4,3,1,3,0,2,2,100,0,1,0,1,6,10,17,0,"https://fbref.com/en/players/9a506145/Rene-Krhin"
2020,"Nantes","Ligue 1","Alban Lafont","FRA","GK","20",1999,27,1,1,1,0,0,1,1,100,0,0,0,0,0,1,12,0,"https://fbref.com/en/players/4e7db402/Alban-Lafont"
2020,"Nantes","Ligue 1","Lucas Lima","BRA","FW,DF","27",1991,3,7,2,4,3,0,2,5,40,3,2,0,2,1,8,3,0,"https://fbref.com/en/players/0f52f925/Lucas-Lima"
2020,"Nantes","Ligue 1","Anthony Limbombe","BEL","FW,MF","25",1994,1.7,3,2,1,2,0,1,1,100,0,1,0,1,0,3,3,0,"https://fbref.com/en/players/ccee698e/Anthony-Limbombe"
2020,"Nantes","Ligue 1","Imran Louza","MAR","MF,FW","20",1999,22.3,53,27,18,27,8,19,46,41.3,27,18,2,16,17,70,7,0,"https://fbref.com/en/players/e1df6989/Imran-Louza"
2020,"Nantes","Ligue 1","Wesley Moustache","FRA","DF","20",1999,0.5,0,0,0,0,0,0,0,NA,0,1,0,1,0,0,2,0,"https://fbref.com/en/players/4c93a97f/Wesley-Moustache"
2020,"Nantes","Ligue 1","Samuel Moutoussamy","COD","DF,MF","22",1996,5.8,4,1,2,1,1,2,7,28.6,5,2,0,2,4,8,7,0,"https://fbref.com/en/players/af0c835b/Samuel-Moutoussamy"
2020,"Nantes","Ligue 1","Nicolas Pallois","FRA","DF","31",1987,21,47,36,28,17,2,31,55,56.4,24,18,13,5,40,87,77,1,"https://fbref.com/en/players/779847d6/Nicolas-Pallois"
2020,"Nantes","Ligue 1","Denis Petrić","SRB","GK","31",1988,1,1,1,1,0,0,1,1,100,0,0,0,0,0,1,0,0,"https://fbref.com/en/players/dab1b8dc/Denis-Petric"
2020,"Nantes","Ligue 1","Percy Prado","PER","DF","23",1996,2.1,6,5,3,2,1,5,9,55.6,4,1,0,1,1,7,5,0,"https://fbref.com/en/players/9bb0b9f1/Percy-Prado"
2020,"Nantes","Ligue 1","Valentin Rongier","FRA","MF","24",1994,3,5,4,0,2,3,3,5,60,2,4,0,4,2,7,0,0,"https://fbref.com/en/players/ed45c4a5/Valentin-Rongier"
2020,"Nantes","Ligue 1","Roli Pereira de Sa","FRA","MF","22",1996,0.1,0,0,0,0,0,0,0,NA,0,0,0,0,0,0,0,0,"https://fbref.com/en/players/60f58477/Roli-Pereira-de-Sa"
2020,"Nantes","Ligue 1","Moses Simon","NGA","FW,MF","24",1995,24.2,15,7,5,4,6,6,21,28.6,15,6,0,6,8,23,6,0,"https://fbref.com/en/players/5f3eaaf5/Moses-Simon"
2020,"Nantes","Ligue 1","Abdoulaye Touré","FRA","MF","25",1994,24.7,32,21,10,21,1,10,30,33.3,20,31,11,20,29,61,18,1,"https://fbref.com/en/players/ef7cd87a/Abdoulaye-Toure"
2020,"Nantes","Ligue 1","Charles Traore","MLI","DF","27",1992,19.3,48,35,27,19,2,36,61,59,25,21,4,17,39,87,64,0,"https://fbref.com/en/players/de488e56/Charles-Traore"
2020,"Nantes","Ligue 1","Molla Wagué","MLI","DF","28",1991,7.6,15,12,11,4,0,7,7,100,0,10,8,2,15,30,42,0,"https://fbref.com/en/players/a440d8ca/Molla-Wague"
2020,"Nantes","Ligue 1","Elie Youan","FRA","FW,MF","20",1999,1.8,0,0,0,0,0,0,7,0,7,2,0,2,0,0,3,0,"https://fbref.com/en/players/698b37b8/Elie-Youan"
2020,"Napoli","Serie A","Allan","BRA","MF","28",1991,14.2,50,27,20,21,9,18,54,33.3,36,19,3,16,16,66,11,1,"https://fbref.com/en/players/cc700722/Allan"
2020,"Napoli","Serie A","José Callejón","ESP","FW,MF","32",1987,24.1,13,9,3,7,3,9,25,36,16,15,3,12,10,23,14,1,"https://fbref.com/en/players/78841da9/Jose-Callejon"
2020,"Napoli","Serie A","Diego Demme","GER","MF","27",1991,10,18,8,14,3,1,8,23,34.8,15,9,1,8,8,26,9,0,"https://fbref.com/en/players/dc3fa3b5/Diego-Demme"
2020,"Napoli","Serie A","Giovanni Di Lorenzo","ITA","DF","25",1993,33,59,35,27,19,13,32,61,52.5,29,27,11,16,28,87,54,0,"https://fbref.com/en/players/230a2fac/Giovanni-Di-Lorenzo"
2020,"Napoli","Serie A","Elif Elmas","MKD","MF","19",1999,12.6,16,7,5,6,5,5,20,25,15,11,1,10,11,27,4,0,"https://fbref.com/en/players/cf007308/Elif-Elmas"
2020,"Napoli","Serie A","Faouzi Ghoulam","ALG","DF","28",1991,4.2,6,4,1,4,1,2,5,40,3,3,2,1,4,10,8,0,"https://fbref.com/en/players/c5adc293/Faouzi-Ghoulam"
2020,"Napoli","Serie A","Elseid Hysaj","ALB","DF","25",1994,16.5,18,9,13,4,1,12,26,46.2,14,16,3,13,24,42,26,0,"https://fbref.com/en/players/2f3452eb/Elseid-Hysaj"
2020,"Napoli","Serie A","Lorenzo Insigne","ITA","FW,MF","28",1991,31.2,21,15,6,8,7,6,35,17.1,29,13,0,13,30,51,4,1,"https://fbref.com/en/players/2f557579/Lorenzo-Insigne"
2020,"Napoli","Serie A","Kalidou Koulibaly","SEN","DF","28",1991,23.4,51,33,30,17,4,17,28,60.7,11,28,16,12,31,82,61,1,"https://fbref.com/en/players/da974c7b/Kalidou-Koulibaly"
2020,"Napoli","Serie A","Fernando Llorente","ESP","FW","34",1985,5.6,0,0,0,0,0,0,1,0,1,4,0,4,1,1,3,0,"https://fbref.com/en/players/82dbf623/Fernando-Llorente"
2020,"Napoli","Serie A","Stanislav Lobotka","SVK","MF","24",1994,8.4,11,9,3,5,3,5,12,41.7,7,3,1,2,9,20,2,0,"https://fbref.com/en/players/e1cbb531/Stanislav-Lobotka"
2020,"Napoli","Serie A","Hirving Lozano","MEX","FW,MF","24",1995,11.4,6,4,1,5,0,2,15,13.3,13,13,0,13,5,11,5,0,"https://fbref.com/en/players/a69e4806/Hirving-Lozano"
2020,"Napoli","Serie A","Sebastiano Luperto","ITA","DF","22",1996,5.9,12,9,7,3,2,6,9,66.7,3,5,3,2,6,18,16,0,"https://fbref.com/en/players/997fff07/Sebastiano-Luperto"
2020,"Napoli","Serie A","Nikola Maksimović","SRB","DF","27",1991,20,35,24,21,14,0,10,21,47.6,11,19,11,8,30,65,64,1,"https://fbref.com/en/players/16b9d5cf/Nikola-Maksimovic"
2020,"Napoli","Serie A","Kévin Malcuit","MAR","DF","28",1991,2.8,8,6,4,3,1,5,6,83.3,1,4,1,3,3,11,2,0,"https://fbref.com/en/players/d6a889ea/Kevin-Malcuit"
2020,"Napoli","Serie A","Kostas Manolas","GRE","DF","28",1991,24.2,23,15,13,10,0,10,17,58.8,7,19,14,5,25,48,76,1,"https://fbref.com/en/players/c707411f/Kostas-Manolas"
2020,"Napoli","Serie A","Alex Meret","ITA","GK","22",1997,21.7,0,0,0,0,0,0,2,0,2,1,0,1,1,1,7,2,"https://fbref.com/en/players/9413b19f/Alex-Meret"
2020,"Napoli","Serie A","Dries Mertens","BEL","FW","32",1987,18.8,13,9,1,8,4,2,27,7.4,25,10,1,9,7,20,4,0,"https://fbref.com/en/players/89b2c8a9/Dries-Mertens"
2020,"Napoli","Serie A","Arkadiusz Milik","POL","FW","25",1994,19.4,12,5,4,1,7,3,11,27.3,8,11,1,10,2,14,12,0,"https://fbref.com/en/players/85613cf0/Arkadiusz-Milik"
2020,"Napoli","Serie A","David Ospina","COL","GK","30",1988,16.3,0,0,0,0,0,0,0,NA,0,0,0,0,0,0,2,1,"https://fbref.com/en/players/82b1198a/David-Ospina"
2020,"Napoli","Serie A","Matteo Politano","ITA","FW","25",1993,8.3,12,6,8,2,2,5,14,35.7,9,6,0,6,5,17,3,0,"https://fbref.com/en/players/5e861944/Matteo-Politano"
2020,"Napoli","Serie A","Mário Rui","POR","DF","28",1991,21.8,31,17,12,12,7,11,29,37.9,18,24,5,19,21,52,43,0,"https://fbref.com/en/players/0b5a292a/Mario-Rui"
2020,"Napoli","Serie A","Fabián Ruiz Peña","ESP","MF","23",1996,29.8,43,26,19,18,6,24,65,36.9,41,32,4,28,32,75,18,2,"https://fbref.com/en/players/c0c7ff58/Fabian-Ruiz-Pena"
2020,"Napoli","Serie A","Amin Younes","GER","FW,MF","25",1993,2,3,2,1,2,0,2,4,50,2,2,0,2,0,3,1,0,"https://fbref.com/en/players/228f73ae/Amin-Younes"
2020,"Napoli","Serie A","Piotr Zieliński","POL","MF","25",1994,32.5,26,16,10,11,5,12,30,40,18,28,5,23,21,47,15,0,"https://fbref.com/en/players/a5296e55/Piotr-Zielinski"
2020,"Newcastle Utd","Premier League","Miguel Almirón","PAR","MF,FW","25",1994,33.6,60,39,32,20,8,19,52,36.5,33,25,1,24,31,91,25,0,"https://fbref.com/en/players/862a1c15/Miguel-Almiron"
2020,"Newcastle Utd","Premier League","Christian Atsu","GHA","MF,FW","27",1992,8.3,10,8,5,5,0,5,14,35.7,9,19,0,19,5,15,9,0,"https://fbref.com/en/players/8816329f/Christian-Atsu"
2020,"Newcastle Utd","Premier League","Nabil Bentaleb","ALG","MF","24",1994,8.3,23,13,14,9,0,7,25,28,18,9,2,7,19,42,9,1,"https://fbref.com/en/players/3189f61a/Nabil-Bentaleb"
2020,"Newcastle Utd","Premier League","Andy Carroll","ENG","FW","30",1989,7,5,3,3,2,0,2,8,25,6,2,1,1,2,7,24,1,"https://fbref.com/en/players/b581987a/Andy-Carroll"
2020,"Newcastle Utd","Premier League","Ciaran Clark","IRL","DF","29",1989,13.2,20,12,18,2,0,9,15,60,6,18,14,4,11,31,82,0,"https://fbref.com/en/players/2b91cf8e/Ciaran-Clark"
2020,"Newcastle Utd","Premier League","Martin Dúbravka","SVK","GK","30",1989,38,1,1,1,0,0,1,2,50,1,2,0,2,1,2,17,5,"https://fbref.com/en/players/3a949a25/Martin-Dubravka"
2020,"Newcastle Utd","Premier League","Paul Dummett","WAL","DF","27",1991,13.6,27,17,19,7,1,21,27,77.8,6,23,9,14,23,50,69,0,"https://fbref.com/en/players/3fe6bd8c/Paul-Dummett"
2020,"Newcastle Utd","Premier League","Federico Fernández","ARG","DF","30",1989,29.1,42,25,30,10,2,23,46,50,23,41,28,13,24,66,190,2,"https://fbref.com/en/players/f25b010f/Federico-Fernandez"
2020,"Newcastle Utd","Premier League","Dwight Gayle","ENG","FW","28",1990,9.4,12,10,4,6,2,4,8,50,4,5,0,5,2,14,9,0,"https://fbref.com/en/players/e58a03c6/Dwight-Gayle"
2020,"Newcastle Utd","Premier League","Isaac Hayden","ENG","MF","24",1995,24.7,55,27,33,17,5,20,50,40,30,24,7,17,38,93,38,0,"https://fbref.com/en/players/c951a6df/Isaac-Hayden"
2020,"Newcastle Utd","Premier League","Joelinton","BRA","FW","22",1996,29.8,34,20,7,22,5,9,32,28.1,23,32,6,26,11,45,30,0,"https://fbref.com/en/players/c17bfb65/Joelinton"
2020,"Newcastle Utd","Premier League","Emil Krafth","SWE","DF","24",1994,11.3,18,12,15,2,1,9,20,45,11,11,8,3,8,26,45,0,"https://fbref.com/en/players/77cf6852/Emil-Krafth"
2020,"Newcastle Utd","Premier League","Jamaal Lascelles","ENG","DF","25",1993,23.1,14,3,10,4,0,4,9,44.4,5,23,20,3,28,42,116,1,"https://fbref.com/en/players/450ab6fc/Jamaal-Lascelles"
2020,"Newcastle Utd","Premier League","Valentino Lazaro","AUT","DF,MF","23",1996,5.3,13,9,11,2,0,11,18,61.1,7,2,0,2,3,16,4,0,"https://fbref.com/en/players/016ff750/Valentino-Lazaro"
2020,"Newcastle Utd","Premier League","Florian Lejeune","FRA","DF","28",1991,4.9,8,2,6,2,0,4,7,57.1,3,6,2,4,10,18,15,2,"https://fbref.com/en/players/6eaed4eb/Florian-Lejeune"
2020,"Newcastle Utd","Premier League","Matthew Longstaff","ENG","MF","19",2000,6.4,3,1,2,1,0,3,14,21.4,11,4,1,3,5,8,3,0,"https://fbref.com/en/players/c0027d2d/Matthew-Longstaff"
2020,"Newcastle Utd","Premier League","Sean Longstaff","ENG","MF","21",1997,15.3,35,19,17,16,2,20,50,40,30,23,5,18,19,54,20,2,"https://fbref.com/en/players/a2b105e0/Sean-Longstaff"
2020,"Newcastle Utd","Premier League","Javier Manquillo","ESP","DF","25",1994,17.8,39,26,27,8,4,24,38,63.2,14,14,2,12,18,57,56,0,"https://fbref.com/en/players/758dd7f0/Javier-Manquillo"
2020,"Newcastle Utd","Premier League","Yoshinori Mutō","JPN","MF,FW","27",1992,2.4,3,2,1,2,0,1,2,50,1,0,0,0,0,3,0,0,"https://fbref.com/en/players/5343eb4e/Yoshinori-Muto"
2020,"Newcastle Utd","Premier League","Matt Ritchie","SCO","DF,MF","29",1989,14.6,22,15,9,10,3,3,15,20,12,20,5,15,14,36,31,1,"https://fbref.com/en/players/71ef519e/Matt-Ritchie"
2020,"Newcastle Utd","Premier League","Danny Rose","ENG","DF","29",1990,9.6,21,12,11,8,2,12,21,57.1,9,11,4,7,10,31,14,1,"https://fbref.com/en/players/89d10e53/Danny-Rose"
2020,"Newcastle Utd","Premier League","Allan Saint-Maximin","FRA","MF,FW","22",1997,20.7,13,8,7,4,2,4,18,22.2,14,5,2,3,9,22,6,0,"https://fbref.com/en/players/2b16cb1a/Allan-Saint-Maximin"
2020,"Newcastle Utd","Premier League","Fabian Schär","SUI","DF,MF","27",1991,18.6,39,21,25,14,0,19,40,47.5,21,35,18,17,47,86,74,2,"https://fbref.com/en/players/c8aa95da/Fabian-Schar"
2020,"Newcastle Utd","Premier League","Jonjo Shelvey","ENG","MF","27",1992,23.5,29,19,17,12,0,11,42,26.2,31,14,5,9,23,52,38,0,"https://fbref.com/en/players/3727dd3c/Jonjo-Shelvey"
2020,"Newcastle Utd","Premier League","Ki Sung-yueng","KOR","MF","30",1989,1.5,1,1,0,1,0,1,3,33.3,2,1,0,1,3,4,2,0,"https://fbref.com/en/players/1d8c99b0/Ki-Sung-yueng"
2020,"Newcastle Utd","Premier League","Kelland Watts","ENG","DF","19",1999,0.2,1,0,1,0,0,1,1,100,0,0,0,0,0,1,0,0,"https://fbref.com/en/players/603e4f0b/Kelland-Watts"
2020,"Newcastle Utd","Premier League","Jetro Willems","NED","DF","25",1994,16.6,37,19,29,6,2,18,39,46.2,21,20,5,15,17,54,42,1,"https://fbref.com/en/players/9050ddc4/Jetro-Willems"
2020,"Newcastle Utd","Premier League","DeAndre Yedlin","USA","DF","26",1993,10.4,18,13,10,6,2,8,16,50,8,13,7,6,10,28,20,0,"https://fbref.com/en/players/ae0a7ddf/DeAndre-Yedlin"
2020,"Nice","Ligue 1","Youcef Atal","ALG","FW,DF","23",1996,11.1,24,11,15,6,3,13,31,41.9,18,12,1,11,24,48,11,1,"https://fbref.com/en/players/6a827d8e/Youcef-Atal"
2020,"Nice","Ligue 1","Danilo Barbosa","BRA","DF,MF","23",1996,12.5,28,21,17,9,2,13,29,44.8,16,21,6,15,20,48,38,0,"https://fbref.com/en/players/0557ff4f/Danilo-Barbosa"
2020,"Nice","Ligue 1","Walter Benítez","ARG","GK","26",1993,26,1,1,1,0,0,1,3,33.3,2,0,0,0,0,1,8,0,"https://fbref.com/en/players/8a2248b4/Walter-Benitez"
2020,"Nice","Ligue 1","Hicham Boudaoui","ALG","MF,FW","19",1999,5.4,20,10,6,11,3,9,23,39.1,14,10,3,7,13,33,7,0,"https://fbref.com/en/players/f9d5908e/Hicham-Boudaoui"
2020,"Nice","Ligue 1","Patrick Burner","MTQ","DF","23",1996,15.9,35,25,15,17,3,14,25,56,11,11,2,9,30,65,37,0,"https://fbref.com/en/players/8746d5d0/Patrick-Burner"
2020,"Nice","Ligue 1","Ibrahim Cissé","CIV","DF","20",1999,0.6,1,1,1,0,0,0,0,NA,0,0,0,0,0,1,6,0,"https://fbref.com/en/players/9cebd6ce/Ibrahim-Cisse"
2020,"Nice","Ligue 1","Alexis Claude-Maurice","FRA","FW,MF","21",1998,18.1,26,16,8,11,7,13,35,37.1,22,20,4,16,11,37,4,0,"https://fbref.com/en/players/741418c3/Alexis-Claude-Maurice"
2020,"Nice","Ligue 1","Yannis Clementia","MTQ","GK","22",1997,2,0,0,0,0,0,0,0,NA,0,0,0,0,0,0,0,0,"https://fbref.com/en/players/7800bdb8/Yannis-Clementia"
2020,"Nice","Ligue 1","Racine Coly","SEN","DF,FW","23",1995,7.2,21,13,15,5,1,9,17,52.9,8,5,0,5,12,33,23,0,"https://fbref.com/en/players/166a981d/Racine-Coly"
2020,"Nice","Ligue 1","Wylan Cyprien","FRA","MF","24",1995,19.7,17,11,5,12,0,7,27,25.9,20,8,2,6,19,36,16,3,"https://fbref.com/en/players/3e092724/Wylan-Cyprien"
2020,"Nice","Ligue 1","Dante","BRA","DF","35",1983,21,34,21,24,10,0,17,25,68,8,27,16,11,26,60,79,0,"https://fbref.com/en/players/fd2bc67d/Dante"
2020,"Nice","Ligue 1","Kasper Dolberg","DEN","FW","21",1997,21,10,6,0,3,7,4,17,23.5,13,18,2,16,10,20,24,0,"https://fbref.com/en/players/cc83b74d/Kasper-Dolberg"
2020,"Nice","Ligue 1","Riza Durmisi","DEN","DF,MF","25",1994,1.8,1,1,1,0,0,0,0,NA,0,2,1,1,1,2,3,0,"https://fbref.com/en/players/e5cd9da6/Riza-Durmisi"
2020,"Nice","Ligue 1","Ignatius Ganago","CMR","FW,MF","20",1999,13.8,10,6,4,3,3,3,18,16.7,15,8,1,7,4,14,13,0,"https://fbref.com/en/players/23c63b7f/Ignatius-Ganago"
2020,"Nice","Ligue 1","Christophe Hérelle","MTQ","DF","26",1992,12.3,14,11,10,4,0,3,7,42.9,4,14,8,6,17,31,26,1,"https://fbref.com/en/players/3681cfff/Christophe-Herelle"
2020,"Nice","Ligue 1","Mickaël Le Bihan","FRA","FW,DF","29",1990,1.1,0,0,0,0,0,0,2,0,2,0,0,0,0,0,2,0,"https://fbref.com/en/players/d512db65/Mickael-Le-Bihan"
2020,"Nice","Ligue 1","Pierre Lees-Melou","FRA","MF","26",1993,25,63,27,34,21,8,31,88,35.2,57,38,12,26,32,95,43,0,"https://fbref.com/en/players/f5044e54/Pierre-Lees-Melou"
2020,"Nice","Ligue 1","Gautier Lloris","FRA","DF","24",1995,3,5,3,5,0,0,4,5,80,1,3,3,0,2,7,11,0,"https://fbref.com/en/players/ac89503b/Gautier-Lloris"
2020,"Nice","Ligue 1","Arnaud Lusamba","COD","MF,FW","22",1997,10.9,20,11,8,10,2,7,23,30.4,16,9,0,9,5,25,6,1,"https://fbref.com/en/players/54131505/Arnaud-Lusamba"
2020,"Nice","Ligue 1","Myziane Maolida","FRA","FW,MF","20",1999,7.5,14,10,5,6,3,5,12,41.7,7,8,0,8,3,17,3,0,"https://fbref.com/en/players/706a60e1/Myziane-Maolida"
2020,"Nice","Ligue 1","Stanley N'Soki","FRA","DF","20",1999,14.1,40,29,24,16,0,23,42,54.8,19,14,6,8,32,72,37,0,"https://fbref.com/en/players/61590953/Stanley-NSoki"
2020,"Nice","Ligue 1","Adam Ounas","ALG","FW,MF","22",1996,12.5,10,5,2,6,2,5,13,38.5,8,9,1,8,11,21,8,1,"https://fbref.com/en/players/ed90babd/Adam-Ounas"
2020,"Nice","Ligue 1","Andy Pelmard","FRA","DF","19",2000,8.5,22,14,13,9,0,9,11,81.8,2,12,4,8,15,37,28,1,"https://fbref.com/en/players/f18d7ab2/Andy-Pelmard"
2020,"Nice","Ligue 1","Ihsan Sacko","FRA","FW","22",1997,1.6,1,1,1,0,0,0,1,0,1,0,0,0,0,1,0,0,"https://fbref.com/en/players/68a87d66/Ihsan-Sacko"
2020,"Nice","Ligue 1","Malang Sarr","FRA","DF","20",1999,16.2,19,11,13,6,0,9,22,40.9,13,10,4,6,38,57,31,4,"https://fbref.com/en/players/4315f30d/Malang-Sarr"
2020,"Nice","Ligue 1","Bassem Srarfi","TUN","FW,MF","22",1997,1.5,0,0,0,0,0,0,2,0,2,0,0,0,2,2,0,0,"https://fbref.com/en/players/84549a07/Bassem-Srarfi"
2020,"Nice","Ligue 1","Eddy Sylvestre","FRA","MF","19",1999,0.4,0,0,0,0,0,0,1,0,1,0,0,0,0,0,0,0,"https://fbref.com/en/players/ff3a6a60/Eddy-Sylvestre"
2020,"Nice","Ligue 1","Adrien Tameze","CMR","MF","25",1994,5.8,6,2,2,3,1,4,16,25,12,7,2,5,7,13,1,1,"https://fbref.com/en/players/8da74c05/Adrien-Tameze"
2020,"Nice","Ligue 1","Khéphren Thuram-Ulie","FRA","MF","18",2001,6.6,22,7,14,8,0,6,17,35.3,11,12,2,10,7,29,13,0,"https://fbref.com/en/players/7d9397f8/Khephren-Thuram-Ulie"
2020,"Nice","Ligue 1","Moussa Wagué","SEN","DF,MF","20",1998,2.2,6,4,3,3,0,2,3,66.7,1,2,1,1,2,8,2,0,"https://fbref.com/en/players/808df563/Moussa-Wague"
2020,"Nice","Ligue 1","Rémi Walter","FRA","MF","24",1995,0.6,1,1,0,1,0,1,1,100,0,0,0,0,0,1,0,0,"https://fbref.com/en/players/0984c5d5/Remi-Walter"
2020,"Norwich City","Premier League","Max Aarons","ENG","DF","19",2000,36,48,30,33,9,6,18,36,50,18,46,29,17,37,85,97,1,"https://fbref.com/en/players/774cf58b/Max-Aarons"
2020,"Norwich City","Premier League","Ibrahim Amadou","FRA","DF,MF","26",1993,8.4,18,11,9,8,1,3,11,27.3,8,8,5,3,16,34,55,1,"https://fbref.com/en/players/9260926b/Ibrahim-Amadou"
2020,"Norwich City","Premier League","Emi Buendía","ARG","FW,MF","22",1996,27.4,82,39,57,21,4,38,118,32.2,80,58,5,53,23,105,32,2,"https://fbref.com/en/players/66b76d44/Emi-Buendia"
2020,"Norwich City","Premier League","Sam Byram","ENG","DF","25",1993,14.4,40,22,24,11,5,18,37,48.6,19,16,8,8,26,66,73,0,"https://fbref.com/en/players/1bf811d4/Sam-Byram"
2020,"Norwich City","Premier League","Todd Cantwell","ENG","FW,MF","21",1998,27.7,51,31,19,27,5,26,73,35.6,47,38,2,36,18,69,35,1,"https://fbref.com/en/players/f63d8a4b/Todd-Cantwell"
2020,"Norwich City","Premier League","Josip Drmić","SUI","FW","26",1992,7.2,3,2,1,2,0,0,8,0,8,6,0,6,1,4,5,1,"https://fbref.com/en/players/15ea94de/Josip-Drmic"
2020,"Norwich City","Premier League","Ondrej Duda","SVK","MF","24",1994,8,18,11,9,6,3,7,16,43.8,9,10,2,8,6,24,8,0,"https://fbref.com/en/players/79ca3e23/Ondrej-Duda"
2020,"Norwich City","Premier League","Ralf Fährmann","GER","GK","30",1988,0.2,0,0,0,0,0,0,0,NA,0,0,0,0,0,0,0,0,"https://fbref.com/en/players/1e43fad8/Ralf-Fahrmann"
2020,"Norwich City","Premier League","Akin Famewo","ENG","MF","20",1998,0,0,0,0,0,0,0,0,NA,0,0,0,0,0,0,0,0,"https://fbref.com/en/players/9d9a71c1/Akin-Famewo"
2020,"Norwich City","Premier League","Ben Godfrey","ENG","DF","21",1998,29.4,22,14,18,3,1,10,18,55.6,8,41,37,4,25,47,152,3,"https://fbref.com/en/players/9f7c837d/Ben-Godfrey"
2020,"Norwich City","Premier League","Grant Hanley","SCO","DF","27",1991,14,24,15,17,7,0,8,14,57.1,6,25,18,7,31,55,77,1,"https://fbref.com/en/players/e9254eec/Grant-Hanley"
2020,"Norwich City","Premier League","Onel Hernández","CUB","FW,MF","26",1993,15.4,27,19,13,11,3,9,31,29,22,12,1,11,19,46,10,0,"https://fbref.com/en/players/007b39a5/Onel-Hernandez"
2020,"Norwich City","Premier League","Adam Idah","IRL","FW,MF","18",2001,2.5,2,2,1,0,1,2,3,66.7,1,4,0,4,0,2,1,0,"https://fbref.com/en/players/291e3ec3/Adam-Idah"
2020,"Norwich City","Premier League","Timm Klose","SUI","DF","31",1988,6.5,8,2,5,2,1,7,11,63.6,4,6,6,0,7,15,29,0,"https://fbref.com/en/players/5f1d07f6/Timm-Klose"
2020,"Norwich City","Premier League","Tim Krul","NED","GK","31",1988,36,0,0,0,0,0,0,1,0,1,2,0,2,1,1,13,1,"https://fbref.com/en/players/f23f9d20/Tim-Krul"
2020,"Norwich City","Premier League","Moritz Leitner","GER","MF","26",1992,7.6,16,9,8,7,1,9,25,36,16,14,4,10,9,25,10,1,"https://fbref.com/en/players/9460aaed/Moritz-Leitner"
2020,"Norwich City","Premier League","Jamal Lewis","NIR","DF","21",1998,25.6,51,35,42,6,3,22,36,61.1,14,27,12,15,25,76,68,0,"https://fbref.com/en/players/efb9215a/Jamal-Lewis"
2020,"Norwich City","Premier League","Josh Martin","ENG","FW,MF","17",2001,0.4,1,0,0,0,1,0,0,NA,0,1,0,1,1,2,0,0,"https://fbref.com/en/players/3f072a68/Josh-Martin"
2020,"Norwich City","Premier League","Michael McGovern","NIR","GK","35",1984,1.8,0,0,0,0,0,0,0,NA,0,0,0,0,0,0,1,1,"https://fbref.com/en/players/51a19d04/Michael-McGovern"
2020,"Norwich City","Premier League","Kenny McLean","SCO","MF","27",1992,33,44,29,20,18,6,14,42,33.3,28,32,7,25,38,82,67,2,"https://fbref.com/en/players/471f16b3/Kenny-McLean"
2020,"Norwich City","Premier League","Teemu Pukki","FIN","FW","29",1990,32.1,12,6,3,5,4,1,23,4.3,22,13,0,13,6,18,7,0,"https://fbref.com/en/players/0745b37d/Teemu-Pukki"
2020,"Norwich City","Premier League","Patrick Roberts","ENG","FW,MF","22",1997,0.3,0,0,0,0,0,0,0,NA,0,0,0,0,0,0,0,0,"https://fbref.com/en/players/59d93937/Patrick-Roberts"
2020,"Norwich City","Premier League","Lukas Rupp","GER","FW,MF","28",1991,7.7,15,9,7,5,3,5,17,29.4,12,11,0,11,15,30,4,0,"https://fbref.com/en/players/3faa1780/Lukas-Rupp"
2020,"Norwich City","Premier League","Dennis Srbeny","GER","MF,FW","25",1994,0.5,5,5,3,2,0,1,3,33.3,2,1,0,1,0,5,1,0,"https://fbref.com/en/players/1fdec858/Dennis-Srbeny"
2020,"Norwich City","Premier League","Marco Stiepermann","GER","MF","28",1991,13.1,20,8,8,9,3,5,21,23.8,16,11,3,8,5,25,16,0,"https://fbref.com/en/players/b606638c/Marco-Stiepermann"
2020,"Norwich City","Premier League","Alexander Tettey","NOR","MF,DF","33",1986,26,23,18,7,16,0,11,39,28.2,28,20,9,11,43,66,72,1,"https://fbref.com/en/players/75566759/Alexander-Tettey"
2020,"Norwich City","Premier League","Jordan Thomas","ENG","FW","18",2001,0,0,0,0,0,0,0,0,NA,0,0,0,0,0,0,0,0,"https://fbref.com/en/players/b547f08c/Jordan-Thomas"
2020,"Norwich City","Premier League","Tom Trybull","GER","MF","26",1993,12.6,39,25,15,18,6,16,60,26.7,44,20,5,15,16,55,35,0,"https://fbref.com/en/players/552aa16c/Tom-Trybull"
2020,"Norwich City","Premier League","Mario Vrančić","BIH","MF","30",1989,7.1,27,16,14,11,2,16,27,59.3,11,9,0,9,10,37,4,2,"https://fbref.com/en/players/16fa6881/Mario-Vrancic"
2020,"Norwich City","Premier League","Christoph Zimmermann","GER","DF","26",1993,15.9,32,21,26,6,0,21,30,70,9,22,18,4,19,51,87,2,"https://fbref.com/en/players/2d5f03bf/Christoph-Zimmermann"
2020,"Nîmes","Ligue 1","Sofiane Alakouch","MAR","DF","21",1998,15.6,45,26,25,13,7,25,48,52.1,23,13,2,11,23,68,39,3,"https://fbref.com/en/players/5314e067/Sofiane-Alakouch"
2020,"Nîmes","Ligue 1","Sami Ben Amar","MAR","FW","21",1998,0.2,1,1,0,0,1,1,1,100,0,1,0,1,1,2,0,0,"https://fbref.com/en/players/c05d65d1/Sami-Ben-Amar"
2020,"Nîmes","Ligue 1","Yassine Benrahou","FRA","MF,FW","20",1999,8.5,13,8,3,3,7,5,16,31.3,11,1,0,1,2,15,0,0,"https://fbref.com/en/players/fbf76716/Yassine-Benrahou"
2020,"Nîmes","Ligue 1","Paul Bernardoni","FRA","GK","22",1997,24.5,0,0,0,0,0,0,1,0,1,0,0,0,0,0,11,1,"https://fbref.com/en/players/28dabd43/Paul-Bernardoni"
2020,"Nîmes","Ligue 1","Antonin Bobichon","FRA","MF","23",1995,2,4,3,1,3,0,3,3,100,0,1,0,1,1,5,0,0,"https://fbref.com/en/players/7d937aa1/Antonin-Bobichon"
2020,"Nîmes","Ligue 1","Anthony Briançon","FRA","DF","24",1994,19.3,29,19,20,9,0,17,34,50,17,22,16,6,39,68,80,0,"https://fbref.com/en/players/16324e1d/Anthony-Briancon"
2020,"Nîmes","Ligue 1","Lucas Buadés","FRA","MF,FW","21",1997,1.3,4,4,3,1,0,1,5,20,4,0,0,0,1,5,3,0,"https://fbref.com/en/players/f9921b7f/Lucas-Buades"
2020,"Nîmes","Ligue 1","Lucas Deaux","FRA","MF","30",1988,14.8,49,26,16,29,4,16,45,35.6,29,20,4,16,15,64,19,0,"https://fbref.com/en/players/44f8c299/Lucas-Deaux"
2020,"Nîmes","Ligue 1","Kevin Denkey","TOG","FW","18",2000,6.7,10,5,1,8,1,6,10,60,4,7,0,7,2,12,1,1,"https://fbref.com/en/players/0d3585b5/Kevin-Denkey"
2020,"Nîmes","Ligue 1","Lucas Dias","FRA","GK","20",1999,3.5,1,1,1,0,0,1,1,100,0,0,0,0,0,1,2,0,"https://fbref.com/en/players/d83f8f69/Lucas-Dias"
2020,"Nîmes","Ligue 1","Haris Duljević","BIH","FW,MF","25",1993,5.8,11,6,3,7,1,4,12,33.3,8,5,0,5,2,13,1,0,"https://fbref.com/en/players/9b6556d2/Haris-Duljevic"
2020,"Nîmes","Ligue 1","Zinedine Ferhat","ALG","FW,MF","26",1993,25,26,16,5,16,5,15,46,32.6,31,15,3,12,16,42,18,0,"https://fbref.com/en/players/005c0807/Zinedine-Ferhat"
2020,"Nîmes","Ligue 1","Lamine Fomba","FRA","MF","21",1998,15.3,65,31,20,37,8,21,43,48.8,22,29,4,25,25,90,11,1,"https://fbref.com/en/players/2145368f/Lamine-Fomba"
2020,"Nîmes","Ligue 1","Moussa Koné","SEN","FW,MF","22",1996,1.6,2,0,1,1,0,1,3,33.3,2,1,0,1,1,3,0,0,"https://fbref.com/en/players/3ef68782/Moussa-Kone"
2020,"Nîmes","Ligue 1","Loïck Landre","FRA","DF","27",1992,10.3,16,9,12,3,1,7,11,63.6,4,12,9,3,17,33,34,0,"https://fbref.com/en/players/08082af0/Loick-Landre"
2020,"Nîmes","Ligue 1","Pablo Martinez","FRA","DF","30",1989,26,42,21,26,15,1,21,40,52.5,19,34,22,12,58,100,97,0,"https://fbref.com/en/players/1ad8cb67/Pablo-Martinez"
2020,"Nîmes","Ligue 1","Florian Miguel","FRA","DF","22",1996,22.8,51,25,27,20,4,31,52,59.6,21,19,4,15,33,84,32,0,"https://fbref.com/en/players/b66d1d8a/Florian-Miguel"
2020,"Nîmes","Ligue 1","Gaëtan Paquiez","FRA","DF","25",1994,17,36,25,14,13,9,17,47,36.2,30,18,5,13,33,69,43,0,"https://fbref.com/en/players/475583ff/Gaetan-Paquiez"
2020,"Nîmes","Ligue 1","Romain Philippoteaux","FRA","FW,MF","31",1988,22.2,23,12,11,11,1,9,43,20.9,34,22,1,21,13,36,10,0,"https://fbref.com/en/players/f98b15f0/Romain-Philippoteaux"
2020,"Nîmes","Ligue 1","Renaud Ripart","FRA","FW,DF","26",1993,22.5,39,23,17,20,2,18,46,39.1,28,17,2,15,12,51,37,0,"https://fbref.com/en/players/beae3a73/Renaud-Ripart"
2020,"Nîmes","Ligue 1","Nolan Roux","FRA","FW","31",1988,6.5,5,2,1,3,1,1,3,33.3,2,2,0,2,4,9,5,0,"https://fbref.com/en/players/3071a619/Nolan-Roux"
2020,"Nîmes","Ligue 1","Théo Sainte-Luce","FRA","MF,DF","20",1998,0.2,0,0,0,0,0,0,0,NA,0,0,0,0,0,0,0,0,"https://fbref.com/en/players/93c942fb/Theo-Sainte-Luce"
2020,"Nîmes","Ligue 1","Sidy Sarr","SEN","MF","23",1996,12.9,35,18,15,16,4,11,34,32.4,23,13,3,10,15,50,18,0,"https://fbref.com/en/players/a0b65401/Sidy-Sarr"
2020,"Nîmes","Ligue 1","Vlatko Stojanovski","MKD","FW","22",1997,1.4,3,3,0,3,0,1,1,100,0,0,0,0,0,3,1,0,"https://fbref.com/en/players/bb67bff1/Vlatko-Stojanovski"
2020,"Nîmes","Ligue 1","Pierrick Valdivia","FRA","MF","31",1988,0.8,1,1,0,0,1,0,1,0,1,0,0,0,0,1,0,0,"https://fbref.com/en/players/e562a02e/Pierrick-Valdivia"
2020,"Nîmes","Ligue 1","Antoine Valerio","FRA","MF","19",1999,1,1,1,0,1,0,0,2,0,2,2,0,2,3,4,1,0,"https://fbref.com/en/players/95981861/Antoine-Valerio"
2020,"Nîmes","Ligue 1","Luca Valls","FRA","MF","20",1998,0.1,1,0,1,0,0,1,1,100,0,1,0,1,0,1,0,0,"https://fbref.com/en/players/254c927d/Luca-Valls"
2020,"Nîmes","Ligue 1","Theo Valls","FRA","MF","23",1995,18.1,39,16,12,26,1,16,50,32,34,17,0,17,13,52,6,0,"https://fbref.com/en/players/c8090cb3/Theo-Valls"
2020,"Osasuna","La Liga","José Arnaiz","ESP","FW,MF","24",1995,8.8,3,2,0,2,1,0,12,0,12,7,0,7,5,8,5,0,"https://fbref.com/en/players/46e07328/Jose-Arnaiz"
2020,"Osasuna","La Liga","Ezequiel Ávila","ARG","FW","25",1994,17.7,17,12,6,7,4,6,18,33.3,12,12,0,12,3,20,5,0,"https://fbref.com/en/players/253a06b9/Ezequiel-Avila"
2020,"Osasuna","La Liga","Kike Barja","ESP","MF,FW","22",1997,3.5,1,1,1,0,0,1,1,100,0,3,1,2,0,1,2,0,"https://fbref.com/en/players/aad53e64/Kike-Barja"
2020,"Osasuna","La Liga","Brandon","ESP","FW","24",1995,4.5,5,3,1,3,1,0,5,0,5,4,0,4,0,5,1,0,"https://fbref.com/en/players/3e016e5a/Brandon"
2020,"Osasuna","La Liga","Darko Brašanac","SRB","MF","27",1992,24.9,45,25,14,26,5,15,41,36.6,26,19,4,15,20,65,21,0,"https://fbref.com/en/players/4accb7e0/Darko-Brasanac"
2020,"Osasuna","La Liga","Marc Cardona","ESP","FW","24",1995,7.8,1,0,0,1,0,0,8,0,8,3,1,2,2,3,2,0,"https://fbref.com/en/players/b92b456a/Marc-Cardona"
2020,"Osasuna","La Liga","Pervis Estupiñán","ECU","DF","21",1998,33.1,84,45,53,27,4,42,77,54.5,35,30,7,23,58,142,61,6,"https://fbref.com/en/players/d38fdf53/Pervis-Estupinan"
2020,"Osasuna","La Liga","Enric Gallego","ESP","FW","32",1986,9.8,9,5,1,5,3,0,4,0,4,10,2,8,4,13,8,0,"https://fbref.com/en/players/82e9b89d/Enric-Gallego"
2020,"Osasuna","La Liga","David García","ESP","DF","25",1994,31,28,16,15,12,1,14,31,45.2,17,20,16,4,48,76,123,2,"https://fbref.com/en/players/3e42f707/David-Garcia"
2020,"Osasuna","La Liga","Rubén García","ESP","MF,FW","26",1993,24.3,55,30,22,26,7,18,46,39.1,28,34,5,29,11,66,23,1,"https://fbref.com/en/players/5c96b017/Ruben-Garcia"
2020,"Osasuna","La Liga","Unai García","ESP","DF","27",1992,6,9,6,4,4,1,5,9,55.6,4,13,9,4,8,17,31,0,"https://fbref.com/en/players/4a633cfe/Unai-Garcia"
2020,"Osasuna","La Liga","Aridane Hernández","EQG","DF","30",1989,29,35,23,22,13,0,15,19,78.9,4,24,15,9,34,69,137,2,"https://fbref.com/en/players/132ac341/Aridane-Hernandez"
2020,"Osasuna","La Liga","Sergio Herrera","ESP","GK","26",1993,18.4,1,1,1,0,0,1,4,25,3,0,0,0,1,2,13,3,"https://fbref.com/en/players/a4995f48/Sergio-Herrera"
2020,"Osasuna","La Liga","Robert Ibáñez","ESP","MF,FW","26",1993,6,13,8,4,5,4,7,20,35,13,7,0,7,5,18,5,0,"https://fbref.com/en/players/c7429db3/Robert-Ibanez"
2020,"Osasuna","La Liga","Toni Lato","ESP","DF,MF","21",1997,5.2,22,15,11,8,3,9,10,90,1,9,1,8,8,30,13,1,"https://fbref.com/en/players/8e088e04/Toni-Lato"
2020,"Osasuna","La Liga","Lillo","ESP","DF","30",1989,2.2,4,2,2,2,0,1,1,100,0,2,1,1,2,6,8,0,"https://fbref.com/en/players/476ca810/Lillo"
2020,"Osasuna","La Liga","Adrián López","ESP","FW","31",1988,16,7,5,1,5,1,2,19,10.5,17,6,2,4,4,11,8,0,"https://fbref.com/en/players/88a359d4/Adrian-Lopez"
2020,"Osasuna","La Liga","Javi Martínez","ESP","MF","19",1999,0.1,0,0,0,0,0,0,0,NA,0,0,0,0,0,0,1,0,"https://fbref.com/en/players/3672b352/Javi-Martinez"
2020,"Osasuna","La Liga","Fran Mérida","ESP","MF","29",1990,12.9,27,15,11,10,6,9,27,33.3,18,15,4,11,25,52,10,0,"https://fbref.com/en/players/0e50f929/Fran-Merida"
2020,"Osasuna","La Liga","Jon Moncayola","ESP","MF,DF","21",1998,16.6,52,30,26,22,4,27,54,50,27,29,5,24,16,68,23,1,"https://fbref.com/en/players/9939e168/Jon-Moncayola"
2020,"Osasuna","La Liga","Raúl Navas","ESP","DF","31",1988,7.9,10,5,4,6,0,4,13,30.8,9,10,4,6,18,28,30,0,"https://fbref.com/en/players/ad178594/Raul-Navas"
2020,"Osasuna","La Liga","Aimar Oroz","ESP","FW","17",2001,0.1,0,0,0,0,0,0,0,NA,0,1,0,1,0,0,0,0,"https://fbref.com/en/players/7c363088/Aimar-Oroz"
2020,"Osasuna","La Liga","Luis Perea","ESP","FW","21",1997,0.2,0,0,0,0,0,0,0,NA,0,0,0,0,0,0,1,0,"https://fbref.com/en/players/8dc6dbb3/Luis-Perea"
2020,"Osasuna","La Liga","Iñigo Pérez","ESP","MF","31",1988,12,15,11,3,7,5,8,22,36.4,14,7,1,6,12,27,6,0,"https://fbref.com/en/players/bc61cc65/Inigo-Perez"
2020,"Osasuna","La Liga","Juan Pérez","ESP","GK","23",1996,2,1,1,1,0,0,1,2,50,1,0,0,0,0,1,0,0,"https://fbref.com/en/players/8f29e08b/Juan-Perez"
2020,"Osasuna","La Liga","Facundo Roncaglia","ARG","DF","32",1987,14.2,24,20,12,10,2,11,20,55,9,18,3,15,22,46,46,0,"https://fbref.com/en/players/51e3954c/Facundo-Roncaglia"
2020,"Osasuna","La Liga","Rubén","ESP","GK","35",1984,17.6,1,1,1,0,0,1,1,100,0,0,0,0,0,1,9,1,"https://fbref.com/en/players/24279b8b/Ruben"
2020,"Osasuna","La Liga","Oier Sanjurjo","ESP","MF","33",1986,25.8,65,34,21,34,10,28,64,43.8,36,33,8,25,35,100,39,1,"https://fbref.com/en/players/466824fb/Oier-Sanjurjo"
2020,"Osasuna","La Liga","Roberto Torres","ESP","MF,FW","30",1989,30.2,33,16,12,18,3,21,49,42.9,28,41,2,39,31,64,37,0,"https://fbref.com/en/players/d733aa38/Roberto-Torres"
2020,"Osasuna","La Liga","Nacho Vidal","ESP","DF","24",1995,25.9,45,29,26,13,6,21,38,55.3,17,24,6,18,44,89,70,1,"https://fbref.com/en/players/3a9c4b7b/Nacho-Vidal"
2020,"Osasuna","La Liga","Juan Villar","ESP","FW","31",1988,2.7,1,0,0,1,0,0,2,0,2,4,1,3,1,2,0,0,"https://fbref.com/en/players/c33ee247/Juan-Villar"
2020,"Paderborn 07","Bundesliga","Christopher Antwi-Adjei","GHA","MF,FW","25",1994,27.4,25,16,13,9,3,9,33,27.3,24,29,2,27,15,40,14,0,"https://fbref.com/en/players/0a3f6cde/Christopher-Antwi-Adjei"
2020,"Paderborn 07","Bundesliga","Jamilu Collins","NGA","DF","24",1994,29.6,69,43,44,21,4,37,62,59.7,25,53,19,34,70,139,91,1,"https://fbref.com/en/players/33a95e0a/Jamilu-Collins"
2020,"Paderborn 07","Bundesliga","Mohamed Dräger","TUN","DF","23",1996,16.2,32,21,22,8,2,14,33,42.4,19,17,5,12,18,50,39,0,"https://fbref.com/en/players/8954fddc/Mohamed-Drager"
2020,"Paderborn 07","Bundesliga","Antony Evans","ENG","MF,DF","20",1998,1.7,5,4,1,3,1,1,5,20,4,1,1,0,2,7,4,0,"https://fbref.com/en/players/cce7087c/Antony-Evans"
2020,"Paderborn 07","Bundesliga","Samúel Friðjónsson","ISL","MF","23",1996,2.1,4,1,3,1,0,1,3,33.3,2,4,1,3,4,8,4,0,"https://fbref.com/en/players/55557b25/Samuel-Fridjonsson"
2020,"Paderborn 07","Bundesliga","Klaus Gjasula","ALB","MF","29",1989,25.3,69,39,30,35,4,30,61,49.2,31,33,6,27,32,101,50,2,"https://fbref.com/en/players/431c837b/Klaus-Gjasula"
2020,"Paderborn 07","Bundesliga","Babacar Guèye","SEN","FW","24",1994,1.2,2,0,0,0,2,0,1,0,1,1,1,0,0,2,3,0,"https://fbref.com/en/players/4942dad3/Babacar-Gueye"
2020,"Paderborn 07","Bundesliga","Gerrit Holtmann","PHI","MF,DF","24",1995,11.8,24,14,14,6,4,15,37,40.5,22,21,1,20,6,30,8,0,"https://fbref.com/en/players/2979c05a/Gerrit-Holtmann"
2020,"Paderborn 07","Bundesliga","Uwe Hünemeier","GER","DF","33",1986,13.4,20,15,9,11,0,10,20,50,10,22,12,10,24,44,63,0,"https://fbref.com/en/players/f42456eb/Uwe-Hunemeier"
2020,"Paderborn 07","Bundesliga","Jannik Huth","GER","GK","25",1994,6,0,0,0,0,0,0,1,0,1,0,0,0,0,0,2,0,"https://fbref.com/en/players/e8fd2e5b/Jannik-Huth"
2020,"Paderborn 07","Bundesliga","Laurent Jans","LUX","DF","26",1992,17.5,42,25,30,8,4,22,48,45.8,26,25,10,15,19,61,49,1,"https://fbref.com/en/players/0fbb73c2/Laurent-Jans"
2020,"Paderborn 07","Bundesliga","Dennis Jastrzembski","POL","MF,FW","19",2000,2,2,0,1,1,0,0,1,0,1,3,0,3,3,5,0,0,"https://fbref.com/en/players/6bba916f/Dennis-Jastrzembski"
2020,"Paderborn 07","Bundesliga","Luca Kilian","GER","DF","19",1999,14,33,24,27,6,0,22,41,53.7,19,20,9,11,12,45,67,0,"https://fbref.com/en/players/610aa1e9/Luca-Kilian"
2020,"Paderborn 07","Bundesliga","Jan Luca Rumpf","GER","DF","20",1999,1,0,0,0,0,0,0,0,NA,0,0,0,0,0,0,2,0,"https://fbref.com/en/players/3588d4fe/Jan-Luca-Rumpf"
2020,"Paderborn 07","Bundesliga","Streli Mamba","GER","FW","25",1994,16.9,15,9,0,9,6,1,13,7.7,12,12,2,10,6,21,2,0,"https://fbref.com/en/players/625e41b1/Streli-Mamba"
2020,"Paderborn 07","Bundesliga","Sven Michel","GER","FW","29",1990,15.3,14,12,3,5,6,3,20,15,17,13,2,11,7,21,7,0,"https://fbref.com/en/players/1e274a0a/Sven-Michel"
2020,"Paderborn 07","Bundesliga","Cauly Oliveira Souza","BRA","MF,FW","23",1995,8,11,7,5,5,1,3,11,27.3,8,9,0,9,6,17,1,0,"https://fbref.com/en/players/2b53f7a5/Cauly-Oliveira-Souza"
2020,"Paderborn 07","Bundesliga","Kai Pröger","GER","MF,FW","27",1992,23.1,43,22,21,17,5,17,58,29.3,41,34,6,28,14,57,20,1,"https://fbref.com/en/players/8a080a61/Kai-Proger"
2020,"Paderborn 07","Bundesliga","Marlon Ritter","GER","MF","24",1994,4.8,7,5,5,2,0,4,9,44.4,5,7,0,7,8,15,3,0,"https://fbref.com/en/players/ce2c51c0/Marlon-Ritter"
2020,"Paderborn 07","Bundesliga","Abdelhamid Sabiri","MAR","MF","22",1996,11.6,20,16,6,11,3,9,27,33.3,18,9,2,7,8,28,18,1,"https://fbref.com/en/players/4830e0af/Abdelhamid-Sabiri"
2020,"Paderborn 07","Bundesliga","Sebastian Schonlau","GER","DF","24",1994,23,64,43,50,14,0,41,66,62.1,25,36,15,21,40,104,138,1,"https://fbref.com/en/players/efd623db/Sebastian-Schonlau"
2020,"Paderborn 07","Bundesliga","Khiry Shelton","USA","FW","26",1993,0.4,1,1,1,0,0,0,0,NA,0,0,0,0,0,1,0,0,"https://fbref.com/en/players/f935709c/Khiry-Shelton"
2020,"Paderborn 07","Bundesliga","Dennis Srbeny","GER","FW,MF","25",1994,12.4,11,6,4,4,3,5,18,27.8,13,11,1,10,3,14,9,0,"https://fbref.com/en/players/1fdec858/Dennis-Srbeny"
2020,"Paderborn 07","Bundesliga","Christian Strohdiek","GER","DF","31",1988,15.1,26,22,21,5,0,20,42,47.6,22,16,10,6,25,51,92,0,"https://fbref.com/en/players/9c2394c9/Christian-Strohdiek"
2020,"Paderborn 07","Bundesliga","Sebastian Vasiliadis","GRE","MF","21",1997,31.2,73,45,34,31,8,28,81,34.6,53,47,6,41,34,107,50,0,"https://fbref.com/en/players/d3112d86/Sebastian-Vasiliadis"
2020,"Paderborn 07","Bundesliga","Leopold Zingerle","GER","GK","25",1994,28,3,1,3,0,0,2,4,50,2,0,0,0,0,3,7,2,"https://fbref.com/en/players/bf9d9070/Leopold-Zingerle"
2020,"Paderborn 07","Bundesliga","Ben Zolinski","GER","FW,MF","27",1992,13.4,17,9,7,9,1,7,27,25.9,20,12,0,12,8,25,4,0,"https://fbref.com/en/players/4d50454e/Ben-Zolinski"
2020,"Paris S-G","Ligue 1","Adil Aouchiche","FRA","MF","17",2002,0.7,3,2,1,2,0,2,4,50,2,3,0,3,0,3,0,0,"https://fbref.com/en/players/b94b8be1/Adil-Aouchiche"
2020,"Paris S-G","Ligue 1","Alphonse Areola","FRA","GK","26",1993,3,0,0,0,0,0,0,0,NA,0,0,0,0,0,0,1,1,"https://fbref.com/en/players/2f965a72/Alphonse-Areola"
2020,"Paris S-G","Ligue 1","Mitchel Bakker","NED","DF","19",2000,1,2,2,1,1,0,1,1,100,0,0,0,0,0,2,2,0,"https://fbref.com/en/players/a8567629/Mitchel-Bakker"
2020,"Paris S-G","Ligue 1","Juan Bernat","ESP","DF,MF","26",1993,15.4,42,27,19,16,7,20,51,39.2,31,13,1,12,10,52,26,0,"https://fbref.com/en/players/433dc9a2/Juan-Bernat"
2020,"Paris S-G","Ligue 1","Marcin Bułka","POL","GK","19",1999,1,0,0,0,0,0,0,0,NA,0,0,0,0,0,0,0,0,"https://fbref.com/en/players/db87a2c4/Marcin-Bulka"
2020,"Paris S-G","Ligue 1","Edinson Cavani","URU","FW","32",1987,6.7,5,1,0,2,3,0,3,0,3,7,0,7,1,6,2,0,"https://fbref.com/en/players/527f063d/Edinson-Cavani"
2020,"Paris S-G","Ligue 1","Colin Dagba","FRA","DF","20",1998,7.4,10,4,2,4,4,5,9,55.6,4,6,1,5,6,16,9,0,"https://fbref.com/en/players/29c02c9f/Colin-Dagba"
2020,"Paris S-G","Ligue 1","Ángel Di María","ARG","FW,MF","31",1988,22.2,17,12,2,8,7,4,34,11.8,30,14,3,11,11,28,1,3,"https://fbref.com/en/players/19cda00b/Angel-Di-Maria"
2020,"Paris S-G","Ligue 1","Abdou Diallo","SEN","DF","23",1996,13.3,20,11,9,10,1,8,14,57.1,6,9,5,4,10,30,32,0,"https://fbref.com/en/players/fc62f087/Abdou-Diallo"
2020,"Paris S-G","Ligue 1","Julian Draxler","GER","MF","25",1993,7.6,13,10,2,9,2,7,15,46.7,8,7,1,6,10,23,1,0,"https://fbref.com/en/players/1a992676/Julian-Draxler"
2020,"Paris S-G","Ligue 1","Idrissa Gana Gueye","SEN","MF","29",1989,18.4,65,34,30,25,10,18,43,41.9,25,29,4,25,33,98,15,0,"https://fbref.com/en/players/72c812f3/Idrissa-Gana-Gueye"
2020,"Paris S-G","Ligue 1","Ander Herrera","ESP","MF,DF","29",1989,6.1,19,11,9,9,1,5,14,35.7,9,10,2,8,6,25,4,0,"https://fbref.com/en/players/436a9dd0/Ander-Herrera"
2020,"Paris S-G","Ligue 1","Mauro Icardi","ARG","FW","26",1993,14.1,4,2,1,3,0,1,10,10,9,7,1,6,2,6,11,0,"https://fbref.com/en/players/43b78598/Mauro-Icardi"
2020,"Paris S-G","Ligue 1","Jesé","ESP","FW","26",1993,0,0,0,0,0,0,0,0,NA,0,0,0,0,0,0,0,0,"https://fbref.com/en/players/4a537185/Jese"
2020,"Paris S-G","Ligue 1","Thilo Kehrer","GER","DF","22",1996,5.3,10,7,4,5,1,5,10,50,5,2,0,2,1,11,2,1,"https://fbref.com/en/players/51dbeea9/Thilo-Kehrer"
2020,"Paris S-G","Ligue 1","Presnel Kimpembe","FRA","DF","23",1995,13.6,33,25,25,8,0,14,20,70,6,7,3,4,21,54,33,1,"https://fbref.com/en/players/aef6e670/Presnel-Kimpembe"
2020,"Paris S-G","Ligue 1","Layvin Kurzawa","FRA","DF","26",1992,9.5,23,16,5,14,4,11,23,47.8,12,12,1,11,18,41,24,1,"https://fbref.com/en/players/41e7ef1c/Layvin-Kurzawa"
2020,"Paris S-G","Ligue 1","Marquinhos","BRA","MF,DF","25",1994,16.4,39,20,17,18,4,11,26,42.3,15,25,8,17,25,64,31,1,"https://fbref.com/en/players/d5f2f82b/Marquinhos"
2020,"Paris S-G","Ligue 1","Eric Maxim Choupo-Moting","CMR","FW,MF","30",1989,5,12,9,3,4,5,4,8,50,4,3,0,3,1,13,3,0,"https://fbref.com/en/players/0e6bc38c/Eric-Maxim-Choupo-Moting"
2020,"Paris S-G","Ligue 1","Kylian Mbappé","FRA","FW","20",1998,16.8,7,2,1,5,1,3,10,30,7,4,0,4,3,10,0,0,"https://fbref.com/en/players/42fd9c7f/Kylian-Mbappe"
2020,"Paris S-G","Ligue 1","Loïc Mbe Soh","FRA","DF","18",2001,0.6,2,2,2,0,0,2,2,100,0,0,0,0,1,3,0,0,"https://fbref.com/en/players/8f534f8e/Loic-Mbe-Soh"
2020,"Paris S-G","Ligue 1","Thomas Meunier","BEL","DF","27",1991,13.8,27,21,9,12,6,16,26,61.5,10,17,5,12,18,45,19,1,"https://fbref.com/en/players/e162b013/Thomas-Meunier"
2020,"Paris S-G","Ligue 1","Keylor Navas","CRC","GK","32",1986,21,0,0,0,0,0,0,0,NA,0,1,0,1,0,0,4,2,"https://fbref.com/en/players/ecada4fc/Keylor-Navas"
2020,"Paris S-G","Ligue 1","Neymar","BRA","MF,FW","27",1992,14.6,12,7,1,9,2,3,21,14.3,18,10,0,10,4,16,1,0,"https://fbref.com/en/players/69384e5d/Neymar"
2020,"Paris S-G","Ligue 1","Tanguy Nianzou","FRA","DF,MF","17",2002,5,2,1,0,1,1,1,3,33.3,2,4,2,2,3,5,6,0,"https://fbref.com/en/players/5853ac44/Tanguy-Nianzou"
2020,"Paris S-G","Ligue 1","Leandro Paredes","ARG","MF","25",1994,9,22,14,7,14,1,13,29,44.8,16,7,1,6,15,37,7,0,"https://fbref.com/en/players/dff153a4/Leandro-Paredes"
2020,"Paris S-G","Ligue 1","Sergio Rico","ESP","GK","25",1993,2,0,0,0,0,0,0,0,NA,0,0,0,0,0,0,1,2,"https://fbref.com/en/players/5f0241b2/Sergio-Rico"
2020,"Paris S-G","Ligue 1","Pablo Sarabia","ESP","FW,MF","27",1992,12.9,12,7,3,6,3,4,25,16,21,19,1,18,10,22,5,0,"https://fbref.com/en/players/9744ff80/Pablo-Sarabia"
2020,"Paris S-G","Ligue 1","Thiago Silva","BRA","DF","34",1984,17.5,28,16,15,13,0,13,16,81.3,3,18,15,3,26,54,54,0,"https://fbref.com/en/players/86e7deaf/Thiago-Silva"
2020,"Paris S-G","Ligue 1","Marco Verratti","ITA","MF","26",1992,16.5,54,32,22,22,10,20,56,35.7,36,23,3,20,19,73,9,0,"https://fbref.com/en/players/1467af0d/Marco-Verratti"
2020,"Paris S-G","Ligue 1","Arthur Zagre","FRA","MF","17",2001,0.3,1,0,1,0,0,0,0,NA,0,1,0,1,1,2,0,0,"https://fbref.com/en/players/3225654e/Arthur-Zagre"
2020,"Parma","Serie A","Bruno Alves","POR","DF","37",1981,29.7,17,11,12,5,0,8,13,61.5,5,30,21,9,25,42,150,2,"https://fbref.com/en/players/585a73a8/Bruno-Alves"
2020,"Parma","Serie A","Antonino Barillà","ITA","MF","31",1988,18.8,43,31,22,19,2,16,45,35.6,29,26,8,18,17,60,32,0,"https://fbref.com/en/players/a64cbd35/Antonino-Barilla"
2020,"Parma","Serie A","Gastón Brugman","URU","MF","26",1992,16.2,47,24,25,15,7,19,46,41.3,27,33,15,18,27,74,19,2,"https://fbref.com/en/players/e947ee4a/Gaston-Brugman"
2020,"Parma","Serie A","Gianluca Caprari","ITA","FW,MF","26",1993,6.5,1,1,0,1,0,0,5,0,5,7,2,5,4,5,2,0,"https://fbref.com/en/players/54e53b7e/Gianluca-Caprari"
2020,"Parma","Serie A","Simone Colombi","ITA","GK","28",1991,4,0,0,0,0,0,0,0,NA,0,0,0,0,0,0,1,0,"https://fbref.com/en/players/72be9309/Simone-Colombi"
2020,"Parma","Serie A","Andreas Cornelius","DEN","FW","26",1993,16.6,9,4,2,5,2,4,11,36.4,7,7,0,7,2,11,26,0,"https://fbref.com/en/players/c693347d/Andreas-Cornelius"
2020,"Parma","Serie A","Matteo Darmian","ITA","DF","29",1989,29.8,81,42,48,30,3,40,83,48.2,43,38,16,22,25,106,78,1,"https://fbref.com/en/players/96e0490d/Matteo-Darmian"
2020,"Parma","Serie A","Kastriot Dermaku","ALB","DF","27",1992,11.4,13,5,10,3,0,3,5,60,2,20,16,4,12,25,61,1,"https://fbref.com/en/players/2990c466/Kastriot-Dermaku"
2020,"Parma","Serie A","Riccardo Gagliolo","SWE","DF","29",1990,28.9,57,32,37,12,8,30,60,50,30,35,18,17,53,110,100,0,"https://fbref.com/en/players/173061c0/Riccardo-Gagliolo"
2020,"Parma","Serie A","Gervinho","CIV","FW","32",1987,25.2,12,6,5,6,1,6,17,35.3,11,4,0,4,5,17,3,0,"https://fbref.com/en/players/e468c053/Gervinho"
2020,"Parma","Serie A","Alberto Grassi","ITA","MF","24",1995,7.1,10,4,7,3,0,5,13,38.5,8,5,2,3,19,29,9,1,"https://fbref.com/en/players/6cc97b6a/Alberto-Grassi"
2020,"Parma","Serie A","Hernani","BRA","MF","25",1994,26.9,61,31,25,31,5,30,112,26.8,82,53,11,42,50,111,51,1,"https://fbref.com/en/players/6f5ead86/Hernani"
2020,"Parma","Serie A","Simone Iacoponi","ITA","DF","32",1987,33.9,49,25,36,12,1,26,42,61.9,16,37,29,8,35,84,140,2,"https://fbref.com/en/players/63071a3f/Simone-Iacoponi"
2020,"Parma","Serie A","Roberto Inglese","ITA","FW","27",1991,8.5,9,6,2,2,5,2,10,20,8,8,2,6,2,11,1,0,"https://fbref.com/en/players/6c1f7328/Roberto-Inglese"
2020,"Parma","Serie A","Yann Karamoh","FRA","FW,MF","21",1998,6.4,10,7,5,4,1,3,9,33.3,6,5,0,5,2,12,3,0,"https://fbref.com/en/players/8b66d9cc/Yann-Karamoh"
2020,"Parma","Serie A","Juraj Kucka","SVK","MF,FW","32",1987,21.5,43,22,21,16,6,14,61,23,47,21,4,17,29,72,36,0,"https://fbref.com/en/players/5aaef9ef/Juraj-Kucka"
2020,"Parma","Serie A","Dejan Kulusevski","SWE","FW,MF","19",2000,32.6,41,21,10,24,7,19,64,29.7,45,25,1,24,23,64,17,0,"https://fbref.com/en/players/df3cda47/Dejan-Kulusevski"
2020,"Parma","Serie A","Jasmin Kurtić","SVN","MF,FW","30",1989,18.5,32,23,19,10,3,13,35,37.1,22,19,5,14,15,47,27,2,"https://fbref.com/en/players/144607cc/Jasmin-Kurtic"
2020,"Parma","Serie A","Vincent Laurini","FRA","DF","30",1989,9.8,26,22,11,11,4,14,18,77.8,4,10,3,7,11,37,29,0,"https://fbref.com/en/players/3535098b/Vincent-Laurini"
2020,"Parma","Serie A","Giuseppe Pezzella","ITA","DF","21",1997,10.5,20,12,17,3,0,11,19,57.9,8,13,9,4,6,26,30,0,"https://fbref.com/en/players/149c5f5d/Giuseppe-Pezzella"
2020,"Parma","Serie A","Vasco Regini","ITA","DF","28",1990,0.6,0,0,0,0,0,0,0,NA,0,0,0,0,0,0,3,0,"https://fbref.com/en/players/339c6ed4/Vasco-Regini"
2020,"Parma","Serie A","Matteo Scozzarella","ITA","MF","31",1988,10.2,23,15,8,13,2,14,29,48.3,15,19,14,5,27,50,28,0,"https://fbref.com/en/players/ea164f99/Matteo-Scozzarella"
2020,"Parma","Serie A","Luigi Sepe","ITA","GK","28",1991,34,1,0,1,0,0,1,2,50,1,0,0,0,0,1,6,2,"https://fbref.com/en/players/343f753a/Luigi-Sepe"
2020,"Parma","Serie A","Luca Siligardi","ITA","MF,FW","31",1988,3.7,6,2,3,2,1,4,8,50,4,3,0,3,3,9,5,0,"https://fbref.com/en/players/1cac99dc/Luca-Siligardi"
2020,"Parma","Serie A","Mattia Sprocati","ITA","FW,MF","26",1993,6.6,4,2,3,1,0,0,1,0,1,5,1,4,2,6,2,0,"https://fbref.com/en/players/bdd0692f/Mattia-Sprocati"
2020,"RB Leipzig","Bundesliga","Tyler Adams","USA","MF,DF","20",1999,10.6,22,15,13,8,1,12,25,48,13,16,1,15,14,36,14,0,"https://fbref.com/en/players/2b09d998/Tyler-Adams"
2020,"RB Leipzig","Bundesliga","Ethan Ampadu","WAL","DF","18",2000,0.9,5,4,3,2,0,1,1,100,0,3,1,2,1,6,3,0,"https://fbref.com/en/players/10b9fa99/Ethan-Ampadu"
2020,"RB Leipzig","Bundesliga","Angeliño","ESP","DF,FW","22",1997,12.2,15,9,7,5,3,5,15,33.3,10,14,1,13,19,34,24,0,"https://fbref.com/en/players/30941e96/Angelino"
2020,"RB Leipzig","Bundesliga","Dennis Borkowski","GER","FW","17",2002,0.1,0,0,0,0,0,0,0,NA,0,0,0,0,0,0,0,0,"https://fbref.com/en/players/78b9e99c/Dennis-Borkowski"
2020,"RB Leipzig","Bundesliga","Matheus Cunha","BRA","FW,MF","20",1999,3.1,6,2,0,1,5,0,2,0,2,5,1,4,1,7,0,0,"https://fbref.com/en/players/dc62b55d/Matheus-Cunha"
2020,"RB Leipzig","Bundesliga","Diego Demme","GER","MF","27",1991,13.5,41,18,17,19,5,17,42,40.5,25,14,2,12,15,56,14,0,"https://fbref.com/en/players/dc3fa3b5/Diego-Demme"
2020,"RB Leipzig","Bundesliga","Emil Forsberg","SWE","MF","27",1991,12.7,16,10,5,8,3,6,26,23.1,20,15,0,15,5,21,3,0,"https://fbref.com/en/players/9a2e0ccc/Emil-Forsberg"
2020,"RB Leipzig","Bundesliga","Péter Gulácsi","HUN","GK","29",1990,32,0,0,0,0,0,0,0,NA,0,0,0,0,1,1,18,6,"https://fbref.com/en/players/bcb2ccd8/Peter-Gulacsi"
2020,"RB Leipzig","Bundesliga","Amadou Haidara","MLI","MF","21",1998,8.4,26,16,7,17,2,10,24,41.7,14,14,2,12,8,34,10,1,"https://fbref.com/en/players/92432bc6/Amadou-Haidara"
2020,"RB Leipzig","Bundesliga","Marcel Halstenberg","GER","DF","27",1991,28,46,31,27,17,2,28,58,48.3,30,37,11,26,46,92,72,2,"https://fbref.com/en/players/8ff2354e/Marcel-Halstenberg"
2020,"RB Leipzig","Bundesliga","Stefan Ilsanker","AUT","DF","30",1989,4.6,3,1,3,0,0,3,6,50,3,6,3,3,7,10,21,0,"https://fbref.com/en/players/8494acc4/Stefan-Ilsanker"
2020,"RB Leipzig","Bundesliga","Kevin Kampl","SVN","MF","28",1990,7.5,17,11,7,10,0,7,23,30.4,16,7,2,5,16,33,6,0,"https://fbref.com/en/players/b825a650/Kevin-Kampl"
2020,"RB Leipzig","Bundesliga","Lukas Klostermann","GER","DF","23",1996,29.4,45,26,24,16,5,18,31,58.1,13,34,16,18,26,71,101,2,"https://fbref.com/en/players/ca8033cb/Lukas-Klostermann"
2020,"RB Leipzig","Bundesliga","Ibrahima Konaté","FRA","DF","20",1999,6.3,11,6,10,1,0,2,7,28.6,5,9,4,5,5,16,35,1,"https://fbref.com/en/players/5ed9b537/Ibrahima-Konate"
2020,"RB Leipzig","Bundesliga","Tom Krauß","GER","MF","18",2001,0,1,1,0,1,0,1,2,50,1,0,0,0,0,1,0,0,"https://fbref.com/en/players/9f77012e/Tom-Krauss"
2020,"RB Leipzig","Bundesliga","Konrad Laimer","AUT","MF","22",1997,23.5,91,45,30,46,15,43,102,42.2,59,51,8,43,34,125,14,0,"https://fbref.com/en/players/c1b7847c/Konrad-Laimer"
2020,"RB Leipzig","Bundesliga","Ademola Lookman","NGA","FW,MF","21",1997,3.4,6,4,3,1,2,1,1,100,0,3,0,3,1,7,0,1,"https://fbref.com/en/players/7c104bb7/Ademola-Lookman"
2020,"RB Leipzig","Bundesliga","Nordi Mukiele","FRA","DF,FW","21",1997,19.8,61,39,39,12,10,25,38,65.8,13,26,4,22,47,108,57,0,"https://fbref.com/en/players/ac73ec79/Nordi-Mukiele"
2020,"RB Leipzig","Bundesliga","Yvon Mvogo","SUI","GK","25",1994,2,0,0,0,0,0,0,0,NA,0,0,0,0,0,0,0,1,"https://fbref.com/en/players/dc29b608/Yvon-Mvogo"
2020,"RB Leipzig","Bundesliga","Christopher Nkunku","FRA","MF,FW","21",1997,21.4,21,13,4,11,6,9,33,27.3,24,25,2,23,20,41,8,0,"https://fbref.com/en/players/7c56da38/Christopher-Nkunku"
2020,"RB Leipzig","Bundesliga","Dani Olmo","ESP","MF,FW","21",1998,8.3,20,14,5,10,5,1,13,7.7,12,7,1,6,4,24,6,0,"https://fbref.com/en/players/ae44e8e2/Dani-Olmo"
2020,"RB Leipzig","Bundesliga","Willi Orban","HUN","DF","26",1992,9.5,20,12,13,7,0,12,20,60,8,14,3,11,16,36,52,1,"https://fbref.com/en/players/20030c06/Willi-Orban"
2020,"RB Leipzig","Bundesliga","Yussuf Poulsen","DEN","FW","25",1994,13.6,14,10,2,10,2,4,21,19,17,12,0,12,4,18,15,0,"https://fbref.com/en/players/d2416c2e/Yussuf-Poulsen"
2020,"RB Leipzig","Bundesliga","Marcel Sabitzer","AUT","MF,FW","25",1994,27.8,39,25,15,18,6,19,56,33.9,37,27,4,23,23,62,25,0,"https://fbref.com/en/players/e280527c/Marcel-Sabitzer"
2020,"RB Leipzig","Bundesliga","Marcelo Saracchi","URU","DF","21",1998,2,8,6,2,5,1,5,6,83.3,1,3,1,2,1,9,5,0,"https://fbref.com/en/players/1c96ad85/Marcelo-Saracchi"
2020,"RB Leipzig","Bundesliga","Patrik Schick","CZE","FW","23",1996,14.4,7,3,1,3,3,2,9,22.2,7,8,2,6,2,9,17,0,"https://fbref.com/en/players/5d4f7d61/Patrik-Schick"
2020,"RB Leipzig","Bundesliga","Dayot Upamecano","FRA","DF","20",1998,26.2,52,31,37,15,0,23,43,53.5,20,31,17,14,43,95,88,1,"https://fbref.com/en/players/d248cd8f/Dayot-Upamecano"
2020,"RB Leipzig","Bundesliga","Timo Werner","GER","FW","23",1996,31.1,20,9,6,7,7,3,16,18.8,13,16,0,16,5,25,2,0,"https://fbref.com/en/players/49fe9070/Timo-Werner"
2020,"RB Leipzig","Bundesliga","Hannes Wolf","AUT","FW,MF","20",1999,0.6,3,0,0,1,2,1,4,25,3,0,0,0,0,3,0,0,"https://fbref.com/en/players/be42a291/Hannes-Wolf"
2020,"Real Madrid","La Liga","Alphonse Areola","FRA","GK","26",1993,4,0,0,0,0,0,0,0,NA,0,0,0,0,0,0,0,0,"https://fbref.com/en/players/2f965a72/Alphonse-Areola"
2020,"Real Madrid","La Liga","Marco Asensio","ESP","FW","23",1996,3.7,4,3,3,1,0,1,4,25,3,2,0,2,1,5,4,0,"https://fbref.com/en/players/45af8a54/Marco-Asensio"
2020,"Real Madrid","La Liga","Gareth Bale","WAL","FW,MF","30",1989,12.1,9,5,5,2,2,3,14,21.4,11,8,2,6,6,15,9,0,"https://fbref.com/en/players/a58bb1e1/Gareth-Bale"
2020,"Real Madrid","La Liga","Karim Benzema","FRA","FW","31",1987,34.9,18,8,3,11,4,2,16,12.5,14,16,4,12,7,25,30,1,"https://fbref.com/en/players/70d74ece/Karim-Benzema"
2020,"Real Madrid","La Liga","Dani Carvajal","ESP","DF","27",1992,30.4,65,46,33,25,7,23,42,54.8,19,43,14,29,36,101,53,0,"https://fbref.com/en/players/4958bfb2/Dani-Carvajal"
2020,"Real Madrid","La Liga","Casemiro","BRA","MF","27",1992,34.3,96,60,43,45,8,39,99,39.4,60,53,10,43,68,164,72,0,"https://fbref.com/en/players/4d224fe8/Casemiro"
2020,"Real Madrid","La Liga","Thibaut Courtois","BEL","GK","27",1992,34,0,0,0,0,0,0,2,0,2,0,0,0,2,2,18,2,"https://fbref.com/en/players/1840e36d/Thibaut-Courtois"
2020,"Real Madrid","La Liga","Brahim Díaz","ESP","FW","19",1999,0.7,1,0,0,1,0,0,2,0,2,2,0,2,0,1,0,0,"https://fbref.com/en/players/407feb71/Brahim-Diaz"
2020,"Real Madrid","La Liga","Eden Hazard","BEL","FW,MF","28",1991,12,7,3,2,3,2,3,15,20,12,5,0,5,6,13,0,0,"https://fbref.com/en/players/a39bb753/Eden-Hazard"
2020,"Real Madrid","La Liga","Isco","ESP","FW,MF","27",1992,13.1,13,9,2,10,1,5,14,35.7,9,9,0,9,7,20,4,1,"https://fbref.com/en/players/a0b4bb3e/Isco"
2020,"Real Madrid","La Liga","Luka Jović","SRB","FW","21",1997,4.8,2,1,0,0,2,1,2,50,1,1,0,1,2,4,0,0,"https://fbref.com/en/players/4d8cd038/Luka-Jovic"
2020,"Real Madrid","La Liga","Vinicius Júnior","BRA","FW,MF","19",2000,15.2,26,16,13,8,5,8,32,25,24,14,0,14,3,29,2,0,"https://fbref.com/en/players/7111d552/Vinicius-Junior"
2020,"Real Madrid","La Liga","Toni Kroos","GER","MF","29",1990,29.5,56,28,18,29,9,18,70,25.7,52,27,0,27,23,79,15,0,"https://fbref.com/en/players/6ce1f46f/Toni-Kroos"
2020,"Real Madrid","La Liga","Marcelo","BRA","DF","31",1988,14.4,19,11,8,8,3,9,28,32.1,19,19,2,17,18,37,21,0,"https://fbref.com/en/players/603116a7/Marcelo"
2020,"Real Madrid","La Liga","Mariano","DOM","FW,MF","25",1993,0.5,0,0,0,0,0,0,1,0,1,0,0,0,0,0,0,0,"https://fbref.com/en/players/5c4dc0ff/Mariano"
2020,"Real Madrid","La Liga","Ferland Mendy","FRA","DF","24",1995,20.1,32,26,20,9,3,14,18,77.8,4,19,5,14,22,54,30,1,"https://fbref.com/en/players/3cefcaef/Ferland-Mendy"
2020,"Real Madrid","La Liga","Éder Militão","BRA","DF","21",1998,11.4,25,15,15,9,1,10,17,58.8,7,12,6,6,20,45,42,0,"https://fbref.com/en/players/2784f898/Eder-Militao"
2020,"Real Madrid","La Liga","Luka Modrić","CRO","MF","33",1985,22.2,37,18,9,15,13,16,41,39,25,10,2,8,22,59,12,0,"https://fbref.com/en/players/6025fab1/Luka-Modric"
2020,"Real Madrid","La Liga","Nacho","ESP","DF","29",1990,4.9,11,6,6,3,2,6,10,60,4,5,3,2,12,23,18,1,"https://fbref.com/en/players/2946f9a1/Nacho"
2020,"Real Madrid","La Liga","Álvaro Odriozola","ESP","DF","23",1995,3.8,5,2,4,0,1,5,8,62.5,3,4,0,4,2,7,8,0,"https://fbref.com/en/players/1d1691ad/Alvaro-Odriozola"
2020,"Real Madrid","La Liga","Sergio Ramos","ESP","DF","33",1986,33.5,46,31,26,17,3,20,42,47.6,22,22,9,13,49,95,102,4,"https://fbref.com/en/players/08511d65/Sergio-Ramos"
2020,"Real Madrid","La Liga","James Rodríguez","COL","MF,FW","28",1991,4.7,17,13,6,8,3,6,12,50,6,3,0,3,3,20,1,0,"https://fbref.com/en/players/715bf047/James-Rodriguez"
2020,"Real Madrid","La Liga","Rodrygo","BRA","FW","18",2001,11.3,6,1,2,3,1,2,21,9.5,19,13,0,13,10,16,5,0,"https://fbref.com/en/players/8f5e92a6/Rodrygo"
2020,"Real Madrid","La Liga","Federico Valverde","URU","MF","21",1998,21.2,38,19,9,19,10,12,36,33.3,24,38,4,34,21,59,12,2,"https://fbref.com/en/players/0959c2a2/Federico-Valverde"
2020,"Real Madrid","La Liga","Raphaël Varane","FRA","DF","26",1993,31.4,30,17,15,14,1,12,23,52.2,11,32,16,16,31,61,124,0,"https://fbref.com/en/players/9f8e9423/Raphael-Varane"
2020,"Real Madrid","La Liga","Lucas Vázquez","ESP","MF,FW","28",1991,9.4,23,17,10,13,0,11,26,42.3,15,10,0,10,10,33,8,1,"https://fbref.com/en/players/fd51b456/Lucas-Vazquez"
2020,"Real Sociedad","La Liga","Miguel Ángel Moyá","ESP","GK","35",1984,13,0,0,0,0,0,0,1,0,1,0,0,0,1,1,6,2,"https://fbref.com/en/players/011d8c56/Miguel-Angel-Moya"
2020,"Real Sociedad","La Liga","Ander Barrenetxea","ESP","FW,MF","17",2001,4.9,12,9,5,5,2,4,10,40,6,3,0,3,3,15,4,0,"https://fbref.com/en/players/200e89e1/Ander-Barrenetxea"
2020,"Real Sociedad","La Liga","Naïs Djouahra","FRA","FW","19",1999,0.3,0,0,0,0,0,0,0,NA,0,0,0,0,0,0,0,0,"https://fbref.com/en/players/3594a357/Nais-Djouahra"
2020,"Real Sociedad","La Liga","Aritz Elustondo","ESP","DF","25",1994,16.8,28,17,19,8,1,13,23,56.5,10,21,8,13,15,43,67,0,"https://fbref.com/en/players/f7dc2ae5/Aritz-Elustondo"
2020,"Real Sociedad","La Liga","Andoni Gorosabel","ESP","DF","22",1996,7.9,14,8,9,3,2,10,20,50,10,13,1,12,13,27,21,0,"https://fbref.com/en/players/6f5f82c0/Andoni-Gorosabel"
2020,"Real Sociedad","La Liga","Ander Guevara","ESP","MF","22",1997,10.4,27,11,9,17,1,12,30,40,18,13,3,10,8,35,15,1,"https://fbref.com/en/players/8e48dc61/Ander-Guevara"
2020,"Real Sociedad","La Liga","Asier Illarramendi","ESP","MF","29",1990,2.4,2,2,1,0,1,2,6,33.3,4,2,1,1,5,7,6,0,"https://fbref.com/en/players/5ce0b5ba/Asier-Illarramendi"
2020,"Real Sociedad","La Liga","Alexander Isak","SWE","FW","19",1999,16.7,7,2,0,3,4,1,8,12.5,7,8,0,8,3,10,6,0,"https://fbref.com/en/players/8e92be30/Alexander-Isak"
2020,"Real Sociedad","La Liga","Adnan Januzaj","BEL","FW,MF","24",1995,13,8,7,3,2,3,3,16,18.8,13,9,1,8,7,15,2,0,"https://fbref.com/en/players/4737cebe/Adnan-Januzaj"
2020,"Real Sociedad","La Liga","Willian José","BRA","FW","27",1991,22.3,5,2,0,4,1,2,8,25,6,10,4,6,1,6,16,0,"https://fbref.com/en/players/d87e2cae/Willian-Jose"
2020,"Real Sociedad","La Liga","Robin Le Normand","FRA","DF","22",1996,26.6,48,27,33,15,0,26,35,74.3,9,20,7,13,20,68,99,0,"https://fbref.com/en/players/9a64e67e/Robin-Le-Normand"
2020,"Real Sociedad","La Liga","Diego Llorente","ESP","DF","25",1993,25.9,30,14,20,9,1,16,28,57.1,12,14,7,7,28,58,101,5,"https://fbref.com/en/players/bba30585/Diego-Llorente"
2020,"Real Sociedad","La Liga","Roberto López","ESP","FW,MF","19",2000,0.6,4,2,1,1,2,2,2,100,0,0,0,0,0,4,0,0,"https://fbref.com/en/players/2a8c9f98/Roberto-Lopez"
2020,"Real Sociedad","La Liga","Mikel Merino","ESP","MF","23",1996,34.9,79,52,20,44,15,28,86,32.6,58,46,8,38,51,130,52,0,"https://fbref.com/en/players/d080ed5e/Mikel-Merino"
2020,"Real Sociedad","La Liga","Nacho Monreal","ESP","DF","33",1986,26.6,38,16,26,9,3,22,42,52.4,20,20,4,16,43,81,66,0,"https://fbref.com/en/players/d4cb83cc/Nacho-Monreal"
2020,"Real Sociedad","La Liga","Aihen Muñoz","ESP","DF","21",1997,10.9,28,18,13,12,3,18,27,66.7,9,13,2,11,2,30,19,0,"https://fbref.com/en/players/228b0d9d/Aihen-Munoz"
2020,"Real Sociedad","La Liga","Mikel Oyarzabal","ESP","FW,MF","22",1997,33.9,36,15,13,15,8,16,46,34.8,30,32,2,30,13,49,19,1,"https://fbref.com/en/players/8c3c640c/Mikel-Oyarzabal"
2020,"Real Sociedad","La Liga","Jon Pacheco","ESP","DF","18",2001,0.9,0,0,0,0,0,0,0,NA,0,1,0,1,0,0,2,0,"https://fbref.com/en/players/44150beb/Jon-Pacheco"
2020,"Real Sociedad","La Liga","Portu","ESP","FW,MF","27",1992,26.6,32,21,10,15,7,13,33,39.4,20,28,3,25,13,45,5,0,"https://fbref.com/en/players/1bda5842/Portu"
2020,"Real Sociedad","La Liga","Álex Remiro","ESP","GK","24",1995,25,0,0,0,0,0,0,1,0,1,0,0,0,0,0,25,1,"https://fbref.com/en/players/374ee424/Alex-Remiro"
2020,"Real Sociedad","La Liga","Kévin Rodrigues","POR","DF","25",1994,0.1,1,0,1,0,0,1,1,100,0,0,0,0,0,1,0,0,"https://fbref.com/en/players/f1bed920/Kevin-Rodrigues"
2020,"Real Sociedad","La Liga","Luca Sangalli","ESP","MF","24",1995,4.1,1,0,0,1,0,1,8,12.5,7,3,0,3,1,2,0,0,"https://fbref.com/en/players/7958dc65/Luca-Sangalli"
2020,"Real Sociedad","La Liga","Joseba Zaldúa","ESP","DF","27",1992,28.3,62,43,39,18,5,31,59,52.5,28,31,7,24,37,99,71,0,"https://fbref.com/en/players/5ca20b7a/Joseba-Zaldua"
2020,"Real Sociedad","La Liga","Igor Zubeldia","ESP","MF,DF","22",1997,29.3,42,21,18,19,5,17,35,48.6,18,38,21,17,26,68,82,2,"https://fbref.com/en/players/5c7845f6/Igor-Zubeldia"
2020,"Real Sociedad","La Liga","Martín Zubimendi","ESP","MF","20",1999,5.8,16,12,9,7,0,6,12,50,6,7,0,7,9,25,2,0,"https://fbref.com/en/players/3ee0dd59/Martin-Zubimendi"
2020,"Real Sociedad","La Liga","David Zurutuza","ESP","MF","33",1986,1.7,4,3,0,3,1,1,2,50,1,1,0,1,4,8,3,0,"https://fbref.com/en/players/d9bda115/David-Zurutuza"
2020,"Real Sociedad","La Liga","Martin Ødegaard","NOR","MF","20",1998,28.1,27,19,5,14,8,7,34,20.6,27,13,0,13,17,44,5,0,"https://fbref.com/en/players/79300479/Martin-Odegaard"
2020,"Reims","Ligue 1","Yunis Abdelhamid","MAR","DF","31",1987,28,46,33,29,15,2,17,30,56.7,13,26,14,12,47,93,99,1,"https://fbref.com/en/players/32c2d95f/Yunis-Abdelhamid"
2020,"Reims","Ligue 1","El Bilal Touré","MLI","FW","17",2001,5,3,3,1,0,2,0,0,NA,0,6,0,6,1,4,1,0,"https://fbref.com/en/players/47c609d5/El-Bilal-Toure"
2020,"Reims","Ligue 1","Mathieu Cafaro","FRA","FW,MF","22",1997,10.3,12,6,5,5,2,6,17,35.3,11,13,0,13,2,14,0,0,"https://fbref.com/en/players/2a657da0/Mathieu-Cafaro"
2020,"Reims","Ligue 1","Moreto Cassamã","GNB","MF","21",1998,6.6,17,11,2,13,2,5,7,71.4,2,7,2,5,5,22,6,0,"https://fbref.com/en/players/f54d2149/Moreto-Cassama"
2020,"Reims","Ligue 1","Xavier Chavalerin","FRA","MF","28",1991,23.9,71,52,29,33,9,19,49,38.8,30,23,8,15,36,107,36,0,"https://fbref.com/en/players/279ddf6a/Xavier-Chavalerin"
2020,"Reims","Ligue 1","Boulaye Dia","SEN","FW","22",1996,20.1,15,9,7,6,2,3,10,30,7,9,2,7,7,22,16,0,"https://fbref.com/en/players/244bc2c8/Boulaye-Dia"
2020,"Reims","Ligue 1","Tristan Dingomé","CMR","MF","28",1991,9.9,10,4,3,6,1,2,12,16.7,10,6,0,6,6,16,1,0,"https://fbref.com/en/players/92b56413/Tristan-Dingome"
2020,"Reims","Ligue 1","Axel Disasi","FRA","DF","21",1998,27,32,21,18,13,1,17,27,63,10,29,24,5,26,58,97,0,"https://fbref.com/en/players/ad82197c/Axel-Disasi"
2020,"Reims","Ligue 1","Anastasios Donis","GRE","FW","22",1996,6.8,3,2,2,1,0,1,9,11.1,8,2,0,2,1,4,3,0,"https://fbref.com/en/players/0f26fd24/Anastasios-Donis"
2020,"Reims","Ligue 1","Moussa Doumbia","MLI","FW,MF","24",1994,19.1,16,8,5,6,5,7,24,29.2,17,14,1,13,9,25,5,0,"https://fbref.com/en/players/6481421d/Moussa-Doumbia"
2020,"Reims","Ligue 1","Thomas Foket","BEL","DF","24",1994,27,61,36,31,23,7,30,48,62.5,18,15,4,11,39,100,59,1,"https://fbref.com/en/players/90eb507d/Thomas-Foket"
2020,"Reims","Ligue 1","Suk Hyun-jun","KOR","FW,MF","28",1991,2.9,3,3,1,1,1,1,2,50,1,1,0,1,1,4,2,0,"https://fbref.com/en/players/7ffaf233/Suk-Hyun-jun"
2020,"Reims","Ligue 1","Hassane Kamara","CIV","DF,FW","25",1994,19,58,47,40,14,4,24,35,68.6,11,17,2,15,58,116,58,0,"https://fbref.com/en/players/19a12bed/Hassane-Kamara"
2020,"Reims","Ligue 1","Ghislain Konan","CIV","DF","23",1995,14.8,43,26,28,14,1,19,28,67.9,9,13,3,10,24,67,34,0,"https://fbref.com/en/players/6b2c894b/Ghislain-Konan"
2020,"Reims","Ligue 1","Dereck Kutesa","SUI","FW,MF","21",1997,5.9,6,5,3,2,1,3,9,33.3,6,5,0,5,1,7,1,0,"https://fbref.com/en/players/1b6862e8/Dereck-Kutesa"
2020,"Reims","Ligue 1","Nicolas Lemaître","FRA","GK","22",1997,1,0,0,0,0,0,0,1,0,1,0,0,0,1,1,1,1,"https://fbref.com/en/players/586ef3a3/Nicolas-Lemaitre"
2020,"Reims","Ligue 1","Dario Maresic","AUT","DF","19",1999,1,0,0,0,0,0,0,0,NA,0,1,1,0,1,1,6,0,"https://fbref.com/en/players/5d93ccee/Dario-Maresic"
2020,"Reims","Ligue 1","Nathanael Mbuku","FRA","FW,MF","17",2002,4.4,4,2,2,2,0,0,3,0,3,0,0,0,2,6,1,0,"https://fbref.com/en/players/46750e9c/Nathanael-Mbuku"
2020,"Reims","Ligue 1","Marshall Munetsi","ZIM","MF","23",1996,9.3,27,19,12,12,3,6,12,50,6,13,7,6,12,39,20,1,"https://fbref.com/en/players/2acf0cd7/Marshall-Munetsi"
2020,"Reims","Ligue 1","Timothée Nkada","FRA","FW","20",1999,1.6,1,0,1,0,0,0,1,0,1,0,0,0,0,1,1,0,"https://fbref.com/en/players/80d1adb3/Timothee-Nkada"
2020,"Reims","Ligue 1","Remi Oudin","FRA","FW,MF","22",1996,15.5,15,7,8,5,2,6,19,31.6,13,16,1,15,18,33,18,1,"https://fbref.com/en/players/ea02beaf/Remi-Oudin"
2020,"Reims","Ligue 1","Predrag Rajković","SRB","GK","23",1995,27,1,1,1,0,0,1,1,100,0,0,0,0,1,2,9,0,"https://fbref.com/en/players/58ad9383/Predrag-Rajkovic"
2020,"Reims","Ligue 1","Alaixys Romao","TOG","MF","35",1984,19.8,46,29,31,14,1,17,57,29.8,40,12,3,9,26,72,38,3,"https://fbref.com/en/players/0aa874f4/Alaixys-Romao"
2020,"Reims","Ligue 1","Kaj Sierhuis","NED","FW","21",1998,0.1,0,0,0,0,0,0,0,NA,0,0,0,0,0,0,0,0,"https://fbref.com/en/players/9c2b1f11/Kaj-Sierhuis"
2020,"Reims","Ligue 1","Sambou Sissoko","FRA","MF,FW","20",1999,0.4,0,0,0,0,0,0,0,NA,0,0,0,0,1,1,2,0,"https://fbref.com/en/players/e4bb1f08/Sambou-Sissoko"
2020,"Reims","Ligue 1","Arber Zeneli","KVX","MF","24",1995,0.1,0,0,0,0,0,0,0,NA,0,0,0,0,0,0,0,0,"https://fbref.com/en/players/095e4199/Arber-Zeneli"
2020,"Rennes","Ligue 1","Sacha Boey","FRA","DF","18",2000,1.9,6,4,3,1,2,4,8,50,4,0,0,0,2,8,5,0,"https://fbref.com/en/players/6c8ddd52/Sacha-Boey"
2020,"Rennes","Ligue 1","Benjamin Bourigeaud","FRA","MF","25",1994,21.1,40,12,18,20,2,17,68,25,51,38,7,31,20,60,25,0,"https://fbref.com/en/players/20e73fac/Benjamin-Bourigeaud"
2020,"Rennes","Ligue 1","Eduardo Camavinga","FRA","MF","16",2002,23.4,105,64,45,56,4,48,96,50,48,26,8,18,34,139,35,0,"https://fbref.com/en/players/7b9c2d84/Eduardo-Camavinga"
2020,"Rennes","Ligue 1","Lucas Da Cunha","FRA","MF","18",2001,0.8,1,0,1,0,0,1,1,100,0,0,0,0,0,1,0,0,"https://fbref.com/en/players/007faf7a/Lucas-Da-Cunha"
2020,"Rennes","Ligue 1","Damien Da Silva","FRA","DF","31",1988,24.9,27,14,20,5,2,10,19,52.6,9,21,13,8,26,53,143,1,"https://fbref.com/en/players/1ec7e1c5/Damien-Da-Silva"
2020,"Rennes","Ligue 1","Romain Del Castillo","FRA","FW,MF","23",1996,13.8,20,14,5,11,4,6,27,22.2,21,12,2,10,7,27,7,0,"https://fbref.com/en/players/0be95d34/Romain-Del-Castillo"
2020,"Rennes","Ligue 1","Souleyman Doumbia","CIV","DF","22",1996,1,1,1,1,0,0,1,1,100,0,2,2,0,0,1,3,0,"https://fbref.com/en/players/9daeac61/Souleyman-Doumbia"
2020,"Rennes","Ligue 1","Yann Gboho","FRA","FW","18",2001,2.5,2,2,1,0,1,0,2,0,2,1,0,1,1,3,0,0,"https://fbref.com/en/players/6be41a31/Yann-Gboho"
2020,"Rennes","Ligue 1","Jérémy Gélin","FRA","DF,MF","22",1997,10.3,14,5,10,2,2,8,13,61.5,5,14,7,7,15,29,33,1,"https://fbref.com/en/players/4c700f46/Jeremy-Gelin"
2020,"Rennes","Ligue 1","Joris Gnagnon","FRA","DF","22",1997,14.2,16,13,14,2,0,10,11,90.9,1,21,17,4,18,34,61,0,"https://fbref.com/en/players/1232e1dc/Joris-Gnagnon"
2020,"Rennes","Ligue 1","Clément Grenier","FRA","MF","28",1991,9.3,21,12,6,15,0,11,40,27.5,29,7,2,5,7,28,16,0,"https://fbref.com/en/players/8b298f56/Clement-Grenier"
2020,"Rennes","Ligue 1","Rafik Guitane","FRA","MF","20",1999,0.2,0,0,0,0,0,0,0,NA,0,0,0,0,0,0,0,0,"https://fbref.com/en/players/7091324a/Rafik-Guitane"
2020,"Rennes","Ligue 1","Adrien Hunou","FRA","FW,MF","25",1994,13.4,21,18,5,11,5,4,21,19,17,16,1,15,5,26,5,0,"https://fbref.com/en/players/d14229f3/Adrien-Hunou"
2020,"Rennes","Ligue 1","James Lea Siliki","CMR","MF","23",1996,12,28,16,19,9,0,16,29,55.2,13,15,4,11,12,40,12,0,"https://fbref.com/en/players/7cf431a5/James-Lea-Siliki"
2020,"Rennes","Ligue 1","Faitout Maouassa","FRA","DF","21",1998,20,51,33,27,20,4,14,26,53.8,12,13,5,8,23,74,59,0,"https://fbref.com/en/players/e54a9890/Faitout-Maouassa"
2020,"Rennes","Ligue 1","Jonas Martin","FRA","MF","29",1990,1.3,6,2,4,0,2,1,1,100,0,2,2,0,0,6,0,0,"https://fbref.com/en/players/468fdbad/Jonas-Martin"
2020,"Rennes","Ligue 1","Edouard Mendy","SEN","GK","27",1992,24,0,0,0,0,0,0,0,NA,0,0,0,0,0,0,5,1,"https://fbref.com/en/players/33887998/Edouard-Mendy"
2020,"Rennes","Ligue 1","Jérémy Morel","MAD","DF","35",1984,20.1,15,9,13,1,1,9,20,45,11,21,17,4,17,32,59,1,"https://fbref.com/en/players/e97150c0/Jeremy-Morel"
2020,"Rennes","Ligue 1","M'Baye Niang","SEN","FW","24",1994,23.6,17,10,3,11,3,6,21,28.6,15,10,1,9,5,22,20,0,"https://fbref.com/en/players/2054d037/MBaye-Niang"
2020,"Rennes","Ligue 1","Gerzino Nyamsi","FRA","DF","22",1997,1.3,1,0,1,0,0,0,0,NA,0,1,0,1,1,2,5,0,"https://fbref.com/en/players/6043997c/Gerzino-Nyamsi"
2020,"Rennes","Ligue 1","Steven Nzonzi","FRA","MF","30",1988,4.3,5,4,3,1,1,1,2,50,1,2,2,0,4,9,18,0,"https://fbref.com/en/players/c7526c18/Steven-Nzonzi"
2020,"Rennes","Ligue 1","Jordan Pefok","USA","FW","23",1996,4.9,7,6,1,4,2,0,2,0,2,3,0,3,1,8,2,0,"https://fbref.com/en/players/b684a484/Jordan-Pefok"
2020,"Rennes","Ligue 1","Raphinha","BRA","MF,FW","22",1996,18.8,22,18,5,12,5,10,32,31.3,22,23,1,22,17,39,14,1,"https://fbref.com/en/players/3423f250/Raphinha"
2020,"Rennes","Ligue 1","Romain Salin","FRA","GK","35",1984,4,0,0,0,0,0,0,1,0,1,0,0,0,0,0,3,0,"https://fbref.com/en/players/74733221/Romain-Salin"
2020,"Rennes","Ligue 1","Flavien Tait","FRA","MF,FW","26",1993,9.8,20,13,12,6,2,9,28,32.1,19,7,0,7,9,29,5,1,"https://fbref.com/en/players/a0f9b535/Flavien-Tait"
2020,"Rennes","Ligue 1","Hamari Traoré","MLI","DF","27",1992,26.8,55,26,34,18,3,32,64,50,32,22,5,17,48,103,59,1,"https://fbref.com/en/players/a4b1028a/Hamari-Traore"
2020,"Roma","Serie A","Mirko Antonucci","ITA","FW,MF","20",1999,0.9,4,3,1,0,3,3,3,100,0,2,0,2,2,6,1,0,"https://fbref.com/en/players/91976866/Mirko-Antonucci"
2020,"Roma","Serie A","Riccardo Calafiori","ITA","DF","17",2002,0.7,0,0,0,0,0,0,1,0,1,0,0,0,2,2,0,0,"https://fbref.com/en/players/aded8e6f/Riccardo-Calafiori"
2020,"Roma","Serie A","Bryan Cristante","ITA","MF","24",1995,18,25,15,6,14,5,8,27,29.6,19,13,4,9,22,47,23,0,"https://fbref.com/en/players/16657b95/Bryan-Cristante"
2020,"Roma","Serie A","Amadou Diawara","GUI","MF","22",1997,16.9,40,25,14,20,6,8,30,26.7,22,10,1,9,33,73,16,2,"https://fbref.com/en/players/bf309d24/Amadou-Diawara"
2020,"Roma","Serie A","Edin Džeko","BIH","FW","33",1986,31.7,16,11,2,7,7,2,13,15.4,11,11,4,7,6,22,33,0,"https://fbref.com/en/players/3bb7f478/Edin-Dzeko"
2020,"Roma","Serie A","Federico Fazio","ARG","DF","32",1987,13.5,19,11,12,6,1,6,11,54.5,5,8,6,2,19,38,52,0,"https://fbref.com/en/players/4e358a2d/Federico-Fazio"
2020,"Roma","Serie A","Alessandro Florenzi","ITA","DF,FW","28",1991,11.1,14,11,8,4,2,7,20,35,13,9,3,6,16,30,19,0,"https://fbref.com/en/players/e288d4b3/Alessandro-Florenzi"
2020,"Roma","Serie A","Daniel Fuzato","BRA","GK","22",1997,1,0,0,0,0,0,0,0,NA,0,0,0,0,0,0,0,0,"https://fbref.com/en/players/82328faf/Daniel-Fuzato"
2020,"Roma","Serie A","Roger Ibanez","BRA","DF","20",1998,6.8,11,8,6,3,2,5,7,71.4,2,9,6,3,18,29,21,1,"https://fbref.com/en/players/82efe6fa/Roger-Ibanez"
2020,"Roma","Serie A","Juan Jesus","BRA","DF","28",1991,1.5,2,1,2,0,0,0,3,0,3,1,0,1,1,3,7,0,"https://fbref.com/en/players/79083382/Juan-Jesus"
2020,"Roma","Serie A","Nikola Kalinić","CRO","FW","31",1988,6.3,2,1,0,2,0,0,0,NA,0,2,0,2,1,3,1,0,"https://fbref.com/en/players/d4931a5a/Nikola-Kalinic"
2020,"Roma","Serie A","Justin Kluivert","NED","FW","20",1999,16.8,17,11,4,8,5,7,16,43.8,9,15,0,15,6,23,7,0,"https://fbref.com/en/players/4c3a6744/Justin-Kluivert"
2020,"Roma","Serie A","Aleksandar Kolarov","SRB","DF","33",1985,30.4,37,28,16,16,5,20,37,54.1,17,20,9,11,31,68,57,0,"https://fbref.com/en/players/eda40760/Aleksandar-Kolarov"
2020,"Roma","Serie A","Pau López","ESP","GK","24",1994,32,1,0,1,0,0,1,5,20,4,0,0,0,1,2,10,3,"https://fbref.com/en/players/20b9f052/Pau-Lopez"
2020,"Roma","Serie A","Gianluca Mancini","ITA","DF,MF","23",1996,30.4,49,26,26,18,5,22,44,50,22,32,15,17,60,109,98,1,"https://fbref.com/en/players/5aa53281/Gianluca-Mancini"
2020,"Roma","Serie A","Yıldırım Mert Çetin","TUR","DF","22",1997,2.9,5,1,4,1,0,3,5,60,2,4,3,1,4,9,8,1,"https://fbref.com/en/players/c730da00/Yildirim-Mert-Cetin"
2020,"Roma","Serie A","Antonio Mirante","ITA","GK","36",1983,5,0,0,0,0,0,0,1,0,1,0,0,0,0,0,2,1,"https://fbref.com/en/players/30223b33/Antonio-Mirante"
2020,"Roma","Serie A","Henrikh Mkhitaryan","ARM","MF,FW","30",1989,17,32,22,10,17,5,19,45,42.2,26,27,3,24,11,43,6,0,"https://fbref.com/en/players/dd0daf32/Henrikh-Mkhitaryan"
2020,"Roma","Serie A","Javier Pastore","ARG","MF","30",1989,5.7,14,10,3,5,6,5,12,41.7,7,4,0,4,5,19,5,0,"https://fbref.com/en/players/881ef58c/Javier-Pastore"
2020,"Roma","Serie A","Lorenzo Pellegrini","ITA","MF","23",1996,23.3,30,13,9,13,8,12,33,36.4,21,28,0,28,15,45,18,0,"https://fbref.com/en/players/4a5a45c7/Lorenzo-Pellegrini"
2020,"Roma","Serie A","Bruno Peres","BRA","DF","29",1990,11.7,14,10,10,3,1,8,21,38.1,13,12,3,9,15,29,19,2,"https://fbref.com/en/players/852351df/Bruno-Peres"
2020,"Roma","Serie A","Carles Pérez","ESP","FW,MF","21",1998,6.3,12,8,4,6,2,3,10,30,7,6,1,5,3,15,1,0,"https://fbref.com/en/players/a8f21b9f/Carles-Perez"
2020,"Roma","Serie A","Diego Perotti","ARG","FW,MF","31",1988,9.7,16,13,5,8,3,5,20,25,15,14,0,14,3,19,6,0,"https://fbref.com/en/players/a40d5a0c/Diego-Perotti"
2020,"Roma","Serie A","Davide Santon","ITA","DF","28",1991,6.9,11,6,6,5,0,6,17,35.3,11,2,1,1,11,22,13,0,"https://fbref.com/en/players/88c89891/Davide-Santon"
2020,"Roma","Serie A","Chris Smalling","ENG","DF","29",1989,28.5,25,16,15,9,1,10,13,76.9,3,44,35,9,56,81,126,2,"https://fbref.com/en/players/b6964eb6/Chris-Smalling"
2020,"Roma","Serie A","Leonardo Spinazzola","ITA","DF","26",1993,17.2,24,12,11,8,5,12,21,57.1,9,13,5,8,20,44,41,0,"https://fbref.com/en/players/3626daea/Leonardo-Spinazzola"
2020,"Roma","Serie A","Cengiz Ünder","TUR","FW","22",1997,9.7,10,6,4,4,2,2,9,22.2,7,7,2,5,8,18,7,0,"https://fbref.com/en/players/1880614f/Cengiz-Under"
2020,"Roma","Serie A","Jordan Veretout","FRA","MF","26",1993,29.2,36,18,13,16,7,14,43,32.6,29,35,5,30,18,54,31,1,"https://fbref.com/en/players/4a56052c/Jordan-Veretout"
2020,"Roma","Serie A","Gonzalo Villar","ESP","MF","21",1998,3.3,5,3,4,0,1,2,4,50,2,2,0,2,2,7,3,0,"https://fbref.com/en/players/bdc74a8f/Gonzalo-Villar"
2020,"Roma","Serie A","Nicolò Zaniolo","ITA","FW,MF","20",1999,16.7,15,11,4,7,4,3,24,12.5,21,14,0,14,5,20,5,0,"https://fbref.com/en/players/9907b1c8/Nicolo-Zaniolo"
2020,"Roma","Serie A","Davide Zappacosta","ITA","DF","27",1992,5,7,3,2,3,2,4,8,50,4,3,1,2,6,13,8,1,"https://fbref.com/en/players/7fe90ccd/Davide-Zappacosta"
2020,"SPAL","Serie A","Etrit Berisha","ALB","GK","30",1989,26,3,2,3,0,0,2,3,66.7,1,0,0,0,1,4,9,0,"https://fbref.com/en/players/ee833569/Etrit-Berisha"
2020,"SPAL","Serie A","Kevin Bonifazi","ITA","DF","23",1996,13.2,16,9,15,1,0,9,18,50,9,20,12,8,35,51,50,2,"https://fbref.com/en/players/fb77bfef/Kevin-Bonifazi"
2020,"SPAL","Serie A","Lucas Castro","ARG","MF","30",1989,4.7,13,5,5,5,3,2,4,50,2,4,0,4,2,15,3,0,"https://fbref.com/en/players/56b2957b/Lucas-Castro"
2020,"SPAL","Serie A","Alberto Cerri","ITA","FW","23",1996,4.7,2,1,0,2,0,1,3,33.3,2,1,0,1,0,2,3,0,"https://fbref.com/en/players/1079c685/Alberto-Cerri"
2020,"SPAL","Serie A","Thiago Cionek","POL","DF","33",1986,24.1,53,32,36,12,5,22,53,41.5,31,30,11,19,46,99,91,2,"https://fbref.com/en/players/46f5c54d/Thiago-Cionek"
2020,"SPAL","Serie A","Jaume Cuéllar","BOL","MF,FW","17",2001,0.8,1,0,0,0,1,0,1,0,1,0,0,0,0,1,0,0,"https://fbref.com/en/players/934e264d/Jaume-Cuellar"
2020,"SPAL","Serie A","Marco D'Alessandro","ITA","MF,DF","28",1991,8.7,11,8,5,3,3,5,8,62.5,3,11,0,11,5,16,6,0,"https://fbref.com/en/players/060606ec/Marco-DAlessandro"
2020,"SPAL","Serie A","Bryan Dabo","BFA","MF","27",1992,12.5,18,10,13,4,1,5,15,33.3,10,13,2,11,9,27,14,0,"https://fbref.com/en/players/c53083ad/Bryan-Dabo"
2020,"SPAL","Serie A","Felipe dal Belo","BRA","DF","35",1984,11.1,13,6,9,4,0,9,15,60,6,14,12,2,9,22,30,0,"https://fbref.com/en/players/8cea6319/Felipe-dal-Belo"
2020,"SPAL","Serie A","Federico Di Francesco","ITA","FW","25",1994,12,11,5,2,6,3,3,15,20,12,9,1,8,3,14,2,1,"https://fbref.com/en/players/1fca9171/Federico-Di-Francesco"
2020,"SPAL","Serie A","Mohamed Fares","ALG","DF,MF","23",1996,4.7,6,4,3,2,1,2,10,20,8,5,3,2,5,11,8,0,"https://fbref.com/en/players/b7a5bc86/Mohamed-Fares"
2020,"SPAL","Serie A","Sergio Floccari","ITA","FW","37",1981,10.5,8,3,3,1,4,0,13,0,13,9,1,8,5,13,1,0,"https://fbref.com/en/players/df301450/Sergio-Floccari"
2020,"SPAL","Serie A","Krisztofer Horváth","HUN","FW,DF","17",2002,0.5,1,1,0,1,0,0,0,NA,0,0,0,0,0,1,0,0,"https://fbref.com/en/players/4ce8f4a3/Krisztofer-Horvath"
2020,"SPAL","Serie A","Igor","BRA","DF","21",1998,14.9,24,16,13,10,1,14,20,70,6,17,9,8,24,48,37,1,"https://fbref.com/en/players/a4e85758/Igor"
2020,"SPAL","Serie A","Jakub Iskra","POL","DF","16",2002,0.9,0,0,0,0,0,0,0,NA,0,0,0,0,1,1,2,0,"https://fbref.com/en/players/103b7264/Jakub-Iskra"
2020,"SPAL","Serie A","Marko Janković","MNE","FW,DF","24",1995,1.3,2,1,0,0,2,1,2,50,1,2,1,1,0,2,0,0,"https://fbref.com/en/players/9866afec/Marko-Jankovic"
2020,"SPAL","Serie A","Jasmin Kurtić","SVN","MF","30",1989,15.7,20,7,8,8,4,6,27,22.2,21,14,2,12,10,30,20,1,"https://fbref.com/en/players/144607cc/Jasmin-Kurtic"
2020,"SPAL","Serie A","Karlo Letica","CRO","GK","22",1997,10,0,0,0,0,0,0,2,0,2,0,0,0,0,0,4,3,"https://fbref.com/en/players/4a6914ff/Karlo-Letica"
2020,"SPAL","Serie A","Simone Missiroli","ITA","MF","33",1986,31.1,42,27,18,20,4,13,43,30.2,30,42,27,15,54,96,62,1,"https://fbref.com/en/players/331c0a43/Simone-Missiroli"
2020,"SPAL","Serie A","Gabriele Moncini","ITA","FW,MF","23",1996,1.7,1,0,0,1,0,0,0,NA,0,2,1,1,1,2,0,0,"https://fbref.com/en/players/c4efe2b4/Gabriele-Moncini"
2020,"SPAL","Serie A","Alessandro Murgia","ITA","MF","22",1996,19.4,27,17,16,8,3,14,34,41.2,20,10,3,7,18,45,15,0,"https://fbref.com/en/players/fb2c533b/Alessandro-Murgia"
2020,"SPAL","Serie A","Alberto Paloschi","ITA","FW","29",1990,4.9,3,0,3,0,0,2,8,25,6,3,0,3,0,3,2,0,"https://fbref.com/en/players/b5cae4e6/Alberto-Paloschi"
2020,"SPAL","Serie A","Andrea Petagna","ITA","FW","24",1995,33.7,9,4,2,7,0,3,17,17.6,14,11,5,6,1,10,27,0,"https://fbref.com/en/players/03f946ed/Andrea-Petagna"
2020,"SPAL","Serie A","Arkadiusz Reca","POL","DF","24",1995,21.4,38,23,22,10,6,13,39,33.3,26,15,2,13,32,70,48,1,"https://fbref.com/en/players/6213fd82/Arkadiusz-Reca"
2020,"SPAL","Serie A","Jacopo Sala","ITA","DF","27",1991,9.5,29,24,17,11,1,17,31,54.8,14,4,0,4,13,42,15,1,"https://fbref.com/en/players/da5a981b/Jacopo-Sala"
2020,"SPAL","Serie A","Bartosz Salamon","POL","DF","28",1991,3.8,2,1,2,0,0,1,2,50,1,4,4,0,6,8,14,0,"https://fbref.com/en/players/9b30df1e/Bartosz-Salamon"
2020,"SPAL","Serie A","Gabriel Strefezza","BRA","DF,MF","22",1997,23.4,64,40,28,26,10,22,54,40.7,32,29,3,26,21,85,17,0,"https://fbref.com/en/players/674cfc5a/Gabriel-Strefezza"
2020,"SPAL","Serie A","Demba Thiam","SEN","GK","21",1998,2,0,0,0,0,0,0,0,NA,0,0,0,0,1,1,0,0,"https://fbref.com/en/players/0f47717b/Demba-Thiam"
2020,"SPAL","Serie A","Nenad Tomović","SRB","DF","31",1987,19.5,26,19,18,6,2,10,21,47.6,11,32,23,9,30,56,65,1,"https://fbref.com/en/players/6aafdc27/Nenad-Tomovic"
2020,"SPAL","Serie A","Georgi Tunjov","EST","MF","18",2001,3.2,4,4,3,1,0,1,11,9.1,10,3,1,2,1,5,0,0,"https://fbref.com/en/players/7aa84ac5/Georgi-Tunjov"
2020,"SPAL","Serie A","Mirko Valdifiori","ITA","MF","33",1986,15.6,31,15,14,17,0,16,33,48.5,17,8,3,5,4,35,25,0,"https://fbref.com/en/players/c710f7d5/Mirko-Valdifiori"
2020,"SPAL","Serie A","Mattia Valoti","ITA","MF,FW","25",1993,17,48,30,21,25,2,16,43,37.2,27,27,6,21,16,64,18,0,"https://fbref.com/en/players/c414df9d/Mattia-Valoti"
2020,"SPAL","Serie A","Francesco Vicari","ITA","DF","24",1994,32.2,27,13,20,6,1,12,25,48,13,48,37,11,38,65,145,1,"https://fbref.com/en/players/de045b15/Francesco-Vicari"
2020,"SPAL","Serie A","Ervin Zukanović","BIH","DF","32",1987,2.3,1,0,0,0,1,1,1,100,0,3,1,2,3,4,15,0,"https://fbref.com/en/players/1253a12e/Ervin-Zukanovic"
2020,"Saint-Étienne","Ligue 1","Charles Abi","FRA","FW","19",2000,6.9,9,9,2,5,2,2,7,28.6,5,2,0,2,4,13,4,0,"https://fbref.com/en/players/469d3d84/Charles-Abi"
2020,"Saint-Étienne","Ligue 1","Jean-Eudes Aholou","CIV","MF","25",1994,7,16,12,2,11,3,3,9,33.3,6,6,1,5,15,31,10,0,"https://fbref.com/en/players/48b28bfd/Jean-Eudes-Aholou"
2020,"Saint-Étienne","Ligue 1","Stefan Bajic","FRA","GK","17",2001,1,0,0,0,0,0,0,0,NA,0,1,0,1,0,0,2,0,"https://fbref.com/en/players/be13e5a8/Stefan-Bajic"
2020,"Saint-Étienne","Ligue 1","Bilal Benkhedim","FRA","MF,FW","18",2001,1.5,3,3,1,1,1,1,4,25,3,1,0,1,1,4,0,0,"https://fbref.com/en/players/b6047994/Bilal-Benkhedim"
2020,"Saint-Étienne","Ligue 1","Robert Berić","SVN","FW","28",1991,4.6,3,2,0,2,1,0,5,0,5,2,0,2,4,7,2,0,"https://fbref.com/en/players/9001138b/Robert-Beric"
2020,"Saint-Étienne","Ligue 1","Denis Bouanga","GAB","FW,MF","24",1994,22.7,45,34,10,25,10,20,55,36.4,35,30,0,30,10,55,15,0,"https://fbref.com/en/players/0b0cbe5b/Denis-Bouanga"
2020,"Saint-Étienne","Ligue 1","Ryad Boudebouz","ALG","MF,FW","29",1990,17.7,25,16,9,14,2,8,25,32,17,14,1,13,7,32,5,0,"https://fbref.com/en/players/1001ae82/Ryad-Boudebouz"
2020,"Saint-Étienne","Ligue 1","Yohan Cabaye","FRA","MF","33",1986,9.5,29,18,11,14,4,14,25,56,11,10,0,10,22,51,7,1,"https://fbref.com/en/players/ad7b19ef/Yohan-Cabaye"
2020,"Saint-Étienne","Ligue 1","Mahdi Camara","FRA","MF","21",1998,10,33,20,12,16,5,18,32,56.3,14,20,2,18,18,51,5,0,"https://fbref.com/en/players/8577e60a/Mahdi-Camara"
2020,"Saint-Étienne","Ligue 1","Edmilson Correia","GNB","FW,DF","19",2000,0.5,0,0,0,0,0,0,1,0,1,1,0,1,1,1,0,0,"https://fbref.com/en/players/bc50c437/Edmilson-Correia"
2020,"Saint-Étienne","Ligue 1","Mathieu Debuchy","FRA","DF","34",1985,19.7,44,26,22,15,7,24,47,51.1,23,21,11,10,43,87,59,0,"https://fbref.com/en/players/92232aad/Mathieu-Debuchy"
2020,"Saint-Étienne","Ligue 1","Lois Diony","FRA","FW","26",1992,7.4,15,5,0,11,4,5,9,55.6,4,3,0,3,1,16,0,0,"https://fbref.com/en/players/4be0b467/Lois-Diony"
2020,"Saint-Étienne","Ligue 1","Assane Dioussé","SEN","MF","21",1997,1.3,1,1,0,1,0,0,3,0,3,0,0,0,0,1,2,0,"https://fbref.com/en/players/7f622eef/Assane-Diousse"
2020,"Saint-Étienne","Ligue 1","Wesley Fofana","FRA","DF","18",2000,13.5,25,15,16,9,0,12,18,66.7,6,10,5,5,36,61,55,4,"https://fbref.com/en/players/132a82f1/Wesley-Fofana"
2020,"Saint-Étienne","Ligue 1","Romain Hamouma","FRA","FW,MF","32",1987,9.6,12,9,1,5,6,2,12,16.7,10,12,0,12,0,12,4,0,"https://fbref.com/en/players/0b4d8274/Romain-Hamouma"
2020,"Saint-Étienne","Ligue 1","Franck Honorat","FRA","FW,DF","22",1996,9.4,16,11,7,8,1,8,23,34.8,15,12,1,11,5,21,13,1,"https://fbref.com/en/players/db7849ca/Franck-Honorat"
2020,"Saint-Étienne","Ligue 1","Wahbi Khazri","TUN","FW,MF","28",1991,12.8,17,9,5,7,5,9,27,33.3,18,11,0,11,4,21,0,0,"https://fbref.com/en/players/2677a1de/Wahbi-Khazri"
2020,"Saint-Étienne","Ligue 1","Timothée Kolodziejczak","FRA","DF","27",1991,14.5,17,10,13,4,0,9,21,42.9,12,8,3,5,30,47,44,2,"https://fbref.com/en/players/ab096c6f/Timothee-Kolodziejczak"
2020,"Saint-Étienne","Ligue 1","Yann M'Vila","FRA","MF,DF","29",1990,21.6,29,14,12,16,1,12,43,27.9,31,14,4,10,40,69,47,1,"https://fbref.com/en/players/d4133fa1/Yann-MVila"
2020,"Saint-Étienne","Ligue 1","Yvann Macon","FRA","DF","20",1998,1.1,0,0,0,0,0,0,1,0,1,2,0,2,3,3,4,0,"https://fbref.com/en/players/0bb6e193/Yvann-Macon"
2020,"Saint-Étienne","Ligue 1","Harold Moukoudi","CMR","DF","21",1997,11,28,19,20,7,1,11,14,78.6,3,16,10,6,16,44,42,2,"https://fbref.com/en/players/5f26e0c5/Harold-Moukoudi"
2020,"Saint-Étienne","Ligue 1","Jessy Moulin","FRA","GK","33",1986,5,0,0,0,0,0,0,0,NA,0,0,0,0,1,1,2,0,"https://fbref.com/en/players/28a65a2c/Jessy-Moulin"
2020,"Saint-Étienne","Ligue 1","Arnaud Nordin","FRA","FW,MF","21",1998,10.1,7,3,3,3,1,4,13,30.8,9,11,1,10,4,11,6,0,"https://fbref.com/en/players/7b9a9e25/Arnaud-Nordin"
2020,"Saint-Étienne","Ligue 1","Sergi Palencia","ESP","DF","23",1996,5.2,16,10,6,10,0,5,7,71.4,2,6,1,5,8,24,4,0,"https://fbref.com/en/players/19f8e480/Sergi-Palencia"
2020,"Saint-Étienne","Ligue 1","Loïc Perrin","FRA","DF","33",1985,19,27,20,16,11,0,11,14,78.6,3,23,17,6,39,66,59,0,"https://fbref.com/en/players/6b200d45/Loic-Perrin"
2020,"Saint-Étienne","Ligue 1","Maxence Rivera","FRA","MF,FW","17",2002,0.3,0,0,0,0,0,0,1,0,1,1,0,1,0,0,0,0,"https://fbref.com/en/players/46a7b605/Maxence-Rivera"
2020,"Saint-Étienne","Ligue 1","Stéphane Ruffier","FRA","GK","32",1986,22,0,0,0,0,0,0,0,NA,0,0,0,0,0,0,5,3,"https://fbref.com/en/players/cac76a72/Stephane-Ruffier"
2020,"Saint-Étienne","Ligue 1","William Saliba","FRA","DF","18",2001,11,19,9,15,3,1,5,10,50,5,13,4,9,21,40,36,1,"https://fbref.com/en/players/972aeb2a/William-Saliba"
2020,"Saint-Étienne","Ligue 1","Gabriel Silva","BRA","DF","28",1991,2.6,4,1,1,2,1,2,3,66.7,1,2,0,2,4,8,8,0,"https://fbref.com/en/players/4914ed4a/Gabriel-Silva"
2020,"Saint-Étienne","Ligue 1","Miguel Trauco","PER","DF","26",1992,16.4,32,20,16,12,4,19,44,43.2,25,8,1,7,23,55,25,0,"https://fbref.com/en/players/e4b72e34/Miguel-Trauco"
2020,"Saint-Étienne","Ligue 1","Zaydou Youssouf","FRA","MF","20",1999,12,40,22,12,26,2,15,35,42.9,20,7,1,6,16,56,13,0,"https://fbref.com/en/players/e2f9bb5f/Zaydou-Youssouf"
2020,"Sampdoria","Serie A","Kristoffer Askildsen","NOR","MF","18",2001,0.8,1,1,1,0,0,0,0,NA,0,1,0,1,1,2,0,0,"https://fbref.com/en/players/a69cc629/Kristoffer-Askildsen"
2020,"Sampdoria","Serie A","Emil Audero","ITA","GK","22",1997,36,1,1,1,0,0,1,3,33.3,2,0,0,0,0,1,21,1,"https://fbref.com/en/players/649b01d8/Emil-Audero"
2020,"Sampdoria","Serie A","Tommaso Augello","ITA","DF","24",1994,12.6,14,9,6,3,5,5,7,71.4,2,8,0,8,15,29,21,1,"https://fbref.com/en/players/3cd3b384/Tommaso-Augello"
2020,"Sampdoria","Serie A","Édgar Barreto","PAR","MF","35",1984,1,4,3,0,1,3,2,3,66.7,1,1,0,1,0,4,0,0,"https://fbref.com/en/players/43a1bea5/Edgar-Barreto"
2020,"Sampdoria","Serie A","Bartosz Bereszyński","POL","DF","27",1992,26.7,53,35,25,23,5,26,52,50,26,38,16,22,35,88,88,1,"https://fbref.com/en/players/61b3978f/Bartosz-Bereszynski"
2020,"Sampdoria","Serie A","Andrea Bertolacci","ITA","MF","28",1991,5.9,7,4,2,3,2,1,8,12.5,7,4,1,3,2,9,13,0,"https://fbref.com/en/players/c75b6a02/Andrea-Bertolacci"
2020,"Sampdoria","Serie A","Federico Bonazzoli","ITA","FW","22",1997,8.3,7,5,1,4,2,0,7,0,7,3,0,3,5,12,2,0,"https://fbref.com/en/players/bf57eaab/Federico-Bonazzoli"
2020,"Sampdoria","Serie A","Gianluca Caprari","ITA","FW,MF","26",1993,7.4,9,7,1,6,2,4,13,30.8,9,5,0,5,7,16,1,0,"https://fbref.com/en/players/54e53b7e/Gianluca-Caprari"
2020,"Sampdoria","Serie A","Julian Chabot","GER","DF","21",1998,6.3,11,7,6,5,0,6,11,54.5,5,3,2,1,15,26,26,0,"https://fbref.com/en/players/ae7058f9/Julian-Chabot"
2020,"Sampdoria","Serie A","Omar Colley","GAM","DF","26",1992,30.8,42,26,27,14,1,12,24,50,12,33,22,11,59,101,155,1,"https://fbref.com/en/players/8b95acda/Omar-Colley"
2020,"Sampdoria","Serie A","Felice D'Amico","ITA","MF","18",2000,0,1,1,0,0,1,0,0,NA,0,0,0,0,0,1,0,0,"https://fbref.com/en/players/0c35d28d/Felice-DAmico"
2020,"Sampdoria","Serie A","Fabio Depaoli","ITA","MF,DF","22",1997,20.6,41,28,26,10,5,17,31,54.8,14,29,3,26,16,57,39,0,"https://fbref.com/en/players/d97f2e8d/Fabio-Depaoli"
2020,"Sampdoria","Serie A","Albin Ekdal","SWE","MF","30",1989,26.5,51,25,18,31,2,24,68,35.3,44,35,14,21,33,84,46,1,"https://fbref.com/en/players/f503ea63/Albin-Ekdal"
2020,"Sampdoria","Serie A","Wladimiro Falcone","ITA","GK","24",1995,2,0,0,0,0,0,0,0,NA,0,0,0,0,0,0,0,0,"https://fbref.com/en/players/9f5a610b/Wladimiro-Falcone"
2020,"Sampdoria","Serie A","Alex Ferrari","ITA","DF","25",1994,11.2,18,13,13,5,0,7,12,58.3,5,13,8,5,12,30,31,0,"https://fbref.com/en/players/d0dbca9f/Alex-Ferrari"
2020,"Sampdoria","Serie A","Manolo Gabbiadini","ITA","FW","27",1991,22.6,9,7,2,3,4,1,7,14.3,6,12,0,12,10,19,11,0,"https://fbref.com/en/players/8f866fe8/Manolo-Gabbiadini"
2020,"Sampdoria","Serie A","Jakub Jankto","CZE","MF,FW","23",1996,23.3,27,13,14,10,3,10,42,23.8,32,30,3,27,22,49,22,0,"https://fbref.com/en/players/1ea5f91c/Jakub-Jankto"
2020,"Sampdoria","Serie A","Antonino La Gumina","ITA","FW","23",1996,2.1,0,0,0,0,0,0,0,NA,0,0,0,0,0,0,1,0,"https://fbref.com/en/players/822a7761/Antonino-La-Gumina"
2020,"Sampdoria","Serie A","Mehdi Léris","ALG","MF,FW","21",1998,5.7,13,11,4,2,7,7,19,36.8,12,12,4,8,6,19,6,0,"https://fbref.com/en/players/7d3cbc67/Mehdi-Leris"
2020,"Sampdoria","Serie A","Karol Linetty","POL","MF","24",1995,22.4,61,32,24,25,12,21,65,32.3,44,26,3,23,26,87,17,0,"https://fbref.com/en/players/d023d70f/Karol-Linetty"
2020,"Sampdoria","Serie A","Gonzalo Maroni","ARG","MF,FW","20",1999,2,3,1,1,1,1,3,7,42.9,4,1,0,1,3,6,0,0,"https://fbref.com/en/players/e01ca8f4/Gonzalo-Maroni"
2020,"Sampdoria","Serie A","Jeison Murillo","COL","DF","27",1992,7.4,18,6,14,4,0,10,19,52.6,9,8,4,4,10,28,28,0,"https://fbref.com/en/players/b233e8e4/Jeison-Murillo"
2020,"Sampdoria","Serie A","Nicola Murru","ITA","DF","24",1994,25.1,40,22,24,8,8,21,41,51.2,20,22,4,18,27,67,58,0,"https://fbref.com/en/players/d183e9d6/Nicola-Murru"
2020,"Sampdoria","Serie A","Fabio Quagliarella","ITA","FW","36",1983,25.3,9,5,0,6,3,2,30,6.7,28,13,0,13,8,17,15,0,"https://fbref.com/en/players/ee4f2f3b/Fabio-Quagliarella"
2020,"Sampdoria","Serie A","Gastón Ramírez","URU","MF,FW","28",1990,15.5,32,21,7,16,9,8,30,26.7,22,28,2,26,11,43,10,0,"https://fbref.com/en/players/2c851997/Gaston-Ramirez"
2020,"Sampdoria","Serie A","Vasco Regini","ITA","DF","28",1990,1.9,4,2,3,1,0,0,0,NA,0,4,2,2,1,5,6,0,"https://fbref.com/en/players/339c6ed4/Vasco-Regini"
2020,"Sampdoria","Serie A","Emiliano Rigoni","ARG","MF,FW","26",1993,4.8,5,4,2,1,2,3,10,30,7,5,1,4,3,8,1,0,"https://fbref.com/en/players/a1216563/Emiliano-Rigoni"
2020,"Sampdoria","Serie A","Morten Thorsby","NOR","MF,DF","23",1996,20.7,53,34,17,23,13,27,52,51.9,25,24,6,18,17,70,34,0,"https://fbref.com/en/players/d1b49282/Morten-Thorsby"
2020,"Sampdoria","Serie A","Lorenzo Tonelli","ITA","DF","29",1990,7.8,13,9,13,0,0,4,10,40,6,10,7,3,4,17,23,0,"https://fbref.com/en/players/8cc29864/Lorenzo-Tonelli"
2020,"Sampdoria","Serie A","Ronaldo Vieira","GNB","MF","21",1998,20.2,NA,21,NA,NA,NA,NA,NA,NA,NA,NA,NA,NA,22,NA,NA,NA,"https://fbref.com/en/players/75e60d75/Ronaldo-Vieira"
2020,"Sampdoria","Serie A","Maya Yoshida","JPN","DF","30",1988,13.2,4,3,2,2,0,2,6,33.3,4,15,12,3,27,31,72,0,"https://fbref.com/en/players/caffaf5a/Maya-Yoshida"
2020,"Sassuolo","Serie A","Domenico Berardi","ITA","FW","24",1994,27.7,32,16,19,8,5,13,59,22,46,31,3,28,33,65,27,0,"https://fbref.com/en/players/53a0e358/Domenico-Berardi"
2020,"Sassuolo","Serie A","Jeremie Boga","CIV","FW","22",1997,27.9,12,7,3,8,1,6,20,30,14,24,0,24,3,15,4,0,"https://fbref.com/en/players/fe012aca/Jeremie-Boga"
2020,"Sassuolo","Serie A","Mehdi Bourabia","MAR","MF","27",1991,10.3,19,9,8,10,1,9,22,40.9,13,12,2,10,22,41,23,0,"https://fbref.com/en/players/0d077b88/Mehdi-Bourabia"
2020,"Sassuolo","Serie A","Francesco Caputo","ITA","FW","31",1987,32.6,7,4,3,2,2,3,11,27.3,8,15,0,15,1,8,8,0,"https://fbref.com/en/players/5bd72174/Francesco-Caputo"
2020,"Sassuolo","Serie A","Vlad Chiricheș","ROU","DF","29",1989,7.9,14,9,12,2,0,7,10,70,3,13,8,5,11,25,28,2,"https://fbref.com/en/players/c316607a/Vlad-Chiriches"
2020,"Sassuolo","Serie A","Andrea Consigli","ITA","GK","32",1987,31,0,0,0,0,0,0,1,0,1,0,0,0,4,4,19,2,"https://fbref.com/en/players/8cabdc1e/Andrea-Consigli"
2020,"Sassuolo","Serie A","Grégoire Defrel","MTQ","FW,MF","28",1991,10.9,12,8,4,6,2,4,15,26.7,11,9,0,9,3,15,5,0,"https://fbref.com/en/players/854ee61a/Gregoire-Defrel"
2020,"Sassuolo","Serie A","Alfred Duncan","GHA","MF","26",1993,9.4,19,12,8,7,4,6,16,37.5,10,7,0,7,9,28,13,0,"https://fbref.com/en/players/528492ea/Alfred-Duncan"
2020,"Sassuolo","Serie A","Andrea Ghion","ITA","FW,MF","19",2000,0.5,3,1,1,2,0,1,1,100,0,0,0,0,0,3,0,0,"https://fbref.com/en/players/7f24b3eb/Andrea-Ghion"
2020,"Sassuolo","Serie A","Lukáš Haraslín","SVK","FW","23",1996,4.3,5,2,1,3,1,2,9,22.2,7,5,0,5,4,9,1,0,"https://fbref.com/en/players/5c397195/Lukas-Haraslin"
2020,"Sassuolo","Serie A","Hamed Junior Traorè","CIV","MF,FW","19",2000,17.4,31,15,10,15,6,14,39,35.9,25,22,1,21,11,42,7,0,"https://fbref.com/en/players/570bb4b9/Hamed-Junior-Traore"
2020,"Sassuolo","Serie A","Giorgos Kyriakopoulos","GRE","DF","23",1996,18.3,35,18,22,7,6,18,32,56.3,14,19,6,13,18,53,41,0,"https://fbref.com/en/players/0a483542/Giorgos-Kyriakopoulos"
2020,"Sassuolo","Serie A","Manuel Locatelli","ITA","MF","21",1998,28.7,76,50,35,37,4,33,69,47.8,36,42,14,28,33,109,36,0,"https://fbref.com/en/players/a8a874f1/Manuel-Locatelli"
2020,"Sassuolo","Serie A","Francesco Magnanelli","ITA","MF","34",1984,15.5,25,13,9,12,4,11,35,31.4,24,12,6,6,19,44,23,1,"https://fbref.com/en/players/07767f42/Francesco-Magnanelli"
2020,"Sassuolo","Serie A","Giangiacomo Magnani","ITA","DF","23",1995,1.6,0,0,0,0,0,0,0,NA,0,2,1,1,2,2,7,0,"https://fbref.com/en/players/cce9f582/Giangiacomo-Magnani"
2020,"Sassuolo","Serie A","Giacomo Manzari","ITA","FW,MF","18",2000,0.2,0,0,0,0,0,0,0,NA,0,0,0,0,0,0,0,0,"https://fbref.com/en/players/d8dfae8a/Giacomo-Manzari"
2020,"Sassuolo","Serie A","Gian Marco Ferrari","ITA","DF","27",1992,21.1,9,5,6,3,0,4,8,50,4,25,22,3,26,35,41,1,"https://fbref.com/en/players/8650af85/Gian-Marco-Ferrari"
2020,"Sassuolo","Serie A","Marlon","BRA","DF","23",1995,20.2,40,23,24,15,1,17,27,63,10,20,13,7,35,75,69,0,"https://fbref.com/en/players/cdf65d12/Marlon"
2020,"Sassuolo","Serie A","Luca Mazzitelli","ITA","MF","23",1995,0.1,1,1,0,1,0,1,1,100,0,0,0,0,0,1,0,0,"https://fbref.com/en/players/dc61b402/Luca-Mazzitelli"
2020,"Sassuolo","Serie A","Mert Müldür","TUR","DF","20",1999,14.1,47,27,33,8,6,27,42,64.3,15,10,0,10,22,69,42,0,"https://fbref.com/en/players/1295552e/Mert-Muldur"
2020,"Sassuolo","Serie A","Pedro Obiang","EQG","MF","27",1992,18.6,46,31,21,19,6,19,40,47.5,21,24,10,14,21,67,31,1,"https://fbref.com/en/players/ba1e04b3/Pedro-Obiang"
2020,"Sassuolo","Serie A","Gianluca Pegolo","ITA","GK","38",1981,5,0,0,0,0,0,0,0,NA,0,0,0,0,0,0,4,0,"https://fbref.com/en/players/f058ed1f/Gianluca-Pegolo"
2020,"Sassuolo","Serie A","Federico Peluso","ITA","DF","35",1984,16.8,19,16,8,8,3,8,9,88.9,1,14,9,5,22,41,58,1,"https://fbref.com/en/players/4f2908e5/Federico-Peluso"
2020,"Sassuolo","Serie A","Stefano Piccinini","ITA","DF","16",2002,0.1,0,0,0,0,0,0,0,NA,0,0,0,0,0,0,0,0,"https://fbref.com/en/players/6010ba04/Stefano-Piccinini"
2020,"Sassuolo","Serie A","Giacomo Raspadori","ITA","MF,FW","19",2000,2.9,8,6,5,2,1,3,4,75,1,5,0,5,1,9,0,0,"https://fbref.com/en/players/6e058f06/Giacomo-Raspadori"
2020,"Sassuolo","Serie A","Rogério","BRA","DF","21",1998,11.3,22,14,12,8,2,16,23,69.6,7,13,3,10,9,31,34,0,"https://fbref.com/en/players/10e7f486/Rogerio"
2020,"Sassuolo","Serie A","Filippo Romagna","ITA","DF","22",1997,16.4,7,6,2,5,0,5,6,83.3,1,24,17,7,10,17,69,0,"https://fbref.com/en/players/84594618/Filippo-Romagna"
2020,"Sassuolo","Serie A","Jeremy Toljan","GER","DF","24",1994,24.3,37,21,24,10,3,18,35,51.4,17,23,12,11,18,55,58,1,"https://fbref.com/en/players/a96e5dc0/Jeremy-Toljan"
2020,"Sassuolo","Serie A","Alessandro Tripaldelli","ITA","DF","20",1999,1.5,4,4,1,3,0,1,3,33.3,2,1,0,1,3,7,3,0,"https://fbref.com/en/players/4571fa88/Alessandro-Tripaldelli"
2020,"Sassuolo","Serie A","Stefano Turati","ITA","GK","17",2001,2,0,0,0,0,0,0,0,NA,0,0,0,0,0,0,1,0,"https://fbref.com/en/players/bf168004/Stefano-Turati"
2020,"Sassuolo","Serie A","Filip Đuričić","SRB","MF,FW","27",1992,18.1,23,14,2,10,11,3,19,15.8,16,20,3,17,8,31,14,0,"https://fbref.com/en/players/eccbe56a/Filip-Djuricic"
2020,"Schalke 04","Bundesliga","Timo Becker","GER","DF,MF","22",1997,3.7,10,9,3,6,1,5,9,55.6,4,6,1,5,3,13,8,0,"https://fbref.com/en/players/543ddcaf/Timo-Becker"
2020,"Schalke 04","Bundesliga","Nassim Boujellab","MAR","MF,FW","20",1999,4.7,12,10,5,4,3,5,14,35.7,9,8,1,7,7,19,5,0,"https://fbref.com/en/players/541127d5/Nassim-Boujellab"
2020,"Schalke 04","Bundesliga","Can Bozdogan","GER","MF","18",2001,2.6,8,6,5,3,0,3,12,25,9,2,0,2,2,10,2,0,"https://fbref.com/en/players/b797f558/Can-Bozdogan"
2020,"Schalke 04","Bundesliga","Guido Burgstaller","AUT","FW","30",1989,13.7,7,3,0,5,2,4,15,26.7,11,12,3,9,4,11,10,0,"https://fbref.com/en/players/2bcc6d52/Guido-Burgstaller"
2020,"Schalke 04","Bundesliga","Daniel Caligiuri","ITA","MF,FW","31",1988,25.5,58,37,18,25,15,27,74,36.5,47,67,6,61,25,83,39,0,"https://fbref.com/en/players/d1273f09/Daniel-Caligiuri"
2020,"Schalke 04","Bundesliga","Michael Gregoritsch","AUT","FW","25",1994,9.2,8,5,0,6,2,0,9,0,9,9,1,8,2,10,10,0,"https://fbref.com/en/players/8e235926/Michael-Gregoritsch"
2020,"Schalke 04","Bundesliga","Amine Harit","MAR","MF,FW","22",1997,23.4,16,7,8,5,3,6,25,24,19,13,0,13,7,23,2,1,"https://fbref.com/en/players/e7d59f4f/Amine-Harit"
2020,"Schalke 04","Bundesliga","Jonas Hofmann","GER","MF","22",1997,0,0,0,0,0,0,0,0,NA,0,0,0,0,0,0,2,0,"https://fbref.com/en/players/9908c518/Jonas-Hofmann"
2020,"Schalke 04","Bundesliga","Ozan Kabak","TUR","DF","19",2000,19.7,37,23,28,9,0,14,21,66.7,7,33,19,14,37,74,97,0,"https://fbref.com/en/players/2d61d13a/Ozan-Kabak"
2020,"Schalke 04","Bundesliga","Jonjoe Kenny","ENG","DF","22",1997,30.2,49,29,24,19,6,26,51,51,25,45,10,35,26,75,79,0,"https://fbref.com/en/players/099e666f/Jonjoe-Kenny"
2020,"Schalke 04","Bundesliga","Ahmed Kutucu","TUR","FW,MF","19",2000,7.5,11,7,3,6,2,4,15,26.7,11,5,0,5,2,13,5,0,"https://fbref.com/en/players/beda9675/Ahmed-Kutucu"
2020,"Schalke 04","Bundesliga","Omar Mascarell","ESP","MF","26",1993,22.5,42,23,17,22,3,21,57,36.8,36,46,14,32,62,104,40,0,"https://fbref.com/en/players/11fd2b75/Omar-Mascarell"
2020,"Schalke 04","Bundesliga","Rabbi Matondo","WAL","FW,MF","18",2000,12.9,10,3,3,2,5,3,13,23.1,10,4,0,4,5,15,1,0,"https://fbref.com/en/players/33144cc5/Rabbi-Matondo"
2020,"Schalke 04","Bundesliga","Weston McKennie","USA","MF,DF","20",1998,23,38,20,17,16,5,13,40,32.5,27,38,12,26,46,84,39,0,"https://fbref.com/en/players/01c3aff5/Weston-McKennie"
2020,"Schalke 04","Bundesliga","Levent Mercan","GER","MF,FW","18",2000,0.8,0,0,0,0,0,0,0,NA,0,0,0,0,0,0,2,1,"https://fbref.com/en/players/33340bd6/Levent-Mercan"
2020,"Schalke 04","Bundesliga","Juan Miranda","ESP","DF","19",2000,8.7,14,10,8,6,0,6,18,33.3,12,12,4,8,10,24,27,1,"https://fbref.com/en/players/ead61f73/Juan-Miranda"
2020,"Schalke 04","Bundesliga","Matija Nastasić","SRB","DF","26",1993,15.2,26,16,17,9,0,14,17,82.4,3,28,16,12,22,48,79,0,"https://fbref.com/en/players/f35430a4/Matija-Nastasic"
2020,"Schalke 04","Bundesliga","Alexander Nübel","GER","GK","22",1996,25.7,0,0,0,0,0,0,0,NA,0,0,0,0,2,2,9,6,"https://fbref.com/en/players/afb0c500/Alexander-Nubel"
2020,"Schalke 04","Bundesliga","Bastian Oczipka","GER","DF","30",1989,33.5,72,50,42,21,9,36,62,58.1,26,35,6,29,37,109,68,0,"https://fbref.com/en/players/d1661819/Bastian-Oczipka"
2020,"Schalke 04","Bundesliga","Benito Raman","BEL","FW","24",1994,17.8,18,9,4,9,5,7,24,29.2,17,11,1,10,7,25,1,0,"https://fbref.com/en/players/867501bf/Benito-Raman"
2020,"Schalke 04","Bundesliga","Fabian Reese","GER","FW","21",1997,1,1,1,1,0,0,0,0,NA,0,1,1,0,0,1,1,0,"https://fbref.com/en/players/b1823b08/Fabian-Reese"
2020,"Schalke 04","Bundesliga","Salif Sané","SEN","DF","28",1990,12.5,16,9,12,4,0,11,19,57.9,8,19,7,12,21,37,50,0,"https://fbref.com/en/players/791abba1/Salif-Sane"
2020,"Schalke 04","Bundesliga","Alessandro Schöpf","AUT","MF","25",1994,15.9,29,16,11,10,8,12,33,36.4,21,17,1,16,26,55,8,0,"https://fbref.com/en/players/106bca06/Alessandro-Schopf"
2020,"Schalke 04","Bundesliga","Markus Schubert","GER","GK","21",1998,8.2,0,0,0,0,0,0,1,0,1,0,0,0,0,0,9,4,"https://fbref.com/en/players/289b90cd/Markus-Schubert"
2020,"Schalke 04","Bundesliga","Suat Serdar","GER","MF","22",1997,17.8,56,37,16,33,7,18,61,29.5,43,39,7,32,24,80,7,0,"https://fbref.com/en/players/b3325a30/Suat-Serdar"
2020,"Schalke 04","Bundesliga","Benjamin Stambouli","FRA","DF","28",1990,9,31,19,14,15,2,11,21,52.4,10,16,6,10,12,43,28,1,"https://fbref.com/en/players/5939baa2/Benjamin-Stambouli"
2020,"Schalke 04","Bundesliga","Malick Thiaw","GER","DF","17",2001,0.8,2,0,1,1,0,1,2,50,1,2,2,0,2,4,4,1,"https://fbref.com/en/players/ff5ea0bf/Malick-Thiaw"
2020,"Schalke 04","Bundesliga","Jean-Clair Todibo","FRA","DF","19",1999,4.1,15,10,10,5,0,8,9,88.9,1,2,0,2,15,30,24,0,"https://fbref.com/en/players/88f130ed/Jean-Clair-Todibo"
2020,"Schalke 04","Bundesliga","Mark Uth","GER","FW,MF","27",1991,3.9,3,2,1,1,1,0,3,0,3,4,0,4,1,4,0,0,"https://fbref.com/en/players/a3ddb1b9/Mark-Uth"
2020,"Sevilla","La Liga","Éver Banega","ARG","MF","31",1988,27.5,43,28,16,18,9,21,70,30,49,19,1,18,15,58,5,0,"https://fbref.com/en/players/fa937f7a/Ever-Banega"
2020,"Sevilla","La Liga","Yassine Bounou","MAR","GK","28",1991,5.5,0,0,0,0,0,0,0,NA,0,0,0,0,0,0,0,0,"https://fbref.com/en/players/f6798fc3/Yassine-Bounou"
2020,"Sevilla","La Liga","Bryan","ESP","FW","18",2001,0.7,1,1,0,1,0,0,1,0,1,0,0,0,0,1,0,0,"https://fbref.com/en/players/7b5ab7f2/Bryan"
2020,"Sevilla","La Liga","Diego Carlos","BRA","DF","26",1993,34.8,35,23,25,9,1,15,25,60,10,33,24,9,37,72,176,1,"https://fbref.com/en/players/b4a014b1/Diego-Carlos"
2020,"Sevilla","La Liga","Daniel Carriço","POR","DF","30",1988,9.4,8,2,4,3,1,1,6,16.7,5,4,3,1,8,16,23,0,"https://fbref.com/en/players/e1deea75/Daniel-Carrico"
2020,"Sevilla","La Liga","Moanes Dabbur","ISR","FW","27",1992,0.3,1,1,0,0,1,0,0,NA,0,1,0,1,0,1,0,0,"https://fbref.com/en/players/eac044ad/Moanes-Dabbur"
2020,"Sevilla","La Liga","Youssef En-Nesyri","MAR","FW","22",1997,8.8,7,5,1,6,0,3,10,30,7,9,3,6,5,12,7,0,"https://fbref.com/en/players/04e17fd5/Youssef-En-Nesyri"
2020,"Sevilla","La Liga","Sergio Escudero","ESP","DF","29",1989,8.6,29,16,17,10,2,19,28,67.9,9,11,1,10,13,42,35,0,"https://fbref.com/en/players/b0616e3d/Sergio-Escudero"
2020,"Sevilla","La Liga","Fernando","BRA","MF","32",1987,29.5,62,33,37,24,1,34,58,58.6,24,38,15,23,67,129,73,1,"https://fbref.com/en/players/41f32541/Fernando"
2020,"Sevilla","La Liga","Sergi Gómez","ESP","DF","27",1992,8,9,7,7,2,0,4,4,100,0,6,6,0,7,16,30,0,"https://fbref.com/en/players/bc6f5f06/Sergi-Gomez"
2020,"Sevilla","La Liga","Nemanja Gudelj","SRB","MF,DF","27",1991,13.5,20,14,11,8,1,6,19,31.6,13,17,8,9,12,32,35,1,"https://fbref.com/en/players/0076ab7f/Nemanja-Gudelj"
2020,"Sevilla","La Liga","Munir El Haddadi","MAR","FW","23",1995,13.9,19,17,6,11,2,4,21,19,17,8,0,8,7,26,8,0,"https://fbref.com/en/players/8696bc90/Munir-El-Haddadi"
2020,"Sevilla","La Liga","Javier Hernández","MEX","FW","31",1988,5,6,4,0,4,2,1,6,16.7,5,5,0,5,5,11,1,0,"https://fbref.com/en/players/189cee7b/Javier-Hernandez"
2020,"Sevilla","La Liga","Luuk de Jong","NED","FW","28",1990,22.9,21,10,4,8,9,6,17,35.3,11,12,1,11,7,28,22,0,"https://fbref.com/en/players/abb3bb95/Luuk-de-Jong"
2020,"Sevilla","La Liga","Joan Jordán","ESP","MF","25",1994,25,64,34,27,31,6,21,76,27.6,55,25,5,20,26,90,20,4,"https://fbref.com/en/players/2a0c8ba4/Joan-Jordan"
2020,"Sevilla","La Liga","Jules Koundé","FRA","DF","20",1998,25.7,23,12,14,5,4,10,18,55.6,8,16,12,4,23,46,91,2,"https://fbref.com/en/players/4d1666ff/Jules-Kounde"
2020,"Sevilla","La Liga","Rony Lopes","POR","FW","23",1995,1.5,0,0,0,0,0,0,0,NA,0,0,0,0,2,2,0,0,"https://fbref.com/en/players/7c2965bb/Rony-Lopes"
2020,"Sevilla","La Liga","Jesús Navas","ESP","DF","33",1985,37.4,27,15,16,7,4,15,32,46.9,17,20,7,13,31,58,70,0,"https://fbref.com/en/players/3f10bd22/Jesus-Navas"
2020,"Sevilla","La Liga","Nolito","ESP","FW","32",1986,10,21,12,5,11,5,7,20,35,13,7,0,7,1,22,1,0,"https://fbref.com/en/players/b2d0ec1b/Nolito"
2020,"Sevilla","La Liga","Lucas Ocampos","ARG","FW,MF","25",1994,30.5,54,31,30,19,5,30,72,41.7,42,33,2,31,22,76,27,0,"https://fbref.com/en/players/a08b974a/Lucas-Ocampos"
2020,"Sevilla","La Liga","Alejandro Pozo Pozo","ESP","MF,FW","20",1999,0.4,1,1,1,0,0,1,1,100,0,0,0,0,0,1,1,0,"https://fbref.com/en/players/3c16d927/Alejandro-Pozo-Pozo"
2020,"Sevilla","La Liga","Sergio Reguilón","ESP","DF","22",1996,27.9,57,30,28,25,4,27,64,42.2,37,25,5,20,33,90,53,0,"https://fbref.com/en/players/3353737a/Sergio-Reguilon"
2020,"Sevilla","La Liga","Suso","ESP","FW,MF","25",1993,8.7,9,4,4,4,1,7,16,43.8,9,6,0,6,2,11,0,0,"https://fbref.com/en/players/4e219ad2/Suso"
2020,"Sevilla","La Liga","Óliver Torres","ESP","MF,FW","24",1994,17.7,45,27,12,26,7,23,60,38.3,37,23,1,22,13,58,9,1,"https://fbref.com/en/players/58a9a4d9/Oliver-Torres"
2020,"Sevilla","La Liga","Tomáš Vaclík","CZE","GK","30",1989,32.5,0,0,0,0,0,0,1,0,1,0,0,0,0,0,7,0,"https://fbref.com/en/players/7b456af7/Tomas-Vaclik"
2020,"Sevilla","La Liga","Franco Vázquez","ARG","MF,FW","30",1989,12.2,25,17,9,14,2,6,36,16.7,30,13,0,13,10,35,10,0,"https://fbref.com/en/players/467bae22/Franco-Vazquez"
2020,"Sheffield Utd","Premier League","George Baldock","GRE","DF","26",1993,38,62,43,35,17,10,27,47,57.4,20,26,3,23,34,96,83,3,"https://fbref.com/en/players/394854c4/George-Baldock"
2020,"Sheffield Utd","Premier League","Chris Basham","ENG","DF","31",1988,36,85,48,58,20,7,48,81,59.3,33,38,15,23,77,162,173,1,"https://fbref.com/en/players/1aa84968/Chris-Basham"
2020,"Sheffield Utd","Premier League","Sander Berge","NOR","MF","21",1998,10.5,22,15,3,14,5,5,10,50,5,15,1,14,10,32,16,0,"https://fbref.com/en/players/d0b6129f/Sander-Berge"
2020,"Sheffield Utd","Premier League","Muhamed Bešić","BIH","MF","26",1992,2.8,8,6,4,4,0,2,5,40,3,4,0,4,1,9,6,0,"https://fbref.com/en/players/7ca9f0f0/Muhamed-Besic"
2020,"Sheffield Utd","Premier League","Leon Clarke","ENG","FW,MF","34",1985,0.4,0,0,0,0,0,0,0,NA,0,0,0,0,0,0,2,0,"https://fbref.com/en/players/91c975a0/Leon-Clarke"
2020,"Sheffield Utd","Premier League","John Egan","IRL","DF","26",1992,35.4,44,27,34,10,0,25,45,55.6,20,39,27,12,58,102,171,4,"https://fbref.com/en/players/debe38a0/John-Egan"
2020,"Sheffield Utd","Premier League","John Fleck","SCO","MF","27",1991,28,36,25,13,14,9,22,64,34.4,42,25,3,22,24,60,26,0,"https://fbref.com/en/players/b63e789d/John-Fleck"
2020,"Sheffield Utd","Premier League","Kieron Freeman","WAL","FW","27",1992,0.1,0,0,0,0,0,0,0,NA,0,0,0,0,0,0,0,0,"https://fbref.com/en/players/c13c24c8/Kieron-Freeman"
2020,"Sheffield Utd","Premier League","Luke Freeman","ENG","MF","27",1992,4.1,6,4,2,2,2,2,8,25,6,1,0,1,10,16,6,0,"https://fbref.com/en/players/636b64cd/Luke-Freeman"
2020,"Sheffield Utd","Premier League","Dean Henderson","ENG","GK","22",1997,36,0,0,0,0,0,0,0,NA,0,0,0,0,1,1,13,1,"https://fbref.com/en/players/e5a76dfe/Dean-Henderson"
2020,"Sheffield Utd","Premier League","Phil Jagielka","ENG","DF","36",1982,2.7,5,4,3,2,0,1,3,33.3,2,5,5,0,4,9,19,0,"https://fbref.com/en/players/3233eefd/Phil-Jagielka"
2020,"Sheffield Utd","Premier League","John Lundstram","ENG","MF","25",1994,27.3,46,30,18,21,7,21,65,32.3,44,18,4,14,33,79,46,1,"https://fbref.com/en/players/0df2b165/John-Lundstram"
2020,"Sheffield Utd","Premier League","Oliver McBurnie","SCO","FW","23",1996,23.5,37,22,6,27,4,11,40,27.5,29,25,3,22,15,52,43,0,"https://fbref.com/en/players/78b8ac63/Oliver-McBurnie"
2020,"Sheffield Utd","Premier League","David McGoldrick","IRL","FW","31",1987,20.2,41,26,9,24,8,5,20,25,15,14,2,12,3,44,23,0,"https://fbref.com/en/players/dbe56a33/David-McGoldrick"
2020,"Sheffield Utd","Premier League","Simon Moore","ENG","GK","29",1990,2,1,0,1,0,0,1,1,100,0,0,0,0,0,1,0,1,"https://fbref.com/en/players/e7434f04/Simon-Moore"
2020,"Sheffield Utd","Premier League","Ravel Morrison","JAM","MF","26",1993,0.1,0,0,0,0,0,0,0,NA,0,0,0,0,0,0,0,0,"https://fbref.com/en/players/bf59c794/Ravel-Morrison"
2020,"Sheffield Utd","Premier League","Lys Mousset","FRA","FW","23",1996,13.8,9,5,0,5,4,3,7,42.9,4,3,0,3,4,13,2,0,"https://fbref.com/en/players/d9cfca3d/Lys-Mousset"
2020,"Sheffield Utd","Premier League","Oliver Norwood","NIR","MF","28",1991,34.3,66,37,35,24,7,28,97,28.9,69,34,12,22,47,113,40,1,"https://fbref.com/en/players/43439614/Oliver-Norwood"
2020,"Sheffield Utd","Premier League","Jack O'Connell","ENG","DF","25",1994,32.4,23,14,15,6,2,10,20,50,10,38,17,21,42,65,154,1,"https://fbref.com/en/players/312626c1/Jack-OConnell"
2020,"Sheffield Utd","Premier League","Ben Osborn","ENG","MF,DF","24",1994,6.6,15,10,11,3,1,3,16,18.8,13,6,1,5,6,21,7,0,"https://fbref.com/en/players/79bc4c45/Ben-Osborn"
2020,"Sheffield Utd","Premier League","Callum Robinson","IRL","FW,MF","24",1995,7.5,6,3,2,2,2,2,7,28.6,5,3,0,3,7,13,3,0,"https://fbref.com/en/players/e75750a3/Callum-Robinson"
2020,"Sheffield Utd","Premier League","Jack Robinson","ENG","DF","25",1993,5.6,10,5,5,5,0,1,6,16.7,5,12,5,7,8,18,24,0,"https://fbref.com/en/players/7399c7a8/Jack-Robinson"
2020,"Sheffield Utd","Premier League","Jack Rodwell","ENG","MF","28",1991,0.2,0,0,0,0,0,0,0,NA,0,0,0,0,0,0,1,0,"https://fbref.com/en/players/a07579ee/Jack-Rodwell"
2020,"Sheffield Utd","Premier League","Billy Sharp","ENG","FW","33",1986,11.7,6,5,2,1,3,1,6,16.7,5,2,0,2,1,7,2,0,"https://fbref.com/en/players/e8c9f4e9/Billy-Sharp"
2020,"Sheffield Utd","Premier League","Enda Stevens","IRL","DF","29",1990,37.2,81,46,48,26,7,42,96,43.8,54,27,8,19,35,116,71,3,"https://fbref.com/en/players/17d4507a/Enda-Stevens"
2020,"Sheffield Utd","Premier League","Richairo Živković","NED","FW","22",1996,1.2,2,2,0,2,0,1,2,50,1,1,0,1,0,2,0,0,"https://fbref.com/en/players/d2d74d9c/Richairo-Zivkovic"
2020,"Southampton","Premier League","Che Adams","SCO","FW","23",1996,12.3,6,4,1,5,0,1,4,25,3,9,1,8,2,8,10,0,"https://fbref.com/en/players/f2bf1b0f/Che-Adams"
2020,"Southampton","Premier League","Stuart Armstrong","SCO","MF","27",1992,19.1,32,19,19,11,2,9,38,23.7,29,22,4,18,11,43,23,1,"https://fbref.com/en/players/97333cf5/Stuart-Armstrong"
2020,"Southampton","Premier League","Jan Bednarek","POL","DF","23",1996,34,65,38,41,18,6,31,61,50.8,30,44,23,21,77,142,198,4,"https://fbref.com/en/players/4115ce4e/Jan-Bednarek"
2020,"Southampton","Premier League","Ryan Bertrand","ENG","DF","29",1989,30.5,47,29,22,15,10,26,58,44.8,32,27,12,15,37,84,31,1,"https://fbref.com/en/players/01226327/Ryan-Bertrand"
2020,"Southampton","Premier League","Sofiane Boufal","MAR","MF,FW","25",1993,8.5,16,8,6,5,5,6,15,40,9,17,0,17,4,20,1,0,"https://fbref.com/en/players/b0c71810/Sofiane-Boufal"
2020,"Southampton","Premier League","Kevin Danso","AUT","DF","20",1998,3.1,6,4,3,3,0,4,7,57.1,3,7,3,4,2,8,7,0,"https://fbref.com/en/players/6e33125f/Kevin-Danso"
2020,"Southampton","Premier League","Moussa Djenepo","MLI","MF,DF","21",1998,10.3,27,21,13,9,5,11,21,52.4,10,15,1,14,9,36,9,0,"https://fbref.com/en/players/254147d4/Moussa-Djenepo"
2020,"Southampton","Premier League","Angus Gunn","ENG","GK","23",1996,10,1,1,1,0,0,1,3,33.3,2,0,0,0,0,1,1,0,"https://fbref.com/en/players/e082af5b/Angus-Gunn"
2020,"Southampton","Premier League","Pierre Højbjerg","DEN","MF","23",1995,30.6,80,49,34,38,8,39,91,42.9,52,44,5,39,46,126,54,2,"https://fbref.com/en/players/8b04d6c1/Pierre-Hojbjerg"
2020,"Southampton","Premier League","Danny Ings","ENG","FW","27",1992,31.2,42,25,16,16,10,13,67,19.4,54,62,4,58,9,51,30,1,"https://fbref.com/en/players/07802f7f/Danny-Ings"
2020,"Southampton","Premier League","Shane Long","IRL","FW","32",1987,15.5,19,10,5,8,6,7,19,36.8,12,12,0,12,4,23,16,0,"https://fbref.com/en/players/9f472354/Shane-Long"
2020,"Southampton","Premier League","Alex McCarthy","ENG","GK","29",1989,28,1,1,1,0,0,1,1,100,0,1,0,1,0,1,11,3,"https://fbref.com/en/players/36c2ca73/Alex-McCarthy"
2020,"Southampton","Premier League","Michael Obafemi","IRL","FW","19",2000,7.4,7,3,1,3,3,2,14,14.3,12,3,0,3,6,13,0,0,"https://fbref.com/en/players/caa1a7f0/Michael-Obafemi"
2020,"Southampton","Premier League","Nathan Redmond","ENG","MF,FW","25",1994,30.7,49,29,17,23,9,21,57,36.8,36,39,2,37,16,65,16,0,"https://fbref.com/en/players/ab651565/Nathan-Redmond"
2020,"Southampton","Premier League","Oriol Romeu","ESP","MF","27",1991,20.7,55,35,23,30,2,27,75,36,48,35,13,22,34,89,32,0,"https://fbref.com/en/players/4b511457/Oriol-Romeu"
2020,"Southampton","Premier League","William Smallbone","IRL","MF","19",2000,4.4,10,5,2,8,0,5,10,50,5,7,1,6,1,11,2,0,"https://fbref.com/en/players/5e105217/William-Smallbone"
2020,"Southampton","Premier League","Cédric Soares","POR","DF","27",1991,14.5,45,26,19,24,2,25,41,61,16,18,4,14,19,64,51,0,"https://fbref.com/en/players/839c14e1/Cedric-Soares"
2020,"Southampton","Premier League","Jack Stephens","ENG","DF","25",1994,27.2,44,27,30,13,1,24,46,52.2,22,38,22,16,31,75,120,2,"https://fbref.com/en/players/6adbc307/Jack-Stephens"
2020,"Southampton","Premier League","Nathan Tella","ENG","FW","20",1999,0,0,0,0,0,0,0,0,NA,0,0,0,0,0,0,0,0,"https://fbref.com/en/players/f1e94cd6/Nathan-Tella"
2020,"Southampton","Premier League","Yan Valery","TUN","DF","20",1999,8.7,20,7,9,7,4,11,19,57.9,8,9,1,8,13,33,32,2,"https://fbref.com/en/players/531a4aa8/Yan-Valery"
2020,"Southampton","Premier League","Jannik Vestergaard","DEN","DF","26",1992,16.6,19,12,14,5,0,11,28,39.3,17,15,9,6,26,45,99,2,"https://fbref.com/en/players/1900032e/Jannik-Vestergaard"
2020,"Southampton","Premier League","Jake Vokins","ENG","DF","19",2000,1,2,2,0,0,2,1,1,100,0,0,0,0,0,2,1,0,"https://fbref.com/en/players/d484c261/Jake-Vokins"
2020,"Southampton","Premier League","Kyle Walker-Peters","ENG","DF","22",1997,7.8,13,8,5,6,2,6,16,37.5,10,10,3,7,14,27,21,1,"https://fbref.com/en/players/984a5a64/Kyle-Walker-Peters"
2020,"Southampton","Premier League","James Ward-Prowse","ENG","MF,DF","24",1994,38,92,48,39,39,14,39,94,41.5,55,48,14,34,60,152,75,1,"https://fbref.com/en/players/3515d404/James-Ward-Prowse"
2020,"Southampton","Premier League","Maya Yoshida","JPN","DF","30",1988,6.2,8,5,4,1,3,3,7,42.9,4,6,2,4,4,12,27,1,"https://fbref.com/en/players/caffaf5a/Maya-Yoshida"
2020,"Strasbourg","Ligue 1","Ludovic Ajorque","FRA","FW","25",1994,22.9,15,10,2,10,3,2,13,15.4,11,11,0,11,2,17,20,0,"https://fbref.com/en/players/462475ed/Ludovic-Ajorque"
2020,"Strasbourg","Ligue 1","Jean-Ricner Bellegarde","FRA","MF","21",1998,16.6,40,27,18,19,3,13,21,61.9,8,16,3,13,22,62,6,0,"https://fbref.com/en/players/10f0fdd3/Jean-Ricner-Bellegarde"
2020,"Strasbourg","Ligue 1","Anthony Caci","FRA","DF","22",1997,7.7,29,17,19,9,1,8,17,47.1,9,15,5,10,19,48,15,1,"https://fbref.com/en/players/0118c54c/Anthony-Caci"
2020,"Strasbourg","Ligue 1","Lionel Carole","FRA","DF","28",1991,14.1,23,8,15,6,2,13,17,76.5,4,2,1,1,19,42,22,0,"https://fbref.com/en/players/5b5724d2/Lionel-Carole"
2020,"Strasbourg","Ligue 1","Benjamin Corgnet","FRA","MF,FW","32",1987,2.9,1,1,1,0,0,1,3,33.3,2,2,0,2,2,3,3,0,"https://fbref.com/en/players/cfd8dde3/Benjamin-Corgnet"
2020,"Strasbourg","Ligue 1","Nuno da Costa","CPV","FW","28",1991,5.9,15,10,3,8,4,4,10,40,6,7,0,7,4,19,3,0,"https://fbref.com/en/players/909222de/Nuno-da-Costa"
2020,"Strasbourg","Ligue 1","Alexander Djiku","GHA","DF,MF","24",1994,22.9,46,32,27,19,0,21,29,72.4,8,14,8,6,55,101,82,4,"https://fbref.com/en/players/43e7a164/Alexander-Djiku"
2020,"Strasbourg","Ligue 1","Youssouf Fofana","FRA","MF","20",1999,11.2,25,17,10,12,3,13,30,43.3,17,11,0,11,14,39,7,0,"https://fbref.com/en/players/822d51d7/Youssouf-Fofana"
2020,"Strasbourg","Ligue 1","Jérémy Grimm","FRA","MF","32",1987,0,0,0,0,0,0,0,0,NA,0,0,0,0,0,0,0,0,"https://fbref.com/en/players/53283127/Jeremy-Grimm"
2020,"Strasbourg","Ligue 1","Lamine Koné","CIV","DF","30",1989,16.4,31,21,20,10,1,12,17,70.6,5,8,5,3,25,56,47,1,"https://fbref.com/en/players/a46472d0/Lamine-Kone"
2020,"Strasbourg","Ligue 1","Kenny Lala","FRA","DF,MF","27",1991,22.7,29,16,17,11,1,11,27,40.7,16,14,5,9,20,49,40,1,"https://fbref.com/en/players/770d7eb8/Kenny-Lala"
2020,"Strasbourg","Ligue 1","Adrien Lebeau","FRA","MF,FW","20",1999,0.1,1,1,1,0,0,0,1,0,1,1,0,1,0,1,0,0,"https://fbref.com/en/players/ca122e29/Adrien-Lebeau"
2020,"Strasbourg","Ligue 1","Dimitri Liénard","FRA","MF","31",1988,16.5,37,24,10,22,5,18,39,46.2,21,18,4,14,17,54,25,0,"https://fbref.com/en/players/f7691f63/Dimitri-Lienard"
2020,"Strasbourg","Ligue 1","Abdul Majeed Waris","GHA","FW","27",1991,4.1,6,4,4,2,0,3,8,37.5,5,2,0,2,4,10,0,0,"https://fbref.com/en/players/46907171/Abdul-Majeed-Waris"
2020,"Strasbourg","Ligue 1","Jonas Martin","FRA","MF","29",1990,2.7,5,3,4,0,1,1,3,33.3,2,3,0,3,1,6,3,0,"https://fbref.com/en/players/468fdbad/Jonas-Martin"
2020,"Strasbourg","Ligue 1","Stefan Mitrović","SRB","DF","29",1990,22.8,15,9,10,5,0,6,14,42.9,8,14,9,5,23,38,90,3,"https://fbref.com/en/players/e6777e6b/Stefan-Mitrovic"
2020,"Strasbourg","Ligue 1","Lebo Mothiba","RSA","FW","23",1996,11.6,4,3,1,1,2,1,6,16.7,5,5,0,5,3,7,1,0,"https://fbref.com/en/players/3eaf8817/Lebo-Mothiba"
2020,"Strasbourg","Ligue 1","Abdallah N'dour","SEN","DF","25",1993,4.1,5,4,2,3,0,5,10,50,5,4,1,3,4,9,5,1,"https://fbref.com/en/players/4749367a/Abdallah-Ndour"
2020,"Strasbourg","Ligue 1","Sanjin Prcić","BIH","MF,FW","25",1993,0.9,1,0,0,0,1,1,2,50,1,1,1,0,1,2,0,0,"https://fbref.com/en/players/51c30111/Sanjin-Prcic"
2020,"Strasbourg","Ligue 1","Matz Sels","BEL","GK","27",1992,27,0,0,0,0,0,0,1,0,1,0,0,0,1,1,6,0,"https://fbref.com/en/players/834b5c4c/Matz-Sels"
2020,"Strasbourg","Ligue 1","Mohamed Simakan","FRA","DF","19",2000,16.7,54,32,35,16,3,22,34,64.7,12,14,3,11,31,85,25,0,"https://fbref.com/en/players/fcb27134/Mohamed-Simakan"
2020,"Strasbourg","Ligue 1","Ibrahima Sissoko","FRA","MF","21",1997,17.8,46,27,21,21,4,16,48,33.3,32,14,5,9,20,66,25,0,"https://fbref.com/en/players/0f8418aa/Ibrahima-Sissoko"
2020,"Strasbourg","Ligue 1","Adrien Thomasson","FRA","MF,FW","25",1993,23,36,21,11,16,9,15,47,31.9,32,21,1,20,9,45,9,0,"https://fbref.com/en/players/c76b7567/Adrien-Thomasson"
2020,"Strasbourg","Ligue 1","Mootaz Zemzemi","TUN","MF","19",1999,0.3,0,0,0,0,0,0,0,NA,0,0,0,0,1,1,0,0,"https://fbref.com/en/players/242b350c/Mootaz-Zemzemi"
2020,"Strasbourg","Ligue 1","Kévin Zohi","MLI","FW,MF","22",1996,5.9,8,6,3,3,2,3,6,50,3,1,0,1,4,12,2,0,"https://fbref.com/en/players/775185ae/Kevin-Zohi"
2020,"Torino","Serie A","Ola Aina","NGA","DF","22",1996,23.1,45,24,23,18,4,17,37,45.9,20,24,6,18,41,86,61,0,"https://fbref.com/en/players/246d153b/Ola-Aina"
2020,"Torino","Serie A","Cristian Ansaldi","ARG","DF,MF","32",1986,19.6,37,25,24,7,6,19,34,55.9,15,23,3,20,14,51,20,4,"https://fbref.com/en/players/bbafc0c4/Cristian-Ansaldi"
2020,"Torino","Serie A","Daniele Baselli","ITA","MF","27",1992,14.2,43,23,17,19,7,13,40,32.5,27,20,4,16,25,68,25,0,"https://fbref.com/en/players/ea06dd97/Daniele-Baselli"
2020,"Torino","Serie A","Andrea Belotti","ITA","FW","25",1993,33.4,29,16,7,17,5,5,31,16.1,26,23,5,18,5,34,20,1,"https://fbref.com/en/players/d705ba44/Andrea-Belotti"
2020,"Torino","Serie A","Álex Berenguer","ESP","MF,DF","24",1995,20.3,20,6,6,13,1,8,33,24.2,25,17,1,16,18,38,17,0,"https://fbref.com/en/players/dc1c2fce/Alex-Berenguer"
2020,"Torino","Serie A","Kevin Bonifazi","ITA","DF","23",1996,2.7,9,8,6,3,0,5,6,83.3,1,3,2,1,5,14,10,0,"https://fbref.com/en/players/fb77bfef/Kevin-Bonifazi"
2020,"Torino","Serie A","Gleison Bremer","BRA","DF","22",1997,25.2,63,36,37,20,6,20,34,58.8,14,48,22,26,74,137,118,1,"https://fbref.com/en/players/5fd5ed86/Gleison-Bremer"
2020,"Torino","Serie A","Christian Celesia","ITA","DF","17",2002,0,0,0,0,0,0,0,0,NA,0,0,0,0,0,0,0,0,"https://fbref.com/en/players/d2fd20d6/Christian-Celesia"
2020,"Torino","Serie A","Lorenzo De Silvestri","ITA","DF","31",1988,24.9,15,8,4,7,4,11,27,40.7,16,20,7,13,19,34,72,0,"https://fbref.com/en/players/e74f0e59/Lorenzo-De-Silvestri"
2020,"Torino","Serie A","Koffi Djidji","CIV","DF","26",1992,9.5,27,12,19,8,0,8,18,44.4,10,28,23,5,15,42,53,1,"https://fbref.com/en/players/933d3b51/Koffi-Djidji"
2020,"Torino","Serie A","Simone Edera","ITA","MF,FW","22",1997,4.4,13,5,3,7,3,2,12,16.7,10,1,0,1,1,14,3,0,"https://fbref.com/en/players/8697c095/Simone-Edera"
2020,"Torino","Serie A","Iago Falque","ESP","FW,MF","29",1990,1.1,0,0,0,0,0,0,1,0,1,1,0,1,0,0,0,0,"https://fbref.com/en/players/440c84ed/Iago-Falque"
2020,"Torino","Serie A","Armando Izzo","ITA","DF","27",1992,29.8,42,24,24,14,4,17,35,48.6,18,44,29,15,71,113,121,1,"https://fbref.com/en/players/89976232/Armando-Izzo"
2020,"Torino","Serie A","Diego Laxalt","URU","DF,MF","26",1993,6.6,19,10,10,6,3,6,20,30,14,12,4,8,6,25,20,0,"https://fbref.com/en/players/f26e3c59/Diego-Laxalt"
2020,"Torino","Serie A","Saša Lukić","SRB","MF","22",1996,20.7,29,17,8,19,2,10,35,28.6,25,21,7,14,29,58,15,0,"https://fbref.com/en/players/c6e8cf1f/Sasa-Lukic"
2020,"Torino","Serie A","Lyanco","BRA","DF","22",1997,13.1,23,13,9,12,2,7,13,53.8,6,29,19,10,23,46,54,2,"https://fbref.com/en/players/b5bf1770/Lyanco"
2020,"Torino","Serie A","Soualiho Meïté","FRA","MF","25",1994,24.5,32,18,14,13,5,12,35,34.3,23,31,6,25,24,56,36,0,"https://fbref.com/en/players/5cec2c74/Soualiho-Meite"
2020,"Torino","Serie A","Vincenzo Millico","ITA","MF,FW","18",2000,2.4,1,0,1,0,0,1,3,33.3,2,2,0,2,0,1,1,0,"https://fbref.com/en/players/6817095b/Vincenzo-Millico"
2020,"Torino","Serie A","Michel Ndary Adopo","FRA","DF,MF","19",2000,0,0,0,0,0,0,0,0,NA,0,1,1,0,0,0,0,0,"https://fbref.com/en/players/599d91d0/Michel-Ndary-Adopo"
2020,"Torino","Serie A","Nicolas Nkoulou","CMR","DF","29",1990,29.9,34,24,21,11,2,16,22,72.7,6,40,18,22,70,104,138,2,"https://fbref.com/en/players/93cf32a8/Nicolas-Nkoulou"
2020,"Torino","Serie A","Tomás Rincón","VEN","MF","31",1988,30,56,25,23,25,8,23,65,35.4,42,20,3,17,36,92,62,0,"https://fbref.com/en/players/f1cfc209/Tomas-Rincon"
2020,"Torino","Serie A","Antonio Rosati","ITA","GK","36",1983,1,0,0,0,0,0,0,0,NA,0,0,0,0,0,0,0,1,"https://fbref.com/en/players/28a15394/Antonio-Rosati"
2020,"Torino","Serie A","Wilfried Singo","CIV","DF","18",2000,1.5,1,0,0,1,0,0,0,NA,0,0,0,0,1,2,2,0,"https://fbref.com/en/players/8b609c34/Wilfried-Singo"
2020,"Torino","Serie A","Salvatore Sirigu","ITA","GK","32",1987,36,0,0,0,0,0,0,0,NA,0,0,0,0,2,2,12,0,"https://fbref.com/en/players/10dc46f0/Salvatore-Sirigu"
2020,"Torino","Serie A","Samir Ujkani","KVX","GK","31",1988,1,0,0,0,0,0,0,0,NA,0,0,0,0,0,0,1,0,"https://fbref.com/en/players/96640846/Samir-Ujkani"
2020,"Torino","Serie A","Simone Verdi","ITA","MF,FW","27",1992,23,19,10,4,12,3,9,38,23.7,29,14,0,14,7,26,1,0,"https://fbref.com/en/players/0375723e/Simone-Verdi"
2020,"Torino","Serie A","Simone Zaza","ITA","FW","28",1991,18.2,15,10,6,4,5,3,10,30,7,11,0,11,9,24,13,1,"https://fbref.com/en/players/9592289a/Simone-Zaza"
2020,"Tottenham","Premier League","Toby Alderweireld","BEL","DF","30",1989,32.9,40,29,24,13,3,11,24,45.8,13,48,32,16,31,71,172,2,"https://fbref.com/en/players/f7d50789/Toby-Alderweireld"
2020,"Tottenham","Premier League","Dele Alli","ENG","MF,FW","23",1996,20.5,34,16,11,20,3,13,37,35.1,24,35,3,32,17,51,17,2,"https://fbref.com/en/players/cea4ee8f/Dele-Alli"
2020,"Tottenham","Premier League","Serge Aurier","CIV","DF","26",1992,30,93,69,58,27,8,39,69,56.5,30,38,6,32,47,140,98,2,"https://fbref.com/en/players/5c2b4f07/Serge-Aurier"
2020,"Tottenham","Premier League","Steven Bergwijn","NED","FW,MF","21",1997,7.8,10,6,3,6,1,4,12,33.3,8,12,0,12,1,11,5,0,"https://fbref.com/en/players/a29b1131/Steven-Bergwijn"
2020,"Tottenham","Premier League","Ben Davies","WAL","DF","26",1993,15.9,28,15,13,11,4,7,21,33.3,14,28,12,16,22,50,47,0,"https://fbref.com/en/players/44781702/Ben-Davies"
2020,"Tottenham","Premier League","Eric Dier","ENG","DF,MF","25",1994,14.9,21,12,10,10,1,10,20,50,10,14,9,5,21,42,65,0,"https://fbref.com/en/players/ac861941/Eric-Dier"
2020,"Tottenham","Premier League","Christian Eriksen","DEN","MF,FW","27",1992,12.2,19,9,10,8,1,7,24,29.2,17,10,1,9,12,31,16,0,"https://fbref.com/en/players/980522ec/Christian-Eriksen"
2020,"Tottenham","Premier League","Gedson Fernandes","POR","MF,DF","20",1999,0.8,2,0,2,0,0,0,2,0,2,2,0,2,1,3,0,0,"https://fbref.com/en/players/e2dde94c/Gedson-Fernandes"
2020,"Tottenham","Premier League","Juan Foyth","ARG","DF","21",1998,0.8,7,3,5,2,0,3,4,75,1,1,0,1,1,8,3,1,"https://fbref.com/en/players/6c7762c3/Juan-Foyth"
2020,"Tottenham","Premier League","Paulo Gazzaniga","ARG","GK","27",1992,17.9,0,0,0,0,0,0,0,NA,0,0,0,0,1,1,4,1,"https://fbref.com/en/players/63d17038/Paulo-Gazzaniga"
2020,"Tottenham","Premier League","Son Heung-min","KOR","FW","27",1992,27.5,23,15,10,11,2,9,57,15.8,48,23,0,23,19,42,18,1,"https://fbref.com/en/players/92e7e919/Son-Heung-min"
2020,"Tottenham","Premier League","Harry Kane","ENG","FW","26",1993,28.7,18,12,3,12,3,4,17,23.5,13,17,7,10,6,24,30,0,"https://fbref.com/en/players/21a66f6a/Harry-Kane"
2020,"Tottenham","Premier League","Érik Lamela","ARG","MF,FW","27",1992,13.5,24,20,9,13,2,2,21,9.5,19,12,3,9,8,32,10,0,"https://fbref.com/en/players/abe66106/Erik-Lamela"
2020,"Tottenham","Premier League","Hugo Lloris","FRA","GK","32",1986,20.1,0,0,0,0,0,0,0,NA,0,0,0,0,1,1,3,2,"https://fbref.com/en/players/8f62b6ee/Hugo-Lloris"
2020,"Tottenham","Premier League","Giovani Lo Celso","ARG","MF,FW","23",1996,16.6,51,29,12,33,6,12,59,20.3,47,20,4,16,9,60,19,0,"https://fbref.com/en/players/d7553721/Giovani-Lo-Celso"
2020,"Tottenham","Premier League","Lucas Moura","BRA","FW,MF","26",1992,24.9,57,33,25,22,10,16,58,27.6,42,29,2,27,15,72,27,0,"https://fbref.com/en/players/2b622f01/Lucas-Moura"
2020,"Tottenham","Premier League","Georges-Kévin N'Koudou","CMR","FW","24",1995,0,0,0,0,0,0,0,1,0,1,0,0,0,0,0,0,0,"https://fbref.com/en/players/76c131da/Georges-Kevin-NKoudou"
2020,"Tottenham","Premier League","Tanguy Ndombele","FRA","MF","22",1996,11.2,24,16,10,13,1,9,22,40.9,13,20,3,17,14,38,7,0,"https://fbref.com/en/players/5cdddffa/Tanguy-Ndombele"
2020,"Tottenham","Premier League","Troy Parrott","IRL","FW","17",2002,0.1,0,0,0,0,0,0,0,NA,0,0,0,0,0,0,0,0,"https://fbref.com/en/players/4357f557/Troy-Parrott"
2020,"Tottenham","Premier League","Danny Rose","ENG","DF","29",1990,9.9,18,11,6,10,2,9,20,45,11,14,6,8,8,26,34,2,"https://fbref.com/en/players/89d10e53/Danny-Rose"
2020,"Tottenham","Premier League","Davinson Sánchez","COL","DF","23",1996,27,44,27,32,12,0,22,44,50,22,40,28,12,34,78,128,5,"https://fbref.com/en/players/da7b447d/Davinson-Sanchez"
2020,"Tottenham","Premier League","Ryan Sessegnon","ENG","DF,FW","19",2000,3.8,6,4,2,4,0,3,6,50,3,0,0,0,3,9,12,0,"https://fbref.com/en/players/6aa3e78b/Ryan-Sessegnon"
2020,"Tottenham","Premier League","Moussa Sissoko","FRA","MF","29",1989,27.2,39,25,25,12,2,20,48,41.7,28,19,4,15,27,66,43,2,"https://fbref.com/en/players/2acd49b9/Moussa-Sissoko"
2020,"Tottenham","Premier League","Oliver Skipp","ENG","MF","18",2000,0.9,2,2,0,2,0,1,4,25,3,3,2,1,0,2,0,0,"https://fbref.com/en/players/6250083a/Oliver-Skipp"
2020,"Tottenham","Premier League","Japhet Tanganga","ENG","DF","20",1999,5.8,17,9,10,6,1,10,17,58.8,7,7,6,1,11,28,31,2,"https://fbref.com/en/players/e9971f2d/Japhet-Tanganga"
2020,"Tottenham","Premier League","Jan Vertonghen","BEL","DF","32",1987,18.3,40,24,25,14,1,20,31,64.5,11,18,10,8,33,73,68,0,"https://fbref.com/en/players/ba23a904/Jan-Vertonghen"
2020,"Tottenham","Premier League","Kyle Walker-Peters","ENG","DF","22",1997,2.7,8,5,8,0,0,5,9,55.6,4,4,2,2,3,11,5,1,"https://fbref.com/en/players/984a5a64/Kyle-Walker-Peters"
2020,"Tottenham","Premier League","Victor Wanyama","KEN","MF","28",1991,0.3,0,0,0,0,0,0,0,NA,0,0,0,0,0,0,0,0,"https://fbref.com/en/players/e0900238/Victor-Wanyama"
2020,"Tottenham","Premier League","Harry Winks","ENG","MF","23",1996,24.7,40,24,18,20,2,17,54,31.5,37,27,8,19,36,76,32,1,"https://fbref.com/en/players/2f7acede/Harry-Winks"
2020,"Toulouse","Ligue 1","Amine Adli","FRA","MF,FW","19",2000,0.5,0,0,0,0,0,0,1,0,1,0,0,0,1,1,0,0,"https://fbref.com/en/players/dcfb17f4/Amine-Adli"
2020,"Toulouse","Ligue 1","Kelvin Amian","FRA","DF","21",1998,18.1,27,21,21,5,1,14,25,56,11,14,7,7,18,45,56,0,"https://fbref.com/en/players/bcc81786/Kelvin-Amian"
2020,"Toulouse","Ligue 1","Janis Antiste","FRA","MF","16",2002,0.1,0,0,0,0,0,0,0,NA,0,0,0,0,0,0,0,0,"https://fbref.com/en/players/38d9ce53/Janis-Antiste"
2020,"Toulouse","Ligue 1","Quentin Boisgard","FRA","MF,FW","22",1997,12.7,31,19,10,14,7,14,35,40,21,11,0,11,12,43,4,1,"https://fbref.com/en/players/f6496133/Quentin-Boisgard"
2020,"Toulouse","Ligue 1","Bafodé Diakité","FRA","DF","18",2001,15.2,23,19,15,8,0,7,13,53.8,6,18,9,9,20,43,75,0,"https://fbref.com/en/players/1bfb6fef/Bafode-Diakite"
2020,"Toulouse","Ligue 1","Moussa Diarra","MLI","DF","18",2000,1,3,3,2,1,0,1,1,100,0,0,0,0,3,6,2,0,"https://fbref.com/en/players/698f11e3/Moussa-Diarra"
2020,"Toulouse","Ligue 1","Mathieu Dossevi","TOG","MF,FW","31",1988,19.5,32,20,7,17,8,15,30,50,15,17,0,17,14,46,7,0,"https://fbref.com/en/players/6421dd73/Mathieu-Dossevi"
2020,"Toulouse","Ligue 1","Ruben Gabrielsen","NOR","DF","27",1992,7.3,3,2,3,0,0,2,4,50,2,5,3,2,8,11,41,0,"https://fbref.com/en/players/9e64fc85/Ruben-Gabrielsen"
2020,"Toulouse","Ligue 1","Mauro Goicoechea","URU","GK","31",1988,2,0,0,0,0,0,0,0,NA,0,0,0,0,0,0,1,2,"https://fbref.com/en/players/132bb875/Mauro-Goicoechea"
2020,"Toulouse","Ligue 1","Mathieu Goncalves","FRA","DF","18",2001,3.5,5,3,5,0,0,2,8,25,6,4,3,1,4,9,10,0,"https://fbref.com/en/players/d26cd32d/Mathieu-Goncalves"
2020,"Toulouse","Ligue 1","Max Gradel","CIV","MF,FW","31",1987,18.2,36,20,17,14,5,12,47,25.5,35,11,1,10,11,47,23,0,"https://fbref.com/en/players/c5a500ca/Max-Gradel"
2020,"Toulouse","Ligue 1","Nicolas Isimat-Mirin","FRA","DF","27",1991,14,14,8,8,6,0,5,11,45.5,6,18,12,6,22,36,71,0,"https://fbref.com/en/players/14e8e9d7/Nicolas-Isimat-Mirin"
2020,"Toulouse","Ligue 1","Corentin Jean","FRA","DF","24",1995,0.1,0,0,0,0,0,0,0,NA,0,0,0,0,0,0,1,0,"https://fbref.com/en/players/7d9b37bf/Corentin-Jean"
2020,"Toulouse","Ligue 1","Lovre Kalinić","CRO","GK","29",1990,3.4,0,0,0,0,0,0,1,0,1,0,0,0,0,0,0,0,"https://fbref.com/en/players/3a74f92b/Lovre-Kalinic"
2020,"Toulouse","Ligue 1","Kouadio Koné","FRA","MF","18",2001,9.7,35,20,17,14,4,13,30,43.3,17,15,1,14,19,54,10,1,"https://fbref.com/en/players/86574238/Kouadio-Kone"
2020,"Toulouse","Ligue 1","Efthimis Koulouris","GRE","FW","23",1996,17.1,13,8,5,5,3,3,13,23.1,10,8,4,4,3,16,16,0,"https://fbref.com/en/players/21f8d950/Efthimis-Koulouris"
2020,"Toulouse","Ligue 1","Aaron Leya Iseka","BEL","FW","21",1997,8.6,2,0,0,2,0,0,3,0,3,5,0,5,1,3,7,0,"https://fbref.com/en/players/29ef0f49/Aaron-Leya-Iseka"
2020,"Toulouse","Ligue 1","Jean-Victor Makengo","FRA","MF","21",1998,11,14,11,3,10,1,4,13,30.8,9,7,1,6,3,17,5,1,"https://fbref.com/en/players/22bfb57e/Jean-Victor-Makengo"
2020,"Toulouse","Ligue 1","Steven Moreira","FRA","DF","24",1994,15.4,37,25,21,15,1,19,31,61.3,12,16,3,13,16,53,29,0,"https://fbref.com/en/players/f10983ae/Steven-Moreira"
2020,"Toulouse","Ligue 1","Nathan N'Goumou","FRA","FW","19",2000,0.1,0,0,0,0,0,0,0,NA,0,0,0,0,0,0,1,0,"https://fbref.com/en/players/e110ea4b/Nathan-NGoumou"
2020,"Toulouse","Ligue 1","Baptiste Reynet","FRA","GK","28",1990,22.6,1,1,1,0,0,1,3,33.3,2,0,0,0,0,1,12,0,"https://fbref.com/en/players/bcf1b2e9/Baptiste-Reynet"
2020,"Toulouse","Ligue 1","Agustín Rogel","URU","DF","21",1997,9.5,15,8,12,3,0,7,13,53.8,6,13,10,3,11,26,35,2,"https://fbref.com/en/players/ea42c03f/Agustin-Rogel"
2020,"Toulouse","Ligue 1","Wesley Saïd","FRA","MF,FW","24",1995,12.9,20,9,8,10,2,2,13,15.4,11,6,0,6,9,29,8,0,"https://fbref.com/en/players/90fcf472/Wesley-Said"
2020,"Toulouse","Ligue 1","Ibrahim Sangaré","CIV","MF","21",1997,24.2,84,54,37,42,5,33,74,44.6,41,28,10,18,39,123,49,4,"https://fbref.com/en/players/bced0375/Ibrahim-Sangare"
2020,"Toulouse","Ligue 1","Yaya Sanogo","FRA","FW","26",1993,10.1,6,3,2,3,1,1,2,50,1,4,1,3,7,13,14,0,"https://fbref.com/en/players/11ced928/Yaya-Sanogo"
2020,"Toulouse","Ligue 1","Gen Shoji","JPN","DF","26",1992,0.5,2,2,2,0,0,1,1,100,0,0,0,0,0,2,2,0,"https://fbref.com/en/players/8b28686a/Gen-Shoji"
2020,"Toulouse","Ligue 1","Kalidou Sidibé","FRA","MF","20",1999,1,3,3,0,3,0,2,5,40,3,0,0,0,1,4,0,0,"https://fbref.com/en/players/ea540835/Kalidou-Sidibe"
2020,"Toulouse","Ligue 1","Issiaga Sylla","GUI","DF","25",1994,28,73,49,44,21,8,40,69,58,29,31,7,24,67,140,90,2,"https://fbref.com/en/players/b99bec05/Issiaga-Sylla"
2020,"Toulouse","Ligue 1","Adil Taoui","FRA","MF","17",2001,0.3,2,2,0,2,0,0,2,0,2,0,0,0,2,4,0,0,"https://fbref.com/en/players/53e585f2/Adil-Taoui"
2020,"Toulouse","Ligue 1","William Vainqueur","FRA","MF","30",1988,19.1,68,36,30,32,6,22,60,36.7,38,21,5,16,29,97,23,0,"https://fbref.com/en/players/92cd4bef/William-Vainqueur"
2020,"Udinese","Serie A","Marco Ballarini","ITA","MF","18",2001,0,0,0,0,0,0,0,0,NA,0,0,0,0,0,0,0,0,"https://fbref.com/en/players/8cb494c9/Marco-Ballarini"
2020,"Udinese","Serie A","Antonín Barák","CZE","MF,FW","24",1994,2.2,5,4,3,0,2,1,5,20,4,6,1,5,0,5,4,0,"https://fbref.com/en/players/01efac19/Antonin-Barak"
2020,"Udinese","Serie A","Rodrigo Becão","BRA","DF","23",1996,24.6,56,25,34,19,3,26,46,56.5,20,40,20,20,45,101,77,0,"https://fbref.com/en/players/19e4eab9/Rodrigo-Becao"
2020,"Udinese","Serie A","Sebastien De Maio","FRA","DF","32",1987,16.7,18,11,11,7,0,7,11,63.6,4,28,20,8,32,50,86,2,"https://fbref.com/en/players/952a03fe/Sebastien-De-Maio"
2020,"Udinese","Serie A","Rodrigo De Paul","ARG","MF","25",1994,31.4,61,31,31,26,4,27,65,41.5,38,38,3,35,29,90,8,1,"https://fbref.com/en/players/162efffd/Rodrigo-De-Paul"
2020,"Udinese","Serie A","Seko Fofana","CIV","MF","24",1995,25,17,12,8,8,1,9,35,25.7,26,20,1,19,17,34,19,0,"https://fbref.com/en/players/5313ed43/Seko-Fofana"
2020,"Udinese","Serie A","Mato Jajalo","BIH","MF","31",1988,18.3,44,19,19,22,3,14,38,36.8,24,20,7,13,19,63,19,2,"https://fbref.com/en/players/8c65eb5f/Mato-Jajalo"
2020,"Udinese","Serie A","Kevin Lasagna","ITA","FW","26",1992,28.5,27,14,7,13,7,6,31,19.4,25,23,1,22,10,37,18,1,"https://fbref.com/en/players/09538fdb/Kevin-Lasagna"
2020,"Udinese","Serie A","Rolando Mandragora","ITA","MF","22",1997,22.8,47,24,15,25,7,15,55,27.3,40,30,5,25,26,73,25,0,"https://fbref.com/en/players/c7259b83/Rolando-Mandragora"
2020,"Udinese","Serie A","Juan Musso","ARG","GK","25",1994,38,0,0,0,0,0,0,1,0,1,0,0,0,1,1,18,2,"https://fbref.com/en/players/a111cf41/Juan-Musso"
2020,"Udinese","Serie A","Ilija Nestorovski","MKD","FW","29",1990,13.9,10,7,5,5,0,6,21,28.6,15,13,2,11,4,14,12,0,"https://fbref.com/en/players/b1236c63/Ilija-Nestorovski"
2020,"Udinese","Serie A","Bram Nuytinck","NED","DF","29",1990,24.7,46,32,30,13,3,17,27,63,10,50,32,18,27,73,96,1,"https://fbref.com/en/players/e33f36d5/Bram-Nuytinck"
2020,"Udinese","Serie A","Stefano Okaka","ITA","FW","29",1989,26.8,19,11,6,8,5,7,27,25.9,20,23,2,21,8,27,28,0,"https://fbref.com/en/players/601ef102/Stefano-Okaka"
2020,"Udinese","Serie A","Nicholas Opoku","GHA","DF","21",1997,5.3,13,8,8,3,2,6,11,54.5,5,6,4,2,4,17,19,0,"https://fbref.com/en/players/b871bf55/Nicholas-Opoku"
2020,"Udinese","Serie A","Martin Palumbo","NOR","MF","17",2002,0,0,0,0,0,0,0,0,NA,0,0,0,0,0,0,0,0,"https://fbref.com/en/players/f8d41a8c/Martin-Palumbo"
2020,"Udinese","Serie A","Giuseppe Pezzella","ITA","DF","21",1997,0.9,0,0,0,0,0,0,0,NA,0,0,0,0,1,1,4,0,"https://fbref.com/en/players/149c5f5d/Giuseppe-Pezzella"
2020,"Udinese","Serie A","Ignacio Pussetto","ARG","FW,MF","23",1995,3.8,8,4,4,3,1,1,4,25,3,3,0,3,4,12,7,0,"https://fbref.com/en/players/62437b4f/Ignacio-Pussetto"
2020,"Udinese","Serie A","Samir Santos","BRA","DF","24",1994,17.2,35,27,24,8,3,12,23,52.2,11,16,6,10,33,68,64,1,"https://fbref.com/en/players/92b4758e/Samir-Santos"
2020,"Udinese","Serie A","Ken Sema","SWE","DF,MF","25",1993,27.3,59,41,43,15,1,36,68,52.9,32,26,6,20,17,76,41,1,"https://fbref.com/en/players/1770bd68/Ken-Sema"
2020,"Udinese","Serie A","Jens Stryger Larsen","DEN","DF","28",1991,31,27,19,15,9,3,17,30,56.7,13,20,5,15,20,47,52,0,"https://fbref.com/en/players/f91e81c9/Jens-Stryger-Larsen"
2020,"Udinese","Serie A","Łukasz Teodorczyk","POL","FW","28",1991,2.5,7,5,1,5,1,3,7,42.9,4,2,0,2,0,7,1,0,"https://fbref.com/en/players/7e81a17d/Lukasz-Teodorczyk"
2020,"Udinese","Serie A","Hidde ter Avest","NED","DF","22",1997,7.6,18,9,13,3,2,14,17,82.4,3,6,1,5,9,27,27,0,"https://fbref.com/en/players/18f9dbd0/Hidde-ter-Avest"
2020,"Udinese","Serie A","William Troost-Ekong","NGA","DF","25",1993,28.6,37,19,25,12,0,10,18,55.6,8,41,29,12,31,68,135,2,"https://fbref.com/en/players/7ed4921e/William-Troost-Ekong"
2020,"Udinese","Serie A","Walace","BRA","MF","24",1995,12.7,28,9,19,6,3,13,42,31,29,14,6,8,33,61,19,0,"https://fbref.com/en/players/26db8853/Walace"
2020,"Udinese","Serie A","Marvin Zeegelaar","NED","DF","28",1990,6.6,15,9,8,4,3,6,11,54.5,5,9,2,7,5,20,10,0,"https://fbref.com/en/players/8abd0c03/Marvin-Zeegelaar"
2020,"Union Berlin","Bundesliga","Suleiman Abdullahi","NGA","FW,MF","22",1996,1.7,0,0,0,0,0,0,3,0,3,2,1,1,1,1,1,0,"https://fbref.com/en/players/abf0cad0/Suleiman-Abdullahi"
2020,"Union Berlin","Bundesliga","Sebastian Andersson","SWE","FW","28",1991,29.8,20,10,0,12,8,4,19,21.1,15,19,3,16,5,25,36,0,"https://fbref.com/en/players/b4cf5806/Sebastian-Andersson"
2020,"Union Berlin","Bundesliga","Robert Andrich","GER","MF","24",1994,28.6,52,27,28,18,6,19,60,31.7,41,27,7,20,47,99,36,0,"https://fbref.com/en/players/e0b113a7/Robert-Andrich"
2020,"Union Berlin","Bundesliga","Sheraldo Becker","SUR","MF,FW","24",1995,6,2,1,2,0,0,1,3,33.3,2,1,0,1,0,2,1,0,"https://fbref.com/en/players/8eb55dbb/Sheraldo-Becker"
2020,"Union Berlin","Bundesliga","Marius Bülter","GER","MF,FW","26",1993,25.8,38,22,19,13,6,17,54,31.5,37,37,3,34,11,49,20,1,"https://fbref.com/en/players/ab5b7dc1/Marius-Bulter"
2020,"Union Berlin","Bundesliga","Marvin Friedrich","GER","DF","23",1995,31,45,31,30,14,1,12,37,32.4,25,46,24,22,42,87,110,0,"https://fbref.com/en/players/b77f44a4/Marvin-Friedrich"
2020,"Union Berlin","Bundesliga","Christian Gentner","GER","MF","33",1985,27.1,53,28,16,32,5,22,73,30.1,51,46,8,38,54,107,50,0,"https://fbref.com/en/players/a4f94a0d/Christian-Gentner"
2020,"Union Berlin","Bundesliga","Rafał Gikiewicz","POL","GK","31",1987,33,1,0,1,0,0,1,4,25,3,0,0,0,2,3,26,4,"https://fbref.com/en/players/17376543/Rafal-Gikiewicz"
2020,"Union Berlin","Bundesliga","Akaki Gogia","GER","MF,FW","27",1992,1.3,2,1,0,0,2,0,2,0,2,2,2,0,0,2,0,0,"https://fbref.com/en/players/deee6467/Akaki-Gogia"
2020,"Union Berlin","Bundesliga","Florian Hübner","GER","DF","28",1991,9.4,16,14,12,4,0,7,17,41.2,10,11,7,4,16,32,39,0,"https://fbref.com/en/players/e87ad81a/Florian-Hubner"
2020,"Union Berlin","Bundesliga","Marcus Ingvartsen","DEN","MF,FW","23",1996,19.1,20,14,5,7,8,9,28,32.1,19,16,1,15,16,36,16,0,"https://fbref.com/en/players/271b8617/Marcus-Ingvartsen"
2020,"Union Berlin","Bundesliga","Felix Kroos","GER","MF,DF","28",1991,4.2,17,9,9,6,2,8,15,53.3,7,6,3,3,3,20,13,1,"https://fbref.com/en/players/4d7faad1/Felix-Kroos"
2020,"Union Berlin","Bundesliga","Christopher Lenz","GER","DF,MF","24",1994,25.2,63,37,37,20,6,26,49,53.1,23,46,11,35,43,106,65,0,"https://fbref.com/en/players/bbd86530/Christopher-Lenz"
2020,"Union Berlin","Bundesliga","Yunus Mallı","TUR","MF,FW","27",1992,7.5,8,3,1,5,2,5,10,50,5,2,0,2,7,15,7,0,"https://fbref.com/en/players/f3722c97/Yunus-Malli"
2020,"Union Berlin","Bundesliga","Joshua Mees","GER","MF,FW","23",1996,3.6,8,5,3,4,1,4,12,33.3,8,3,0,3,2,10,4,0,"https://fbref.com/en/players/4b6dd263/Joshua-Mees"
2020,"Union Berlin","Bundesliga","Moritz Nicolas","GER","GK","21",1997,1,0,0,0,0,0,0,0,NA,0,0,0,0,0,0,0,0,"https://fbref.com/en/players/226ddf9d/Moritz-Nicolas"
2020,"Union Berlin","Bundesliga","Michael Parensen","GER","DF","33",1986,7,11,6,5,6,0,5,10,50,5,14,8,6,12,23,17,0,"https://fbref.com/en/players/3acad81a/Michael-Parensen"
2020,"Union Berlin","Bundesliga","Sebastian Polter","GER","FW","28",1991,3.7,2,2,0,1,1,1,3,33.3,2,2,0,2,1,3,1,0,"https://fbref.com/en/players/3745e8bd/Sebastian-Polter"
2020,"Union Berlin","Bundesliga","Grischa Prömel","GER","MF","24",1995,10.3,14,11,6,6,2,7,19,36.8,12,10,2,8,14,28,9,0,"https://fbref.com/en/players/924f9191/Grischa-Promel"
2020,"Union Berlin","Bundesliga","Ken Reichel","GER","DF","32",1986,5.9,6,3,2,3,1,3,13,23.1,10,8,1,7,9,15,12,0,"https://fbref.com/en/players/e881ed15/Ken-Reichel"
2020,"Union Berlin","Bundesliga","Julian Ryerson","NOR","DF,MF","21",1997,4.1,7,5,2,1,4,3,6,50,3,5,3,2,5,12,9,0,"https://fbref.com/en/players/009a4f60/Julian-Ryerson"
2020,"Union Berlin","Bundesliga","Keven Schlotterbeck","GER","DF","22",1997,21.5,52,27,36,15,1,17,29,58.6,12,40,21,19,40,92,113,1,"https://fbref.com/en/players/f6bdc830/Keven-Schlotterbeck"
2020,"Union Berlin","Bundesliga","Manuel Schmiedebach","GER","MF","30",1988,2,4,1,0,3,1,1,7,14.3,6,1,1,0,3,7,3,0,"https://fbref.com/en/players/d8f5dc3d/Manuel-Schmiedebach"
2020,"Union Berlin","Bundesliga","Neven Subotić","SRB","DF","30",1988,21.8,30,18,12,16,2,8,32,25,24,21,8,13,34,64,89,0,"https://fbref.com/en/players/821233cc/Neven-Subotic"
2020,"Union Berlin","Bundesliga","Christopher Trimmel","AUT","DF,MF","32",1987,31.8,71,41,35,32,4,32,54,59.3,22,31,10,21,51,122,88,1,"https://fbref.com/en/players/056d2d95/Christopher-Trimmel"
2020,"Union Berlin","Bundesliga","Anthony Ujah","NGA","FW,MF","28",1990,10.5,8,6,4,2,2,1,6,16.7,5,0,0,0,3,11,10,0,"https://fbref.com/en/players/99be8fb5/Anthony-Ujah"
2020,"Valencia","La Liga","Denis Cheryshev","RUS","MF,FW","28",1990,10.3,16,9,5,4,7,3,17,17.6,14,15,1,14,7,23,10,0,"https://fbref.com/en/players/0ac94a23/Denis-Cheryshev"
2020,"Valencia","La Liga","Jasper Cillessen","NED","GK","30",1989,23.3,0,0,0,0,0,0,1,0,1,0,0,0,3,3,3,1,"https://fbref.com/en/players/04ac8285/Jasper-Cillessen"
2020,"Valencia","La Liga","Francis Coquelin","FRA","MF","28",1991,21.2,37,21,25,11,1,16,38,42.1,22,19,9,10,38,75,25,0,"https://fbref.com/en/players/a6951bf8/Francis-Coquelin"
2020,"Valencia","La Liga","Thierry Correia","POR","DF","20",1999,2.9,8,3,5,3,0,1,2,50,1,5,0,5,2,10,10,0,"https://fbref.com/en/players/c78b352d/Thierry-Correia"
2020,"Valencia","La Liga","Jaume Costa","ESP","DF","31",1988,15.4,27,23,17,8,2,14,28,50,14,11,6,5,24,51,52,1,"https://fbref.com/en/players/808d48f3/Jaume-Costa"
2020,"Valencia","La Liga","Mouctar Diakhaby","GUI","DF","22",1996,16,11,8,7,3,1,5,8,62.5,3,17,15,2,11,22,73,0,"https://fbref.com/en/players/d2110326/Mouctar-Diakhaby"
2020,"Valencia","La Liga","Jaume Doménech","ESP","GK","28",1990,14.7,0,0,0,0,0,0,1,0,1,0,0,0,1,1,3,1,"https://fbref.com/en/players/c9cb972b/Jaume-Domenech"
2020,"Valencia","La Liga","Vicente Esquerdo","ESP","MF,FW","20",1999,0.2,1,0,1,0,0,0,0,NA,0,1,0,1,0,1,1,0,"https://fbref.com/en/players/ced26057/Vicente-Esquerdo"
2020,"Valencia","La Liga","Alessandro Florenzi","ITA","DF","28",1991,8.4,13,9,9,4,0,8,18,44.4,10,11,1,10,14,27,21,0,"https://fbref.com/en/players/e288d4b3/Alessandro-Florenzi"
2020,"Valencia","La Liga","Kévin Gameiro","FRA","FW","32",1987,17.6,17,9,7,6,4,5,21,23.8,16,10,1,9,5,22,5,0,"https://fbref.com/en/players/42276181/Kevin-Gameiro"
2020,"Valencia","La Liga","Ezequiel Garay","ARG","DF","32",1986,16,12,8,9,2,1,7,11,63.6,4,19,17,2,14,26,71,0,"https://fbref.com/en/players/ac3fb1be/Ezequiel-Garay"
2020,"Valencia","La Liga","Maxi Gómez","URU","FW","22",1996,23.8,9,7,1,6,2,4,8,50,4,8,1,7,5,14,14,0,"https://fbref.com/en/players/4c2e9442/Maxi-Gomez"
2020,"Valencia","La Liga","Gonçalo Guedes","POR","MF,FW","22",1996,14.1,19,11,11,7,1,9,32,28.1,23,10,1,9,7,26,1,0,"https://fbref.com/en/players/e6bc67d7/Goncalo-Guedes"
2020,"Valencia","La Liga","Adrián Guerrero","ESP","DF","21",1998,1.4,2,2,1,1,0,2,3,66.7,1,0,0,0,2,4,1,0,"https://fbref.com/en/players/58a3a572/Adrian-Guerrero"
2020,"Valencia","La Liga","Hugo Guillamón","ESP","DF","19",2000,5.5,8,3,5,2,1,5,10,50,5,3,2,1,5,13,29,0,"https://fbref.com/en/players/f7c12fbf/Hugo-Guillamon"
2020,"Valencia","La Liga","Lee Kangin","KOR","MF,FW","18",2001,5,3,1,0,2,1,3,6,50,3,5,0,5,3,6,0,0,"https://fbref.com/en/players/8455ad90/Lee-Kangin"
2020,"Valencia","La Liga","Geoffrey Kondogbia","CTA","MF","26",1993,20.1,63,40,40,18,5,19,51,37.3,32,25,6,19,57,120,36,2,"https://fbref.com/en/players/cce181df/Geoffrey-Kondogbia"
2020,"Valencia","La Liga","José Luis Gayà","ESP","DF","24",1995,22.1,44,30,29,12,3,28,41,68.3,13,22,9,13,18,62,48,1,"https://fbref.com/en/players/b05e2dbd/Jose-Luis-Gaya"
2020,"Valencia","La Liga","Eliaquim Mangala","FRA","DF","28",1991,7.5,4,4,3,1,0,1,2,50,1,7,6,1,7,11,40,0,"https://fbref.com/en/players/f520049f/Eliaquim-Mangala"
2020,"Valencia","La Liga","Daniel Parejo","ESP","MF","30",1989,33.6,67,41,29,32,6,32,101,31.7,69,38,11,27,22,89,20,2,"https://fbref.com/en/players/7460ca0d/Daniel-Parejo"
2020,"Valencia","La Liga","Gabriel Paulista","BRA","DF","28",1990,31.1,22,14,17,2,3,15,25,60,10,36,29,7,48,70,151,3,"https://fbref.com/en/players/b7ca5c51/Gabriel-Paulista"
2020,"Valencia","La Liga","Cristiano Piccini","ITA","DF","26",1992,0.8,5,4,1,0,4,4,4,100,0,0,0,0,2,7,1,0,"https://fbref.com/en/players/32c0491f/Cristiano-Piccini"
2020,"Valencia","La Liga","Rodrigo","ESP","FW","28",1991,20.9,10,6,4,5,1,2,23,8.7,21,9,1,8,9,19,13,0,"https://fbref.com/en/players/1fb1c435/Rodrigo"
2020,"Valencia","La Liga","Rubén Sobrino","ESP","FW,MF","27",1992,1.9,7,5,3,2,2,2,3,66.7,1,1,0,1,0,7,1,0,"https://fbref.com/en/players/19b776e9/Ruben-Sobrino"
2020,"Valencia","La Liga","Carlos Soler","ESP","MF","22",1997,23,21,10,10,10,1,9,39,23.1,30,16,6,10,9,30,14,0,"https://fbref.com/en/players/fed17f5a/Carlos-Soler"
2020,"Valencia","La Liga","Ferrán Torres","ESP","MF,FW","19",2000,25,23,15,6,16,1,8,30,26.7,22,20,3,17,14,37,12,0,"https://fbref.com/en/players/9e1035f8/Ferran-Torres"
2020,"Valencia","La Liga","Manu Vallejo","ESP","MF,FW","22",1997,4.6,7,3,0,3,4,5,9,55.6,4,4,0,4,2,9,2,0,"https://fbref.com/en/players/0bc4e720/Manu-Vallejo"
2020,"Valencia","La Liga","Daniel Wass","DEN","DF,MF","30",1989,30.4,44,25,25,13,6,25,57,43.9,32,22,5,17,31,75,91,1,"https://fbref.com/en/players/d83bbc54/Daniel-Wass"
2020,"Valladolid","La Liga","Rubén Alcaraz","ESP","MF","28",1991,21.4,61,30,37,20,4,30,63,47.6,33,46,15,31,15,76,41,0,"https://fbref.com/en/players/036bba5f/Ruben-Alcaraz"
2020,"Valladolid","La Liga","Antoñito","ESP","DF,MF","31",1987,11.4,26,18,19,7,0,12,20,60,8,9,0,9,15,41,20,1,"https://fbref.com/en/players/dbe519cf/Antonito"
2020,"Valladolid","La Liga","Anuar","MAR","MF,FW","24",1995,2.1,4,2,1,2,1,2,6,33.3,4,7,3,4,5,9,0,0,"https://fbref.com/en/players/c93231dc/Anuar"
2020,"Valladolid","La Liga","Federico Barba","ITA","DF","25",1993,5,12,6,10,2,0,7,9,77.8,2,5,2,3,8,20,12,0,"https://fbref.com/en/players/c010b898/Federico-Barba"
2020,"Valladolid","La Liga","Hatem Ben Arfa","FRA","MF,FW","32",1987,1.8,0,0,0,0,0,0,4,0,4,1,0,1,0,0,0,0,"https://fbref.com/en/players/74dc806c/Hatem-Ben-Arfa"
2020,"Valladolid","La Liga","Churripi","ESP","GK","25",1994,2.7,1,1,1,0,0,1,1,100,0,0,0,0,0,1,2,0,"https://fbref.com/en/players/81a606fc/Churripi"
2020,"Valladolid","La Liga","Matheus Fernandes","BRA","MF,FW","21",1998,1.8,6,2,2,2,2,3,5,60,2,4,0,4,2,8,2,0,"https://fbref.com/en/players/f76fdcd2/Matheus-Fernandes"
2020,"Valladolid","La Liga","Joaquín Fernández","ESP","MF,DF","23",1996,18.4,30,24,17,10,3,9,30,30,21,14,10,4,32,62,57,0,"https://fbref.com/en/players/b86a64b2/Joaquin-Fernandez"
2020,"Valladolid","La Liga","Jorge de Frutos","ESP","MF,DF","22",1997,0.7,2,2,2,0,0,1,2,50,1,0,0,0,0,2,1,0,"https://fbref.com/en/players/38ce1150/Jorge-de-Frutos"
2020,"Valladolid","La Liga","Raúl García","ESP","DF,MF","30",1989,11.2,20,12,11,7,2,9,22,40.9,13,12,2,10,8,28,30,0,"https://fbref.com/en/players/1a317a1b/Raul-Garcia"
2020,"Valladolid","La Liga","Víctor García","ESP","FW,MF","22",1997,1,0,0,0,0,0,0,1,0,1,1,0,1,0,0,1,0,"https://fbref.com/en/players/6636496a/Victor-Garcia"
2020,"Valladolid","La Liga","Sergi Guardiola","ESP","FW","28",1991,29.5,14,6,3,7,4,4,24,16.7,20,23,0,23,6,20,18,1,"https://fbref.com/en/players/32974271/Sergi-Guardiola"
2020,"Valladolid","La Liga","Pablo Hervías","ESP","MF,FW","26",1993,11.3,24,20,8,14,2,12,22,54.5,10,8,0,8,5,29,0,0,"https://fbref.com/en/players/ba5a9545/Pablo-Hervias"
2020,"Valladolid","La Liga","Jordi Masip","ESP","GK","30",1989,35,1,1,1,0,0,0,2,0,2,0,0,0,1,2,7,3,"https://fbref.com/en/players/8fae77ea/Jordi-Masip"
2020,"Valladolid","La Liga","Míchel","ESP","MF","31",1988,24.2,50,28,26,19,5,22,75,29.3,53,22,4,18,33,83,41,1,"https://fbref.com/en/players/418f8f61/Michel"
2020,"Valladolid","La Liga","Miguel","ESP","FW","19",1999,2.6,2,1,1,0,1,1,2,50,1,3,1,2,0,2,1,0,"https://fbref.com/en/players/6763373d/Miguel"
2020,"Valladolid","La Liga","Javi Moyano","ESP","DF","33",1986,24.7,19,8,11,8,0,8,20,40,12,18,5,13,27,46,63,0,"https://fbref.com/en/players/933e8c8a/Javi-Moyano"
2020,"Valladolid","La Liga","Nacho","ESP","DF","30",1989,21,43,22,24,15,4,17,48,35.4,31,36,8,28,25,68,61,0,"https://fbref.com/en/players/e29d1111/Nacho"
2020,"Valladolid","La Liga","Kiko Olivas","ESP","DF","30",1988,32.7,33,16,25,7,1,13,35,37.1,22,30,16,14,61,94,112,2,"https://fbref.com/en/players/72b07a9c/Kiko-Olivas"
2020,"Valladolid","La Liga","Kike Pérez","ESP","MF,FW","22",1997,2.4,6,1,1,3,2,3,7,42.9,4,1,0,1,10,16,4,0,"https://fbref.com/en/players/237a3851/Kike-Perez"
2020,"Valladolid","La Liga","Samu Pérez","ESP","GK","22",1997,0.3,0,0,0,0,0,0,0,NA,0,0,0,0,0,0,0,0,"https://fbref.com/en/players/aae17c81/Samu-Perez"
2020,"Valladolid","La Liga","Óscar Plano","ESP","MF","28",1991,27.8,48,30,25,19,4,20,61,32.8,41,36,3,33,35,83,29,0,"https://fbref.com/en/players/7c388b20/Oscar-Plano"
2020,"Valladolid","La Liga","Pedro Porro","ESP","DF,MF","19",1999,8.2,18,10,11,7,0,10,18,55.6,8,3,0,3,7,25,19,1,"https://fbref.com/en/players/27d0a506/Pedro-Porro"
2020,"Valladolid","La Liga","Sandro Ramírez","ESP","FW,MF","24",1995,14.5,12,10,2,6,4,2,20,10,18,11,1,10,7,19,2,0,"https://fbref.com/en/players/833fb62e/Sandro-Ramirez"
2020,"Valladolid","La Liga","Waldo Rubio","ESP","MF,FW","23",1995,9.8,13,8,10,3,0,5,31,16.1,26,12,0,12,7,20,7,0,"https://fbref.com/en/players/ccaa5728/Waldo-Rubio"
2020,"Valladolid","La Liga","Mohammed Salisu","GHA","DF","20",1999,30.3,41,24,28,13,0,21,34,61.8,13,32,26,6,35,76,158,3,"https://fbref.com/en/players/0b33f6ad/Mohammed-Salisu"
2020,"Valladolid","La Liga","Fede San Emeterio","ESP","MF","22",1997,19.5,26,13,18,6,2,7,29,24.1,22,20,8,12,28,54,13,1,"https://fbref.com/en/players/efecd633/Fede-San-Emeterio"
2020,"Valladolid","La Liga","Javi Sánchez","ESP","DF","22",1997,5.5,5,4,3,2,0,1,3,33.3,2,4,2,2,4,9,24,0,"https://fbref.com/en/players/60359288/Javi-Sanchez"
2020,"Valladolid","La Liga","Enes Ünal","TUR","FW","22",1997,26,20,12,6,11,3,6,28,21.4,22,17,5,12,6,26,13,0,"https://fbref.com/en/players/f8eca1b6/Enes-Unal"
2020,"Valladolid","La Liga","Toni Villa","ESP","MF","24",1995,15,31,16,13,14,4,13,50,26,37,16,1,15,8,39,11,0,"https://fbref.com/en/players/636eae97/Toni-Villa"
2020,"Villarreal","La Liga","Raúl Albiol","ESP","DF","33",1985,36,43,23,27,16,0,18,27,66.7,9,29,21,8,42,85,175,2,"https://fbref.com/en/players/4bd414c1/Raul-Albiol"
2020,"Villarreal","La Liga","Paco Alcácer","ESP","FW","25",1993,10.3,3,3,2,1,0,1,7,14.3,6,4,1,3,2,5,10,0,"https://fbref.com/en/players/a7a9d95a/Paco-Alcacer"
2020,"Villarreal","La Liga","Sergio Asenjo","ESP","GK","30",1989,34,0,0,0,0,0,0,2,0,2,0,0,0,1,1,15,1,"https://fbref.com/en/players/9f0ea33f/Sergio-Asenjo"
2020,"Villarreal","La Liga","Carlos Bacca","COL","FW","32",1986,7.6,5,1,1,2,2,2,6,33.3,4,4,0,4,0,5,7,0,"https://fbref.com/en/players/09a9e921/Carlos-Bacca"
2020,"Villarreal","La Liga","Alex Baena","ESP","MF","18",2001,0.2,0,0,0,0,0,0,0,NA,0,1,0,1,0,0,0,0,"https://fbref.com/en/players/518f2234/Alex-Baena"
2020,"Villarreal","La Liga","Santi Cazorla","ESP","MF","34",1984,27.2,48,25,14,21,13,20,57,35.1,37,23,1,22,19,67,16,2,"https://fbref.com/en/players/e2e9c250/Santi-Cazorla"
2020,"Villarreal","La Liga","Sofian Chakla","MAR","DF","25",1993,2,0,0,0,0,0,0,1,0,1,2,1,1,3,3,7,1,"https://fbref.com/en/players/37f04799/Sofian-Chakla"
2020,"Villarreal","La Liga","Samuel Chukwueze","NGA","FW,MF","20",1999,22.8,23,14,12,6,5,13,30,43.3,17,15,1,14,10,33,14,1,"https://fbref.com/en/players/b8a642fc/Samuel-Chukwueze"
2020,"Villarreal","La Liga","Andrés Fernández","ESP","GK","32",1986,4,0,0,0,0,0,0,0,NA,0,0,0,0,0,0,2,0,"https://fbref.com/en/players/307fcd26/Andres-Fernandez"
2020,"Villarreal","La Liga","Ramiro Funes Mori","ARG","DF","28",1991,5,5,2,2,3,0,0,2,0,2,8,2,6,3,8,9,1,"https://fbref.com/en/players/89cbc961/Ramiro-Funes-Mori"
2020,"Villarreal","La Liga","Mario Gaspar","ESP","DF","28",1990,21.8,35,20,16,16,3,15,31,48.4,16,25,10,15,26,61,69,0,"https://fbref.com/en/players/fb5d47b3/Mario-Gaspar"
2020,"Villarreal","La Liga","Moi Gómez","ESP","FW,MF","25",1994,25.8,30,22,9,14,7,11,33,33.3,22,22,2,20,25,55,23,0,"https://fbref.com/en/players/5a626448/Moi-Gomez"
2020,"Villarreal","La Liga","Vicente Iborra","ESP","MF","31",1988,29.4,61,42,31,25,5,30,67,44.8,37,35,16,19,40,101,63,1,"https://fbref.com/en/players/ad1ffcfd/Vicente-Iborra"
2020,"Villarreal","La Liga","Alberto Moreno","ESP","DF","27",1992,16.3,27,16,15,11,1,9,25,36,16,15,3,12,25,52,36,0,"https://fbref.com/en/players/11b9265b/Alberto-Moreno"
2020,"Villarreal","La Liga","Gerard Moreno","ESP","FW,MF","27",1992,30.5,19,8,4,10,5,5,46,10.9,41,19,3,16,10,29,51,0,"https://fbref.com/en/players/81f0781e/Gerard-Moreno"
2020,"Villarreal","La Liga","Manu Morlanes","ESP","MF","20",1999,2.8,7,3,3,4,0,2,9,22.2,7,1,1,0,2,9,2,0,"https://fbref.com/en/players/a0255c67/Manu-Morlanes"
2020,"Villarreal","La Liga","Fernando Niño","ESP","FW","18",2000,0.9,1,0,0,1,0,1,2,50,1,0,0,0,0,1,2,0,"https://fbref.com/en/players/81d5c497/Fernando-Nino"
2020,"Villarreal","La Liga","Javier Ontiveros","ESP","FW,MF","21",1997,9.9,29,14,13,14,2,8,35,22.9,27,13,1,12,5,34,7,0,"https://fbref.com/en/players/a83d8b0c/Javier-Ontiveros"
2020,"Villarreal","La Liga","Rubén Peña","ESP","DF","28",1991,21.2,42,24,23,19,0,17,50,34,33,25,8,17,35,77,58,2,"https://fbref.com/en/players/1f079188/Ruben-Pena"
2020,"Villarreal","La Liga","Xavi Quintillà","ESP","DF","22",1996,17.5,22,12,14,4,4,10,20,50,10,11,4,7,12,34,35,0,"https://fbref.com/en/players/84fb6aff/Xavi-Quintilla"
2020,"Villarreal","La Liga","Bruno Soriano","ESP","MF,FW","35",1984,2.9,4,0,1,2,1,1,1,100,0,4,0,4,1,5,7,0,"https://fbref.com/en/players/09332647/Bruno-Soriano"
2020,"Villarreal","La Liga","Karl Toko Ekambi","CMR","FW","26",1992,11,5,3,0,3,2,1,4,25,3,2,0,2,3,8,2,0,"https://fbref.com/en/players/5ceba7fc/Karl-Toko-Ekambi"
2020,"Villarreal","La Liga","Pau Torres","ESP","DF","22",1997,33,34,21,24,10,0,16,24,66.7,8,39,23,16,27,61,153,1,"https://fbref.com/en/players/532e1e4f/Pau-Torres"
2020,"Villarreal","La Liga","Manu Trigueros","ESP","MF","27",1991,17.2,34,21,10,17,7,12,45,26.7,33,23,12,11,4,38,21,0,"https://fbref.com/en/players/963829d0/Manu-Trigueros"
2020,"Villarreal","La Liga","Andre-Frank Zambo Anguissa","CMR","MF","23",1995,28.7,76,49,29,40,7,26,78,33.3,52,42,6,36,44,120,30,0,"https://fbref.com/en/players/6bb2c084/Andre-Frank-Zambo-Anguissa"
2020,"Watford","Premier League","Étienne Capoue","FRA","MF","31",1988,29.2,75,40,38,30,7,37,85,43.5,48,30,11,19,68,143,61,0,"https://fbref.com/en/players/5acc4a10/Etienne-Capoue"
2020,"Watford","Premier League","Craig Cathcart","NIR","DF","30",1989,27.6,41,26,25,15,1,10,24,41.7,14,19,16,3,25,66,136,1,"https://fbref.com/en/players/89e4b358/Craig-Cathcart"
2020,"Watford","Premier League","Nathaniel Chalobah","ENG","MF","24",1994,10.3,30,11,13,13,4,12,27,44.4,15,10,4,6,18,48,20,0,"https://fbref.com/en/players/422862ea/Nathaniel-Chalobah"
2020,"Watford","Premier League","Tom Cleverley","ENG","MF","29",1989,10.8,28,15,8,14,6,9,36,25,27,13,1,12,10,38,15,0,"https://fbref.com/en/players/6cdd8245/Tom-Cleverley"
2020,"Watford","Premier League","Craig Dawson","ENG","DF","29",1990,26.2,29,18,16,13,0,17,31,54.8,14,41,32,9,34,63,116,0,"https://fbref.com/en/players/3e9e06cb/Craig-Dawson"
2020,"Watford","Premier League","Troy Deeney","ENG","FW","31",1988,24.7,19,12,6,10,3,6,29,20.7,23,13,1,12,11,30,27,0,"https://fbref.com/en/players/82e34b69/Troy-Deeney"
2020,"Watford","Premier League","Gerard Deulofeu","ESP","FW","25",1994,23.3,33,16,18,9,6,12,59,20.3,47,10,0,10,25,58,6,0,"https://fbref.com/en/players/39583cfd/Gerard-Deulofeu"
2020,"Watford","Premier League","Abdoulaye Doucouré","MLI","MF","26",1993,35.1,64,30,29,29,6,16,57,28.1,41,46,8,38,31,95,32,0,"https://fbref.com/en/players/02b29014/Abdoulaye-Doucoure"
2020,"Watford","Premier League","Kiko Femenía","ESP","DF","28",1991,24.9,68,38,49,17,2,43,80,53.8,37,16,2,14,36,104,49,0,"https://fbref.com/en/players/e5d01ecf/Kiko-Femenia"
2020,"Watford","Premier League","Ben Foster","ENG","GK","36",1983,38,1,0,1,0,0,1,3,33.3,2,1,0,1,0,1,16,2,"https://fbref.com/en/players/d0b3ceb9/Ben-Foster"
2020,"Watford","Premier League","Dimitri Foulquier","FRA","DF,MF","26",1993,0.7,1,0,1,0,0,0,0,NA,0,1,0,1,2,3,2,0,"https://fbref.com/en/players/45e17712/Dimitri-Foulquier"
2020,"Watford","Premier League","Andre Gray","JAM","FW","28",1991,8.4,4,3,0,2,2,1,3,33.3,2,4,1,3,1,5,2,0,"https://fbref.com/en/players/c24dba2a/Andre-Gray"
2020,"Watford","Premier League","José Holebas","GRE","DF","35",1984,11.4,26,15,19,7,0,9,28,32.1,19,11,4,7,3,29,33,0,"https://fbref.com/en/players/12aa7661/Jose-Holebas"
2020,"Watford","Premier League","Will Hughes","ENG","MF","24",1995,25,75,47,24,41,10,25,67,37.3,42,48,8,40,37,112,28,0,"https://fbref.com/en/players/a0666d3e/Will-Hughes"
2020,"Watford","Premier League","Daryl Janmaat","NED","DF","30",1989,6.7,14,10,8,6,0,6,13,46.2,7,7,2,5,7,21,23,0,"https://fbref.com/en/players/45da6694/Daryl-Janmaat"
2020,"Watford","Premier League","João Pedro","BRA","FW,MF","17",2001,0.3,0,0,0,0,0,0,0,NA,0,0,0,0,0,0,0,0,"https://fbref.com/en/players/e8832875/Joao-Pedro"
2020,"Watford","Premier League","Christian Kabasele","BEL","DF","28",1991,25,37,24,26,11,0,17,32,53.1,15,31,23,8,36,73,127,0,"https://fbref.com/en/players/914ab9a1/Christian-Kabasele"
2020,"Watford","Premier League","Adrian Mariappa","JAM","DF","32",1986,16.8,20,14,15,4,1,11,30,36.7,19,22,7,15,11,31,73,0,"https://fbref.com/en/players/8aa5f52c/Adrian-Mariappa"
2020,"Watford","Premier League","Adam Masina","MAR","DF","25",1994,20.2,38,22,24,11,3,14,37,37.8,23,26,12,14,28,66,66,0,"https://fbref.com/en/players/de0f152c/Adam-Masina"
2020,"Watford","Premier League","Roberto Pereyra","ARG","FW,MF","28",1991,18.3,20,8,11,7,2,9,28,32.1,19,21,0,21,14,34,12,1,"https://fbref.com/en/players/75f2c59f/Roberto-Pereyra"
2020,"Watford","Premier League","Sebastian Prödl","AUT","DF","32",1987,0.6,0,0,0,0,0,0,0,NA,0,0,0,0,0,0,4,0,"https://fbref.com/en/players/f5e6d08d/Sebastian-Prodl"
2020,"Watford","Premier League","Ignacio Pussetto","ARG","FW,MF","23",1995,0.8,7,4,4,2,1,3,8,37.5,5,2,1,1,3,10,4,0,"https://fbref.com/en/players/62437b4f/Ignacio-Pussetto"
2020,"Watford","Premier League","Domingos Quina","POR","MF,FW","19",1999,0.2,2,0,1,1,0,1,2,50,1,3,0,3,0,2,0,0,"https://fbref.com/en/players/41fb0f4e/Domingos-Quina"
2020,"Watford","Premier League","Ismaila Sarr","SEN","FW,MF","21",1998,22.5,11,10,5,2,4,5,23,21.7,18,9,1,8,18,29,10,0,"https://fbref.com/en/players/bfdb33aa/Ismaila-Sarr"
2020,"Watford","Premier League","Isaac Success","NGA","FW,MF","23",1996,0.8,0,0,0,0,0,0,0,NA,0,0,0,0,1,1,0,0,"https://fbref.com/en/players/f573a8bf/Isaac-Success"
2020,"Watford","Premier League","Danny Welbeck","ENG","FW,MF","28",1990,9.1,14,6,6,5,3,3,11,27.3,8,12,1,11,5,19,7,0,"https://fbref.com/en/players/ce5143da/Danny-Welbeck"
2020,"Werder Bremen","Bundesliga","Ludwig Augustinsson","SWE","DF,MF","25",1994,10.3,29,12,15,9,5,12,23,52.2,11,19,5,14,10,39,29,0,"https://fbref.com/en/players/9fec8860/Ludwig-Augustinsson"
2020,"Werder Bremen","Bundesliga","Philipp Bargfrede","GER","MF","30",1989,6.5,15,12,8,5,2,6,23,26.1,17,8,2,6,16,31,15,0,"https://fbref.com/en/players/3f7cd8f1/Philipp-Bargfrede"
2020,"Werder Bremen","Bundesliga","Fin Bartels","GER","MF,FW","32",1987,3.8,9,5,4,4,1,3,12,25,9,3,1,2,1,10,1,0,"https://fbref.com/en/players/acc7b7ec/Fin-Bartels"
2020,"Werder Bremen","Bundesliga","Leonardo Bittencourt","GER","FW,MF","25",1993,21,52,28,23,18,11,9,51,17.6,42,20,3,17,12,64,14,0,"https://fbref.com/en/players/dc62fbee/Leonardo-Bittencourt"
2020,"Werder Bremen","Bundesliga","Johannes Eggestein","GER","MF,FW","21",1998,5.7,8,6,2,2,4,3,12,25,9,6,0,6,2,10,4,0,"https://fbref.com/en/players/d571df78/Johannes-Eggestein"
2020,"Werder Bremen","Bundesliga","Maximilian Eggestein","GER","MF","22",1996,31.7,40,28,20,18,2,15,43,34.9,28,37,8,29,36,76,57,0,"https://fbref.com/en/players/beb882a8/Maximilian-Eggestein"
2020,"Werder Bremen","Bundesliga","Marco Friedl","AUT","DF,MF","21",1998,24.3,61,39,42,15,4,29,54,53.7,25,29,9,20,34,95,78,0,"https://fbref.com/en/players/f86ad3f5/Marco-Friedl"
2020,"Werder Bremen","Bundesliga","Niclas Füllkrug","GER","FW","26",1993,4.5,2,2,1,1,0,1,3,33.3,2,3,0,3,3,5,6,0,"https://fbref.com/en/players/4f16405e/Niclas-Fullkrug"
2020,"Werder Bremen","Bundesliga","Theodor Gebre Selassie","CZE","DF,MF","32",1986,27,36,27,23,10,3,17,35,48.6,18,26,9,17,63,99,81,0,"https://fbref.com/en/players/3f65898c/Theodor-Gebre-Selassie"
2020,"Werder Bremen","Bundesliga","Benjamin Goller","GER","FW,MF","20",1999,3.2,8,3,3,4,1,3,10,30,7,3,0,3,1,9,1,0,"https://fbref.com/en/players/d5980989/Benjamin-Goller"
2020,"Werder Bremen","Bundesliga","Christian Groß","GER","DF,MF","30",1989,9.7,23,17,16,5,2,9,16,56.3,7,13,7,6,14,37,50,1,"https://fbref.com/en/players/14a7af33/Christian-Gross"
2020,"Werder Bremen","Bundesliga","Martin Harnik","AUT","MF,FW","32",1987,0.1,0,0,0,0,0,0,0,NA,0,0,0,0,0,0,0,0,"https://fbref.com/en/players/99b7584f/Martin-Harnik"
2020,"Werder Bremen","Bundesliga","Luc Ihorst","GER","FW","19",2000,0.1,1,1,0,0,1,0,0,NA,0,1,0,1,0,1,0,0,"https://fbref.com/en/players/e5cad51e/Luc-Ihorst"
2020,"Werder Bremen","Bundesliga","Stefanos Kapino","GRE","GK","25",1994,1,0,0,0,0,0,0,0,NA,0,0,0,0,1,1,0,0,"https://fbref.com/en/players/62ba5881/Stefanos-Kapino"
2020,"Werder Bremen","Bundesliga","Davy Klaassen","NED","MF","26",1993,32.6,55,43,19,23,13,19,57,33.3,38,46,18,28,38,93,45,2,"https://fbref.com/en/players/15fd5593/Davy-Klaassen"
2020,"Werder Bremen","Bundesliga","Michael Lang","SUI","DF,FW","28",1991,6,8,5,3,5,0,6,12,50,6,5,1,4,7,15,22,0,"https://fbref.com/en/players/864db10a/Michael-Lang"
2020,"Werder Bremen","Bundesliga","Sebastian Langkamp","GER","DF","31",1988,3.5,3,2,3,0,0,2,4,50,2,5,3,2,3,6,11,1,"https://fbref.com/en/players/74d70fb5/Sebastian-Langkamp"
2020,"Werder Bremen","Bundesliga","Kevin Möhwald","GER","MF","26",1993,0.8,2,1,1,1,0,1,2,50,1,0,0,0,0,2,1,0,"https://fbref.com/en/players/a5ce09f2/Kevin-Mohwald"
2020,"Werder Bremen","Bundesliga","Niklas Moisander","FIN","DF","33",1985,22,27,15,19,6,2,11,26,42.3,15,37,19,18,49,76,85,0,"https://fbref.com/en/players/00844823/Niklas-Moisander"
2020,"Werder Bremen","Bundesliga","Yuya Osako","JPN","FW,MF","29",1990,20.5,29,16,5,19,5,3,29,10.3,26,10,1,9,6,35,13,1,"https://fbref.com/en/players/f69fba57/Yuya-Osako"
2020,"Werder Bremen","Bundesliga","Jiří Pavlenka","CZE","GK","27",1992,33,1,0,1,0,0,1,2,50,1,1,0,1,5,6,11,3,"https://fbref.com/en/players/0a1cb833/Jiri-Pavlenka"
2020,"Werder Bremen","Bundesliga","Claudio Pizarro","PER","FW,MF","40",1978,2.6,2,1,0,1,1,0,1,0,1,2,0,2,2,4,2,0,"https://fbref.com/en/players/54b6ee79/Claudio-Pizarro"
2020,"Werder Bremen","Bundesliga","Milot Rashica","KVX","FW","23",1996,25.2,21,14,13,6,2,9,33,27.3,24,15,2,13,6,27,16,1,"https://fbref.com/en/players/6c6a3300/Milot-Rashica"
2020,"Werder Bremen","Bundesliga","Nuri Şahin","TUR","MF","30",1988,13.9,27,16,10,14,3,11,35,31.4,24,15,7,8,37,64,38,0,"https://fbref.com/en/players/f4081572/Nuri-Sahin"
2020,"Werder Bremen","Bundesliga","Josh Sargent","USA","FW","19",2000,15.7,11,6,5,4,2,2,12,16.7,10,17,1,16,14,25,21,0,"https://fbref.com/en/players/a8d4428b/Josh-Sargent"
2020,"Werder Bremen","Bundesliga","Davie Selke","GER","FW","24",1995,5.1,2,0,1,1,0,0,2,0,2,1,0,1,0,2,2,0,"https://fbref.com/en/players/1238a3f9/Davie-Selke"
2020,"Werder Bremen","Bundesliga","Ömer Toprak","TUR","DF","30",1989,7.9,7,2,4,2,1,3,6,50,3,6,4,2,12,19,41,0,"https://fbref.com/en/players/c5fd13e9/Omer-Toprak"
2020,"Werder Bremen","Bundesliga","Miloš Veljković","SRB","DF","23",1995,22.8,55,33,36,18,1,33,53,62.3,20,25,11,14,26,81,92,1,"https://fbref.com/en/players/a5ae8f8e/Milos-Veljkovic"
2020,"Werder Bremen","Bundesliga","Kevin Vogt","GER","DF,MF","27",1991,12.3,14,10,8,6,0,8,16,50,8,15,12,3,25,39,37,1,"https://fbref.com/en/players/1d8e9add/Kevin-Vogt"
2020,"Werder Bremen","Bundesliga","Nick Woltemade","GER","FW,MF","17",2002,1,2,1,0,2,0,0,1,0,1,1,0,1,0,2,2,0,"https://fbref.com/en/players/7ca196eb/Nick-Woltemade"
2020,"West Ham","Premier League","Albian Ajeti","SUI","FW","22",1997,1.5,1,0,0,0,1,0,0,NA,0,0,0,0,0,1,0,0,"https://fbref.com/en/players/2b1c4abd/Albian-Ajeti"
2020,"West Ham","Premier League","Felipe Anderson","BRA","MF,FW","26",1993,16.6,46,32,20,21,5,11,47,23.4,36,19,1,18,22,68,11,0,"https://fbref.com/en/players/9f1893b9/Felipe-Anderson"
2020,"West Ham","Premier League","Michail Antonio","JAM","FW","29",1990,19.6,13,9,5,4,4,4,14,28.6,10,17,2,15,9,22,5,0,"https://fbref.com/en/players/ac05f970/Michail-Antonio"
2020,"West Ham","Premier League","Fabián Balbuena","PAR","DF","27",1991,13.1,17,12,13,3,1,9,25,36,16,15,5,10,26,43,75,3,"https://fbref.com/en/players/3626f7d9/Fabian-Balbuena"
2020,"West Ham","Premier League","Jarrod Bowen","ENG","FW,MF","22",1996,10.2,19,15,7,9,3,4,17,23.5,13,6,0,6,16,35,8,0,"https://fbref.com/en/players/79c84d1c/Jarrod-Bowen"
2020,"West Ham","Premier League","Aaron Cresswell","ENG","DF","29",1989,30.3,43,26,21,18,4,23,46,50,23,33,10,23,35,78,75,2,"https://fbref.com/en/players/4f974391/Aaron-Cresswell"
2020,"West Ham","Premier League","Issa Diop","FRA","DF","22",1997,30.7,27,15,18,9,0,16,25,64,9,37,21,16,47,74,166,2,"https://fbref.com/en/players/a712ca2b/Issa-Diop"
2020,"West Ham","Premier League","Łukasz Fabiański","POL","GK","34",1985,23.5,2,2,2,0,0,2,4,50,2,0,0,0,1,3,5,3,"https://fbref.com/en/players/9328b835/Lukasz-Fabianski"
2020,"West Ham","Premier League","Pablo Fornals","ESP","MF,FW","23",1996,24.1,46,28,21,18,7,19,64,29.7,45,35,1,34,25,71,15,0,"https://fbref.com/en/players/82927de4/Pablo-Fornals"
2020,"West Ham","Premier League","Ryan Fredericks","ENG","DF","26",1992,24.9,82,56,59,18,5,41,64,64.1,23,20,10,10,24,106,73,1,"https://fbref.com/en/players/c067631c/Ryan-Fredericks"
2020,"West Ham","Premier League","Sébastien Haller","CIV","FW","25",1994,25.2,22,15,8,10,4,3,30,10,27,19,5,14,8,30,27,0,"https://fbref.com/en/players/ba115a40/Sebastien-Haller"
2020,"West Ham","Premier League","Javier Hernández","MEX","FW","31",1988,1.2,0,0,0,0,0,0,1,0,1,0,0,0,1,1,0,0,"https://fbref.com/en/players/189cee7b/Javier-Hernandez"
2020,"West Ham","Premier League","Nathan Holland","ENG","MF","21",1998,0.4,3,1,2,1,0,0,0,NA,0,1,0,1,0,3,0,0,"https://fbref.com/en/players/45ab2170/Nathan-Holland"
2020,"West Ham","Premier League","Ben Johnson","ENG","DF","19",2000,3,8,4,7,1,0,7,10,70,3,5,2,3,3,11,11,0,"https://fbref.com/en/players/9319781b/Ben-Johnson"
2020,"West Ham","Premier League","Manuel Lanzini","ARG","MF,FW","26",1993,15.3,14,9,6,6,2,7,39,17.9,32,9,1,8,10,24,3,0,"https://fbref.com/en/players/26f6dca8/Manuel-Lanzini"
2020,"West Ham","Premier League","David Martin","ENG","GK","33",1986,4.8,0,0,0,0,0,0,0,NA,0,0,0,0,0,0,1,1,"https://fbref.com/en/players/07666c20/David-Martin"
2020,"West Ham","Premier League","Arthur Masuaku","COD","DF","25",1993,10.4,41,23,24,13,4,23,39,59,16,19,5,14,14,55,23,0,"https://fbref.com/en/players/57df7a11/Arthur-Masuaku"
2020,"West Ham","Premier League","Jeremy Ngakia","ENG","DF","18",2000,4.9,15,7,10,5,0,9,21,42.9,12,6,1,5,7,22,16,0,"https://fbref.com/en/players/3631ad41/Jeremy-Ngakia"
2020,"West Ham","Premier League","Mark Noble","ENG","MF","32",1987,29.7,52,30,19,28,5,22,64,34.4,42,20,6,14,20,72,10,1,"https://fbref.com/en/players/ff527768/Mark-Noble"
2020,"West Ham","Premier League","Angelo Ogbonna","ITA","DF","31",1988,31,38,24,20,14,4,18,32,56.3,14,50,32,18,27,65,134,1,"https://fbref.com/en/players/74b2cd7e/Angelo-Ogbonna"
2020,"West Ham","Premier League","Darren Randolph","IRL","GK","32",1987,2,0,0,0,0,0,0,0,NA,0,0,0,0,0,0,2,0,"https://fbref.com/en/players/6385ebfb/Darren-Randolph"
2020,"West Ham","Premier League","Declan Rice","ENG","MF","20",1999,38,116,60,64,48,4,47,98,48,51,41,9,32,77,193,55,0,"https://fbref.com/en/players/1c7012b8/Declan-Rice"
2020,"West Ham","Premier League","Roberto","ESP","GK","33",1986,7.6,0,0,0,0,0,0,0,NA,0,0,0,0,0,0,2,2,"https://fbref.com/en/players/ba3ca78f/Roberto"
2020,"West Ham","Premier League","Carlos Sánchez","COL","MF","33",1986,1.3,1,0,0,1,0,1,1,100,0,1,0,1,2,3,1,0,"https://fbref.com/en/players/50b51fac/Carlos-Sanchez"
2020,"West Ham","Premier League","Robert Snodgrass","SCO","MF,FW","31",1987,16.8,29,16,17,10,2,13,44,29.5,31,12,1,11,4,33,11,0,"https://fbref.com/en/players/9f4647e9/Robert-Snodgrass"
2020,"West Ham","Premier League","Tomáš Souček","CZE","MF","24",1995,11.6,29,15,13,15,1,10,23,43.5,13,7,1,6,22,51,35,0,"https://fbref.com/en/players/6613c819/Tomas-Soucek"
2020,"West Ham","Premier League","Jack Wilshere","ENG","MF","27",1992,2.4,1,0,1,0,0,0,4,0,4,3,0,3,1,2,0,0,"https://fbref.com/en/players/9c318325/Jack-Wilshere"
2020,"West Ham","Premier League","Andriy Yarmolenko","UKR","MF,FW","29",1989,11,13,8,5,6,2,5,20,25,15,3,1,2,6,19,4,0,"https://fbref.com/en/players/849c826a/Andriy-Yarmolenko"
2020,"West Ham","Premier League","Pablo Zabaleta","ARG","DF","34",1985,6.6,18,10,12,5,1,6,13,46.2,7,5,3,2,14,32,21,0,"https://fbref.com/en/players/6813ac34/Pablo-Zabaleta"
2020,"Wolfsburg","Bundesliga","Maximilian Arnold","GER","MF","25",1994,31.3,42,24,15,23,4,16,62,25.8,46,25,6,19,25,67,35,0,"https://fbref.com/en/players/86e119e0/Maximilian-Arnold"
2020,"Wolfsburg","Bundesliga","Josip Brekalo","CRO","MF,FW","21",1998,18.6,18,8,5,6,7,5,23,21.7,18,26,0,26,16,34,4,0,"https://fbref.com/en/players/d4a2533d/Josip-Brekalo"
2020,"Wolfsburg","Bundesliga","John Brooks","USA","DF","26",1993,24.7,38,27,27,9,2,24,49,49,25,31,12,19,41,79,93,0,"https://fbref.com/en/players/e27da244/John-Brooks"
2020,"Wolfsburg","Bundesliga","Jeffrey Bruma","NED","DF","27",1991,9,9,5,4,5,0,7,13,53.8,6,6,3,3,13,22,51,1,"https://fbref.com/en/players/fbffc4b1/Jeffrey-Bruma"
2020,"Wolfsburg","Bundesliga","Koen Casteels","BEL","GK","27",1992,26,0,0,0,0,0,0,0,NA,0,0,0,0,0,0,9,1,"https://fbref.com/en/players/db401046/Koen-Casteels"
2020,"Wolfsburg","Bundesliga","Yannick Gerhardt","GER","MF","25",1994,9.2,28,18,7,15,6,8,21,38.1,13,11,3,8,12,40,9,0,"https://fbref.com/en/players/62ab9184/Yannick-Gerhardt"
2020,"Wolfsburg","Bundesliga","Daniel Ginczek","GER","FW","28",1991,8.5,4,3,3,1,0,1,11,9.1,10,3,1,2,1,5,3,0,"https://fbref.com/en/players/e5f63987/Daniel-Ginczek"
2020,"Wolfsburg","Bundesliga","Josuha Guilavogui","FRA","MF,DF","28",1990,22.9,41,26,17,23,1,10,30,33.3,20,35,9,26,45,86,64,2,"https://fbref.com/en/players/e6c43eec/Josuha-Guilavogui"
2020,"Wolfsburg","Bundesliga","Luca Horn","GER","DF","20",1998,0.1,0,0,0,0,0,0,0,NA,0,0,0,0,0,0,0,0,"https://fbref.com/en/players/60dfc525/Luca-Horn"
2020,"Wolfsburg","Bundesliga","Mamoudou Karamoko","FRA","MF","19",1999,0.1,0,0,0,0,0,0,0,NA,0,0,0,0,0,0,0,0,"https://fbref.com/en/players/23a10591/Mamoudou-Karamoko"
2020,"Wolfsburg","Bundesliga","Felix Klaus","GER","MF,FW","26",1992,7.4,24,16,4,13,7,7,19,36.8,12,10,2,8,3,27,5,0,"https://fbref.com/en/players/aeda1f69/Felix-Klaus"
2020,"Wolfsburg","Bundesliga","Robin Knoche","GER","DF","27",1992,17.7,29,14,24,5,0,17,30,56.7,13,19,11,8,27,56,77,1,"https://fbref.com/en/players/6bd5cd5d/Robin-Knoche"
2020,"Wolfsburg","Bundesliga","Omar Marmoush","EGY","MF,FW","20",1999,0.9,1,1,1,0,0,0,0,NA,0,1,0,1,1,2,0,0,"https://fbref.com/en/players/0e0102eb/Omar-Marmoush"
2020,"Wolfsburg","Bundesliga","Kevin Mbabu","SUI","DF","24",1995,18.8,69,48,39,24,6,35,54,64.8,19,33,10,23,23,92,53,0,"https://fbref.com/en/players/493924a7/Kevin-Mbabu"
2020,"Wolfsburg","Bundesliga","Admir Mehmedi","SUI","MF,FW","28",1991,13.3,14,6,2,9,3,4,15,26.7,11,10,0,10,5,19,4,0,"https://fbref.com/en/players/b500b384/Admir-Mehmedi"
2020,"Wolfsburg","Bundesliga","Lukas Nmecha","GER","MF,FW","20",1998,1.5,0,0,0,0,0,0,0,NA,0,0,0,0,0,0,0,0,"https://fbref.com/en/players/0cc5f4a5/Lukas-Nmecha"
2020,"Wolfsburg","Bundesliga","Paulo Otávio","BRA","DF","24",1994,4.2,21,16,11,9,1,10,13,76.9,3,12,2,10,9,30,11,0,"https://fbref.com/en/players/1cbe4984/Paulo-Otavio"
2020,"Wolfsburg","Bundesliga","Pavao Pervan","AUT","GK","31",1987,8,0,0,0,0,0,0,1,0,1,0,0,0,0,0,4,0,"https://fbref.com/en/players/c89e8aae/Pavao-Pervan"
2020,"Wolfsburg","Bundesliga","Marin Pongračić","CRO","DF","21",1997,10.3,14,9,11,2,1,9,10,90,1,11,7,4,19,33,21,1,"https://fbref.com/en/players/2a6cd437/Marin-Pongracic"
2020,"Wolfsburg","Bundesliga","Jérôme Roussillon","FRA","DF","26",1993,26.3,48,29,26,18,4,15,29,51.7,14,33,5,28,30,78,58,0,"https://fbref.com/en/players/13203c45/Jerome-Roussillon"
2020,"Wolfsburg","Bundesliga","João Victor Santos Sá","BRA","MF,FW","25",1994,18.1,35,22,12,17,6,10,38,26.3,28,31,1,30,9,44,9,0,"https://fbref.com/en/players/1a1033a1/Joao-Victor-Santos-Sa"
2020,"Wolfsburg","Bundesliga","Xaver Schlager","AUT","MF","21",1997,19.1,47,29,13,30,4,14,44,31.8,30,16,2,14,17,64,12,0,"https://fbref.com/en/players/8f056768/Xaver-Schlager"
2020,"Wolfsburg","Bundesliga","Renato Steffen","SUI","MF,FW","27",1991,17.6,25,18,4,14,7,14,39,35.9,25,25,2,23,23,48,10,0,"https://fbref.com/en/players/dd669209/Renato-Steffen"
2020,"Wolfsburg","Bundesliga","Marcel Tisserand","COD","DF","26",1993,13.4,21,10,14,5,2,7,12,58.3,5,13,4,9,32,53,49,2,"https://fbref.com/en/players/45954ec7/Marcel-Tisserand"
2020,"Wolfsburg","Bundesliga","Wout Weghorst","NED","FW","26",1992,30.4,15,8,4,5,6,1,17,5.9,16,17,4,13,2,17,30,0,"https://fbref.com/en/players/c4e87b8b/Wout-Weghorst"
2020,"Wolfsburg","Bundesliga","William","BRA","DF","24",1995,15.2,55,26,34,14,7,27,59,45.8,32,10,3,7,24,79,38,1,"https://fbref.com/en/players/d4d0a9ad/William"
2020,"Wolves","Premier League","Ryan Bennett","ENG","DF","29",1990,6.7,4,2,4,0,0,2,6,33.3,4,14,8,6,9,13,29,0,"https://fbref.com/en/players/0bad4516/Ryan-Bennett"
2020,"Wolves","Premier League","Willy Boly","CIV","DF","28",1991,22,57,33,36,21,0,25,43,58.1,18,28,11,17,39,96,108,3,"https://fbref.com/en/players/a4ac4b8f/Willy-Boly"
2020,"Wolves","Premier League","Jonny Castro","ESP","MF,DF","25",1994,32.1,91,55,54,26,11,29,82,35.4,53,45,10,35,53,144,45,2,"https://fbref.com/en/players/e28868f3/Jonny-Castro"
2020,"Wolves","Premier League","Conor Coady","ENG","DF","26",1993,38,36,23,30,6,0,15,30,50,15,22,15,7,28,64,119,2,"https://fbref.com/en/players/2928dca2/Conor-Coady"
2020,"Wolves","Premier League","Patrick Cutrone","ITA","FW","21",1998,3.3,4,2,2,1,1,1,5,20,4,1,1,0,2,6,1,0,"https://fbref.com/en/players/a4fe8cda/Patrick-Cutrone"
2020,"Wolves","Premier League","Leander Dendoncker","BEL","MF,DF","24",1995,31.1,68,31,41,19,8,28,67,41.8,39,39,12,27,38,106,64,2,"https://fbref.com/en/players/5a7301ae/Leander-Dendoncker"
2020,"Wolves","Premier League","Matt Doherty","IRL","MF,DF","27",1992,31.5,55,29,34,17,4,27,41,65.9,14,34,4,30,40,95,52,1,"https://fbref.com/en/players/d557d734/Matt-Doherty"
2020,"Wolves","Premier League","Morgan Gibbs-White","ENG","MF,FW","19",2000,1.4,0,0,0,0,0,0,0,NA,0,0,0,0,2,2,0,0,"https://fbref.com/en/players/32f60ed8/Morgan-Gibbs-White"
2020,"Wolves","Premier League","Raúl Jiménez","MEX","FW","28",1991,36,20,12,6,10,4,3,31,9.7,28,26,0,26,16,36,34,1,"https://fbref.com/en/players/b561db50/Raul-Jimenez"
2020,"Wolves","Premier League","Bruno Jordão","POR","FW","20",1998,0.1,0,0,0,0,0,0,0,NA,0,1,0,1,0,0,0,0,"https://fbref.com/en/players/41ff002d/Bruno-Jordao"
2020,"Wolves","Premier League","Diogo Jota","POR","FW","22",1996,25.4,28,15,16,10,2,12,48,25,36,17,0,17,9,37,10,2,"https://fbref.com/en/players/178ae8f8/Diogo-Jota"
2020,"Wolves","Premier League","Max Kilman","ENG","DF","22",1997,2.1,4,2,1,3,0,2,2,100,0,1,1,0,4,8,7,0,"https://fbref.com/en/players/d0f72bf1/Max-Kilman"
2020,"Wolves","Premier League","João Moutinho","POR","MF","32",1986,34.5,93,50,43,41,9,46,139,33.1,93,43,13,30,50,143,18,1,"https://fbref.com/en/players/f5a00fa4/Joao-Moutinho"
2020,"Wolves","Premier League","Pedro Neto","POR","FW,MF","19",2000,10.4,9,4,3,6,0,4,15,26.7,11,2,0,2,6,15,4,0,"https://fbref.com/en/players/7ba2eaa9/Pedro-Neto"
2020,"Wolves","Premier League","Rúben Neves","POR","MF","22",1997,34,62,33,27,32,3,34,86,39.5,52,38,9,29,56,118,34,1,"https://fbref.com/en/players/44bfb6c5/Ruben-Neves"
2020,"Wolves","Premier League","Rui Patrício","POR","GK","31",1988,38,0,0,0,0,0,0,2,0,2,2,0,2,2,2,5,2,"https://fbref.com/en/players/79b0d6a0/Rui-Patricio"
2020,"Wolves","Premier League","Daniel Podence","POR","FW,MF","23",1995,3.2,3,3,2,0,1,0,2,0,2,4,1,3,2,5,1,0,"https://fbref.com/en/players/7fcc71d8/Daniel-Podence"
2020,"Wolves","Premier League","Romain Saïss","MAR","DF","29",1990,30.1,55,38,37,15,3,32,46,69.6,14,31,16,15,55,110,127,3,"https://fbref.com/en/players/9fbbcf39/Romain-Saiss"
2020,"Wolves","Premier League","Adama Traoré","ESP","FW,DF","23",1996,28.9,33,21,6,14,13,8,23,34.8,15,19,3,16,13,46,14,2,"https://fbref.com/en/players/9a28eba4/Adama-Traore"
2020,"Wolves","Premier League","Jesús Vallejo","ESP","DF","22",1997,1.8,1,1,1,0,0,1,2,50,1,4,3,1,2,3,8,1,"https://fbref.com/en/players/c2111b45/Jesus-Vallejo"
2020,"Wolves","Premier League","Rúben Vinagre","POR","MF,DF","20",1999,7.2,23,13,15,6,2,12,15,80,3,7,2,5,11,34,22,0,"https://fbref.com/en/players/b937e490/Ruben-Vinagre"
2021,"Alavés","La Liga","Martin Agirregabiria","ESP","DF,MF","24",1996,17.3,32,18,17,12,3,17,33,51.5,16,9,3,6,27,59,36,0,"https://fbref.com/en/players/355c883a/Martin-Agirregabiria"
2021,"Alavés","La Liga","Rodrigo Battaglia","ARG","MF","29",1991,27.7,38,16,21,14,3,16,50,32,34,30,14,16,29,67,40,1,"https://fbref.com/en/players/d637fc22/Rodrigo-Battaglia"
2021,"Alavés","La Liga","Burgui","ESP","MF","26",1993,0.2,3,1,2,1,0,1,1,100,0,0,0,0,0,3,0,0,"https://fbref.com/en/players/45e304c8/Burgui"
2021,"Alavés","La Liga","Iñigo Córdoba","ESP","MF","23",1997,2.4,6,4,1,3,2,2,10,20,8,7,0,7,3,9,2,0,"https://fbref.com/en/players/49ea92be/Inigo-Cordoba"
2021,"Alavés","La Liga","Deyverson","BRA","FW","29",1991,9.7,6,4,3,1,2,2,13,15.4,11,9,0,9,9,15,13,0,"https://fbref.com/en/players/2e5e846d/Deyverson"
2021,"Alavés","La Liga","Rubén Duarte","ESP","DF","24",1995,28.3,55,30,28,21,6,23,52,44.2,29,44,6,38,66,121,72,0,"https://fbref.com/en/players/1fe0492d/Ruben-Duarte"
2021,"Alavés","La Liga","Rodrigo Ely","BRA","DF","26",1993,5.2,5,2,3,2,0,3,4,75,1,2,1,1,7,12,23,1,"https://fbref.com/en/players/fd47b4f2/Rodrigo-Ely"
2021,"Alavés","La Liga","Manu García","ESP","MF","34",1986,12.5,24,13,10,13,1,8,35,22.9,27,16,1,15,12,36,21,0,"https://fbref.com/en/players/05a4465d/Manu-Garcia"
2021,"Alavés","La Liga","Sergi García","ESP","MF","21",1999,0.2,1,1,0,1,0,0,1,0,1,0,0,0,0,1,0,0,"https://fbref.com/en/players/a039d52e/Sergi-Garcia"
2021,"Alavés","La Liga","John Guidetti","SWE","FW","28",1992,2.3,2,2,0,2,0,0,2,0,2,0,0,0,1,3,2,0,"https://fbref.com/en/players/99bebd12/John-Guidetti"
2021,"Alavés","La Liga","Joselu","ESP","FW","30",1990,33.6,27,14,6,15,6,8,28,28.6,20,26,3,23,15,42,58,1,"https://fbref.com/en/players/6265208f/Joselu"
2021,"Alavés","La Liga","Jota","ESP","MF","29",1991,15.5,19,14,6,7,6,3,29,10.3,26,12,0,12,9,28,9,0,"https://fbref.com/en/players/9f351459/Jota"
2021,"Alavés","La Liga","Stephane Keller","CMR","DF","18",2001,0.2,1,0,1,0,0,1,1,100,0,0,0,0,0,1,0,0,"https://fbref.com/en/players/89d1e9fa/Stephane-Keller"
2021,"Alavés","La Liga","Víctor Laguardia","ESP","DF","30",1989,29.2,20,12,13,6,1,14,31,45.2,17,25,13,12,37,57,104,0,"https://fbref.com/en/players/b7c99b9b/Victor-Laguardia"
2021,"Alavés","La Liga","Florian Lejeune","FRA","DF","29",1991,33.5,43,32,36,7,0,21,35,60,14,38,24,14,51,94,149,1,"https://fbref.com/en/players/6eaed4eb/Florian-Lejeune"
2021,"Alavés","La Liga","Javi López","ESP","DF,MF","18",2002,2.8,5,5,3,2,0,2,3,66.7,1,2,0,2,3,8,3,1,"https://fbref.com/en/players/e9ada8cf/Javi-Lopez"
2021,"Alavés","La Liga","Abdallahi Mahmoud","MTN","MF","20",2000,0.7,2,2,1,1,0,0,1,0,1,0,0,0,1,3,0,0,"https://fbref.com/en/players/ab99e4a0/Abdallahi-Mahmoud"
2021,"Alavés","La Liga","Adrián Marín","ESP","DF,MF","23",1997,1,1,1,0,1,0,0,2,0,2,1,0,1,2,3,2,0,"https://fbref.com/en/players/b7f2edff/Adrian-Marin"
2021,"Alavés","La Liga","Édgar Méndez","ESP","MF,FW","30",1990,23.2,39,29,18,13,8,15,48,31.3,33,20,3,17,19,58,14,0,"https://fbref.com/en/players/aed746df/Edgar-Mendez"
2021,"Alavés","La Liga","Ximo Navarro","ESP","DF","30",1990,26.4,54,30,36,17,1,14,30,46.7,16,14,4,10,47,101,75,3,"https://fbref.com/en/players/8db394aa/Ximo-Navarro"
2021,"Alavés","La Liga","Fernando Pacheco","ESP","GK","28",1992,37.2,2,0,2,0,0,2,4,50,2,0,0,0,2,4,19,0,"https://fbref.com/en/players/97852360/Fernando-Pacheco"
2021,"Alavés","La Liga","Facundo Pellistri","URU","MF,FW","18",2001,6,8,5,2,4,2,3,13,23.1,10,0,0,0,4,12,3,0,"https://fbref.com/en/players/ac7e7b1c/Facundo-Pellistri"
2021,"Alavés","La Liga","Lucas Pérez","ESP","FW","31",1988,19.5,6,2,3,3,0,2,10,20,8,6,1,5,2,8,5,0,"https://fbref.com/en/players/a300ac7e/Lucas-Perez"
2021,"Alavés","La Liga","Tomás Pina Isla","ESP","MF","32",1987,28.6,39,18,18,16,5,16,42,38.1,26,28,8,20,37,76,42,0,"https://fbref.com/en/players/e54bd0a2/Tomas-Pina-Isla"
2021,"Alavés","La Liga","Pere Pons","ESP","MF","27",1993,13.2,20,10,8,8,4,5,16,31.3,11,15,2,13,7,27,10,0,"https://fbref.com/en/players/29b61deb/Pere-Pons"
2021,"Alavés","La Liga","Luis Rioja","ESP","MF,FW","26",1993,23.2,21,14,11,7,3,7,39,17.9,32,23,1,22,20,41,30,0,"https://fbref.com/en/players/eb3dd471/Luis-Rioja"
2021,"Alavés","La Liga","Borja Sainz","ESP","MF,FW","19",2001,5,7,3,3,2,2,4,16,25,12,4,0,4,6,13,1,0,"https://fbref.com/en/players/1b40049a/Borja-Sainz"
2021,"Alavés","La Liga","Antonio Sivera","ESP","GK","23",1996,0.8,0,0,0,0,0,0,0,NA,0,0,0,0,0,0,0,0,"https://fbref.com/en/players/9970da54/Antonio-Sivera"
2021,"Alavés","La Liga","Tachi","ESP","DF","22",1997,9.4,11,9,9,2,0,6,14,42.9,8,9,6,3,11,22,32,0,"https://fbref.com/en/players/8b625720/Tachi"
2021,"Alavés","La Liga","Tomás Tavares","POR","MF,DF","19",2001,0.7,2,1,2,0,0,2,2,100,0,1,0,1,0,2,1,0,"https://fbref.com/en/players/0dce3356/Tomas-Tavares"
2021,"Angers","Ligue 1","Rayan Aït Nouri","FRA","DF","19",2001,2.1,3,2,1,2,0,3,5,60,2,2,1,1,4,7,1,0,"https://fbref.com/en/players/9b398aea/Rayan-Ait-Nouri"
2021,"Angers","Ligue 1","Mohamed Ali Cho","FRA","FW,MF","16",2004,3.9,9,7,2,6,1,4,9,44.4,5,4,0,4,3,12,0,0,"https://fbref.com/en/players/f8405304/Mohamed-Ali-Cho"
2021,"Angers","Ligue 1","Rachid Alioui","MAR","FW","28",1992,0.2,0,0,0,0,0,0,1,0,1,0,0,0,0,0,0,0,"https://fbref.com/en/players/bdedd861/Rachid-Alioui"
2021,"Angers","Ligue 1","Ibrahim Amadou","FRA","MF","27",1993,16.7,39,26,18,19,2,15,38,39.5,23,14,4,10,23,62,25,0,"https://fbref.com/en/players/9260926b/Ibrahim-Amadou"
2021,"Angers","Ligue 1","Stéphane Bahoken","CMR","FW","28",1992,18,9,6,1,7,1,4,12,33.3,8,9,0,9,9,18,9,0,"https://fbref.com/en/players/5046b7d4/Stephane-Bahoken"
2021,"Angers","Ligue 1","Abdoulaye Bamba","CIV","DF","30",1990,15,27,17,19,7,1,19,28,67.9,9,7,1,6,19,46,34,0,"https://fbref.com/en/players/7fecbcdb/Abdoulaye-Bamba"
2021,"Angers","Ligue 1","Paul Bernardoni","FRA","GK","23",1997,38,1,1,1,0,0,1,2,50,1,0,0,0,2,3,23,1,"https://fbref.com/en/players/28dabd43/Paul-Bernardoni"
2021,"Angers","Ligue 1","Antonin Bobichon","FRA","MF,FW","24",1995,10.1,23,14,10,8,5,9,15,60,6,4,1,3,2,25,1,0,"https://fbref.com/en/players/7d937aa1/Antonin-Bobichon"
2021,"Angers","Ligue 1","Sofiane Boufal","MAR","FW,MF","26",1993,8.1,17,11,8,6,3,8,28,28.6,20,8,0,8,3,20,1,0,"https://fbref.com/en/players/b0c71810/Sofiane-Boufal"
2021,"Angers","Ligue 1","Jimmy Cabot","FRA","FW,MF","26",1994,10.5,26,13,8,14,4,11,36,30.6,25,8,0,8,12,38,6,0,"https://fbref.com/en/players/46359159/Jimmy-Cabot"
2021,"Angers","Ligue 1","Pierrick Capelle","FRA","MF,DF","33",1987,22.8,53,28,24,17,12,31,79,39.2,48,25,1,24,47,100,32,0,"https://fbref.com/en/players/79b2399c/Pierrick-Capelle"
2021,"Angers","Ligue 1","Lassana Coulibaly","MLI","MF","24",1996,18.7,78,41,33,34,11,39,75,52,36,29,4,25,33,111,17,0,"https://fbref.com/en/players/85a44ecc/Lassana-Coulibaly"
2021,"Angers","Ligue 1","Lois Diony","FRA","FW","27",1992,19.4,15,10,3,9,3,4,18,22.2,14,6,3,3,5,20,16,0,"https://fbref.com/en/players/4be0b467/Lois-Diony"
2021,"Angers","Ligue 1","Souleyman Doumbia","CIV","DF","23",1996,24.7,48,33,25,19,4,22,36,61.1,14,18,4,14,42,90,50,0,"https://fbref.com/en/players/9daeac61/Souleyman-Doumbia"
2021,"Angers","Ligue 1","Enzo Ebosse","CMR","DF","21",1999,2.9,5,3,5,0,0,3,4,75,1,1,1,0,2,7,13,0,"https://fbref.com/en/players/9ba7b4fa/Enzo-Ebosse"
2021,"Angers","Ligue 1","Noah Fatar","FRA","FW,MF","18",2002,0.2,1,0,0,0,1,0,0,NA,0,0,0,0,0,1,0,0,"https://fbref.com/en/players/2693f6bc/Noah-Fatar"
2021,"Angers","Ligue 1","Yassin Fortune","FRA","FW","21",1999,0.2,0,0,0,0,0,0,0,NA,0,0,0,0,0,0,0,0,"https://fbref.com/en/players/ddcc9e22/Yassin-Fortune"
2021,"Angers","Ligue 1","Angelo Fulgini","FRA","MF","23",1996,30.3,22,13,4,12,6,12,34,35.3,22,17,0,17,15,37,9,0,"https://fbref.com/en/players/4b96c347/Angelo-Fulgini"
2021,"Angers","Ligue 1","Wilfried Kanga","CIV","FW","22",1998,1.5,0,0,0,0,0,0,1,0,1,1,0,1,0,0,2,0,"https://fbref.com/en/players/b4c816a9/Wilfried-Kanga"
2021,"Angers","Ligue 1","Vincent Manceau","FRA","DF","31",1989,25.7,42,27,23,17,2,30,63,47.6,33,23,2,21,35,77,61,0,"https://fbref.com/en/players/c26a3918/Vincent-Manceau"
2021,"Angers","Ligue 1","Thomas Mangani","FRA","MF","33",1987,29.9,54,37,25,26,3,30,90,33.3,60,31,8,23,38,92,39,0,"https://fbref.com/en/players/c801616a/Thomas-Mangani"
2021,"Angers","Ligue 1","Farid El Melali","ALG","FW,MF","23",1997,4.6,9,5,5,4,0,2,13,15.4,11,12,0,12,6,15,2,0,"https://fbref.com/en/players/d21e361a/Farid-El-Melali"
2021,"Angers","Ligue 1","Casimir Ninga","CHA","FW","27",1993,0.3,0,0,0,0,0,0,0,NA,0,0,0,0,0,0,1,0,"https://fbref.com/en/players/91f2da4c/Casimir-Ninga"
2021,"Angers","Ligue 1","Zinédine Ould Khaled","FRA","MF","20",2000,0.4,0,0,0,0,0,0,0,NA,0,0,0,0,1,1,0,0,"https://fbref.com/en/players/6b4436ba/Zinedine-Ould-Khaled"
2021,"Angers","Ligue 1","Mateo Pavlović","BIH","DF","30",1990,12.3,11,6,8,3,0,8,23,34.8,15,13,11,2,21,32,40,0,"https://fbref.com/en/players/450e277f/Mateo-Pavlovic"
2021,"Angers","Ligue 1","Mathias Pereira Lage","POR","FW,MF","23",1996,16.3,29,17,12,15,2,10,40,25,30,21,4,17,15,44,16,0,"https://fbref.com/en/players/8846a40f/Mathias-Pereira-Lage"
2021,"Angers","Ligue 1","Baptiste Santamaria","FRA","MF","25",1995,3,9,6,3,5,1,2,7,28.6,5,4,0,4,7,16,8,0,"https://fbref.com/en/players/5e22e2a4/Baptiste-Santamaria"
2021,"Angers","Ligue 1","Waniss Taibi","FRA","MF","18",2002,0.4,0,0,0,0,0,0,2,0,2,1,0,1,0,0,0,0,"https://fbref.com/en/players/95192fe4/Waniss-Taibi"
2021,"Angers","Ligue 1","Sada Thioub","SEN","FW,MF","25",1995,14,17,14,7,6,4,7,23,30.4,16,10,0,10,9,26,3,0,"https://fbref.com/en/players/f4bc42b1/Sada-Thioub"
2021,"Angers","Ligue 1","Romain Thomas","FRA","DF","32",1988,33.6,47,25,34,11,2,20,35,57.1,15,35,20,15,50,97,138,0,"https://fbref.com/en/players/275e2c51/Romain-Thomas"
2021,"Angers","Ligue 1","Ismaël Traoré","CIV","DF","33",1986,33.3,32,14,23,9,0,20,37,54.1,17,27,13,14,40,72,107,0,"https://fbref.com/en/players/b666421b/Ismael-Traore"
2021,"Arminia","Bundesliga","Jacob Barrett Laursen","DEN","DF","25",1994,12.3,23,12,13,8,2,10,16,62.5,6,14,4,10,24,47,37,0,"https://fbref.com/en/players/c0d3bd23/Jacob-Barrett-Laursen"
2021,"Arminia","Bundesliga","Brian Behrendt","GER","DF","28",1991,0.9,0,0,0,0,0,0,1,0,1,0,0,0,0,0,1,0,"https://fbref.com/en/players/b1a21aca/Brian-Behrendt"
2021,"Arminia","Bundesliga","Cédric Brunner","SUI","DF","26",1994,29.5,42,22,24,15,3,27,40,67.5,13,30,10,20,42,84,96,0,"https://fbref.com/en/players/f0a37d36/Cedric-Brunner"
2021,"Arminia","Bundesliga","Sergio Córdova","VEN","FW,MF","22",1997,12.1,16,8,0,10,6,2,15,13.3,13,14,3,11,9,25,9,0,"https://fbref.com/en/players/229cd98a/Sergio-Cordova"
2021,"Arminia","Bundesliga","Mike van der Hoorn","NED","DF","27",1992,15.1,8,4,3,5,0,1,3,33.3,2,12,8,4,27,35,73,0,"https://fbref.com/en/players/25f50295/Mike-van-der-Hoorn"
2021,"Arminia","Bundesliga","Ritsu Doan","JPN","MF,FW","22",1998,30.8,53,31,22,19,12,19,52,36.5,33,42,1,41,31,84,11,0,"https://fbref.com/en/players/d01bbb6f/Ritsu-Doan"
2021,"Arminia","Bundesliga","Christian Gebauer","AUT","MF,FW","26",1993,7.6,9,4,2,5,2,4,11,36.4,7,4,1,3,6,15,14,0,"https://fbref.com/en/players/d847944b/Christian-Gebauer"
2021,"Arminia","Bundesliga","Marcel Hartel","GER","MF","24",1996,18.7,35,19,15,18,2,20,40,50,20,17,4,13,26,61,16,1,"https://fbref.com/en/players/614eca9b/Marcel-Hartel"
2021,"Arminia","Bundesliga","Fabian Klos","GER","FW","32",1987,30.1,24,13,9,11,4,7,26,26.9,19,20,6,14,4,28,29,0,"https://fbref.com/en/players/e21042ae/Fabian-Klos"
2021,"Arminia","Bundesliga","Fabian Kunze","GER","MF","22",1998,14.1,38,26,19,15,4,19,42,45.2,23,19,3,16,18,56,22,1,"https://fbref.com/en/players/d25fee56/Fabian-Kunze"
2021,"Arminia","Bundesliga","Anderson Lucoqui","ANG","DF","23",1997,17.8,40,25,23,17,0,20,40,50,20,30,7,23,27,67,53,0,"https://fbref.com/en/players/5569bf9a/Anderson-Lucoqui"
2021,"Arminia","Bundesliga","Arne Maier","GER","MF","21",1999,11.5,13,9,5,7,1,4,11,36.4,7,10,3,7,8,21,11,1,"https://fbref.com/en/players/ab700320/Arne-Maier"
2021,"Arminia","Bundesliga","Nathan de Medina","BEL","DF","22",1997,7.1,16,10,9,6,1,3,10,30,7,12,2,10,11,27,22,0,"https://fbref.com/en/players/d686dbc0/Nathan-de-Medina"
2021,"Arminia","Bundesliga","Sebastian Müller","GER","MF,DF","19",2001,0,0,0,0,0,0,0,0,NA,0,0,0,0,0,0,0,0,"https://fbref.com/en/players/d3585b17/Sebastian-Muller"
2021,"Arminia","Bundesliga","Joakim Nilsson","SWE","DF","26",1994,24,36,24,23,12,1,14,23,60.9,9,29,22,7,39,75,111,0,"https://fbref.com/en/players/c562c5b4/Joakim-Nilsson"
2021,"Arminia","Bundesliga","Masaya Okugawa","JPN","MF","24",1996,10.2,17,8,5,11,1,6,14,42.9,8,17,2,15,8,25,5,0,"https://fbref.com/en/players/63b9cc6d/Masaya-Okugawa"
2021,"Arminia","Bundesliga","Stefan Ortega","GER","GK","27",1992,34,2,1,2,0,0,2,6,33.3,4,0,0,0,0,2,12,3,"https://fbref.com/en/players/c1242d4e/Stefan-Ortega"
2021,"Arminia","Bundesliga","Amos Pieper","GER","DF","22",1998,29.8,58,32,39,17,2,20,33,60.6,13,48,35,13,66,124,160,3,"https://fbref.com/en/players/526ea7cc/Amos-Pieper"
2021,"Arminia","Bundesliga","Manuel Prietl","AUT","MF","28",1991,28,65,44,33,28,4,12,73,16.4,61,34,7,27,45,110,24,0,"https://fbref.com/en/players/901c0f97/Manuel-Prietl"
2021,"Arminia","Bundesliga","Sven Schipplock","GER","FW,MF","31",1988,8.3,15,8,7,6,2,6,27,22.2,21,13,2,11,6,21,8,0,"https://fbref.com/en/players/53eeaf6a/Sven-Schipplock"
2021,"Arminia","Bundesliga","Nils Seufert","GER","MF,FW","23",1997,3.8,12,9,2,5,5,2,8,25,6,3,1,2,5,17,6,0,"https://fbref.com/en/players/0da32a38/Nils-Seufert"
2021,"Arminia","Bundesliga","Jóan Símun Edmundsson","FRO","FW,MF","29",1991,0.6,0,0,0,0,0,0,0,NA,0,1,0,1,1,1,0,0,"https://fbref.com/en/players/1be390b3/Joan-Simun-Edmundsson"
2021,"Arminia","Bundesliga","Cebio Soukou","BEN","FW,MF","27",1992,5.1,12,8,5,5,2,6,11,54.5,5,3,0,3,3,15,4,0,"https://fbref.com/en/players/3c4b7820/Cebio-Soukou"
2021,"Arminia","Bundesliga","Michel Vlap","NED","MF,FW","23",1997,4.1,1,1,0,1,0,0,8,0,8,4,0,4,5,6,3,0,"https://fbref.com/en/players/02760e49/Michel-Vlap"
2021,"Arminia","Bundesliga","Andreas Voglsammer","GER","FW,MF","28",1992,11.1,12,8,6,6,0,8,17,47.1,9,11,0,11,3,15,11,0,"https://fbref.com/en/players/daa78200/Andreas-Voglsammer"
2021,"Arminia","Bundesliga","Reinhold Yabo","GER","MF,FW","28",1992,7.2,5,2,2,2,1,2,9,22.2,7,6,1,5,4,9,1,0,"https://fbref.com/en/players/7dca49f6/Reinhold-Yabo"
2021,"Arsenal","Premier League","Rúnar Alex Rúnarsson","ISL","GK","25",1995,0.2,0,0,0,0,0,0,0,NA,0,0,0,0,0,0,0,0,"https://fbref.com/en/players/8fa8f8d2/Runar-Alex-Runarsson"
2021,"Arsenal","Premier League","Pierre-Emerick Aubameyang","GAB","FW","31",1989,25.9,12,8,7,4,1,3,20,15,17,18,0,18,7,19,17,0,"https://fbref.com/en/players/d5dd5f1f/Pierre-Emerick-Aubameyang"
2021,"Arsenal","Premier League","Héctor Bellerín","ESP","DF,MF","25",1995,23.2,29,19,14,12,3,12,41,29.3,29,26,8,18,33,62,33,0,"https://fbref.com/en/players/f874dd44/Hector-Bellerin"
2021,"Arsenal","Premier League","Dani Ceballos","ESP","MF","23",1996,17.9,37,22,20,11,6,21,51,41.2,30,23,6,17,35,72,14,1,"https://fbref.com/en/players/c0617e2b/Dani-Ceballos"
2021,"Arsenal","Premier League","Calum Chambers","ENG","DF","25",1995,8.4,7,3,3,2,2,3,8,37.5,5,6,2,4,10,17,37,0,"https://fbref.com/en/players/dc6f5bdd/Calum-Chambers"
2021,"Arsenal","Premier League","Gabriel Dos Santos","BRA","DF","22",1997,22.2,25,15,19,5,1,13,19,68.4,6,27,19,8,26,51,74,2,"https://fbref.com/en/players/67ac5bb8/Gabriel-Dos-Santos"
2021,"Arsenal","Premier League","Mohamed Elneny","EGY","MF","28",1992,17.2,14,6,7,7,0,7,28,25,21,11,4,7,24,38,20,2,"https://fbref.com/en/players/47a34c4f/Mohamed-Elneny"
2021,"Arsenal","Premier League","Rob Holding","ENG","DF","24",1995,28.4,43,20,28,13,2,17,35,48.6,18,37,27,10,24,67,120,0,"https://fbref.com/en/players/d79a8c87/Rob-Holding"
2021,"Arsenal","Premier League","Sead Kolašinac","BIH","DF","27",1993,1,0,0,0,0,0,0,0,NA,0,0,0,0,1,1,0,0,"https://fbref.com/en/players/3935e52e/Sead-Kolasinac"
2021,"Arsenal","Premier League","Alexandre Lacazette","FRA","FW","29",1991,21.4,18,10,4,11,3,4,22,18.2,18,20,1,19,12,30,13,0,"https://fbref.com/en/players/9dbb75ca/Alexandre-Lacazette"
2021,"Arsenal","Premier League","Bernd Leno","GER","GK","28",1992,34.8,1,0,1,0,0,1,1,100,0,1,0,1,0,1,11,2,"https://fbref.com/en/players/2628fd2b/Bernd-Leno"
2021,"Arsenal","Premier League","David Luiz","BRA","DF","33",1987,15.5,12,9,5,7,0,4,4,100,0,16,9,7,16,28,50,2,"https://fbref.com/en/players/c0e27d1a/David-Luiz"
2021,"Arsenal","Premier League","Ainsley Maitland-Niles","ENG","MF,DF","22",1997,5.4,11,7,6,5,0,8,12,66.7,4,12,2,10,14,25,7,1,"https://fbref.com/en/players/e3a5814e/Ainsley-Maitland-Niles"
2021,"Arsenal","Premier League","Pablo Marí","ESP","DF","26",1993,10,15,9,12,3,0,5,10,50,5,8,7,1,9,24,30,2,"https://fbref.com/en/players/aa54ec6f/Pablo-Mari"
2021,"Arsenal","Premier League","Martinelli","BRA","FW","19",2001,6.5,7,1,2,3,2,4,10,40,6,6,0,6,8,15,4,0,"https://fbref.com/en/players/48a5a5d6/Martinelli"
2021,"Arsenal","Premier League","Shkodran Mustafi","GER","DF","28",1992,0.5,1,1,1,0,0,1,1,100,0,1,0,1,0,1,3,0,"https://fbref.com/en/players/3f2d59fe/Shkodran-Mustafi"
2021,"Arsenal","Premier League","Reiss Nelson","ENG","FW,MF","20",1999,0.8,1,0,0,0,1,0,0,NA,0,0,0,0,1,2,1,0,"https://fbref.com/en/players/c5bdb6e3/Reiss-Nelson"
2021,"Arsenal","Premier League","Eddie Nketiah","ENG","FW","21",1999,4.7,3,1,0,2,1,0,2,0,2,6,0,6,0,3,5,0,"https://fbref.com/en/players/a53649b7/Eddie-Nketiah"
2021,"Arsenal","Premier League","Thomas Partey","GHA","MF","27",1993,17,44,21,16,24,4,24,56,42.9,32,17,5,12,23,67,18,0,"https://fbref.com/en/players/529f49ab/Thomas-Partey"
2021,"Arsenal","Premier League","Nicolas Pépé","CIV","FW","25",1995,18,20,15,8,6,6,8,23,34.8,15,16,1,15,12,32,19,0,"https://fbref.com/en/players/57e3f0c7/Nicolas-Pepe"
2021,"Arsenal","Premier League","Mathew Ryan","AUS","GK","28",1992,3,0,0,0,0,0,0,0,NA,0,0,0,0,0,0,1,0,"https://fbref.com/en/players/4535e4bb/Mathew-Ryan"
2021,"Arsenal","Premier League","Bukayo Saka","ENG","FW,MF","18",2001,28.4,25,16,10,13,2,11,40,27.5,29,21,2,19,25,50,24,0,"https://fbref.com/en/players/bc7dc64d/Bukayo-Saka"
2021,"Arsenal","Premier League","Emile Smith Rowe","ENG","MF,FW","20",2000,16,14,7,5,5,4,6,17,35.3,11,15,1,14,10,24,12,0,"https://fbref.com/en/players/17695062/Emile-Smith-Rowe"
2021,"Arsenal","Premier League","Cédric Soares","POR","DF","28",1991,8.3,12,8,6,4,2,6,21,28.6,15,6,1,5,8,20,16,1,"https://fbref.com/en/players/839c14e1/Cedric-Soares"
2021,"Arsenal","Premier League","Kieran Tierney","SCO","DF","23",1997,25.5,27,15,5,14,8,11,31,35.5,20,31,10,21,16,43,63,0,"https://fbref.com/en/players/fce2302c/Kieran-Tierney"
2021,"Arsenal","Premier League","Willian","BRA","FW","31",1988,15.6,13,7,6,6,1,6,16,37.5,10,13,0,13,8,21,8,0,"https://fbref.com/en/players/8b9ebd03/Willian"
2021,"Arsenal","Premier League","Joe Willock","ENG","MF","20",1999,2.6,6,3,1,4,1,3,7,42.9,4,6,1,5,3,9,0,0,"https://fbref.com/en/players/a3b03921/Joe-Willock"
2021,"Arsenal","Premier League","Granit Xhaka","SUI","MF,DF","27",1992,28,50,26,18,17,15,30,58,51.7,28,23,7,16,24,74,38,3,"https://fbref.com/en/players/e61b8aee/Granit-Xhaka"
2021,"Arsenal","Premier League","Martin Ødegaard","NOR","MF","21",1998,9.6,9,3,2,6,1,4,14,28.6,10,2,0,2,2,11,5,0,"https://fbref.com/en/players/79300479/Martin-Odegaard"
2021,"Aston Villa","Premier League","Ross Barkley","ENG","MF","26",1993,17,6,2,2,4,0,3,15,20,12,9,1,8,5,11,6,1,"https://fbref.com/en/players/3a24769f/Ross-Barkley"
2021,"Aston Villa","Premier League","Matty Cash","POL","DF","22",1997,26.4,71,40,43,22,6,41,74,55.4,33,50,11,39,60,131,95,0,"https://fbref.com/en/players/2389cdc2/Matty-Cash"
2021,"Aston Villa","Premier League","Carney Chukwuemeka","ENG","MF,FW","16",2003,0.2,2,2,1,0,1,1,3,33.3,2,0,0,0,0,2,0,0,"https://fbref.com/en/players/b2f9c73e/Carney-Chukwuemeka"
2021,"Aston Villa","Premier League","Keinan Davis","ENG","FW,MF","22",1998,3.1,2,1,1,0,1,0,1,0,1,1,0,1,0,2,2,0,"https://fbref.com/en/players/9deaf2c8/Keinan-Davis"
2021,"Aston Villa","Premier League","Ahmed Elmohamady","EGY","DF","32",1987,9.3,17,13,12,4,1,9,14,64.3,5,6,3,3,17,34,26,0,"https://fbref.com/en/players/615ef733/Ahmed-Elmohamady"
2021,"Aston Villa","Premier League","Anwar El Ghazi","NED","FW","25",1995,17.9,16,13,6,7,3,7,23,30.4,16,11,0,11,6,22,11,0,"https://fbref.com/en/players/ffa90327/Anwar-El-Ghazi"
2021,"Aston Villa","Premier League","Jack Grealish","ENG","FW,MF","24",1995,24.3,31,14,8,16,7,15,24,62.5,9,20,3,17,12,43,5,3,"https://fbref.com/en/players/b0b4fd3e/Jack-Grealish"
2021,"Aston Villa","Premier League","Kortney Hause","ENG","DF","25",1995,7,4,2,3,1,0,0,3,0,3,4,2,2,8,12,53,0,"https://fbref.com/en/players/bf8fad51/Kortney-Hause"
2021,"Aston Villa","Premier League","Conor Hourihane","IRL","MF","29",1991,2.5,0,0,0,0,0,0,2,0,2,3,0,3,0,0,2,0,"https://fbref.com/en/players/fcab00a0/Conor-Hourihane"
2021,"Aston Villa","Premier League","Ezri Konsa","ENG","DF","22",1997,35.5,25,13,18,6,1,9,13,69.2,4,53,47,6,29,54,162,1,"https://fbref.com/en/players/0313a347/Ezri-Konsa"
2021,"Aston Villa","Premier League","Douglas Luiz","BRA","MF","22",1998,30.9,49,18,22,26,1,20,58,34.5,38,52,17,35,43,92,44,2,"https://fbref.com/en/players/6f7d826d/Douglas-Luiz"
2021,"Aston Villa","Premier League","Emiliano Martínez","ARG","GK","27",1992,38,3,3,3,0,0,3,4,75,1,0,0,0,2,5,10,2,"https://fbref.com/en/players/7956236f/Emiliano-Martinez"
2021,"Aston Villa","Premier League","John McGinn","SCO","MF","25",1994,37,61,37,23,31,7,27,84,32.1,57,38,6,32,43,104,23,2,"https://fbref.com/en/players/90f91999/John-McGinn"
2021,"Aston Villa","Premier League","Tyrone Mings","ENG","DF","27",1993,35.5,32,16,23,7,2,16,24,66.7,8,59,40,19,41,73,172,3,"https://fbref.com/en/players/8397a50c/Tyrone-Mings"
2021,"Aston Villa","Premier League","Wesley Moraes","BRA","FW","23",1996,0.2,0,0,0,0,0,0,1,0,1,0,0,0,0,0,0,0,"https://fbref.com/en/players/bfae110f/Wesley-Moraes"
2021,"Aston Villa","Premier League","Marvelous Nakamba","ZIM","MF","26",1994,8.3,22,14,10,11,1,7,12,58.3,5,16,5,11,17,39,9,1,"https://fbref.com/en/players/de5b5570/Marvelous-Nakamba"
2021,"Aston Villa","Premier League","Jaden Philogene Bidace","ENG","FW","18",2002,0,0,0,0,0,0,0,0,NA,0,0,0,0,0,0,0,0,"https://fbref.com/en/players/19f4d211/Jaden-Philogene-Bidace"
2021,"Aston Villa","Premier League","Jacob Ramsey","ENG","MF","19",2001,7,10,5,3,4,3,2,12,16.7,10,13,6,7,4,14,5,0,"https://fbref.com/en/players/1544f145/Jacob-Ramsey"
2021,"Aston Villa","Premier League","Morgan Sanson","FRA","MF","25",1994,3.3,7,4,4,2,1,1,4,25,3,5,0,5,4,11,1,0,"https://fbref.com/en/players/6e7f1353/Morgan-Sanson"
2021,"Aston Villa","Premier League","Matt Targett","ENG","DF","24",1995,37.8,83,39,52,20,11,56,88,63.6,32,40,14,26,55,138,102,1,"https://fbref.com/en/players/e514ab62/Matt-Targett"
2021,"Aston Villa","Premier League","Neil Taylor","WAL","DF","31",1989,0.2,1,1,1,0,0,0,0,NA,0,1,0,1,0,1,0,0,"https://fbref.com/en/players/c2f9d19f/Neil-Taylor"
2021,"Aston Villa","Premier League","Bertrand Traoré","BFA","FW","24",1995,25.7,26,10,8,10,8,10,34,29.4,24,23,1,22,15,41,14,1,"https://fbref.com/en/players/c47541e0/Bertrand-Traore"
2021,"Aston Villa","Premier League","Trézéguet","EGY","FW","25",1994,13,33,18,14,15,4,13,45,28.9,32,13,1,12,19,52,17,0,"https://fbref.com/en/players/3ae14ed1/Trezeguet"
2021,"Aston Villa","Premier League","Ollie Watkins","ENG","FW","24",1995,37,29,17,5,16,8,10,33,30.3,23,21,2,19,7,36,24,0,"https://fbref.com/en/players/aed3a70f/Ollie-Watkins"
2021,"Atalanta","Serie A","Davide Angelo Ghislandi","ITA","DF","19",2001,0.1,0,0,0,0,0,0,0,NA,0,0,0,0,0,0,1,0,"https://fbref.com/en/players/0e0e4422/Davide-Angelo-Ghislandi"
2021,"Atalanta","Serie A","Mattia Caldara","ITA","DF","26",1994,1.2,1,0,0,1,0,1,1,100,0,3,2,1,4,5,3,0,"https://fbref.com/en/players/ac7e640b/Mattia-Caldara"
2021,"Atalanta","Serie A","Fabio Depaoli","ITA","DF","23",1997,2.1,3,2,0,1,2,1,2,50,1,4,0,4,3,6,2,0,"https://fbref.com/en/players/d97f2e8d/Fabio-Depaoli"
2021,"Atalanta","Serie A","Amad Diallo","CIV","MF","18",2002,0.2,0,0,0,0,0,0,0,NA,0,0,0,0,0,0,0,0,"https://fbref.com/en/players/9dc96f10/Amad-Diallo"
2021,"Atalanta","Serie A","Berat Djimsiti","ALB","DF","27",1993,29.2,41,29,27,12,2,17,34,50,17,34,20,14,62,103,89,1,"https://fbref.com/en/players/6eee05f1/Berat-Djimsiti"
2021,"Atalanta","Serie A","Remo Freuler","SUI","MF","28",1992,30.1,63,39,17,38,8,32,76,42.1,44,52,4,48,39,102,27,2,"https://fbref.com/en/players/98d2c2c4/Remo-Freuler"
2021,"Atalanta","Serie A","Pierluigi Gollini","ITA","GK","25",1995,24,1,0,1,0,0,1,2,50,1,1,0,1,1,2,11,0,"https://fbref.com/en/players/f0f7f62f/Pierluigi-Gollini"
2021,"Atalanta","Serie A","Papu Gómez","ARG","MF,FW","32",1988,7.4,3,2,2,1,0,2,8,25,6,8,1,7,1,4,1,0,"https://fbref.com/en/players/6e4df551/Papu-Gomez"
2021,"Atalanta","Serie A","Robin Gosens","GER","DF","26",1994,28,46,35,20,15,11,17,41,41.5,24,50,7,43,41,87,34,0,"https://fbref.com/en/players/2d970560/Robin-Gosens"
2021,"Atalanta","Serie A","Manu Gyabuaa","ITA","MF","18",2001,0,0,0,0,0,0,0,0,NA,0,0,0,0,0,0,0,0,"https://fbref.com/en/players/a69eb5fd/Manu-Gyabuaa"
2021,"Atalanta","Serie A","Hans Hateboer","NED","DF","26",1994,19.6,28,17,12,14,2,13,23,56.5,10,8,1,7,17,45,9,0,"https://fbref.com/en/players/3b333ac3/Hans-Hateboer"
2021,"Atalanta","Serie A","Josip Iličić","SVN","MF,FW","32",1988,17,9,4,1,5,3,5,21,23.8,16,12,0,12,2,11,0,1,"https://fbref.com/en/players/68252d6d/Josip-Ilicic"
2021,"Atalanta","Serie A","Viktor Kovalenko","UKR","FW","24",1996,0,0,0,0,0,0,0,0,NA,0,0,0,0,0,0,1,0,"https://fbref.com/en/players/9d60028d/Viktor-Kovalenko"
2021,"Atalanta","Serie A","Sam Lammers","NED","FW,MF","23",1997,3.2,2,0,0,2,0,0,6,0,6,0,0,0,0,2,3,0,"https://fbref.com/en/players/c283ddef/Sam-Lammers"
2021,"Atalanta","Serie A","José Luis Palomino","ARG","DF","30",1990,27,67,33,41,19,7,24,48,50,24,30,16,14,79,146,60,2,"https://fbref.com/en/players/921f6058/Jose-Luis-Palomino"
2021,"Atalanta","Serie A","Ruslan Malinovskyi","UKR","MF,FW","27",1993,20.8,19,8,2,13,4,8,23,34.8,15,16,1,15,2,21,4,0,"https://fbref.com/en/players/48d5bd33/Ruslan-Malinovskyi"
2021,"Atalanta","Serie A","Aleksei Miranchuk","RUS","MF,FW","24",1995,7.5,24,13,8,9,7,6,9,66.7,3,1,0,1,3,27,1,0,"https://fbref.com/en/players/a9aa0d1d/Aleksei-Miranchuk"
2021,"Atalanta","Serie A","Johan Mojica","COL","DF","27",1992,3.3,4,4,3,1,0,2,3,66.7,1,3,0,3,7,11,6,0,"https://fbref.com/en/players/608f2092/Johan-Mojica"
2021,"Atalanta","Serie A","Luis Muriel","COL","FW","29",1991,16,20,9,4,8,8,9,26,34.6,17,17,0,17,7,27,4,0,"https://fbref.com/en/players/eb2fe5b6/Luis-Muriel"
2021,"Atalanta","Serie A","Joakim Mæhle","DEN","DF","23",1997,13.5,18,10,7,5,6,8,19,42.1,11,17,2,15,11,29,5,0,"https://fbref.com/en/players/c459a650/Joakim-Maehle"
2021,"Atalanta","Serie A","Mario Pašalić","CRO","MF","25",1995,12.5,26,15,5,17,4,12,19,63.2,7,12,1,11,8,34,6,0,"https://fbref.com/en/players/e599253a/Mario-Pasalic"
2021,"Atalanta","Serie A","Matteo Pessina","ITA","MF","23",1997,18.3,14,7,4,6,4,7,24,29.2,17,17,2,15,17,31,7,1,"https://fbref.com/en/players/780e3631/Matteo-Pessina"
2021,"Atalanta","Serie A","Cristiano Piccini","ITA","DF","27",1992,0.7,1,1,1,0,0,0,1,0,1,1,0,1,0,1,0,0,"https://fbref.com/en/players/32c0491f/Cristiano-Piccini"
2021,"Atalanta","Serie A","Cristian Romero","ARG","DF","22",1998,28.3,63,32,41,19,3,27,49,55.1,22,31,13,18,96,159,71,2,"https://fbref.com/en/players/a3d94a58/Cristian-Romero"
2021,"Atalanta","Serie A","Marten de Roon","NED","MF","29",1991,33.6,80,48,30,36,14,36,84,42.9,48,44,9,35,69,149,40,0,"https://fbref.com/en/players/2a1beb34/Marten-de-Roon"
2021,"Atalanta","Serie A","Matteo Ruggeri","ITA","DF","18",2002,2.3,3,0,1,2,0,2,3,66.7,1,2,0,2,4,7,2,0,"https://fbref.com/en/players/ae9898c5/Matteo-Ruggeri"
2021,"Atalanta","Serie A","Marco Sportiello","ITA","GK","28",1992,14,2,2,2,0,0,1,3,33.3,2,0,0,0,2,4,5,1,"https://fbref.com/en/players/ac4003af/Marco-Sportiello"
2021,"Atalanta","Serie A","Bosko Sutalo","CRO","DF","20",2000,2.6,5,5,0,3,2,4,5,80,1,2,1,1,2,7,7,1,"https://fbref.com/en/players/1d0bb7e4/Bosko-Sutalo"
2021,"Atalanta","Serie A","Rafael Tolói","ITA","DF","29",1990,28.2,51,23,21,26,4,26,48,54.2,22,37,7,30,33,84,66,0,"https://fbref.com/en/players/c56dc39e/Rafael-Toloi"
2021,"Atalanta","Serie A","Duván Zapata","COL","FW","29",1991,26.4,12,5,2,3,7,4,13,30.8,9,19,5,14,6,18,19,0,"https://fbref.com/en/players/d3de9af0/Duvan-Zapata"
2021,"Athletic Club","La Liga","Yeray Álvarez","ESP","DF","25",1995,21.6,19,12,11,8,0,9,21,42.9,12,12,5,7,53,72,73,0,"https://fbref.com/en/players/3ecc11d8/Yeray-Alvarez"
2021,"Athletic Club","La Liga","Mikel Balenziaga","ESP","DF","32",1988,18.8,26,15,11,12,3,9,18,50,9,22,7,15,7,33,46,0,"https://fbref.com/en/players/1fe67e86/Mikel-Balenziaga"
2021,"Athletic Club","La Liga","Yuri Berchiche","ESP","DF","30",1990,18.7,24,19,14,5,5,10,24,41.7,14,14,0,14,11,35,29,0,"https://fbref.com/en/players/b6e50615/Yuri-Berchiche"
2021,"Athletic Club","La Liga","Álex Berenguer","ESP","MF,FW","25",1995,25.3,47,31,21,20,6,9,51,17.6,42,48,3,45,18,65,27,0,"https://fbref.com/en/players/dc1c2fce/Alex-Berenguer"
2021,"Athletic Club","La Liga","Ander Capa","ESP","DF","28",1992,23.7,37,18,22,13,2,18,37,48.6,19,21,8,13,25,62,57,0,"https://fbref.com/en/players/37f1cf47/Ander-Capa"
2021,"Athletic Club","La Liga","Iñigo Córdoba","ESP","FW,MF","23",1997,1.1,0,0,0,0,0,0,3,0,3,4,0,4,2,2,1,0,"https://fbref.com/en/players/49ea92be/Inigo-Cordoba"
2021,"Athletic Club","La Liga","Jokin Ezkieta","ESP","GK","23",1996,1,0,0,0,0,0,0,0,NA,0,0,0,0,0,0,0,0,"https://fbref.com/en/players/0f7dbaf6/Jokin-Ezkieta"
2021,"Athletic Club","La Liga","Dani García","ESP","MF","30",1990,21.3,39,19,10,23,6,15,46,32.6,31,20,7,13,33,72,34,0,"https://fbref.com/en/players/240d3a0b/Dani-Garcia"
2021,"Athletic Club","La Liga","Raúl García","ESP","FW,MF","34",1986,19.4,34,19,9,19,6,7,22,31.8,15,30,1,29,15,49,20,0,"https://fbref.com/en/players/b418dbd4/Raul-Garcia"
2021,"Athletic Club","La Liga","Ibai Gómez","ESP","MF","30",1989,4.7,6,4,2,3,1,4,7,57.1,3,3,0,3,2,8,4,0,"https://fbref.com/en/players/9d2a3d5f/Ibai-Gomez"
2021,"Athletic Club","La Liga","Kenan Kodro","BIH","FW,MF","26",1993,0.5,0,0,0,0,0,0,1,0,1,0,0,0,0,0,0,0,"https://fbref.com/en/players/e82d2807/Kenan-Kodro"
2021,"Athletic Club","La Liga","Iñigo Lekue","ESP","DF","27",1993,7.2,9,7,6,3,0,3,8,37.5,5,8,1,7,4,13,24,0,"https://fbref.com/en/players/59b7d823/Inigo-Lekue"
2021,"Athletic Club","La Liga","Unai López","ESP","MF","24",1995,15.8,27,17,13,13,1,10,29,34.5,19,20,5,15,18,45,9,1,"https://fbref.com/en/players/88050721/Unai-Lopez"
2021,"Athletic Club","La Liga","Óscar de Marcos","ESP","DF,MF","31",1989,16.9,28,17,12,10,6,10,25,40,15,12,1,11,12,40,38,0,"https://fbref.com/en/players/9f323c71/Oscar-de-Marcos"
2021,"Athletic Club","La Liga","Iñigo Martínez","ESP","DF","29",1991,28,22,15,16,6,0,9,27,33.3,18,17,7,10,28,50,96,0,"https://fbref.com/en/players/3fc45c73/Inigo-Martinez"
2021,"Athletic Club","La Liga","Jon Morcillo","ESP","MF,FW","21",1998,15.1,16,9,3,6,7,7,30,23.3,23,9,0,9,15,31,11,0,"https://fbref.com/en/players/b7d7f3bf/Jon-Morcillo"
2021,"Athletic Club","La Liga","Iker Muniain","ESP","MF,FW","27",1992,21.6,20,7,4,10,6,6,24,25,18,15,0,15,11,31,4,0,"https://fbref.com/en/players/c05dfb74/Iker-Muniain"
2021,"Athletic Club","La Liga","Unai Núñez","ESP","DF","23",1997,23.4,23,12,16,7,0,10,15,66.7,5,19,14,5,32,55,110,0,"https://fbref.com/en/players/be170419/Unai-Nunez"
2021,"Athletic Club","La Liga","Oihan Sancet","ESP","FW,MF","20",2000,11.5,8,2,3,4,1,2,7,28.6,5,4,0,4,5,13,7,0,"https://fbref.com/en/players/bdb624a3/Oihan-Sancet"
2021,"Athletic Club","La Liga","Unai Simón","ESP","GK","23",1997,37,1,0,1,0,0,1,2,50,1,0,0,0,0,1,7,7,"https://fbref.com/en/players/5dcf3e90/Unai-Simon"
2021,"Athletic Club","La Liga","Unai Vencedor Paris","ESP","MF","19",2000,18.9,31,21,10,15,6,11,42,26.2,31,17,6,11,18,49,14,0,"https://fbref.com/en/players/4112ace5/Unai-Vencedor-Paris"
2021,"Athletic Club","La Liga","Mikel Vesga","ESP","MF","27",1993,19.1,28,14,8,16,4,12,50,24,38,28,8,20,27,55,35,1,"https://fbref.com/en/players/b0fce72c/Mikel-Vesga"
2021,"Athletic Club","La Liga","Iñigo Vicente","ESP","FW,MF","22",1998,0.6,1,1,1,0,0,1,1,100,0,0,0,0,0,1,0,0,"https://fbref.com/en/players/afafac57/Inigo-Vicente"
2021,"Athletic Club","La Liga","Asier Villalibre","ESP","FW","22",1997,17.7,3,2,0,2,1,2,8,25,6,4,0,4,2,5,16,0,"https://fbref.com/en/players/57be54ec/Asier-Villalibre"
2021,"Athletic Club","La Liga","Iñaki Williams","GHA","FW","26",1994,26.5,11,7,0,4,7,2,14,14.3,12,13,1,12,5,16,22,0,"https://fbref.com/en/players/6a99e0b1/Inaki-Williams"
2021,"Athletic Club","La Liga","Nico Williams","ESP","MF","18",2002,0.6,1,0,1,0,0,0,2,0,2,0,0,0,1,2,0,0,"https://fbref.com/en/players/afdc14d7/Nico-Williams"
2021,"Athletic Club","La Liga","Oier Zarraga","ESP","MF","21",1999,1.1,1,1,0,1,0,1,2,50,1,1,0,1,0,1,0,0,"https://fbref.com/en/players/968a1c2f/Oier-Zarraga"
2021,"Atlético Madrid","La Liga","Yannick Carrasco","BEL","DF,MF","26",1993,24.2,27,15,14,6,7,15,34,44.1,19,24,0,24,17,44,16,1,"https://fbref.com/en/players/de39485a/Yannick-Carrasco"
2021,"Atlético Madrid","La Liga","Ángel Correa","ARG","FW,MF","25",1995,26.6,38,21,10,23,5,15,45,33.3,30,18,1,17,22,60,16,0,"https://fbref.com/en/players/01eb744d/Angel-Correa"
2021,"Atlético Madrid","La Liga","Diego Costa","ESP","FW","31",1988,2.3,1,0,1,0,0,1,3,33.3,2,0,0,0,0,1,2,0,"https://fbref.com/en/players/a190d597/Diego-Costa"
2021,"Atlético Madrid","La Liga","Moussa Dembélé","FRA","FW","24",1996,1.1,0,0,0,0,0,0,1,0,1,0,0,0,1,1,0,0,"https://fbref.com/en/players/e7986081/Moussa-Dembele"
2021,"Atlético Madrid","La Liga","Felipe","BRA","DF","31",1989,22.9,29,17,19,10,0,18,23,78.3,5,30,15,15,36,65,128,2,"https://fbref.com/en/players/51a3c4c8/Felipe"
2021,"Atlético Madrid","La Liga","João Félix","POR","FW,MF","20",1999,17.5,8,4,1,6,1,4,17,23.5,13,3,0,3,5,13,2,0,"https://fbref.com/en/players/8aafd64f/Joao-Felix"
2021,"Atlético Madrid","La Liga","Mario Hermoso","ESP","DF","25",1995,28.6,55,31,40,11,4,37,61,60.7,24,23,10,13,36,91,73,0,"https://fbref.com/en/players/555f3a0b/Mario-Hermoso"
2021,"Atlético Madrid","La Liga","Héctor Herrera","MEX","MF","30",1990,7.6,12,7,5,6,1,7,13,53.8,6,7,2,5,14,26,8,0,"https://fbref.com/en/players/a8542814/Hector-Herrera"
2021,"Atlético Madrid","La Liga","Koke","ESP","MF","28",1992,33.6,64,42,22,31,11,28,98,28.6,70,35,6,29,36,100,40,0,"https://fbref.com/en/players/55126f3b/Koke"
2021,"Atlético Madrid","La Liga","Geoffrey Kondogbia","CTA","MF","27",1993,6.8,30,20,12,16,2,11,20,55,9,11,5,6,11,41,8,1,"https://fbref.com/en/players/cce181df/Geoffrey-Kondogbia"
2021,"Atlético Madrid","La Liga","Thomas Lemar","FRA","MF","24",1995,15.2,30,17,9,17,4,11,24,45.8,13,22,1,21,11,41,10,0,"https://fbref.com/en/players/4dbd0916/Thomas-Lemar"
2021,"Atlético Madrid","La Liga","Marcos Llorente","ESP","MF,FW","25",1995,32.8,71,42,21,40,10,26,62,41.9,36,40,3,37,29,100,28,0,"https://fbref.com/en/players/02c15616/Marcos-Llorente"
2021,"Atlético Madrid","La Liga","Renan Lodi","BRA","DF,FW","22",1998,12.5,30,17,13,12,5,17,26,65.4,9,15,0,15,16,46,18,0,"https://fbref.com/en/players/ed9f7cfe/Renan-Lodi"
2021,"Atlético Madrid","La Liga","José María Giménez","URU","DF","25",1995,19.6,20,7,14,5,1,12,17,70.6,5,17,11,6,21,41,65,0,"https://fbref.com/en/players/f0da930c/Jose-Maria-Gimenez"
2021,"Atlético Madrid","La Liga","Saúl Ñíguez","ESP","MF,DF","25",1994,22.6,57,34,27,23,7,30,59,50.8,29,35,2,33,19,76,43,0,"https://fbref.com/en/players/c14bc029/Saul-Niguez"
2021,"Atlético Madrid","La Liga","Jan Oblak","SVN","GK","27",1993,38,0,0,0,0,0,0,0,NA,0,0,0,0,0,0,6,2,"https://fbref.com/en/players/ee8508c0/Jan-Oblak"
2021,"Atlético Madrid","La Liga","Thomas Partey","GHA","MF","27",1993,2.2,7,4,4,3,0,5,8,62.5,3,4,1,3,2,9,1,0,"https://fbref.com/en/players/529f49ab/Thomas-Partey"
2021,"Atlético Madrid","La Liga","Ricard","ESP","DF","20",2000,0.3,1,1,0,0,1,0,0,NA,0,1,0,1,0,1,1,0,"https://fbref.com/en/players/fce521d7/Ricard"
2021,"Atlético Madrid","La Liga","Manuel Sánchez","ESP","DF","19",2000,0.5,0,0,0,0,0,0,1,0,1,1,0,1,0,0,1,0,"https://fbref.com/en/players/ffacd3d5/Manuel-Sanchez"
2021,"Atlético Madrid","La Liga","Stefan Savić","MNE","DF","29",1991,32.8,40,25,32,7,1,21,34,61.8,13,33,19,14,42,82,110,0,"https://fbref.com/en/players/f6ac68c1/Stefan-Savic"
2021,"Atlético Madrid","La Liga","Luis Suárez","URU","FW","33",1987,27.9,11,7,0,4,7,3,12,25,9,7,0,7,5,16,13,0,"https://fbref.com/en/players/a6154613/Luis-Suarez"
2021,"Atlético Madrid","La Liga","Lucas Torreira","URU","MF","24",1996,5.8,8,4,2,3,3,0,3,0,3,5,3,2,12,20,8,0,"https://fbref.com/en/players/52611641/Lucas-Torreira"
2021,"Atlético Madrid","La Liga","Kieran Trippier","ENG","DF","29",1990,27.5,61,39,30,25,6,26,52,50,26,22,4,18,40,101,58,1,"https://fbref.com/en/players/21512407/Kieran-Trippier"
2021,"Atlético Madrid","La Liga","Vitolo","ESP","MF,FW","30",1989,3.3,4,1,2,0,2,1,6,16.7,5,3,0,3,3,7,2,0,"https://fbref.com/en/players/db750822/Vitolo"
2021,"Atlético Madrid","La Liga","Šime Vrsaljko","CRO","FW,DF","28",1992,5.8,18,12,13,5,0,8,12,66.7,4,5,0,5,8,26,14,0,"https://fbref.com/en/players/46a8347f/Sime-Vrsaljko"
2021,"Augsburg","Bundesliga","Noah Joel Sarenren Bazee","NGA","FW,MF","23",1996,0.4,0,0,0,0,0,0,1,0,1,0,0,0,1,1,0,0,"https://fbref.com/en/players/fbbc8e15/Noah-Joel-Sarenren-Bazee"
2021,"Augsburg","Bundesliga","László Bénes","SVK","MF","22",1997,7.3,8,6,4,4,0,2,8,25,6,6,2,4,7,15,1,1,"https://fbref.com/en/players/fe888e39/Laszlo-Benes"
2021,"Augsburg","Bundesliga","Daniel Caligiuri","ITA","MF,FW","32",1988,29.6,71,46,29,31,11,29,92,31.5,63,45,6,39,38,109,41,0,"https://fbref.com/en/players/d1273f09/Daniel-Caligiuri"
2021,"Augsburg","Bundesliga","Tim Civeja","GER","MF","18",2002,0.4,0,0,0,0,0,0,1,0,1,0,0,0,3,3,0,0,"https://fbref.com/en/players/59a48c59/Tim-Civeja"
2021,"Augsburg","Bundesliga","Ohis Felix Uduokhai","GER","DF","22",1997,29,33,24,19,10,4,18,27,66.7,9,48,25,23,54,87,164,2,"https://fbref.com/en/players/677da306/Ohis-Felix-Uduokhai"
2021,"Augsburg","Bundesliga","Alfreð Finnbogason","ISL","FW","31",1989,6,2,1,0,1,1,0,1,0,1,7,1,6,1,3,4,0,"https://fbref.com/en/players/f9e7c4ac/Alfred-Finnbogason"
2021,"Augsburg","Bundesliga","Raphael Framberger","GER","DF","24",1995,17.1,42,23,26,11,5,19,25,76,6,24,2,22,36,78,62,1,"https://fbref.com/en/players/626fab5f/Raphael-Framberger"
2021,"Augsburg","Bundesliga","Rafał Gikiewicz","POL","GK","32",1987,34,0,0,0,0,0,0,3,0,3,0,0,0,3,3,9,1,"https://fbref.com/en/players/17376543/Rafal-Gikiewicz"
2021,"Augsburg","Bundesliga","Jeffrey Gouweleeuw","NED","DF","29",1991,31.5,36,20,24,11,1,16,33,48.5,17,37,18,19,69,105,149,2,"https://fbref.com/en/players/1025db8e/Jeffrey-Gouweleeuw"
2021,"Augsburg","Bundesliga","Michael Gregoritsch","AUT","FW,MF","26",1994,9.3,13,10,6,7,0,3,10,30,7,2,0,2,3,16,17,0,"https://fbref.com/en/players/8e235926/Michael-Gregoritsch"
2021,"Augsburg","Bundesliga","Carlos Gruezo","ECU","MF","25",1995,23.2,57,32,20,32,5,20,52,38.5,32,32,5,27,35,92,29,1,"https://fbref.com/en/players/f2dd9a21/Carlos-Gruezo"
2021,"Augsburg","Bundesliga","Robert Gumny","POL","DF","22",1998,15.3,24,15,12,9,3,15,23,65.2,8,12,2,10,18,42,31,0,"https://fbref.com/en/players/1df0c0b9/Robert-Gumny"
2021,"Augsburg","Bundesliga","André Hahn","GER","FW,MF","29",1990,22.6,31,17,14,13,4,9,44,20.5,35,35,3,32,14,45,24,0,"https://fbref.com/en/players/cd82452e/Andre-Hahn"
2021,"Augsburg","Bundesliga","Iago","BRA","DF","23",1997,17.3,37,27,21,13,3,17,29,58.6,12,17,5,12,22,59,55,0,"https://fbref.com/en/players/054849d2/Iago"
2021,"Augsburg","Bundesliga","Fredrik Jensen","FIN","FW,MF","22",1997,4.2,3,2,1,2,0,3,6,50,3,4,1,3,2,5,6,0,"https://fbref.com/en/players/3eeb80e0/Fredrik-Jensen"
2021,"Augsburg","Bundesliga","Rani Khedira","GER","MF","26",1994,20.2,29,10,13,15,1,10,20,50,10,14,5,9,31,60,47,0,"https://fbref.com/en/players/59e4b92e/Rani-Khedira"
2021,"Augsburg","Bundesliga","Jan Morávek","CZE","MF","30",1989,3,5,3,4,1,0,1,8,12.5,7,3,0,3,7,12,2,0,"https://fbref.com/en/players/e7d22eae/Jan-Moravek"
2021,"Augsburg","Bundesliga","Florian Niederlechner","GER","FW","29",1990,19.3,7,5,1,4,2,0,10,0,10,8,3,5,10,17,18,0,"https://fbref.com/en/players/d6862409/Florian-Niederlechner"
2021,"Augsburg","Bundesliga","Reece Oxford","ENG","DF","21",1998,15.1,26,18,15,11,0,10,17,58.8,7,28,22,6,29,55,89,0,"https://fbref.com/en/players/8b6e0db2/Reece-Oxford"
2021,"Augsburg","Bundesliga","Mads Pedersen","DEN","DF","23",1996,9.9,25,16,20,3,2,10,22,45.5,12,13,3,10,15,40,32,0,"https://fbref.com/en/players/582a5247/Mads-Pedersen"
2021,"Augsburg","Bundesliga","Lukas Petkov","GER","MF","19",2000,0,0,0,0,0,0,0,0,NA,0,0,0,0,0,0,0,0,"https://fbref.com/en/players/f503ef6e/Lukas-Petkov"
2021,"Augsburg","Bundesliga","Marco Richter","GER","FW,MF","22",1997,15.7,17,9,3,12,2,7,23,30.4,16,10,0,10,6,23,9,0,"https://fbref.com/en/players/f972644c/Marco-Richter"
2021,"Augsburg","Bundesliga","Tobias Strobl","GER","MF","30",1990,20.5,21,10,12,9,0,10,30,33.3,20,21,8,13,28,49,27,0,"https://fbref.com/en/players/17780d2b/Tobias-Strobl"
2021,"Augsburg","Bundesliga","Marek Suchý","CZE","DF","32",1988,3.4,4,2,1,3,0,1,2,50,1,3,3,0,4,8,9,0,"https://fbref.com/en/players/c5224618/Marek-Suchy"
2021,"Augsburg","Bundesliga","Ruben Vargas","SUI","MF,FW","21",1998,17.9,18,12,6,9,3,1,16,6.3,15,26,2,24,18,36,27,0,"https://fbref.com/en/players/6ecbddf6/Ruben-Vargas"
2021,"Barcelona","La Liga","Jordi Alba","ESP","DF,FW","31",1989,33.6,45,30,22,16,7,24,52,46.2,28,21,2,19,49,94,48,0,"https://fbref.com/en/players/4601e194/Jordi-Alba"
2021,"Barcelona","La Liga","Carles Aleñá","ESP","MF","22",1998,0.5,1,0,1,0,0,0,0,NA,0,0,0,0,0,1,0,0,"https://fbref.com/en/players/6c811eb7/Carles-Alena"
2021,"Barcelona","La Liga","Ronald Araújo","URU","DF","21",1999,16.8,22,11,12,8,2,9,9,100,0,24,15,9,20,42,47,1,"https://fbref.com/en/players/2bef2bca/Ronald-Araujo"
2021,"Barcelona","La Liga","Martin Braithwaite","DEN","FW","29",1991,13.1,8,4,2,3,3,1,6,16.7,5,2,0,2,6,14,7,0,"https://fbref.com/en/players/fd771f95/Martin-Braithwaite"
2021,"Barcelona","La Liga","Sergio Busquets","ESP","MF","32",1988,28,63,35,21,29,13,27,76,35.5,49,27,4,23,53,116,18,2,"https://fbref.com/en/players/5ab0ea87/Sergio-Busquets"
2021,"Barcelona","La Liga","Philippe Coutinho","BRA","MF,FW","28",1992,7.3,8,6,2,5,1,3,9,33.3,6,7,0,7,2,10,1,0,"https://fbref.com/en/players/0ef89a37/Philippe-Coutinho"
2021,"Barcelona","La Liga","Ousmane Dembélé","FRA","FW","23",1997,19.7,14,9,4,9,1,6,17,35.3,11,10,0,10,9,23,3,1,"https://fbref.com/en/players/b19db005/Ousmane-Dembele"
2021,"Barcelona","La Liga","Sergiño Dest","USA","DF,FW","19",2000,21.2,31,16,23,6,2,18,32,56.3,14,25,4,21,10,41,24,1,"https://fbref.com/en/players/5976f83e/Sergino-Dest"
2021,"Barcelona","La Liga","Ansu Fati","ESP","FW","17",2002,4.8,9,4,2,4,3,2,10,20,8,4,0,4,3,12,1,0,"https://fbref.com/en/players/0ba976e4/Ansu-Fati"
2021,"Barcelona","La Liga","Junior Firpo","ESP","DF,MF","23",1996,3.2,1,1,1,0,0,0,1,0,1,5,3,2,4,5,7,0,"https://fbref.com/en/players/24f59bb2/Junior-Firpo"
2021,"Barcelona","La Liga","Antoine Griezmann","FRA","FW,MF","29",1991,28.9,37,22,10,18,9,12,40,30,28,20,1,19,12,49,11,0,"https://fbref.com/en/players/df69b544/Antoine-Griezmann"
2021,"Barcelona","La Liga","Frenkie de Jong","NED","MF,DF","23",1997,35,44,27,21,19,4,15,35,42.9,20,20,4,16,38,82,29,2,"https://fbref.com/en/players/1bacc518/Frenkie-de-Jong"
2021,"Barcelona","La Liga","Clément Lenglet","FRA","DF","25",1995,27.5,36,21,23,10,3,19,28,67.9,9,26,12,14,33,69,71,1,"https://fbref.com/en/players/4f28a6ff/Clement-Lenglet"
2021,"Barcelona","La Liga","Lionel Messi","ARG","FW,MF","33",1987,33.6,18,10,3,9,6,6,17,35.3,11,12,0,12,6,24,0,2,"https://fbref.com/en/players/d70ce98e/Lionel-Messi"
2021,"Barcelona","La Liga","Óscar Mingueza","ESP","DF","21",1999,21.1,52,33,28,17,7,30,53,56.6,23,19,6,13,20,72,48,2,"https://fbref.com/en/players/056269d7/Oscar-Mingueza"
2021,"Barcelona","La Liga","Ilaix Moriba","GUI","MF","17",2003,6,14,6,5,7,2,5,10,50,5,16,1,15,5,19,4,1,"https://fbref.com/en/players/f4c69aa6/Ilaix-Moriba"
2021,"Barcelona","La Liga","Neto","BRA","GK","31",1989,7,0,0,0,0,0,0,1,0,1,0,0,0,0,0,3,1,"https://fbref.com/en/players/a9dc785c/Neto"
2021,"Barcelona","La Liga","Pedri","ESP","MF","17",2002,26.8,44,27,16,16,12,17,71,23.9,54,46,1,45,33,77,7,0,"https://fbref.com/en/players/0d9b2d31/Pedri"
2021,"Barcelona","La Liga","Gerard Piqué","ESP","DF","33",1987,16.5,16,11,11,5,0,9,12,75,3,9,4,5,26,42,46,0,"https://fbref.com/en/players/adfc9123/Gerard-Pique"
2021,"Barcelona","La Liga","Miralem Pjanić","BIH","MF","30",1990,7,13,8,7,4,2,7,13,53.8,6,5,1,4,11,24,5,0,"https://fbref.com/en/players/ad6df2d5/Miralem-Pjanic"
2021,"Barcelona","La Liga","Riqui Puig","ESP","MF,FW","20",1999,3.2,5,3,1,3,1,4,8,50,4,0,0,0,1,6,0,0,"https://fbref.com/en/players/f090a37a/Riqui-Puig"
2021,"Barcelona","La Liga","Sergi Roberto","ESP","DF,FW","28",1992,10.5,9,6,5,2,2,7,13,53.8,6,12,6,6,10,19,20,0,"https://fbref.com/en/players/335fa267/Sergi-Roberto"
2021,"Barcelona","La Liga","Marc-André ter Stegen","GER","GK","28",1992,31,0,0,0,0,0,0,2,0,2,0,0,0,0,0,12,2,"https://fbref.com/en/players/6f51e382/Marc-Andre-ter-Stegen"
2021,"Barcelona","La Liga","Francisco Trincão","POR","FW,MF","20",1999,7.8,4,2,0,3,1,2,5,40,3,4,0,4,1,5,2,0,"https://fbref.com/en/players/77e39b04/Francisco-Trincao"
2021,"Barcelona","La Liga","Samuel Umtiti","FRA","DF","26",1993,7.2,5,1,3,2,0,1,2,50,1,11,6,5,9,14,15,0,"https://fbref.com/en/players/3eed9821/Samuel-Umtiti"
2021,"Bayern Munich","Bundesliga","David Alaba","AUT","DF,MF","28",1992,29.7,37,21,14,19,4,17,32,53.1,15,29,13,16,43,80,60,0,"https://fbref.com/en/players/05439de2/David-Alaba"
2021,"Bayern Munich","Bundesliga","Jérôme Boateng","GER","DF","31",1988,26.3,26,16,17,8,1,14,32,43.8,18,24,17,7,40,66,63,1,"https://fbref.com/en/players/2db2fd7b/Jerome-Boateng"
2021,"Bayern Munich","Bundesliga","Kingsley Coman","FRA","FW,MF","24",1996,19.5,14,8,6,7,1,2,21,9.5,19,22,0,22,4,18,3,0,"https://fbref.com/en/players/042e8a49/Kingsley-Coman"
2021,"Bayern Munich","Bundesliga","Douglas Costa","BRA","FW,MF","29",1990,3.6,2,1,1,1,0,1,3,33.3,2,7,0,7,2,4,1,0,"https://fbref.com/en/players/4fa7cb9b/Douglas-Costa"
2021,"Bayern Munich","Bundesliga","Mickaël Cuisance","FRA","FW","20",1999,0.2,0,0,0,0,0,0,0,NA,0,1,0,1,0,0,0,0,"https://fbref.com/en/players/5722eced/Mickael-Cuisance"
2021,"Bayern Munich","Bundesliga","Tiago Dantas","POR","MF","19",2000,0.8,1,1,0,0,1,0,0,NA,0,0,0,0,0,1,0,0,"https://fbref.com/en/players/234204f4/Tiago-Dantas"
2021,"Bayern Munich","Bundesliga","Alphonso Davies","CAN","DF","19",2000,19.6,39,27,16,17,6,28,40,70,12,21,1,20,28,67,33,1,"https://fbref.com/en/players/d781d855/Alphonso-Davies"
2021,"Bayern Munich","Bundesliga","Serge Gnabry","GER","FW,MF","25",1995,18.3,39,19,7,19,13,12,32,37.5,20,17,0,17,26,65,3,0,"https://fbref.com/en/players/88e357ef/Serge-Gnabry"
2021,"Bayern Munich","Bundesliga","Leon Goretzka","GER","MF","25",1995,18.9,37,23,12,21,4,16,39,41,23,30,2,28,44,81,11,0,"https://fbref.com/en/players/cc86b9a3/Leon-Goretzka"
2021,"Bayern Munich","Bundesliga","Lucas Hernández","FRA","DF","24",1996,17.7,41,31,16,17,8,17,31,54.8,14,24,6,18,19,60,38,0,"https://fbref.com/en/players/c3ee18ef/Lucas-Hernandez"
2021,"Bayern Munich","Bundesliga","Joshua Kimmich","GER","MF","25",1995,24.4,40,28,16,19,5,10,53,18.9,43,25,5,20,36,76,19,0,"https://fbref.com/en/players/49296448/Joshua-Kimmich"
2021,"Bayern Munich","Bundesliga","Robert Lewandowski","POL","FW","31",1988,27.3,15,9,0,7,8,2,13,15.4,11,9,1,8,3,18,11,0,"https://fbref.com/en/players/8d78e732/Robert-Lewandowski"
2021,"Bayern Munich","Bundesliga","Javi Martínez","ESP","DF,MF","31",1988,5.2,10,5,4,4,2,7,9,77.8,2,8,4,4,13,23,19,0,"https://fbref.com/en/players/7f97771d/Javi-Martinez"
2021,"Bayern Munich","Bundesliga","Eric Maxim Choupo-Moting","CMR","FW,MF","31",1989,9.1,8,2,0,5,3,1,4,25,3,6,0,6,2,10,7,0,"https://fbref.com/en/players/0e6bc38c/Eric-Maxim-Choupo-Moting"
2021,"Bayern Munich","Bundesliga","Thomas Müller","GER","MF","30",1989,29.7,49,22,11,23,15,24,73,32.9,49,43,3,40,21,70,18,1,"https://fbref.com/en/players/3c6089ab/Thomas-Muller"
2021,"Bayern Munich","Bundesliga","Jamal Musiala","GER","FW,MF","17",2003,9.8,20,12,5,7,8,7,22,31.8,15,17,2,15,14,34,3,0,"https://fbref.com/en/players/2c0558b8/Jamal-Musiala"
2021,"Bayern Munich","Bundesliga","Manuel Neuer","GER","GK","34",1986,33,0,0,0,0,0,0,1,0,1,0,0,0,2,2,12,3,"https://fbref.com/en/players/8778c910/Manuel-Neuer"
2021,"Bayern Munich","Bundesliga","Tanguy Nianzou","FRA","DF,FW","18",2002,1.3,3,1,3,0,0,1,1,100,0,0,0,0,3,6,1,0,"https://fbref.com/en/players/5853ac44/Tanguy-Nianzou"
2021,"Bayern Munich","Bundesliga","Alexander Nübel","GER","GK","23",1996,1,0,0,0,0,0,0,0,NA,0,0,0,0,0,0,1,0,"https://fbref.com/en/players/afb0c500/Alexander-Nubel"
2021,"Bayern Munich","Bundesliga","Benjamin Pavard","FRA","DF","24",1996,21.6,44,27,20,16,8,23,40,57.5,17,29,5,24,48,92,31,1,"https://fbref.com/en/players/45a03961/Benjamin-Pavard"
2021,"Bayern Munich","Bundesliga","Chris Richards","USA","DF","20",2000,1,0,0,0,0,0,0,0,NA,0,0,0,0,1,1,1,0,"https://fbref.com/en/players/0a3d6d2b/Chris-Richards"
2021,"Bayern Munich","Bundesliga","Marc Roca","ESP","MF","23",1996,2,2,2,0,0,2,0,4,0,4,4,1,3,2,4,1,0,"https://fbref.com/en/players/da27e268/Marc-Roca"
2021,"Bayern Munich","Bundesliga","Leroy Sané","GER","FW,MF","24",1996,20.1,18,10,2,10,6,13,30,43.3,17,23,1,22,9,27,8,1,"https://fbref.com/en/players/2b114be3/Leroy-Sane"
2021,"Bayern Munich","Bundesliga","Bouna Sarr","SEN","DF","28",1992,5,9,8,4,3,2,3,6,50,3,7,0,7,10,19,7,1,"https://fbref.com/en/players/1a4b9094/Bouna-Sarr"
2021,"Bayern Munich","Bundesliga","Christopher Scott","GER","MF,FW","18",2002,0.4,2,1,0,1,1,2,2,100,0,0,0,0,0,2,1,0,"https://fbref.com/en/players/2723ce5d/Christopher-Scott"
2021,"Bayern Munich","Bundesliga","Josip Stanišić","CRO","DF","20",2000,1,2,2,1,1,0,1,1,100,0,3,0,3,2,4,2,0,"https://fbref.com/en/players/7ed08d5c/Josip-Stanisic"
2021,"Bayern Munich","Bundesliga","Niklas Süle","GER","DF","24",1995,16.7,32,21,15,14,3,13,21,61.9,8,24,12,12,21,53,36,1,"https://fbref.com/en/players/e33c06cf/Niklas-Sule"
2021,"Bayern Munich","Bundesliga","Corentin Tolisso","FRA","MF","25",1994,8.7,19,19,4,11,4,9,29,31,20,15,2,13,6,25,8,0,"https://fbref.com/en/players/652d4c37/Corentin-Tolisso"
2021,"Bayern Munich","Bundesliga","Joshua Zirkzee","NED","FW","19",2001,1,1,0,0,1,0,1,2,50,1,0,0,0,0,1,0,0,"https://fbref.com/en/players/028e70b9/Joshua-Zirkzee"
2021,"Benevento","Serie A","Federico Barba","ITA","DF","26",1993,29.5,31,16,22,8,1,21,35,60,14,39,18,21,48,79,94,4,"https://fbref.com/en/players/c010b898/Federico-Barba"
2021,"Benevento","Serie A","Luca Caldirola","ITA","DF","29",1991,17.5,21,13,13,6,2,10,22,45.5,12,20,15,5,20,41,56,0,"https://fbref.com/en/players/226008f1/Luca-Caldirola"
2021,"Benevento","Serie A","Gianluca Caprari","ITA","MF,FW","27",1993,20.7,16,11,5,5,6,6,31,19.4,25,19,1,18,18,34,8,0,"https://fbref.com/en/players/54e53b7e/Gianluca-Caprari"
2021,"Benevento","Serie A","Bryan Dabo","BFA","MF","28",1992,12.4,11,8,5,3,3,5,16,31.3,11,7,1,6,13,24,16,0,"https://fbref.com/en/players/c53083ad/Bryan-Dabo"
2021,"Benevento","Serie A","Lorenzo Del Pinto","ITA","MF","30",1990,0.1,0,0,0,0,0,0,2,0,2,0,0,0,0,0,0,0,"https://fbref.com/en/players/081b6080/Lorenzo-Del-Pinto"
2021,"Benevento","Serie A","Fabio Depaoli","ITA","DF","23",1997,12.4,25,13,15,6,4,15,32,46.9,17,16,4,12,12,37,38,0,"https://fbref.com/en/players/d97f2e8d/Fabio-Depaoli"
2021,"Benevento","Serie A","Giuseppe Di Serio","ITA","FW,MF","19",2001,3.2,2,2,1,1,0,0,4,0,4,5,0,5,0,2,4,0,"https://fbref.com/en/players/5048486b/Giuseppe-Di-Serio"
2021,"Benevento","Serie A","Amadou Diambo","GHA","FW","19",2001,0,0,0,0,0,0,0,0,NA,0,0,0,0,0,0,0,0,"https://fbref.com/en/players/c3a847c7/Amadou-Diambo"
2021,"Benevento","Serie A","Iago Falque","ESP","MF,FW","30",1990,4,4,2,2,2,0,1,6,16.7,5,4,1,3,0,4,1,0,"https://fbref.com/en/players/440c84ed/Iago-Falque"
2021,"Benevento","Serie A","Daam Foulon","BEL","DF","21",1999,11.3,26,15,21,5,0,16,28,57.1,12,12,3,9,14,40,34,0,"https://fbref.com/en/players/658d44be/Daam-Foulon"
2021,"Benevento","Serie A","Adolfo Gaich","ARG","FW","21",1999,8.5,9,4,1,7,1,1,13,7.7,12,4,0,4,2,11,4,0,"https://fbref.com/en/players/8dfed6e9/Adolfo-Gaich"
2021,"Benevento","Serie A","Kamil Glik","POL","DF","32",1988,35.6,44,24,33,10,1,25,53,47.2,28,37,31,6,62,106,153,0,"https://fbref.com/en/players/c6056d58/Kamil-Glik"
2021,"Benevento","Serie A","Përparim Hetemaj","FIN","MF","33",1986,24.6,44,27,21,18,5,26,61,42.6,35,41,5,36,22,66,24,1,"https://fbref.com/en/players/90b70194/Perparim-Hetemaj"
2021,"Benevento","Serie A","Riccardo Improta","ITA","DF,MF","26",1993,25.9,39,23,25,8,6,21,45,46.7,24,23,4,19,28,67,47,0,"https://fbref.com/en/players/f6dfa5b8/Riccardo-Improta"
2021,"Benevento","Serie A","Roberto Insigne","ITA","MF,FW","26",1994,17.8,16,10,8,3,5,7,27,25.9,20,10,0,10,7,23,9,0,"https://fbref.com/en/players/8faf7b3c/Roberto-Insigne"
2021,"Benevento","Serie A","Artur Ioniță","MDA","MF","29",1990,31.5,47,22,11,31,5,17,63,27,46,38,14,24,19,66,28,0,"https://fbref.com/en/players/cedb3e36/Artur-Ionita"
2021,"Benevento","Serie A","Gianluca Lapadula","PER","FW","30",1990,28.5,22,12,3,13,6,6,25,24,19,18,3,15,5,27,16,0,"https://fbref.com/en/players/2ead2809/Gianluca-Lapadula"
2021,"Benevento","Serie A","Gaetano Letizia","ITA","DF","30",1990,17.4,36,25,19,13,4,17,36,47.2,19,15,3,12,20,56,42,1,"https://fbref.com/en/players/3dd45b70/Gaetano-Letizia"
2021,"Benevento","Serie A","Christian Maggio","ITA","DF","38",1982,3.3,9,4,2,7,0,3,9,33.3,6,4,1,3,2,11,6,0,"https://fbref.com/en/players/31d7f557/Christian-Maggio"
2021,"Benevento","Serie A","Niccolò Manfredini","ITA","GK","32",1988,1,0,0,0,0,0,0,0,NA,0,0,0,0,0,0,2,1,"https://fbref.com/en/players/e4b39692/Niccolo-Manfredini"
2021,"Benevento","Serie A","Gabriele Moncini","ITA","FW,MF","24",1996,4,2,1,2,0,0,0,1,0,1,2,0,2,2,4,4,0,"https://fbref.com/en/players/c4efe2b4/Gabriele-Moncini"
2021,"Benevento","Serie A","Lorenzo Montipò","ITA","GK","24",1996,37,0,0,0,0,0,0,0,NA,0,1,0,1,0,0,16,3,"https://fbref.com/en/players/c1d95617/Lorenzo-Montipo"
2021,"Benevento","Serie A","Christian Pastina","ITA","DF","19",2001,1.3,0,0,0,0,0,0,1,0,1,1,0,1,1,1,8,0,"https://fbref.com/en/players/38bf62b5/Christian-Pastina"
2021,"Benevento","Serie A","Siriki Sanogo","CIV","MF","18",2001,0.1,0,0,0,0,0,0,0,NA,0,0,0,0,0,0,0,0,"https://fbref.com/en/players/ff120e44/Siriki-Sanogo"
2021,"Benevento","Serie A","Marco Sau","ITA","MF,FW","32",1987,8.7,6,2,0,6,0,1,16,6.3,15,7,0,7,5,11,3,0,"https://fbref.com/en/players/1ad1f50d/Marco-Sau"
2021,"Benevento","Serie A","Pasquale Schiattarella","ITA","MF","33",1987,25,37,22,25,12,0,19,47,40.4,28,19,5,14,32,69,29,2,"https://fbref.com/en/players/bd84fc61/Pasquale-Schiattarella"
2021,"Benevento","Serie A","Andrés Tello","COL","DF,MF","23",1996,4.6,9,6,8,0,1,5,20,25,15,8,1,7,6,15,6,0,"https://fbref.com/en/players/5f951ef1/Andres-Tello"
2021,"Benevento","Serie A","Alessandro Tuia","ITA","DF","30",1990,19.6,39,17,34,4,1,15,25,60,10,22,10,12,36,75,91,1,"https://fbref.com/en/players/26c54058/Alessandro-Tuia"
2021,"Benevento","Serie A","Nicolas Viola","ITA","MF","30",1989,11.5,16,9,2,11,3,6,28,21.4,22,10,3,7,9,25,7,0,"https://fbref.com/en/players/45392b06/Nicolas-Viola"
2021,"Betis","La Liga","Paul Akouokou","CIV","MF","22",1997,4.2,11,8,2,8,1,5,8,62.5,3,3,1,2,6,17,7,0,"https://fbref.com/en/players/31f5b89b/Paul-Akouokou"
2021,"Betis","La Liga","Marc Bartra","ESP","DF","29",1991,18.8,27,16,18,8,1,12,22,54.5,10,19,5,14,40,67,74,3,"https://fbref.com/en/players/b742cc0d/Marc-Bartra"
2021,"Betis","La Liga","Claudio Bravo","CHI","GK","37",1983,20,0,0,0,0,0,0,1,0,1,0,0,0,0,0,11,0,"https://fbref.com/en/players/10072610/Claudio-Bravo"
2021,"Betis","La Liga","Sergio Canales","ESP","MF,FW","29",1991,27.8,16,9,9,6,1,3,21,14.3,18,18,0,18,13,29,5,0,"https://fbref.com/en/players/a6de370d/Sergio-Canales"
2021,"Betis","La Liga","William Carvalho","POR","MF","28",1992,13.6,19,12,7,11,1,5,21,23.8,16,11,3,8,11,30,14,1,"https://fbref.com/en/players/dee86451/William-Carvalho"
2021,"Betis","La Liga","Emerson","BRA","DF","21",1999,33.2,91,52,62,25,4,43,78,55.1,35,33,6,27,61,152,102,2,"https://fbref.com/en/players/df8b52a5/Emerson"
2021,"Betis","La Liga","Nabil Fekir","FRA","MF,FW","27",1993,29.1,45,23,9,22,14,7,43,16.3,36,31,2,29,8,53,2,0,"https://fbref.com/en/players/bece776f/Nabil-Fekir"
2021,"Betis","La Liga","Andrés Guardado","MEX","MF","33",1986,14.6,25,12,10,11,4,10,25,40,15,13,3,10,18,43,19,0,"https://fbref.com/en/players/ef322658/Andres-Guardado"
2021,"Betis","La Liga","Borja Iglesias","ESP","FW","27",1993,15.7,1,1,0,0,1,1,8,12.5,7,7,2,5,3,4,9,0,"https://fbref.com/en/players/75645f0e/Borja-Iglesias"
2021,"Betis","La Liga","Joaquín","ESP","FW,MF","39",1981,14.3,9,3,1,5,3,4,12,33.3,8,8,0,8,17,26,11,0,"https://fbref.com/en/players/4c5b14d2/Joaquin"
2021,"Betis","La Liga","Juanmi","ESP","FW,MF","27",1993,6.7,13,9,3,5,5,4,18,22.2,14,4,0,4,2,15,4,0,"https://fbref.com/en/players/84399660/Juanmi"
2021,"Betis","La Liga","Diego Lainez","MEX","FW,MF","20",2000,9.6,9,4,3,5,1,6,16,37.5,10,15,0,15,11,20,6,0,"https://fbref.com/en/players/bf12926c/Diego-Lainez"
2021,"Betis","La Liga","Aïssa Mandi","ALG","DF","28",1991,26.6,30,17,20,10,0,10,16,62.5,6,21,13,8,39,69,90,0,"https://fbref.com/en/players/fbd6378b/Aissa-Mandi"
2021,"Betis","La Liga","Juan Miranda","ESP","DF","20",2000,18.4,27,11,16,9,2,16,32,50,16,18,2,16,29,56,58,1,"https://fbref.com/en/players/ead61f73/Juan-Miranda"
2021,"Betis","La Liga","Martín Montoya","ESP","DF","29",1991,2.7,6,3,2,2,2,1,3,33.3,2,1,1,0,2,8,6,0,"https://fbref.com/en/players/5cec2487/Martin-Montoya"
2021,"Betis","La Liga","Álex Moreno","ESP","DF","27",1993,19.8,42,26,25,12,5,20,43,46.5,23,18,4,14,35,77,48,0,"https://fbref.com/en/players/16e9d0ea/Alex-Moreno"
2021,"Betis","La Liga","Loren Morón","ESP","FW","26",1993,11,11,7,2,6,3,1,16,6.3,15,11,0,11,3,14,14,0,"https://fbref.com/en/players/3aa4a3be/Loren-Moron"
2021,"Betis","La Liga","Joel Robles","ESP","GK","30",1990,18,0,0,0,0,0,0,1,0,1,1,0,1,0,0,11,2,"https://fbref.com/en/players/cda0b317/Joel-Robles"
2021,"Betis","La Liga","Rodrigo","ESP","FW,MF","20",2000,6,3,3,1,2,0,1,6,16.7,5,7,0,7,2,5,0,0,"https://fbref.com/en/players/85bed4ee/Rodrigo"
2021,"Betis","La Liga","Guido Rodríguez","ARG","MF","26",1994,31.8,98,56,52,40,6,40,85,47.1,45,52,14,38,68,166,58,2,"https://fbref.com/en/players/34e393f2/Guido-Rodriguez"
2021,"Betis","La Liga","Aitor Ruibal","ESP","FW,MF","24",1996,17.7,32,18,14,14,4,10,35,28.6,25,26,0,26,11,43,8,0,"https://fbref.com/en/players/a55d8df5/Aitor-Ruibal"
2021,"Betis","La Liga","Víctor Ruiz","ESP","DF","31",1989,24,11,7,7,4,0,4,13,30.8,9,17,13,4,44,55,85,0,"https://fbref.com/en/players/b3dc6eca/Victor-Ruiz"
2021,"Betis","La Liga","Antonio Sanabria","PAR","FW","24",1996,10.4,5,5,0,4,1,0,2,0,2,8,1,7,3,8,9,0,"https://fbref.com/en/players/0a447501/Antonio-Sanabria"
2021,"Betis","La Liga","Sidnei","BRA","DF","30",1989,7.7,9,3,6,3,0,4,9,44.4,5,6,4,2,16,25,28,0,"https://fbref.com/en/players/b14d0c5d/Sidnei"
2021,"Betis","La Liga","Cristian Tello","ESP","FW,MF","28",1991,14.3,16,10,5,9,2,4,22,18.2,18,14,0,14,11,27,8,0,"https://fbref.com/en/players/72a99e38/Cristian-Tello"
2021,"Bologna","Serie A","Wisdom Amey","ITA","DF","14",2005,0,0,0,0,0,0,0,0,NA,0,0,0,0,0,0,0,0,"https://fbref.com/en/players/35b4bc62/Wisdom-Amey"
2021,"Bologna","Serie A","Valentin Antov","BUL","DF","19",2000,2.6,4,2,3,1,0,3,10,30,7,6,5,1,4,8,13,0,"https://fbref.com/en/players/8f68aa41/Valentin-Antov"
2021,"Bologna","Serie A","Musa Barrow","GAM","FW,MF","21",1998,32.5,26,10,8,10,8,10,25,40,15,37,2,35,11,37,15,0,"https://fbref.com/en/players/e5bf73f3/Musa-Barrow"
2021,"Bologna","Serie A","Arturo Calabresi","ITA","DF,FW","24",1996,0.2,0,0,0,0,0,0,0,NA,0,0,0,0,0,0,2,0,"https://fbref.com/en/players/34bb6fbd/Arturo-Calabresi"
2021,"Bologna","Serie A","Angelo da Costa Júnior","BRA","GK","36",1983,6,0,0,0,0,0,0,0,NA,0,0,0,0,0,0,2,3,"https://fbref.com/en/players/18736214/Angelo-da-Costa-Junior"
2021,"Bologna","Serie A","Lorenzo De Silvestri","ITA","DF","32",1988,23.8,34,24,18,13,3,16,37,43.2,21,37,10,27,30,64,62,3,"https://fbref.com/en/players/e74f0e59/Lorenzo-De-Silvestri"
2021,"Bologna","Serie A","Stefano Denswil","NED","DF","27",1993,1.3,2,1,1,1,0,0,1,0,1,1,0,1,1,3,1,0,"https://fbref.com/en/players/5832ebfe/Stefano-Denswil"
2021,"Bologna","Serie A","Mitchell Dijks","NED","DF","27",1993,16.5,21,14,15,5,1,12,21,57.1,9,17,2,15,17,38,35,0,"https://fbref.com/en/players/0a3065c8/Mitchell-Dijks"
2021,"Bologna","Serie A","Nicolás Domínguez","ARG","MF","22",1998,13.9,48,28,26,17,5,15,37,40.5,22,26,7,19,24,72,20,0,"https://fbref.com/en/players/20b3a502/Nicolas-Dominguez"
2021,"Bologna","Serie A","Andri Fannar Baldursson","ISL","MF","18",2002,2.4,6,6,1,2,3,1,3,33.3,2,3,1,2,3,9,7,0,"https://fbref.com/en/players/61f2f56a/Andri-Fannar-Baldursson"
2021,"Bologna","Serie A","Paolo Faragò","ITA","DF","27",1993,0.3,1,1,1,0,0,1,2,50,1,1,0,1,0,1,0,0,"https://fbref.com/en/players/9085dd7c/Paolo-Farago"
2021,"Bologna","Serie A","Aaron Hickey","SCO","DF","18",2002,8.4,12,8,10,2,0,7,17,41.2,10,6,1,5,15,27,15,1,"https://fbref.com/en/players/1780bb4a/Aaron-Hickey"
2021,"Bologna","Serie A","Musa Juwara","GAM","MF,DF","18",2001,0.5,2,2,2,0,0,1,3,33.3,2,1,0,1,0,2,0,0,"https://fbref.com/en/players/7737dee2/Musa-Juwara"
2021,"Bologna","Serie A","Omar Khailoti","ITA","DF","18",2001,0.3,0,0,0,0,0,0,0,NA,0,2,0,2,1,1,0,0,"https://fbref.com/en/players/19d1c41f/Omar-Khailoti"
2021,"Bologna","Serie A","Danilo Larangeira","BRA","DF","36",1984,34.8,33,24,23,10,0,8,29,27.6,21,58,36,22,51,84,127,2,"https://fbref.com/en/players/fed5f993/Danilo-Larangeira"
2021,"Bologna","Serie A","Ibrahima Mbaye","SEN","DF","25",1994,4.8,6,5,5,1,0,3,5,60,2,5,3,2,1,7,10,0,"https://fbref.com/en/players/cfbf9881/Ibrahima-Mbaye"
2021,"Bologna","Serie A","Gary Medel","CHI","DF,MF","32",1987,5.7,12,9,6,5,1,4,10,40,6,8,6,2,7,19,10,0,"https://fbref.com/en/players/563a68ad/Gary-Medel"
2021,"Bologna","Serie A","Riccardo Orsolini","ITA","FW,MF","23",1997,19.5,37,18,13,12,12,16,39,41,23,22,3,19,10,47,22,0,"https://fbref.com/en/players/e14ec482/Riccardo-Orsolini"
2021,"Bologna","Serie A","Mattia Pagliuca","ITA","MF","18",2002,0.1,0,0,0,0,0,0,0,NA,0,0,0,0,1,1,0,0,"https://fbref.com/en/players/ad84294f/Mattia-Pagliuca"
2021,"Bologna","Serie A","Rodrigo Palacio","ARG","FW","38",1982,27.8,13,6,2,3,8,1,15,6.7,14,18,0,18,7,20,29,0,"https://fbref.com/en/players/8d8178ac/Rodrigo-Palacio"
2021,"Bologna","Serie A","Nehuén Paz","ARG","DF","27",1993,4,9,4,4,5,0,6,7,85.7,1,4,2,2,11,20,16,0,"https://fbref.com/en/players/42b1a58a/Nehuen-Paz"
2021,"Bologna","Serie A","Andrea Poli","ITA","MF","30",1989,4.3,9,7,4,2,3,6,12,50,6,7,1,6,7,16,7,0,"https://fbref.com/en/players/b3fd7075/Andrea-Poli"
2021,"Bologna","Serie A","Simone Rabbi","ITA","FW,DF","18",2001,0.4,0,0,0,0,0,0,1,0,1,0,0,0,0,0,0,0,"https://fbref.com/en/players/3688af6c/Simone-Rabbi"
2021,"Bologna","Serie A","Antonio Raimondo","ITA","FW","16",2004,0,0,0,0,0,0,0,0,NA,0,0,0,0,0,0,0,0,"https://fbref.com/en/players/ce1a6c7e/Antonio-Raimondo"
2021,"Bologna","Serie A","Federico Ravaglia","ITA","GK","20",1999,4,0,0,0,0,0,0,1,0,1,0,0,0,0,0,2,0,"https://fbref.com/en/players/6662d731/Federico-Ravaglia"
2021,"Bologna","Serie A","Nicola Sansone","ITA","FW,MF","28",1991,13,22,11,7,12,3,10,31,32.3,21,15,0,15,9,31,7,0,"https://fbref.com/en/players/7eb97a8e/Nicola-Sansone"
2021,"Bologna","Serie A","Federico Santander","PAR","FW","29",1991,0.4,0,0,0,0,0,0,0,NA,0,0,0,0,0,0,0,0,"https://fbref.com/en/players/df85d472/Federico-Santander"
2021,"Bologna","Serie A","Jerdy Schouten","NED","MF","23",1997,27.9,50,25,23,25,2,16,37,43.2,21,36,13,23,79,129,37,6,"https://fbref.com/en/players/2cfae697/Jerdy-Schouten"
2021,"Bologna","Serie A","Łukasz Skorupski","POL","GK","29",1991,28,1,1,1,0,0,1,4,25,3,0,0,0,0,1,23,5,"https://fbref.com/en/players/ab4449d6/Lukasz-Skorupski"
2021,"Bologna","Serie A","Andreas Skov Olsen","DEN","FW,DF","20",1999,13.1,19,10,11,4,4,11,21,52.4,10,15,0,15,3,22,25,0,"https://fbref.com/en/players/c50cee19/Andreas-Skov-Olsen"
2021,"Bologna","Serie A","Roberto Soriano","ITA","MF","29",1991,36.1,48,26,15,20,13,15,64,23.4,49,31,8,23,18,66,43,0,"https://fbref.com/en/players/9d4c45d6/Roberto-Soriano"
2021,"Bologna","Serie A","Adama Soumaoro","FRA","DF","28",1992,19.5,24,14,17,7,0,6,12,50,6,28,23,5,20,44,72,0,"https://fbref.com/en/players/7b075c75/Adama-Soumaoro"
2021,"Bologna","Serie A","Mattias Svanberg","SWE","MF","21",1999,20.6,38,17,21,9,8,16,45,35.6,29,25,4,21,30,68,25,1,"https://fbref.com/en/players/92d83c27/Mattias-Svanberg"
2021,"Bologna","Serie A","Takehiro Tomiyasu","JPN","DF","21",1998,30.2,47,31,27,14,6,21,34,61.8,13,37,19,18,54,101,106,0,"https://fbref.com/en/players/b3af9be1/Takehiro-Tomiyasu"
2021,"Bologna","Serie A","Kacper Urbanski","POL","FW","15",2004,0,0,0,0,0,0,0,0,NA,0,0,0,0,0,0,0,0,"https://fbref.com/en/players/2d9d9e42/Kacper-Urbanski"
2021,"Bologna","Serie A","Edoardo Vergani","ITA","FW","19",2001,0.1,0,0,0,0,0,0,0,NA,0,0,0,0,0,0,0,0,"https://fbref.com/en/players/2873973b/Edoardo-Vergani"
2021,"Bologna","Serie A","Emanuel Vignato","ITA","FW,MF","19",2000,13.4,18,9,9,6,3,3,15,20,12,6,1,5,10,28,7,0,"https://fbref.com/en/players/ec5dae45/Emanuel-Vignato"
2021,"Bordeaux","Ligue 1","Yacine Adli","FRA","MF","20",2000,26.9,74,37,30,33,11,35,92,38,57,27,2,25,39,113,17,2,"https://fbref.com/en/players/26777636/Yacine-Adli"
2021,"Bordeaux","Ligue 1","Dilane Bakwa","FRA","FW,MF","17",2002,0.6,2,2,1,1,0,0,1,0,1,2,0,2,1,3,0,0,"https://fbref.com/en/players/2b5a35e5/Dilane-Bakwa"
2021,"Bordeaux","Ligue 1","Toma Bašić","CRO","MF","23",1996,28.9,33,22,15,16,2,16,58,27.6,42,21,5,16,32,65,42,1,"https://fbref.com/en/players/80556f08/Toma-Basic"
2021,"Bordeaux","Ligue 1","Paul Baysse","FRA","DF","32",1988,29,35,18,21,13,1,16,21,76.2,5,33,24,9,52,87,123,1,"https://fbref.com/en/players/2515040a/Paul-Baysse"
2021,"Bordeaux","Ligue 1","Hatem Ben Arfa","FRA","MF,FW","33",1987,18.9,11,7,1,7,3,2,9,22.2,7,3,0,3,2,13,0,0,"https://fbref.com/en/players/74dc806c/Hatem-Ben-Arfa"
2021,"Bordeaux","Ligue 1","Loris Benito","SUI","DF","28",1992,29.5,42,26,27,12,3,22,48,45.8,26,33,10,23,42,84,70,0,"https://fbref.com/en/players/f5b6fb78/Loris-Benito"
2021,"Bordeaux","Ligue 1","Loïc Bessile","TOG","DF","21",1999,1,0,0,0,0,0,0,0,NA,0,2,1,1,1,1,3,0,"https://fbref.com/en/players/4e9957ff/Loic-Bessile"
2021,"Bordeaux","Ligue 1","Jimmy Briand","FRA","FW","34",1985,6.3,7,3,3,2,2,1,1,100,0,2,0,2,1,8,3,0,"https://fbref.com/en/players/f83c8d6c/Jimmy-Briand"
2021,"Bordeaux","Ligue 1","Benoît Costil","FRA","GK","33",1987,38,1,1,1,0,0,1,3,33.3,2,1,0,1,1,2,17,0,"https://fbref.com/en/players/2434f24a/Benoit-Costil"
2021,"Bordeaux","Ligue 1","Samuel Kalu","NGA","FW,MF","22",1997,10.7,21,12,11,8,2,4,13,30.8,9,14,0,14,9,30,2,0,"https://fbref.com/en/players/b8d22478/Samuel-Kalu"
2021,"Bordeaux","Ligue 1","Laurent Koscielny","FRA","DF","34",1985,24.6,29,17,18,11,0,16,24,66.7,8,44,34,10,54,83,115,1,"https://fbref.com/en/players/f5efb153/Laurent-Koscielny"
2021,"Bordeaux","Ligue 1","Enock Kwateng","FRA","DF","23",1997,11.5,21,12,15,4,2,14,27,51.9,13,15,3,12,26,47,27,0,"https://fbref.com/en/players/4bf69118/Enock-Kwateng"
2021,"Bordeaux","Ligue 1","Tom Lacoux","FRA","MF","18",2002,5.8,22,14,10,11,1,9,21,42.9,12,12,3,9,12,34,7,0,"https://fbref.com/en/players/295ba708/Tom-Lacoux"
2021,"Bordeaux","Ligue 1","Josh Maja","NGA","FW","21",1998,8.9,8,2,3,3,2,3,14,21.4,11,3,0,3,6,14,9,0,"https://fbref.com/en/players/bc0bfc64/Josh-Maja"
2021,"Bordeaux","Ligue 1","Sekou Mara","FRA","FW,MF","18",2002,2.5,5,3,1,3,1,2,10,20,8,0,0,0,1,6,1,0,"https://fbref.com/en/players/3544641e/Sekou-Mara"
2021,"Bordeaux","Ligue 1","Mexer","MOZ","DF","31",1988,7.9,9,6,8,0,1,5,10,50,5,8,5,3,17,26,22,0,"https://fbref.com/en/players/ce492295/Mexer"
2021,"Bordeaux","Ligue 1","Otávio","BRA","MF","26",1994,17.3,54,31,33,19,2,26,55,47.3,29,20,5,15,26,80,36,0,"https://fbref.com/en/players/243f4a0b/Otavio"
2021,"Bordeaux","Ligue 1","Remi Oudin","FRA","FW,MF","23",1996,26.9,34,16,22,7,5,15,36,41.7,21,22,2,20,51,85,40,1,"https://fbref.com/en/players/ea02beaf/Remi-Oudin"
2021,"Bordeaux","Ligue 1","Pablo","BRA","DF","29",1991,12,17,11,13,4,0,8,14,57.1,6,17,12,5,25,42,46,1,"https://fbref.com/en/players/29d8ad3f/Pablo"
2021,"Bordeaux","Ligue 1","Rubén Pardo","ESP","MF","27",1992,0.3,0,0,0,0,0,0,0,NA,0,0,0,0,1,1,0,0,"https://fbref.com/en/players/2306bfde/Ruben-Pardo"
2021,"Bordeaux","Ligue 1","Maxime Poundjé","FRA","DF","27",1992,5.5,10,7,9,1,0,2,6,33.3,4,7,3,4,11,21,5,0,"https://fbref.com/en/players/b92edde2/Maxime-Poundje"
2021,"Bordeaux","Ligue 1","Nicolas de Préville","FRA","FW,MF","29",1991,17.9,19,14,7,6,6,9,42,21.4,33,15,0,15,13,32,7,0,"https://fbref.com/en/players/b0547a87/Nicolas-de-Preville"
2021,"Bordeaux","Ligue 1","Youssouf Sabaly","SEN","DF","27",1993,32.3,47,33,24,17,6,27,45,60,18,31,8,23,49,96,57,2,"https://fbref.com/en/players/fbbb9269/Youssouf-Sabaly"
2021,"Bordeaux","Ligue 1","Jean Seri","CIV","MF","29",1991,7.9,17,9,3,12,2,4,15,26.7,11,8,2,6,12,29,7,0,"https://fbref.com/en/players/10efd0e1/Jean-Seri"
2021,"Bordeaux","Ligue 1","Issouf Sissokho","MLI","MF,DF","18",2002,0.9,6,4,4,2,0,3,6,50,3,2,0,2,1,7,0,0,"https://fbref.com/en/players/792a9d41/Issouf-Sissokho"
2021,"Bordeaux","Ligue 1","Amadou Traore","FRA","FW,MF","18",2002,3.4,6,1,2,2,2,2,9,22.2,7,9,0,9,1,7,2,0,"https://fbref.com/en/players/4eb0686f/Amadou-Traore"
2021,"Bordeaux","Ligue 1","Hwang Ui-jo","KOR","FW,MF","27",1992,27.8,14,6,5,8,1,6,25,24,19,17,2,15,8,22,14,0,"https://fbref.com/en/players/a2d873dd/Hwang-Ui-jo"
2021,"Bordeaux","Ligue 1","Mehdi Zerkane","ALG","MF,FW","21",1999,13.2,23,15,7,10,6,5,18,27.8,13,15,2,13,9,32,5,0,"https://fbref.com/en/players/53f6306f/Mehdi-Zerkane"
2021,"Brest","Ligue 1","Ludovic Baal","GUF","DF,MF","34",1986,3.3,6,5,4,1,1,2,5,40,3,4,1,3,5,11,5,0,"https://fbref.com/en/players/d3ce9f1f/Ludovic-Baal"
2021,"Brest","Ligue 1","Cristian Battocchio","ITA","MF","28",1992,3.9,5,2,1,4,0,2,9,22.2,7,0,0,0,4,9,5,0,"https://fbref.com/en/players/0f9b8301/Cristian-Battocchio"
2021,"Brest","Ligue 1","Haris Belkebla","ALG","MF","26",1994,30.3,69,39,32,28,9,31,66,47,35,26,5,21,57,126,34,0,"https://fbref.com/en/players/2b1bed19/Haris-Belkebla"
2021,"Brest","Ligue 1","Lilian Brassier","FRA","DF","20",1999,10.7,19,10,12,4,3,7,11,63.6,4,13,6,7,23,42,38,1,"https://fbref.com/en/players/5b146df3/Lilian-Brassier"
2021,"Brest","Ligue 1","Irvin Cardona","FRA","FW","22",1997,22.5,10,5,3,6,1,4,22,18.2,18,17,3,14,9,19,23,2,"https://fbref.com/en/players/5e080f73/Irvin-Cardona"
2021,"Brest","Ligue 1","Gaëtan Charbonnier","FRA","MF,FW","31",1988,17.4,24,15,6,11,7,12,32,37.5,20,15,1,14,9,33,19,0,"https://fbref.com/en/players/18ebca4b/Gaetan-Charbonnier"
2021,"Brest","Ligue 1","Brendan Chardonnet","FRA","DF","25",1994,30.2,51,29,31,19,1,27,41,65.9,14,54,41,13,64,115,151,0,"https://fbref.com/en/players/16aa7d4c/Brendan-Chardonnet"
2021,"Brest","Ligue 1","Sébastien Cibois","FRA","GK","22",1998,3,0,0,0,0,0,0,0,NA,0,0,0,0,0,0,0,1,"https://fbref.com/en/players/2b9b37b2/Sebastien-Cibois"
2021,"Brest","Ligue 1","Ibrahima Diallo","FRA","MF","21",1999,4.9,14,9,2,9,3,4,8,50,4,4,0,4,3,17,3,0,"https://fbref.com/en/players/11ff3d56/Ibrahima-Diallo"
2021,"Brest","Ligue 1","Jean-Kevin Duverne","FRA","DF","23",1997,22.5,38,21,24,14,0,15,32,46.9,17,24,16,8,30,68,70,0,"https://fbref.com/en/players/0cbc8baa/Jean-Kevin-Duverne"
2021,"Brest","Ligue 1","Bandiougou Fadiga","FRA","MF,FW","19",2001,0.5,0,0,0,0,0,0,2,0,2,0,0,0,0,0,0,0,"https://fbref.com/en/players/45bb4303/Bandiougou-Fadiga"
2021,"Brest","Ligue 1","Romain Faivre","FRA","MF,FW","22",1998,32.1,54,27,26,23,5,21,54,38.9,33,30,0,30,30,84,18,0,"https://fbref.com/en/players/745ca0a3/Romain-Faivre"
2021,"Brest","Ligue 1","Julien Faussurier","FRA","DF","33",1987,10.6,16,11,6,8,2,11,25,44,14,12,4,8,9,25,10,0,"https://fbref.com/en/players/767212e6/Julien-Faussurier"
2021,"Brest","Ligue 1","Christophe Hérelle","MTQ","DF","27",1992,15.3,19,13,12,6,1,10,12,83.3,2,13,9,4,31,50,41,2,"https://fbref.com/en/players/3681cfff/Christophe-Herelle"
2021,"Brest","Ligue 1","Franck Honorat","FRA","MF,FW","23",1996,27.3,28,13,12,10,6,14,37,37.8,23,15,3,12,11,39,24,0,"https://fbref.com/en/players/db7849ca/Franck-Honorat"
2021,"Brest","Ligue 1","Gautier Larsonneur","FRA","GK","23",1997,35,1,1,1,0,0,1,1,100,0,2,0,2,0,1,16,3,"https://fbref.com/en/players/b49729cb/Gautier-Larsonneur"
2021,"Brest","Ligue 1","Paul Lasne","FRA","MF","31",1989,18.7,46,26,25,19,2,17,40,42.5,23,25,5,20,47,93,17,2,"https://fbref.com/en/players/542cc80f/Paul-Lasne"
2021,"Brest","Ligue 1","Jérémy Le Douaron","FRA","FW,MF","22",1998,9.1,15,10,9,4,2,7,21,33.3,14,14,1,13,8,23,11,0,"https://fbref.com/en/players/88c4d190/Jeremy-Le-Douaron"
2021,"Brest","Ligue 1","Jean Lucas","BRA","MF,FW","22",1998,11.2,19,13,10,9,0,8,29,27.6,21,7,0,7,8,27,10,1,"https://fbref.com/en/players/a99138af/Jean-Lucas"
2021,"Brest","Ligue 1","Hugo Magnetti","FRA","MF","22",1998,6.7,24,12,10,13,1,20,40,50,20,6,1,5,14,38,8,0,"https://fbref.com/en/players/d4d35152/Hugo-Magnetti"
2021,"Brest","Ligue 1","Hianga Mananga Mbock","FRA","MF,FW","20",1999,5.1,4,3,2,2,0,2,9,22.2,7,2,0,2,3,7,6,0,"https://fbref.com/en/players/0f86995c/Hianga-Mananga-Mbock"
2021,"Brest","Ligue 1","Steve Mounié","BEN","FW","25",1994,29.8,15,11,3,11,1,3,28,10.7,25,18,3,15,12,27,40,0,"https://fbref.com/en/players/19ba6c6d/Steve-Mounie"
2021,"Brest","Ligue 1","Romain Perraud","FRA","DF","22",1997,34.9,60,34,42,16,2,24,45,53.3,21,36,3,33,45,105,76,0,"https://fbref.com/en/players/6dfd8f05/Romain-Perraud"
2021,"Brest","Ligue 1","Romain Philippoteaux","FRA","MF,FW","32",1988,6.5,11,6,6,3,2,6,9,66.7,3,4,0,4,10,21,2,0,"https://fbref.com/en/players/f98b15f0/Romain-Philippoteaux"
2021,"Brest","Ligue 1","Ronaël Pierre-Gabriel","FRA","DF","22",1998,25.6,60,40,42,16,2,35,52,67.3,17,17,7,10,30,90,57,0,"https://fbref.com/en/players/64ba07c0/Ronael-Pierre-Gabriel"
2021,"Brest","Ligue 1","Heriberto Tavares","POR","FW,MF","23",1997,0.5,2,0,0,0,2,1,3,33.3,2,0,0,0,1,3,1,0,"https://fbref.com/en/players/2d9f280e/Heriberto-Tavares"
2021,"Brighton","Premier League","Steven Alzate","COL","MF","21",1998,10,17,8,10,4,3,6,15,40,9,8,1,7,8,25,10,0,"https://fbref.com/en/players/ad1f61f3/Steven-Alzate"
2021,"Brighton","Premier League","Bernardo","BRA","DF,MF","25",1995,2.3,10,8,8,1,1,4,6,66.7,2,2,0,2,1,11,1,0,"https://fbref.com/en/players/17370b95/Bernardo"
2021,"Brighton","Premier League","Yves Bissouma","MLI","MF","23",1996,34.6,104,68,50,48,6,33,67,49.3,34,42,6,36,64,168,67,0,"https://fbref.com/en/players/6c203af0/Yves-Bissouma"
2021,"Brighton","Premier League","Dan Burn","ENG","DF","28",1992,22.9,50,26,33,14,3,27,53,50.9,26,30,7,23,31,81,75,0,"https://fbref.com/en/players/b2d31e83/Dan-Burn"
2021,"Brighton","Premier League","Aaron Connolly","IRL","FW","20",2000,8.8,6,3,1,3,2,0,2,0,2,4,0,4,0,6,2,0,"https://fbref.com/en/players/27c01749/Aaron-Connolly"
2021,"Brighton","Premier League","Lewis Dunk","ENG","DF","28",1991,32.6,30,15,20,8,2,16,23,69.6,7,29,20,9,32,62,106,0,"https://fbref.com/en/players/282f75f3/Lewis-Dunk"
2021,"Brighton","Premier League","Pascal Groß","GER","MF,DF","29",1991,27.6,45,24,24,15,6,24,53,45.3,29,25,4,21,23,68,18,1,"https://fbref.com/en/players/8aec0537/Pascal-Gross"
2021,"Brighton","Premier League","José Izquierdo","COL","DF","28",1992,0.1,0,0,0,0,0,0,0,NA,0,0,0,0,0,0,0,0,"https://fbref.com/en/players/ca2bc3df/Jose-Izquierdo"
2021,"Brighton","Premier League","Alireza Jahanbakhsh","IRN","FW,MF","26",1993,5.9,9,7,3,5,1,2,12,16.7,10,8,0,8,8,17,1,0,"https://fbref.com/en/players/08452314/Alireza-Jahanbakhsh"
2021,"Brighton","Premier League","Reda Khadra","GER","MF","19",2001,0.1,0,0,0,0,0,0,0,NA,0,0,0,0,0,0,0,0,"https://fbref.com/en/players/88acf83f/Reda-Khadra"
2021,"Brighton","Premier League","Adam Lallana","ENG","MF,FW","32",1988,17.7,28,13,11,13,4,8,39,20.5,31,18,3,15,15,43,13,0,"https://fbref.com/en/players/99813635/Adam-Lallana"
2021,"Brighton","Premier League","Tariq Lamptey","GHA","DF,MF","19",2000,9.8,17,9,7,6,4,6,13,46.2,7,8,1,7,19,36,12,1,"https://fbref.com/en/players/f4e433d4/Tariq-Lamptey"
2021,"Brighton","Premier League","Alexis Mac Allister","ARG","MF,FW","21",1998,12.4,26,12,6,16,4,11,38,28.9,27,25,4,21,9,35,4,0,"https://fbref.com/en/players/83d074ff/Alexis-Mac-Allister"
2021,"Brighton","Premier League","Solly March","ENG","DF,MF","26",1994,18.6,49,23,24,15,10,18,34,52.9,16,30,5,25,22,71,30,0,"https://fbref.com/en/players/bb5fbd2b/Solly-March"
2021,"Brighton","Premier League","Neal Maupay","FRA","FW,MF","23",1996,27.9,20,8,9,7,4,4,24,16.7,20,20,0,20,13,33,6,0,"https://fbref.com/en/players/4bcf39f6/Neal-Maupay"
2021,"Brighton","Premier League","Jakub Moder","POL","DF,MF","21",1999,7.2,15,7,5,7,3,7,20,35,13,12,1,11,3,18,9,0,"https://fbref.com/en/players/f230bc30/Jakub-Moder"
2021,"Brighton","Premier League","Jayson Molumby","IRL","MF","20",1999,0,0,0,0,0,0,0,0,NA,0,0,0,0,0,0,0,0,"https://fbref.com/en/players/c908a1bc/Jayson-Molumby"
2021,"Brighton","Premier League","Davy Pröpper","NED","MF","28",1991,2.4,6,5,0,6,0,2,5,40,3,3,0,3,1,7,0,0,"https://fbref.com/en/players/fdd85f94/Davy-Propper"
2021,"Brighton","Premier League","Mathew Ryan","AUS","GK","28",1992,11,1,0,1,0,0,0,0,NA,0,0,0,0,0,1,4,0,"https://fbref.com/en/players/4535e4bb/Mathew-Ryan"
2021,"Brighton","Premier League","Robert Sánchez","ESP","GK","22",1997,27,1,0,1,0,0,1,1,100,0,1,0,1,1,2,11,2,"https://fbref.com/en/players/6a713852/Robert-Sanchez"
2021,"Brighton","Premier League","Percy Tau","RSA","FW","26",1994,1.1,1,1,1,0,0,0,2,0,2,1,0,1,0,1,1,0,"https://fbref.com/en/players/4d0eb7d2/Percy-Tau"
2021,"Brighton","Premier League","Leandro Trossard","BEL","MF,FW","25",1994,29,33,14,11,16,6,10,36,27.8,26,34,2,32,26,59,7,1,"https://fbref.com/en/players/38ceb24a/Leandro-Trossard"
2021,"Brighton","Premier League","Joël Veltman","NED","DF","28",1992,25.3,67,33,34,25,8,29,57,50.9,28,24,5,19,33,100,64,0,"https://fbref.com/en/players/dad4b285/Joel-Veltman"
2021,"Brighton","Premier League","Adam Webster","ENG","DF","25",1995,28.8,29,16,15,10,4,12,25,48,13,29,16,13,47,76,92,3,"https://fbref.com/en/players/c40b6180/Adam-Webster"
2021,"Brighton","Premier League","Danny Welbeck","ENG","FW","29",1990,17.2,12,6,2,6,4,7,19,36.8,12,17,0,17,7,19,13,0,"https://fbref.com/en/players/ce5143da/Danny-Welbeck"
2021,"Brighton","Premier League","Ben White","ENG","DF,MF","22",1997,35.5,49,26,21,24,4,24,57,42.1,33,46,22,24,62,111,56,0,"https://fbref.com/en/players/35e413f1/Ben-White"
2021,"Brighton","Premier League","Andi Zeqiri","SUI","FW,DF","21",1999,1.9,3,2,0,2,1,1,2,50,1,1,0,1,0,3,2,0,"https://fbref.com/en/players/d01231f0/Andi-Zeqiri"
2021,"Burnley","Premier League","Phil Bardsley","SCO","DF","35",1985,3,6,5,4,2,0,3,6,50,3,3,1,2,6,12,12,0,"https://fbref.com/en/players/1ae30132/Phil-Bardsley"
2021,"Burnley","Premier League","Ashley Barnes","ENG","FW","30",1989,14.8,12,6,2,6,4,3,13,23.1,10,14,2,12,5,17,11,0,"https://fbref.com/en/players/2691c772/Ashley-Barnes"
2021,"Burnley","Premier League","Josh Benson","ENG","MF","20",1999,2.9,5,1,3,0,2,1,6,16.7,5,3,0,3,3,8,2,0,"https://fbref.com/en/players/bf3aeb61/Josh-Benson"
2021,"Burnley","Premier League","Jóhann Berg Guðmundsson","ISL","MF","29",1990,15.1,19,11,6,9,4,11,23,47.8,12,11,2,9,17,36,19,0,"https://fbref.com/en/players/f72293fc/Johann-Berg-Gudmundsson"
2021,"Burnley","Premier League","Robbie Brady","IRL","MF","28",1992,11.7,22,15,12,6,4,12,35,34.3,23,16,0,16,9,31,29,1,"https://fbref.com/en/players/96bb8cc2/Robbie-Brady"
2021,"Burnley","Premier League","Josh Brownhill","ENG","MF","24",1995,31.3,45,27,9,29,7,15,44,34.1,29,33,11,22,69,114,39,0,"https://fbref.com/en/players/47369df8/Josh-Brownhill"
2021,"Burnley","Premier League","Jack Cork","ENG","MF","31",1989,15,26,10,5,17,4,11,31,35.5,20,15,4,11,16,42,20,0,"https://fbref.com/en/players/74e12f1e/Jack-Cork"
2021,"Burnley","Premier League","Jimmy Dunne","IRL","DF","22",1997,3,3,3,2,1,0,1,2,50,1,3,2,1,6,9,16,1,"https://fbref.com/en/players/1fdfd6da/Jimmy-Dunne"
2021,"Burnley","Premier League","Kevin Long","IRL","DF","29",1990,7.1,11,6,9,2,0,7,9,77.8,2,11,7,4,6,17,24,0,"https://fbref.com/en/players/5a4280b1/Kevin-Long"
2021,"Burnley","Premier League","Matthew Lowton","ENG","DF","31",1989,34,54,32,31,22,1,32,73,43.8,41,36,13,23,56,110,91,1,"https://fbref.com/en/players/9a9c05db/Matthew-Lowton"
2021,"Burnley","Premier League","Dwight McNeil","ENG","MF","20",1999,34.1,47,24,24,18,5,18,56,32.1,38,44,6,38,32,79,32,1,"https://fbref.com/en/players/fc15fb84/Dwight-McNeil"
2021,"Burnley","Premier League","Ben Mee","ENG","DF","30",1989,29.9,32,15,16,14,2,14,29,48.3,15,54,45,9,43,75,148,2,"https://fbref.com/en/players/8df7a2fb/Ben-Mee"
2021,"Burnley","Premier League","Joel Mumbongo","SWE","FW","21",1999,0.4,0,0,0,0,0,0,0,NA,0,1,0,1,0,0,0,0,"https://fbref.com/en/players/f8e588df/Joel-Mumbongo"
2021,"Burnley","Premier League","Will Norris","ENG","GK","26",1993,2,0,0,0,0,0,0,0,NA,0,0,0,0,0,0,0,0,"https://fbref.com/en/players/c73ada83/Will-Norris"
2021,"Burnley","Premier League","Bailey Peacock-Farrell","NIR","GK","23",1996,4,0,0,0,0,0,0,0,NA,0,0,0,0,0,0,0,0,"https://fbref.com/en/players/4879f8cb/Bailey-Peacock-Farrell"
2021,"Burnley","Premier League","Erik Pieters","NED","DF,MF","31",1988,14.1,30,21,18,9,3,19,39,48.7,20,30,9,21,12,42,34,0,"https://fbref.com/en/players/1ef37668/Erik-Pieters"
2021,"Burnley","Premier League","Nick Pope","ENG","GK","28",1992,32,1,1,1,0,0,0,1,0,1,0,0,0,2,3,29,2,"https://fbref.com/en/players/4b40d9ca/Nick-Pope"
2021,"Burnley","Premier League","Lewis Richardson","ENG","FW,MF","17",2003,0,0,0,0,0,0,0,0,NA,0,0,0,0,0,0,0,0,"https://fbref.com/en/players/4fa62ae4/Lewis-Richardson"
2021,"Burnley","Premier League","Jay Rodriguez","ENG","FW","31",1989,14.1,25,16,5,15,5,13,28,46.4,15,25,4,21,2,27,7,0,"https://fbref.com/en/players/4ab53cdb/Jay-Rodriguez"
2021,"Burnley","Premier League","Dale Stephens","ENG","MF","31",1989,2.9,11,6,2,7,2,3,6,50,3,3,0,3,8,19,2,0,"https://fbref.com/en/players/653ee42d/Dale-Stephens"
2021,"Burnley","Premier League","James Tarkowski","ENG","DF","27",1992,36,66,39,52,11,3,25,49,51,24,54,42,12,44,110,163,1,"https://fbref.com/en/players/15ea812b/James-Tarkowski"
2021,"Burnley","Premier League","Charlie Taylor","ENG","DF","26",1993,27,48,28,30,15,3,25,46,54.3,21,36,19,17,29,77,87,2,"https://fbref.com/en/players/cc2d7ad5/Charlie-Taylor"
2021,"Burnley","Premier League","Matěj Vydra","CZE","FW","28",1992,15.2,9,5,2,4,3,1,8,12.5,7,8,1,7,6,15,5,0,"https://fbref.com/en/players/0d4ceb32/Matej-Vydra"
2021,"Burnley","Premier League","Ashley Westwood","ENG","MF","30",1990,37.9,23,15,6,12,5,10,42,23.8,32,26,9,17,44,67,33,0,"https://fbref.com/en/players/495945ef/Ashley-Westwood"
2021,"Burnley","Premier League","Chris Wood","NZL","FW","28",1991,30.5,12,7,2,4,6,5,18,27.8,13,14,3,11,1,13,21,0,"https://fbref.com/en/players/4e9a0555/Chris-Wood"
2021,"Cagliari","Serie A","Kwadwo Asamoah","GHA","DF,MF","31",1988,2.5,4,3,2,2,0,2,3,66.7,1,5,1,4,4,8,2,1,"https://fbref.com/en/players/089550f5/Kwadwo-Asamoah"
2021,"Cagliari","Serie A","Arturo Calabresi","ITA","DF","24",1996,0.2,0,0,0,0,0,0,1,0,1,0,0,0,0,0,0,0,"https://fbref.com/en/players/34bb6fbd/Arturo-Calabresi"
2021,"Cagliari","Serie A","Fabrizio Caligara","ITA","MF,FW","20",2000,2,6,4,2,2,2,6,9,66.7,3,9,2,7,3,9,3,0,"https://fbref.com/en/players/22ca11f1/Fabrizio-Caligara"
2021,"Cagliari","Serie A","Andrea Carboni","ITA","DF","19",2001,12.1,34,23,23,11,0,15,28,53.6,13,15,4,11,14,48,52,0,"https://fbref.com/en/players/f7e2af2c/Andrea-Carboni"
2021,"Cagliari","Serie A","Luca Ceppitelli","ITA","DF","30",1989,16.3,25,19,13,10,2,14,26,53.8,12,23,12,11,25,50,58,1,"https://fbref.com/en/players/7d50454d/Luca-Ceppitelli"
2021,"Cagliari","Serie A","Alberto Cerri","ITA","FW","24",1996,4.1,3,2,0,2,1,0,5,0,5,4,2,2,2,5,6,0,"https://fbref.com/en/players/1079c685/Alberto-Cerri"
2021,"Cagliari","Serie A","Alessio Cragno","ITA","GK","26",1994,34,0,0,0,0,0,0,1,0,1,0,0,0,1,1,10,0,"https://fbref.com/en/players/f554e29b/Alessio-Cragno"
2021,"Cagliari","Serie A","Alessandro Deiola","ITA","MF","24",1995,6.8,13,5,5,4,4,8,23,34.8,15,7,2,5,11,24,11,0,"https://fbref.com/en/players/7f267d66/Alessandro-Deiola"
2021,"Cagliari","Serie A","Kiril Despodov","BUL","FW","23",1996,0.1,1,1,0,1,0,1,1,100,0,0,0,0,0,1,0,0,"https://fbref.com/en/players/13c8e5f6/Kiril-Despodov"
2021,"Cagliari","Serie A","Alfred Duncan","GHA","MF","27",1993,11.9,18,10,8,9,1,4,21,19,17,8,0,8,16,34,8,1,"https://fbref.com/en/players/528492ea/Alfred-Duncan"
2021,"Cagliari","Serie A","Paolo Faragò","ITA","DF","27",1993,4.1,13,9,10,3,0,9,20,45,11,3,2,1,6,19,15,0,"https://fbref.com/en/players/9085dd7c/Paolo-Farago"
2021,"Cagliari","Serie A","Diego Godín","URU","DF","34",1986,27.9,60,32,51,9,0,24,39,61.5,15,41,24,17,56,116,117,0,"https://fbref.com/en/players/fc4f85b1/Diego-Godin"
2021,"Cagliari","Serie A","Ragnar Klavan","EST","DF","34",1985,8.6,15,9,9,5,1,7,11,63.6,4,9,4,5,8,23,34,0,"https://fbref.com/en/players/008a6e6d/Ragnar-Klavan"
2021,"Cagliari","Serie A","Charalambos Lykogiannis","GRE","DF","26",1993,26.9,34,21,22,9,3,22,38,57.9,16,34,13,21,32,66,94,0,"https://fbref.com/en/players/5efc5389/Charalambos-Lykogiannis"
2021,"Cagliari","Serie A","Răzvan Marin","ROU","MF","24",1996,32.9,54,33,26,22,6,27,53,50.9,26,29,10,19,29,83,15,0,"https://fbref.com/en/players/7fac99d4/Razvan-Marin"
2021,"Cagliari","Serie A","Radja Nainggolan","BEL","MF","32",1988,20.5,41,26,22,14,5,19,34,55.9,15,18,0,18,15,56,15,1,"https://fbref.com/en/players/1f9328da/Radja-Nainggolan"
2021,"Cagliari","Serie A","Nahitan Nández","URU","MF,DF","24",1995,30.4,56,28,23,23,10,25,68,36.8,43,26,4,22,23,79,49,0,"https://fbref.com/en/players/95facda1/Nahitan-Nandez"
2021,"Cagliari","Serie A","Christian Oliva","URU","MF","24",1996,4.3,10,4,6,3,1,6,17,35.3,11,11,1,10,8,18,7,0,"https://fbref.com/en/players/d3b888e3/Christian-Oliva"
2021,"Cagliari","Serie A","Adam Ounas","ALG","MF,FW","23",1996,3.4,3,2,3,0,0,0,11,0,11,5,0,5,3,6,0,0,"https://fbref.com/en/players/ed90babd/Adam-Ounas"
2021,"Cagliari","Serie A","Leonardo Pavoletti","ITA","FW","31",1988,17.6,7,3,2,5,0,1,20,5,19,4,2,2,4,11,32,0,"https://fbref.com/en/players/d37b0350/Leonardo-Pavoletti"
2021,"Cagliari","Serie A","João Pedro","ITA","FW,MF","28",1992,36.1,13,6,2,6,5,2,27,7.4,25,32,6,26,13,26,28,0,"https://fbref.com/en/players/81255c03/Joao-Pedro"
2021,"Cagliari","Serie A","Gastón Pereiro","URU","MF,DF","25",1995,3,3,1,2,1,0,1,2,50,1,2,0,2,1,4,2,1,"https://fbref.com/en/players/7ec7738e/Gaston-Pereiro"
2021,"Cagliari","Serie A","Fabio Pisacane","ITA","DF","34",1986,2.5,3,2,2,1,0,3,7,42.9,4,8,5,3,1,4,9,1,"https://fbref.com/en/players/56400c01/Fabio-Pisacane"
2021,"Cagliari","Serie A","Marko Rog","CRO","MF","25",1995,12.9,40,24,15,22,3,16,37,43.2,21,17,6,11,19,59,15,0,"https://fbref.com/en/players/b6b2b820/Marko-Rog"
2021,"Cagliari","Serie A","Daniele Rugani","ITA","DF","26",1994,11.1,24,11,10,12,2,10,20,50,10,15,10,5,15,39,46,0,"https://fbref.com/en/players/14b8fcdf/Daniele-Rugani"
2021,"Cagliari","Serie A","Giovanni Simeone","ARG","FW","25",1995,19.3,24,11,2,15,7,7,31,22.6,24,23,1,22,10,34,18,0,"https://fbref.com/en/players/343c0d52/Giovanni-Simeone"
2021,"Cagliari","Serie A","Riccardo Sottil","ITA","FW,MF","21",1999,13.2,7,3,2,3,2,0,7,0,7,4,0,4,5,12,3,0,"https://fbref.com/en/players/94816803/Riccardo-Sottil"
2021,"Cagliari","Serie A","Mattéo Tramoni","FRA","MF,FW","20",2000,0.8,4,2,2,1,1,1,2,50,1,5,0,5,1,5,2,0,"https://fbref.com/en/players/2e0ae188/Matteo-Tramoni"
2021,"Cagliari","Serie A","Alessandro Tripaldelli","ITA","DF","21",1999,3.3,13,6,5,6,2,5,6,83.3,1,6,1,5,3,16,15,0,"https://fbref.com/en/players/4571fa88/Alessandro-Tripaldelli"
2021,"Cagliari","Serie A","Guglielmo Vicario","ITA","GK","23",1996,4,0,0,0,0,0,0,0,NA,0,0,0,0,0,0,1,0,"https://fbref.com/en/players/77d6fd4d/Guglielmo-Vicario"
2021,"Cagliari","Serie A","Sebastian Walukiewicz","POL","DF","20",2000,18,27,19,11,13,3,12,30,40,18,22,14,8,36,63,60,0,"https://fbref.com/en/players/217875a4/Sebastian-Walukiewicz"
2021,"Cagliari","Serie A","Gabriele Zappa","ITA","DF","20",1999,26.6,34,17,16,15,3,22,49,44.9,27,36,4,32,24,58,50,0,"https://fbref.com/en/players/ca3db240/Gabriele-Zappa"
2021,"Celta Vigo","La Liga","Joseph Aidoo","GHA","DF","24",1995,14.3,26,17,17,9,0,12,21,57.1,9,7,4,3,25,51,88,1,"https://fbref.com/en/players/18abe173/Joseph-Aidoo"
2021,"Celta Vigo","La Liga","Alfon","ESP","MF","21",1999,0.4,0,0,0,0,0,0,0,NA,0,0,0,0,0,0,0,0,"https://fbref.com/en/players/1c772b46/Alfon"
2021,"Celta Vigo","La Liga","Néstor Araujo","MEX","DF","28",1991,27,24,16,14,9,1,7,15,46.7,8,23,18,5,43,67,89,2,"https://fbref.com/en/players/27a013f7/Nestor-Araujo"
2021,"Celta Vigo","La Liga","Iago Aspas","ESP","FW","32",1987,31.8,11,3,2,7,2,2,23,8.7,21,25,2,23,16,27,21,0,"https://fbref.com/en/players/7dcf86f6/Iago-Aspas"
2021,"Celta Vigo","La Liga","Miguel Baeza","ESP","MF,FW","20",2000,6,7,6,5,2,0,5,13,38.5,8,3,0,3,3,10,2,0,"https://fbref.com/en/players/a98f3cbf/Miguel-Baeza"
2021,"Celta Vigo","La Liga","Fran Beltrán","ESP","MF,FW","21",1999,15.5,30,22,15,12,3,8,24,33.3,16,14,1,13,16,46,24,0,"https://fbref.com/en/players/ed5c5fa3/Fran-Beltran"
2021,"Celta Vigo","La Liga","Rubén Blanco","ESP","GK","25",1995,18.2,0,0,0,0,0,0,0,NA,0,0,0,0,0,0,7,3,"https://fbref.com/en/players/967f34d3/Ruben-Blanco"
2021,"Celta Vigo","La Liga","Sergio Carreira","ESP","DF","19",2000,2.9,3,0,2,1,0,1,1,100,0,2,0,2,1,4,7,0,"https://fbref.com/en/players/8d6a9c93/Sergio-Carreira"
2021,"Celta Vigo","La Liga","Carlos Dominguez","ESP","DF","19",2001,4,5,4,4,1,0,3,6,50,3,5,3,2,6,11,24,0,"https://fbref.com/en/players/3521abfe/Carlos-Dominguez"
2021,"Celta Vigo","La Liga","Facundo Ferreyra","ARG","FW","29",1991,3.3,4,3,1,2,1,0,2,0,2,5,0,5,2,6,2,0,"https://fbref.com/en/players/b39a793e/Facundo-Ferreyra"
2021,"Celta Vigo","La Liga","José Fontán","ESP","DF","20",2000,7.2,12,9,8,4,0,5,11,45.5,6,4,3,1,13,25,27,0,"https://fbref.com/en/players/1827a42d/Jose-Fontan"
2021,"Celta Vigo","La Liga","Jordan Holsgrove","SCO","MF","20",1999,1.6,6,4,4,1,1,5,8,62.5,3,2,0,2,2,8,1,0,"https://fbref.com/en/players/8a6daac3/Jordan-Holsgrove"
2021,"Celta Vigo","La Liga","Lauti","URU","FW","19",2001,0.2,NA,0,NA,NA,NA,NA,NA,NA,NA,NA,NA,NA,0,NA,NA,NA,"https://fbref.com/en/players/f934c5c9/Lauti"
2021,"Celta Vigo","La Liga","Hugo Mallo","ESP","DF","29",1991,28.9,58,40,34,23,1,24,52,46.2,28,42,11,31,37,95,77,0,"https://fbref.com/en/players/cb574619/Hugo-Mallo"
2021,"Celta Vigo","La Liga","Aarón Martín","ESP","DF","23",1997,17.1,34,20,15,16,3,10,33,30.3,23,15,4,11,13,47,37,0,"https://fbref.com/en/players/2f3e911a/Aaron-Martin"
2021,"Celta Vigo","La Liga","Brais Méndez","ESP","MF,FW","23",1997,29.7,59,31,23,27,9,16,65,24.6,49,27,2,25,32,91,34,0,"https://fbref.com/en/players/c9e39d91/Brais-Mendez"
2021,"Celta Vigo","La Liga","Santi Mina","ESP","FW","24",1995,26.8,31,13,9,12,10,6,37,16.2,31,15,3,12,6,37,17,0,"https://fbref.com/en/players/0b90bb97/Santi-Mina"
2021,"Celta Vigo","La Liga","Emre Mor","TUR","FW,MF","23",1997,5.6,8,4,1,3,4,0,3,0,3,5,0,5,5,13,0,0,"https://fbref.com/en/players/0c3f7197/Emre-Mor"
2021,"Celta Vigo","La Liga","Jeison Murillo","COL","DF","28",1992,30,45,21,35,9,1,24,44,54.5,20,29,17,12,36,81,100,2,"https://fbref.com/en/players/b233e8e4/Jeison-Murillo"
2021,"Celta Vigo","La Liga","Nolito","ESP","MF,FW","33",1986,28.9,70,36,30,30,10,32,92,34.8,60,46,2,44,22,92,19,0,"https://fbref.com/en/players/b2d0ec1b/Nolito"
2021,"Celta Vigo","La Liga","Lucas Olaza","URU","DF","26",1994,17.9,25,16,12,12,1,10,18,55.6,8,15,1,14,24,49,34,0,"https://fbref.com/en/players/4cee5954/Lucas-Olaza"
2021,"Celta Vigo","La Liga","Miguel Rodríguez","ESP","FW,DF","17",2003,0.3,1,1,0,1,0,0,0,NA,0,0,0,0,0,1,0,0,"https://fbref.com/en/players/958d67bb/Miguel-Rodriguez"
2021,"Celta Vigo","La Liga","Augusto Solari","ARG","MF","28",1992,5.4,18,13,9,8,1,6,26,23.1,20,13,1,12,6,24,5,0,"https://fbref.com/en/players/3ca6106c/Augusto-Solari"
2021,"Celta Vigo","La Liga","Hugo Sotelo","ESP","MF","16",2003,0,0,0,0,0,0,0,0,NA,0,0,0,0,0,0,0,0,"https://fbref.com/en/players/3aa74860/Hugo-Sotelo"
2021,"Celta Vigo","La Liga","Denis Suárez","ESP","MF","26",1994,31.7,64,32,22,30,12,21,94,22.3,73,30,2,28,22,86,15,2,"https://fbref.com/en/players/12c50af5/Denis-Suarez"
2021,"Celta Vigo","La Liga","Renato Tapia","PER","MF","25",1995,30,93,44,50,34,9,32,83,38.6,51,56,13,43,53,146,75,2,"https://fbref.com/en/players/34269bdf/Renato-Tapia"
2021,"Celta Vigo","La Liga","Kevin Vázquez","ESP","DF","27",1993,6.2,11,5,9,2,0,3,9,33.3,6,8,0,8,9,20,18,0,"https://fbref.com/en/players/ee923664/Kevin-Vazquez"
2021,"Celta Vigo","La Liga","Gabriel Veiga","ESP","MF,DF","18",2002,1.3,3,0,3,0,0,1,4,25,3,3,0,3,3,6,0,0,"https://fbref.com/en/players/35a6e5c7/Gabriel-Veiga"
2021,"Celta Vigo","La Liga","Iván Villar","ESP","GK","23",1997,19.8,0,0,0,0,0,0,1,0,1,0,0,0,0,0,18,0,"https://fbref.com/en/players/cde52ef5/Ivan-Villar"
2021,"Celta Vigo","La Liga","Okay Yokuşlu","TUR","MF","26",1994,5.1,14,8,8,4,2,5,9,55.6,4,5,2,3,10,24,9,0,"https://fbref.com/en/players/e49ce451/Okay-Yokuslu"
2021,"Chelsea","Premier League","Tammy Abraham","ENG","FW","22",1997,11.6,7,5,3,3,1,1,7,14.3,6,6,0,6,5,12,17,0,"https://fbref.com/en/players/f586779e/Tammy-Abraham"
2021,"Chelsea","Premier League","Marcos Alonso","ESP","DF","29",1990,10.7,13,3,6,4,3,7,14,50,7,12,1,11,12,25,30,0,"https://fbref.com/en/players/f4290206/Marcos-Alonso"
2021,"Chelsea","Premier League","Kepa Arrizabalaga","ESP","GK","25",1994,6.5,0,0,0,0,0,0,1,0,1,0,0,0,0,0,0,3,"https://fbref.com/en/players/28d596a0/Kepa-Arrizabalaga"
2021,"Chelsea","Premier League","César Azpilicueta","ESP","DF","30",1989,24.3,53,28,22,24,7,19,37,51.4,18,30,5,25,28,81,62,2,"https://fbref.com/en/players/53cad200/Cesar-Azpilicueta"
2021,"Chelsea","Premier League","Ross Barkley","ENG","FW,MF","26",1993,0.5,0,0,0,0,0,0,0,NA,0,0,0,0,0,0,0,0,"https://fbref.com/en/players/3a24769f/Ross-Barkley"
2021,"Chelsea","Premier League","Willy Caballero","ARG","GK","38",1981,1,0,0,0,0,0,0,0,NA,0,0,0,0,0,0,0,0,"https://fbref.com/en/players/a179d516/Willy-Caballero"
2021,"Chelsea","Premier League","Ben Chilwell","ENG","DF","23",1996,25.4,42,22,16,22,4,15,33,45.5,18,28,3,25,24,66,58,0,"https://fbref.com/en/players/d2424d1b/Ben-Chilwell"
2021,"Chelsea","Premier League","Andreas Christensen","DEN","DF","24",1996,15.2,11,6,8,3,0,0,8,0,8,19,14,5,20,31,51,1,"https://fbref.com/en/players/1cb49278/Andreas-Christensen"
2021,"Chelsea","Premier League","Billy Gilmour","SCO","MF","19",2001,2.9,4,2,1,2,1,2,7,28.6,5,3,2,1,3,7,1,0,"https://fbref.com/en/players/df10e27c/Billy-Gilmour"
2021,"Chelsea","Premier League","Olivier Giroud","FRA","FW","33",1986,8.3,4,2,0,1,3,1,7,14.3,6,4,1,3,5,9,10,0,"https://fbref.com/en/players/16ceb862/Olivier-Giroud"
2021,"Chelsea","Premier League","Kai Havertz","GER","MF,FW","21",1999,16.9,18,9,6,10,2,6,27,22.2,21,25,0,25,4,22,22,1,"https://fbref.com/en/players/fed7cb61/Kai-Havertz"
2021,"Chelsea","Premier League","Callum Hudson-Odoi","ENG","FW,DF","19",2000,11.8,23,15,11,7,5,8,21,38.1,13,15,1,14,6,29,6,0,"https://fbref.com/en/players/15f3ec41/Callum-Hudson-Odoi"
2021,"Chelsea","Premier League","Reece James","ENG","DF","20",1999,26.4,55,35,24,22,9,21,44,47.7,23,36,7,29,17,72,52,0,"https://fbref.com/en/players/1265a93a/Reece-James"
2021,"Chelsea","Premier League","Jorginho","ITA","MF","28",1991,22.3,57,30,22,31,4,31,76,40.8,45,33,5,28,40,97,21,3,"https://fbref.com/en/players/45db685d/Jorginho"
2021,"Chelsea","Premier League","N'Golo Kanté","FRA","MF","29",1991,23.8,79,42,39,35,5,27,56,48.2,29,42,4,38,59,138,34,0,"https://fbref.com/en/players/b9fbae28/NGolo-Kante"
2021,"Chelsea","Premier League","Mateo Kovačić","CRO","MF","26",1994,20.2,46,28,19,24,3,17,32,53.1,15,18,1,17,15,61,11,2,"https://fbref.com/en/players/79c0821a/Mateo-Kovacic"
2021,"Chelsea","Premier League","Ruben Loftus-Cheek","ENG","FW","24",1996,0.7,0,0,0,0,0,0,0,NA,0,0,0,0,0,0,0,0,"https://fbref.com/en/players/e97fd090/Ruben-Loftus-Cheek"
2021,"Chelsea","Premier League","Edouard Mendy","SEN","GK","28",1992,30.5,0,0,0,0,0,0,1,0,1,0,0,0,1,1,9,3,"https://fbref.com/en/players/33887998/Edouard-Mendy"
2021,"Chelsea","Premier League","Mason Mount","ENG","MF","21",1999,32.1,75,35,22,38,15,25,69,36.2,44,40,2,38,31,106,14,0,"https://fbref.com/en/players/9674002f/Mason-Mount"
2021,"Chelsea","Premier League","Emerson Palmieri","ITA","DF","25",1994,1,3,3,2,0,1,1,3,33.3,2,0,0,0,1,4,6,0,"https://fbref.com/en/players/e0bc6fdc/Emerson-Palmieri"
2021,"Chelsea","Premier League","Christian Pulisic","USA","FW,MF","21",1998,19.3,19,11,8,10,1,8,21,38.1,13,25,2,23,12,31,9,0,"https://fbref.com/en/players/1bf33a9a/Christian-Pulisic"
2021,"Chelsea","Premier League","Antonio Rüdiger","GER","DF","27",1993,19,31,23,16,14,1,12,15,80,3,17,10,7,18,49,51,0,"https://fbref.com/en/players/18b896d6/Antonio-Rudiger"
2021,"Chelsea","Premier League","Thiago Silva","BRA","DF","35",1984,21.5,20,12,11,8,1,14,21,66.7,7,21,13,8,33,53,86,1,"https://fbref.com/en/players/86e7deaf/Thiago-Silva"
2021,"Chelsea","Premier League","Fikayo Tomori","ENG","DF","22",1997,0.5,2,1,2,0,0,0,0,NA,0,1,1,0,2,4,8,0,"https://fbref.com/en/players/7edfbb8a/Fikayo-Tomori"
2021,"Chelsea","Premier League","Timo Werner","GER","FW,MF","24",1996,28.9,20,9,6,11,3,7,43,16.3,36,23,1,22,8,28,8,0,"https://fbref.com/en/players/49fe9070/Timo-Werner"
2021,"Chelsea","Premier League","Hakim Ziyech","MAR","MF,FW","27",1993,13,14,10,5,7,2,5,19,26.3,14,9,1,8,10,24,2,0,"https://fbref.com/en/players/6622454d/Hakim-Ziyech"
2021,"Chelsea","Premier League","Kurt Zouma","FRA","DF","25",1994,22.5,16,10,8,6,2,4,8,50,4,13,9,4,28,44,93,0,"https://fbref.com/en/players/ce4246f5/Kurt-Zouma"
2021,"Crotone","Serie A","Ahmad Benali","LBY","MF","28",1992,13.5,19,11,10,9,0,11,38,28.9,27,15,2,13,6,25,15,0,"https://fbref.com/en/players/a128b07e/Ahmad-Benali"
2021,"Crotone","Serie A","Luca Cigarini","ITA","MF","34",1986,10.3,26,14,11,12,3,12,28,42.9,16,10,1,9,12,38,9,0,"https://fbref.com/en/players/ae64d449/Luca-Cigarini"
2021,"Crotone","Serie A","Alex Cordaz","ITA","GK","37",1983,36,0,0,0,0,0,0,0,NA,0,0,0,0,1,1,7,2,"https://fbref.com/en/players/e66ebabb/Alex-Cordaz"
2021,"Crotone","Serie A","Gian Crespi","ITA","GK","19",2001,1,0,0,0,0,0,0,0,NA,0,0,0,0,0,0,0,0,"https://fbref.com/en/players/4dea2f2c/Gian-Crespi"
2021,"Crotone","Serie A","Giovanni Crociata","ITA","DF","22",1997,0.3,1,0,0,1,0,0,1,0,1,1,0,1,0,1,0,0,"https://fbref.com/en/players/8c964914/Giovanni-Crociata"
2021,"Crotone","Serie A","Giuseppe Cuomo","ITA","DF","22",1998,8.9,26,19,17,9,0,9,14,64.3,5,10,2,8,18,44,19,1,"https://fbref.com/en/players/ae5b04fe/Giuseppe-Cuomo"
2021,"Crotone","Serie A","Samuel Di Carmine","ITA","FW","31",1988,5.3,2,2,1,0,1,1,3,33.3,2,2,0,2,0,2,5,0,"https://fbref.com/en/players/ef94dc2f/Samuel-Di-Carmine"
2021,"Crotone","Serie A","Koffi Djidji","CIV","DF","27",1992,16.9,39,28,30,8,1,10,20,50,10,35,20,15,28,67,73,0,"https://fbref.com/en/players/933d3b51/Koffi-Djidji"
2021,"Crotone","Serie A","Denis Drăguș","ROU","FW,MF","21",1999,2,3,1,0,0,3,0,4,0,4,4,0,4,1,4,0,0,"https://fbref.com/en/players/0e490f6e/Denis-Dragus"
2021,"Crotone","Serie A","Marco Festa","ITA","GK","28",1992,1,0,0,0,0,0,0,0,NA,0,0,0,0,0,0,0,0,"https://fbref.com/en/players/c195ae4a/Marco-Festa"
2021,"Crotone","Serie A","Vladimir Golemić","SVN","DF","29",1991,26,33,16,17,13,3,14,19,73.7,5,38,26,12,40,73,97,2,"https://fbref.com/en/players/1db295e5/Vladimir-Golemic"
2021,"Crotone","Serie A","Tomislav Gomelt","CRO","MF","25",1995,0.2,1,1,0,1,0,0,0,NA,0,0,0,0,1,2,0,0,"https://fbref.com/en/players/a5055b1b/Tomislav-Gomelt"
2021,"Crotone","Serie A","Eduardo Henrique","BRA","MF","25",1995,10.3,5,2,1,4,0,3,12,25,9,6,1,5,7,12,7,1,"https://fbref.com/en/players/1bd5fc78/Eduardo-Henrique"
2021,"Crotone","Serie A","Augustus Kargbo","SLE","FW","20",1999,0.4,0,0,0,0,0,0,0,NA,0,0,0,0,0,0,0,0,"https://fbref.com/en/players/0c8f27b5/Augustus-Kargbo"
2021,"Crotone","Serie A","Sebastiano Luperto","ITA","DF","23",1996,20.9,38,20,28,8,2,16,27,59.3,11,17,7,10,27,65,74,1,"https://fbref.com/en/players/997fff07/Sebastiano-Luperto"
2021,"Crotone","Serie A","Lisandro Magallán","ARG","DF","26",1993,24.2,54,31,28,24,2,17,42,40.5,25,29,15,14,44,98,78,1,"https://fbref.com/en/players/01a49bd2/Lisandro-Magallan"
2021,"Crotone","Serie A","Luca Marrone","ITA","DF","30",1990,17.6,25,18,16,9,0,13,21,61.9,8,22,11,11,26,51,56,1,"https://fbref.com/en/players/ea468ea8/Luca-Marrone"
2021,"Crotone","Serie A","Antonio Mazzotta","ITA","DF","30",1989,0.6,1,1,0,1,0,0,0,NA,0,0,0,0,0,1,1,0,"https://fbref.com/en/players/4366d5e9/Antonio-Mazzotta"
2021,"Crotone","Serie A","Junior Messias","BRA","MF,FW","29",1991,35.7,60,35,26,24,10,22,70,31.4,48,32,12,20,35,95,40,0,"https://fbref.com/en/players/f49c4ae9/Junior-Messias"
2021,"Crotone","Serie A","Salvatore Molina","ITA","MF,DF","28",1992,25.7,39,22,18,14,7,29,45,64.4,16,30,8,22,17,56,41,0,"https://fbref.com/en/players/54ab971f/Salvatore-Molina"
2021,"Crotone","Serie A","Simeon Nwankwo","NGA","FW","28",1992,32.7,9,2,2,6,1,3,22,13.6,19,21,5,16,6,15,51,0,"https://fbref.com/en/players/80dbbd10/Simeon-Nwankwo"
2021,"Crotone","Serie A","Adam Ounas","ALG","FW,MF","23",1996,13.3,9,4,4,4,1,0,7,0,7,12,1,11,3,12,4,0,"https://fbref.com/en/players/ed90babd/Adam-Ounas"
2021,"Crotone","Serie A","Pedro Pereira","POR","DF","22",1998,28.3,50,32,29,17,4,21,40,52.5,19,33,11,22,19,69,61,0,"https://fbref.com/en/players/c77be0cf/Pedro-Pereira"
2021,"Crotone","Serie A","Jacopo Petriccione","ITA","MF","25",1995,10.6,14,8,6,7,1,9,24,37.5,15,11,2,9,8,22,11,0,"https://fbref.com/en/players/909bce7f/Jacopo-Petriccione"
2021,"Crotone","Serie A","Arkadiusz Reca","POL","DF","25",1995,25.7,34,16,15,11,8,10,45,22.2,35,30,3,27,50,84,64,0,"https://fbref.com/en/players/6213fd82/Arkadiusz-Reca"
2021,"Crotone","Serie A","Andrea Rispoli","ITA","DF","31",1988,7.2,6,3,2,3,1,2,7,28.6,5,12,3,9,5,11,15,1,"https://fbref.com/en/players/39ee6cb6/Andrea-Rispoli"
2021,"Crotone","Serie A","Emmanuel Rivière","FRA","FW","30",1990,7.1,2,1,2,0,0,0,3,0,3,5,1,4,1,3,0,0,"https://fbref.com/en/players/2bae5658/Emmanuel-Riviere"
2021,"Crotone","Serie A","Luis Rojas","CHI","MF,FW","18",2002,1.2,1,0,0,1,0,1,2,50,1,2,0,2,1,2,0,0,"https://fbref.com/en/players/11e0904f/Luis-Rojas"
2021,"Crotone","Serie A","Luca Siligardi","ITA","MF,FW","32",1988,0.5,4,2,0,3,1,1,5,20,4,0,0,0,0,4,0,0,"https://fbref.com/en/players/1cac99dc/Luca-Siligardi"
2021,"Crotone","Serie A","Miloš Vulić","SRB","MF","23",1996,14.5,15,8,9,1,5,8,21,38.1,13,10,1,9,8,23,8,0,"https://fbref.com/en/players/5944af8f/Milos-Vulic"
2021,"Crotone","Serie A","Niccolò Zanellato","ITA","MF","22",1998,18.2,24,14,16,6,2,13,36,36.1,23,19,5,14,16,40,12,2,"https://fbref.com/en/players/741e058f/Niccolo-Zanellato"
2021,"Crystal Palace","Premier League","Patrick van Aanholt","NED","DF","29",1990,19.7,35,22,18,17,0,19,43,44.2,24,18,6,12,30,65,40,2,"https://fbref.com/en/players/5f09991f/Patrick-van-Aanholt"
2021,"Crystal Palace","Premier League","Jordan Ayew","GHA","FW,MF","28",1991,23.3,38,26,8,16,14,16,44,36.4,28,28,2,26,16,54,12,0,"https://fbref.com/en/players/da052c14/Jordan-Ayew"
2021,"Crystal Palace","Premier League","Michy Batshuayi","BEL","FW","26",1993,8.1,5,3,1,2,2,1,9,11.1,8,5,1,4,4,9,5,0,"https://fbref.com/en/players/2973d8ff/Michy-Batshuayi"
2021,"Crystal Palace","Premier League","Christian Benteke","BEL","FW","29",1990,20.2,15,7,1,7,7,2,9,22.2,7,17,6,11,4,19,39,0,"https://fbref.com/en/players/ab070c55/Christian-Benteke"
2021,"Crystal Palace","Premier League","Jack Butland","ENG","GK","27",1993,1,0,0,0,0,0,0,0,NA,0,0,0,0,0,0,0,0,"https://fbref.com/en/players/cc70a1d5/Jack-Butland"
2021,"Crystal Palace","Premier League","Gary Cahill","ENG","DF","34",1985,20,13,9,10,3,0,7,11,63.6,4,27,22,5,13,26,88,0,"https://fbref.com/en/players/7914b9fe/Gary-Cahill"
2021,"Crystal Palace","Premier League","Nathaniel Clyne","ENG","DF","29",1991,12.7,17,10,8,8,1,9,16,56.3,7,7,2,5,18,35,25,1,"https://fbref.com/en/players/0442183b/Nathaniel-Clyne"
2021,"Crystal Palace","Premier League","Scott Dann","ENG","DF","33",1987,15,6,4,5,1,0,4,11,36.4,7,16,14,2,18,24,59,1,"https://fbref.com/en/players/52105203/Scott-Dann"
2021,"Crystal Palace","Premier League","Eberechi Eze","ENG","MF","22",1998,28.4,27,14,11,13,3,16,35,45.7,19,19,3,16,24,51,9,1,"https://fbref.com/en/players/ae4fc6a4/Eberechi-Eze"
2021,"Crystal Palace","Premier League","Vicente Guaita","ESP","GK","33",1987,37,1,1,1,0,0,1,1,100,0,0,0,0,1,2,11,1,"https://fbref.com/en/players/ab13a5aa/Vicente-Guaita"
2021,"Crystal Palace","Premier League","Martin Kelly","ENG","DF","30",1990,0,1,0,1,0,0,1,1,100,0,0,0,0,0,1,0,0,"https://fbref.com/en/players/d7492450/Martin-Kelly"
2021,"Crystal Palace","Premier League","Cheikhou Kouyaté","SEN","DF","30",1989,34.7,58,37,44,12,2,25,43,58.1,18,42,26,16,32,90,125,2,"https://fbref.com/en/players/8d3c902d/Cheikhou-Kouyate"
2021,"Crystal Palace","Premier League","Jean-Philippe Mateta","FRA","FW","23",1997,2.5,1,1,0,1,0,1,3,33.3,2,1,0,1,0,1,2,0,"https://fbref.com/en/players/50e6dc35/Jean-Philippe-Mateta"
2021,"Crystal Palace","Premier League","James McArthur","SCO","MF","32",1987,16.3,57,32,25,27,5,15,39,38.5,24,28,3,25,23,80,31,0,"https://fbref.com/en/players/cee31595/James-McArthur"
2021,"Crystal Palace","Premier League","James McCarthy","IRL","MF","29",1990,9.1,16,12,9,7,0,8,21,38.1,13,15,7,8,8,24,12,0,"https://fbref.com/en/players/64b08de7/James-McCarthy"
2021,"Crystal Palace","Premier League","Luka Milivojević","SRB","MF","29",1991,26.2,65,34,25,31,9,42,77,54.5,35,29,6,23,35,100,47,2,"https://fbref.com/en/players/2ce2508a/Luka-Milivojevic"
2021,"Crystal Palace","Premier League","Tyrick Mitchell","ENG","DF","20",1999,19,64,35,48,9,7,23,40,57.5,17,29,10,19,21,85,62,1,"https://fbref.com/en/players/5cbd1eb0/Tyrick-Mitchell"
2021,"Crystal Palace","Premier League","Jaïro Riedewald","NED","MF","23",1996,20.2,34,15,13,17,4,16,36,44.4,20,39,7,32,29,63,25,0,"https://fbref.com/en/players/7a1f2c08/Jairo-Riedewald"
2021,"Crystal Palace","Premier League","Mamadou Sakho","FRA","DF","30",1990,3.1,3,2,1,2,0,3,3,100,0,3,2,1,3,6,11,0,"https://fbref.com/en/players/87935cf3/Mamadou-Sakho"
2021,"Crystal Palace","Premier League","Jeffrey Schlupp","GHA","MF","27",1992,15.9,29,16,14,12,3,6,23,26.1,17,24,8,16,22,51,16,0,"https://fbref.com/en/players/3312f911/Jeffrey-Schlupp"
2021,"Crystal Palace","Premier League","James Tomkins","ENG","DF","31",1989,6.1,4,2,4,0,0,3,4,75,1,4,3,1,4,8,45,0,"https://fbref.com/en/players/e7ca0439/James-Tomkins"
2021,"Crystal Palace","Premier League","Andros Townsend","ENG","MF,FW","29",1991,25.1,78,41,45,20,13,30,79,38,49,48,2,46,41,119,19,0,"https://fbref.com/en/players/b28bbd58/Andros-Townsend"
2021,"Crystal Palace","Premier League","Joel Ward","ENG","DF","30",1989,25.1,43,25,29,14,0,24,42,57.1,18,27,8,19,41,84,87,2,"https://fbref.com/en/players/8a7ff278/Joel-Ward"
2021,"Crystal Palace","Premier League","Wilfried Zaha","CIV","FW","27",1992,29,26,18,8,15,3,11,30,36.7,19,21,0,21,9,35,4,0,"https://fbref.com/en/players/b2bc3b1f/Wilfried-Zaha"
2021,"Cádiz","La Liga","Bobby Adekanye","NED","FW,MF","21",1999,0.4,0,0,0,0,0,0,1,0,1,0,0,0,0,0,1,0,"https://fbref.com/en/players/3ed84b2c/Bobby-Adekanye"
2021,"Cádiz","La Liga","Carlos Akapo","EQG","DF","27",1993,9.6,18,14,14,4,0,10,18,55.6,8,16,3,13,19,37,33,0,"https://fbref.com/en/players/f2a68b97/Carlos-Akapo"
2021,"Cádiz","La Liga","Pedro Alcalá","ESP","DF","31",1989,10.1,8,4,6,2,0,3,5,60,2,19,13,6,16,24,50,0,"https://fbref.com/en/players/ba71d071/Pedro-Alcala"
2021,"Cádiz","La Liga","Iván Alejo","ESP","MF,FW","25",1995,9.2,14,10,8,4,2,4,23,17.4,19,14,1,13,3,17,10,0,"https://fbref.com/en/players/3d7e48ce/Ivan-Alejo"
2021,"Cádiz","La Liga","Jon Ander Garrido","ESP","MF","30",1989,8.9,18,10,8,7,3,10,26,38.5,16,12,4,8,14,32,13,0,"https://fbref.com/en/players/c46736ab/Jon-Ander-Garrido"
2021,"Cádiz","La Liga","Marc Baró","ESP","DF","20",1999,1,2,1,2,0,0,0,2,0,2,1,0,1,2,4,2,1,"https://fbref.com/en/players/74aa6ab7/Marc-Baro"
2021,"Cádiz","La Liga","Álvaro Bastida","ESP","MF","16",2004,0.4,0,0,0,0,0,0,0,NA,0,0,0,0,0,0,0,0,"https://fbref.com/en/players/42a028c5/Alvaro-Bastida"
2021,"Cádiz","La Liga","Yann Bodiger","FRA","MF","25",1995,2.8,2,2,1,1,0,1,6,16.7,5,7,3,4,8,10,4,0,"https://fbref.com/en/players/8c2c48a9/Yann-Bodiger"
2021,"Cádiz","La Liga","Cala","ESP","DF","30",1989,25.2,21,12,15,6,0,11,21,52.4,10,18,8,10,35,56,91,0,"https://fbref.com/en/players/fe05804b/Cala"
2021,"Cádiz","La Liga","Isaac Carcelen","ESP","DF","27",1993,28.7,68,43,36,25,7,33,60,55,27,37,12,25,49,117,89,0,"https://fbref.com/en/players/c4b888df/Isaac-Carcelen"
2021,"Cádiz","La Liga","Alberto Cifuentes","ESP","GK","41",1979,2,0,0,0,0,0,0,0,NA,0,0,0,0,0,0,0,0,"https://fbref.com/en/players/94084f83/Alberto-Cifuentes"
2021,"Cádiz","La Liga","Alfonso Espino","URU","DF","28",1992,28.9,92,48,63,28,1,43,85,50.6,42,30,5,25,41,133,74,0,"https://fbref.com/en/players/db001fa9/Alfonso-Espino"
2021,"Cádiz","La Liga","Fali","ESP","DF,MF","26",1993,29.3,42,25,24,15,3,16,37,43.2,21,28,15,13,32,74,119,0,"https://fbref.com/en/players/72a84002/Fali"
2021,"Cádiz","La Liga","Álex Fernández","ESP","MF","27",1992,21.6,19,9,8,8,3,8,30,26.7,22,14,1,13,22,41,15,0,"https://fbref.com/en/players/aa677a35/Alex-Fernandez"
2021,"Cádiz","La Liga","Augusto Fernández","ARG","MF","34",1986,4.1,11,3,5,6,0,2,13,15.4,11,5,1,4,9,20,5,0,"https://fbref.com/en/players/78c40e94/Augusto-Fernandez"
2021,"Cádiz","La Liga","David Gil","ESP","GK","26",1994,4,0,0,0,0,0,0,1,0,1,0,0,0,0,0,2,0,"https://fbref.com/en/players/fea23125/David-Gil"
2021,"Cádiz","La Liga","Álvaro Giménez","ESP","FW","29",1991,4.5,4,2,2,2,0,0,3,0,3,2,0,2,2,6,3,0,"https://fbref.com/en/players/18017beb/Alvaro-Gimenez"
2021,"Cádiz","La Liga","Sergio González","ESP","MF,DF","23",1997,1,1,0,0,1,0,1,2,50,1,0,0,0,2,3,0,0,"https://fbref.com/en/players/5dd16ace/Sergio-Gonzalez"
2021,"Cádiz","La Liga","Marcos Mauro López Gutiérrez","ARG","DF","29",1991,20.3,23,15,15,8,0,15,24,62.5,9,18,12,6,22,45,78,0,"https://fbref.com/en/players/b3b62f94/Marcos-Mauro-Lopez-Gutierrez"
2021,"Cádiz","La Liga","Jairo Izquierdo","ESP","MF,DF","26",1993,14.2,21,13,13,8,0,12,31,38.7,19,7,1,6,14,35,12,0,"https://fbref.com/en/players/2ceb58ab/Jairo-Izquierdo"
2021,"Cádiz","La Liga","Jens Jønsson","DEN","MF","27",1993,29.1,55,29,25,25,5,22,52,42.3,30,39,7,32,51,106,45,0,"https://fbref.com/en/players/53520a67/Jens-Jonsson"
2021,"Cádiz","La Liga","Jeremías Ledesma","ARG","GK","27",1993,32,1,0,1,0,0,1,1,100,0,1,0,1,0,1,22,6,"https://fbref.com/en/players/6c4776b1/Jeremias-Ledesma"
2021,"Cádiz","La Liga","Anthony Lozano","HON","FW","27",1993,16.9,12,4,1,5,6,2,13,15.4,11,3,1,2,3,15,8,0,"https://fbref.com/en/players/38699c72/Anthony-Lozano"
2021,"Cádiz","La Liga","Filip Malbašić","SRB","FW,MF","27",1992,9.6,12,7,4,5,3,6,18,33.3,12,10,0,10,4,16,2,0,"https://fbref.com/en/players/04981123/Filip-Malbasic"
2021,"Cádiz","La Liga","José Mari","ESP","MF","32",1987,16.1,32,17,13,18,1,14,31,45.2,17,16,7,9,27,59,33,1,"https://fbref.com/en/players/6f4c734d/Jose-Mari"
2021,"Cádiz","La Liga","Álex Martín","ESP","DF","22",1998,1.1,2,0,1,1,0,2,4,50,2,1,1,0,0,2,6,0,"https://fbref.com/en/players/80153344/Alex-Martin"
2021,"Cádiz","La Liga","Nano","ESP","FW","25",1995,0.1,0,0,0,0,0,0,0,NA,0,0,0,0,0,0,0,0,"https://fbref.com/en/players/217011a0/Nano"
2021,"Cádiz","La Liga","Álvaro Negredo","ESP","FW","34",1985,24.4,11,5,3,4,4,5,11,45.5,6,7,2,5,3,14,19,0,"https://fbref.com/en/players/63b0ca6b/Alvaro-Negredo"
2021,"Cádiz","La Liga","Nieto","ESP","FW,DF","22",1998,0.2,1,1,0,1,0,0,0,NA,0,0,0,0,0,1,1,0,"https://fbref.com/en/players/3afeb49f/Nieto"
2021,"Cádiz","La Liga","Alberto Perea","ESP","MF","29",1990,17.2,28,17,12,10,6,9,35,25.7,26,26,1,25,21,49,9,0,"https://fbref.com/en/players/5496cc91/Alberto-Perea"
2021,"Cádiz","La Liga","Jorge Pombo","ESP","FW,MF","26",1994,5.8,7,3,3,2,2,1,8,12.5,7,2,0,2,2,9,3,0,"https://fbref.com/en/players/0a8bcb23/Jorge-Pombo"
2021,"Cádiz","La Liga","Salvi","ESP","MF,FW","29",1991,21.5,18,10,14,3,1,8,26,30.8,18,14,1,13,20,38,24,0,"https://fbref.com/en/players/405f267a/Salvi"
2021,"Cádiz","La Liga","Ivan Šaponjić","SRB","FW","22",1997,4.3,1,0,0,1,0,0,2,0,2,2,0,2,1,2,4,0,"https://fbref.com/en/players/d2aea9ac/Ivan-Saponjic"
2021,"Cádiz","La Liga","Rubén Sobrino","ESP","FW,MF","28",1992,12.4,29,13,8,16,5,8,18,44.4,10,19,0,19,15,44,11,0,"https://fbref.com/en/players/19b776e9/Ruben-Sobrino"
2021,"Dijon","Ligue 1","Saturnin Allagbé","BEN","GK","26",1993,12,0,0,0,0,0,0,1,0,1,0,0,0,0,0,9,3,"https://fbref.com/en/players/b052b8bf/Saturnin-Allagbe"
2021,"Dijon","Ligue 1","Romain Amalfitano","FRA","FW,DF","30",1989,1.3,4,2,3,1,0,1,3,33.3,2,2,1,1,1,5,1,0,"https://fbref.com/en/players/d7bf3d19/Romain-Amalfitano"
2021,"Dijon","Ligue 1","Roger Assalé","CIV","FW,MF","26",1993,9.2,10,8,3,5,2,4,12,33.3,8,7,3,4,2,12,2,0,"https://fbref.com/en/players/5d5219b1/Roger-Assale"
2021,"Dijon","Ligue 1","Erwan Belhadji","FRA","MF","19",2001,0.3,3,0,3,0,0,3,5,60,2,1,0,1,0,3,0,0,"https://fbref.com/en/players/7615f332/Erwan-Belhadji"
2021,"Dijon","Ligue 1","Yassine Benzia","ALG","MF,FW","25",1994,4.5,10,5,5,3,2,2,10,20,8,3,0,3,6,16,2,0,"https://fbref.com/en/players/6fbde63a/Yassine-Benzia"
2021,"Dijon","Ligue 1","Sacha Boey","FRA","DF","19",2000,20.7,54,40,30,23,1,27,55,49.1,28,25,5,20,41,95,62,0,"https://fbref.com/en/players/6c8ddd52/Sacha-Boey"
2021,"Dijon","Ligue 1","Bersant Celina","KVX","MF,FW","23",1996,25.5,20,12,8,8,4,7,38,18.4,31,20,2,18,8,28,10,0,"https://fbref.com/en/players/3043d33f/Bersant-Celina"
2021,"Dijon","Ligue 1","Fouad Chafik","MAR","DF","33",1986,18,39,24,29,8,2,16,35,45.7,19,19,10,9,21,60,41,0,"https://fbref.com/en/players/edd1466a/Fouad-Chafik"
2021,"Dijon","Ligue 1","Aníbal Chalá","ECU","DF","24",1996,8.3,10,7,6,3,1,6,12,50,6,5,3,2,14,24,15,1,"https://fbref.com/en/players/84c0768a/Anibal-Chala"
2021,"Dijon","Ligue 1","Pape Cheikh Diop","SEN","MF","22",1997,12.1,24,14,15,6,3,13,33,39.4,20,14,2,12,6,30,6,0,"https://fbref.com/en/players/873ce3a2/Pape-Cheikh-Diop"
2021,"Dijon","Ligue 1","Mounir Chouiar","FRA","FW,MF","21",1999,14.3,22,12,10,9,3,6,18,33.3,12,10,0,10,11,33,8,0,"https://fbref.com/en/players/45c1c326/Mounir-Chouiar"
2021,"Dijon","Ligue 1","Charles Costes","FRA","MF","17",2002,0,0,0,0,0,0,0,0,NA,0,0,0,0,0,0,0,0,"https://fbref.com/en/players/aa67d758/Charles-Costes"
2021,"Dijon","Ligue 1","Senou Coulibaly","MLI","DF","25",1994,21.5,33,21,23,10,0,12,24,50,12,18,12,6,30,63,89,0,"https://fbref.com/en/players/67b7357e/Senou-Coulibaly"
2021,"Dijon","Ligue 1","Junior Dina Ebimbe","FRA","FW,MF","19",2000,23.8,38,25,14,19,5,15,45,33.3,30,17,1,16,14,52,9,0,"https://fbref.com/en/players/95bb6ddc/Junior-Dina-Ebimbe"
2021,"Dijon","Ligue 1","Mihai Dobre","ROU","FW","21",1998,5.9,12,5,6,2,4,7,14,50,7,5,0,5,10,22,3,0,"https://fbref.com/en/players/a1f3f5a0/Mihai-Dobre"
2021,"Dijon","Ligue 1","Bruno Ecuele Manga","GAB","DF","32",1988,38,52,38,46,6,0,29,40,72.5,11,50,33,17,57,109,165,3,"https://fbref.com/en/players/72a0fb65/Bruno-Ecuele-Manga"
2021,"Dijon","Ligue 1","Alfred Gomis","SEN","GK","26",1993,5,1,0,1,0,0,1,2,50,1,0,0,0,1,2,7,0,"https://fbref.com/en/players/cecbce23/Alfred-Gomis"
2021,"Dijon","Ligue 1","Didier Ibrahim Ndong","GAB","MF","26",1994,29,53,32,22,30,1,25,70,35.7,45,35,7,28,37,90,40,0,"https://fbref.com/en/players/885b7aa7/Didier-Ibrahim-Ndong"
2021,"Dijon","Ligue 1","Aboubakar Kamara","MTN","FW,MF","25",1995,6.2,3,1,0,2,1,1,7,14.3,6,1,0,1,0,3,2,0,"https://fbref.com/en/players/4047c976/Aboubakar-Kamara"
2021,"Dijon","Ligue 1","Moussa Konaté","SEN","FW","27",1993,13.3,5,3,1,2,2,2,11,18.2,9,4,1,3,5,10,8,0,"https://fbref.com/en/players/fcbcbd94/Moussa-Konate"
2021,"Dijon","Ligue 1","Wesley Lautoa","NCL","MF,DF","32",1987,17.9,36,20,20,13,3,11,37,29.7,26,17,8,9,29,65,33,1,"https://fbref.com/en/players/6e5b5a45/Wesley-Lautoa"
2021,"Dijon","Ligue 1","Jordan Marié","FRA","MF","28",1991,15.9,34,17,9,23,2,23,56,41.1,33,14,5,9,23,57,12,2,"https://fbref.com/en/players/0d2158d5/Jordan-Marie"
2021,"Dijon","Ligue 1","Muzinga Ngonda","COD","DF","25",1994,25.6,59,40,37,21,1,30,50,60,20,28,3,25,72,131,58,0,"https://fbref.com/en/players/b748968d/Muzinga-Ngonda"
2021,"Dijon","Ligue 1","Ahmad Ngouyamsa","CMR","DF","19",2000,1.7,6,4,5,1,0,4,8,50,4,2,1,1,2,8,8,0,"https://fbref.com/en/players/8413ceb1/Ahmad-Ngouyamsa"
2021,"Dijon","Ligue 1","Jonathan Panzo","ENG","DF","19",2000,20,17,12,13,4,0,8,11,72.7,3,27,13,14,59,76,91,2,"https://fbref.com/en/players/c795c408/Jonathan-Panzo"
2021,"Dijon","Ligue 1","Rayan Philippe","FRA","FW","19",2000,1,3,1,1,1,1,2,2,100,0,0,0,0,0,3,0,0,"https://fbref.com/en/players/a046fc35/Rayan-Philippe"
2021,"Dijon","Ligue 1","Anthony Racioppi","SUI","GK","21",1998,21,0,0,0,0,0,0,2,0,2,0,0,0,2,2,12,4,"https://fbref.com/en/players/abc06eb3/Anthony-Racioppi"
2021,"Dijon","Ligue 1","Mama Samba Baldé","GNB","FW","24",1995,24,23,9,4,13,6,9,22,40.9,13,16,1,15,4,27,26,0,"https://fbref.com/en/players/fb14aa28/Mama-Samba-Balde"
2021,"Dijon","Ligue 1","Frédéric Sammaritano","FRA","FW,MF","34",1986,12.6,15,10,9,5,1,9,26,34.6,17,6,0,6,9,24,3,0,"https://fbref.com/en/players/8802c1d5/Frederic-Sammaritano"
2021,"Dijon","Ligue 1","Aurélien Scheidler","FRA","FW","22",1998,3.8,2,0,0,2,0,0,2,0,2,0,0,0,1,3,5,0,"https://fbref.com/en/players/bc9479b9/Aurelien-Scheidler"
2021,"Dijon","Ligue 1","Jacques Siwe","FRA","FW","19",2001,1.9,4,1,1,1,2,0,1,0,1,1,0,1,1,5,1,0,"https://fbref.com/en/players/c39b09e3/Jacques-Siwe"
2021,"Dijon","Ligue 1","Wilitty Younoussa","CMR","MF","18",2001,0.9,6,3,3,3,0,3,7,42.9,4,3,0,3,2,8,0,0,"https://fbref.com/en/players/2736b85e/Wilitty-Younoussa"
2021,"Dijon","Ligue 1","Arthur Zagre","FRA","DF,MF","18",2001,1.4,3,1,2,1,0,2,2,100,0,1,1,0,3,6,1,0,"https://fbref.com/en/players/3225654e/Arthur-Zagre"
2021,"Dortmund","Bundesliga","Manuel Akanji","SUI","DF","25",1995,26.1,41,22,23,12,6,19,31,61.3,12,23,10,13,49,90,70,1,"https://fbref.com/en/players/89ac64a6/Manuel-Akanji"
2021,"Dortmund","Bundesliga","Jude Bellingham","ENG","MF","17",2003,18.9,49,31,11,29,9,19,46,41.3,27,37,5,32,24,73,13,0,"https://fbref.com/en/players/57d88cf9/Jude-Bellingham"
2021,"Dortmund","Bundesliga","Julian Brandt","GER","FW,MF","24",1996,16.6,27,14,13,9,5,12,43,27.9,31,25,1,24,17,44,7,1,"https://fbref.com/en/players/a167537f/Julian-Brandt"
2021,"Dortmund","Bundesliga","Roman Bürki","SUI","GK","29",1990,18.5,0,0,0,0,0,0,0,NA,0,0,0,0,0,0,5,1,"https://fbref.com/en/players/9d12e142/Roman-Burki"
2021,"Dortmund","Bundesliga","Emre Can","GER","DF,MF","26",1994,23.7,43,34,20,20,3,20,37,54.1,17,35,10,25,48,91,52,0,"https://fbref.com/en/players/a65ce836/Emre-Can"
2021,"Dortmund","Bundesliga","Mahmoud Dahoud","GER","MF","24",1996,14,30,18,9,20,1,14,38,36.8,24,23,5,18,18,48,11,1,"https://fbref.com/en/players/db4ed67b/Mahmoud-Dahoud"
2021,"Dortmund","Bundesliga","Thomas Delaney","DEN","MF","28",1991,14.3,40,30,15,20,5,11,31,35.5,20,28,10,18,22,62,15,1,"https://fbref.com/en/players/fe641c1a/Thomas-Delaney"
2021,"Dortmund","Bundesliga","Raphaël Guerreiro","POR","DF","26",1993,24.6,30,13,14,8,8,16,31,51.6,15,21,4,17,28,58,31,1,"https://fbref.com/en/players/048a1cbc/Raphael-Guerreiro"
2021,"Dortmund","Bundesliga","Erling Haaland","NOR","FW","20",2000,26.7,7,2,1,3,3,1,4,25,3,19,4,15,4,11,16,0,"https://fbref.com/en/players/1f44ac21/Erling-Haaland"
2021,"Dortmund","Bundesliga","Thorgan Hazard","BEL","MF,FW","27",1993,7.3,8,2,6,1,1,3,13,23.1,10,4,0,4,10,18,1,0,"https://fbref.com/en/players/50871bcc/Thorgan-Hazard"
2021,"Dortmund","Bundesliga","Marwin Hitz","SUI","GK","32",1987,15.5,1,1,1,0,0,1,1,100,0,0,0,0,0,1,7,1,"https://fbref.com/en/players/2e7ff968/Marwin-Hitz"
2021,"Dortmund","Bundesliga","Mats Hummels","GER","DF","31",1988,31.3,58,40,34,18,6,26,42,61.9,16,31,22,9,73,131,122,2,"https://fbref.com/en/players/05d548d8/Mats-Hummels"
2021,"Dortmund","Bundesliga","Ansgar Knauff","GER","MF,FW","18",2002,0.8,0,0,0,0,0,0,1,0,1,3,1,2,0,0,0,0,"https://fbref.com/en/players/19a967ab/Ansgar-Knauff"
2021,"Dortmund","Bundesliga","Thomas Meunier","BEL","DF","28",1991,16.4,30,21,19,6,5,20,29,69,9,16,6,10,18,48,29,2,"https://fbref.com/en/players/e162b013/Thomas-Meunier"
2021,"Dortmund","Bundesliga","Mateu Morey","ESP","DF","20",2000,9.2,13,7,4,7,2,9,12,75,3,6,1,5,18,31,7,1,"https://fbref.com/en/players/5fd5e542/Mateu-Morey"
2021,"Dortmund","Bundesliga","Youssoufa Moukoko","GER","FW,MF","15",2004,4.7,3,2,1,1,1,0,0,NA,0,3,0,3,0,3,2,0,"https://fbref.com/en/players/6ce43701/Youssoufa-Moukoko"
2021,"Dortmund","Bundesliga","Felix Passlack","GER","DF","22",1998,4,9,6,4,2,3,4,8,50,4,11,1,10,3,12,2,0,"https://fbref.com/en/players/5c899683/Felix-Passlack"
2021,"Dortmund","Bundesliga","Łukasz Piszczek","POL","DF","35",1985,5.1,10,7,6,4,0,5,12,41.7,7,5,1,4,5,15,12,0,"https://fbref.com/en/players/fe2db476/Lukasz-Piszczek"
2021,"Dortmund","Bundesliga","Reinier","BRA","MF,FW","18",2002,2.9,9,4,6,1,2,2,4,50,2,4,1,3,2,11,0,0,"https://fbref.com/en/players/6b21b7b5/Reinier"
2021,"Dortmund","Bundesliga","Marco Reus","GER","MF,FW","31",1989,25.3,33,16,9,16,8,9,33,27.3,24,22,2,20,14,47,13,0,"https://fbref.com/en/players/36a3ff67/Marco-Reus"
2021,"Dortmund","Bundesliga","Gio Reyna","USA","MF,FW","17",2002,22,24,13,9,8,7,9,25,36,16,14,1,13,10,34,11,0,"https://fbref.com/en/players/7fa4e703/Gio-Reyna"
2021,"Dortmund","Bundesliga","Jadon Sancho","ENG","FW,MF","20",2000,22.9,18,11,4,10,4,7,16,43.8,9,20,1,19,16,34,9,0,"https://fbref.com/en/players/dbf053da/Jadon-Sancho"
2021,"Dortmund","Bundesliga","Nico Schulz","GER","DF","27",1993,6.8,9,6,4,3,2,2,11,18.2,9,12,4,8,6,15,10,0,"https://fbref.com/en/players/fa274d97/Nico-Schulz"
2021,"Dortmund","Bundesliga","Steffen Tigges","GER","FW,DF","22",1998,0.6,4,4,0,1,3,2,3,66.7,1,1,0,1,0,4,1,0,"https://fbref.com/en/players/6b8887c2/Steffen-Tigges"
2021,"Dortmund","Bundesliga","Axel Witsel","BEL","MF","31",1989,12.6,18,12,6,11,1,8,16,50,8,13,3,10,22,40,13,0,"https://fbref.com/en/players/5dfc6ad5/Axel-Witsel"
2021,"Dortmund","Bundesliga","Dan-Axel Zagadou","FRA","DF","21",1999,3.1,2,2,2,0,0,0,0,NA,0,3,2,1,6,8,13,0,"https://fbref.com/en/players/a4effc55/Dan-Axel-Zagadou"
2021,"Eibar","La Liga","Sergio Álvarez","ESP","MF,DF","28",1992,17.4,42,25,13,26,3,8,22,36.4,14,22,5,17,22,64,24,2,"https://fbref.com/en/players/88d91621/Sergio-Alvarez"
2021,"Eibar","La Liga","José Ángel","ESP","DF","30",1989,10,15,8,9,4,2,8,12,66.7,4,7,0,7,13,28,17,1,"https://fbref.com/en/players/3024e383/Jose-Angel"
2021,"Eibar","La Liga","Anaitz Arbilla","ESP","DF","33",1987,31.2,45,26,31,11,3,27,54,50,27,36,11,25,69,114,73,1,"https://fbref.com/en/players/850c0a0d/Anaitz-Arbilla"
2021,"Eibar","La Liga","Unai Arietaleanizbeaskoa","ESP","FW,MF","21",1999,0.5,1,0,0,0,1,0,0,NA,0,0,0,0,0,1,0,0,"https://fbref.com/en/players/74d9a90b/Unai-Arietaleanizbeaskoa"
2021,"Eibar","La Liga","Miguel Atienza","ESP","MF","21",1999,9.3,20,9,5,15,0,8,23,34.8,15,14,1,13,9,29,12,0,"https://fbref.com/en/players/12eda7be/Miguel-Atienza"
2021,"Eibar","La Liga","Pedro Bigas","ESP","DF","29",1990,17,11,9,7,4,0,7,14,50,7,12,6,6,23,34,54,0,"https://fbref.com/en/players/697295b1/Pedro-Bigas"
2021,"Eibar","La Liga","Bryan","ESP","MF,FW","19",2001,25.2,28,18,12,11,5,6,23,26.1,17,20,0,20,17,45,6,0,"https://fbref.com/en/players/7b5ab7f2/Bryan"
2021,"Eibar","La Liga","Esteban Burgos","ARG","DF","28",1992,12.3,7,6,4,3,0,1,5,20,4,8,7,1,23,30,54,2,"https://fbref.com/en/players/40449bbd/Esteban-Burgos"
2021,"Eibar","La Liga","Rober Correa","ESP","DF","27",1992,12.6,16,9,8,6,2,8,12,66.7,4,9,1,8,20,36,31,0,"https://fbref.com/en/players/46bd3a5b/Rober-Correa"
2021,"Eibar","La Liga","Sergio Cubero Ezcurra","ESP","MF","20",1999,0,0,0,0,0,0,0,0,NA,0,0,0,0,0,0,0,0,"https://fbref.com/en/players/d858d079/Sergio-Cubero-Ezcurra"
2021,"Eibar","La Liga","Papakouli Diop","SEN","MF","34",1986,25.8,43,29,15,22,6,12,41,29.3,29,23,5,18,39,82,34,1,"https://fbref.com/en/players/7329018e/Papakouli-Diop"
2021,"Eibar","La Liga","Marko Dmitrović","SRB","GK","28",1992,34.7,4,3,4,0,0,2,4,50,2,0,0,0,0,4,16,2,"https://fbref.com/en/players/ac295d9e/Marko-Dmitrovic"
2021,"Eibar","La Liga","Unai Dufur","ESP","DF","21",1999,0.7,2,2,2,0,0,2,4,50,2,0,0,0,1,3,0,0,"https://fbref.com/en/players/c261b5dd/Unai-Dufur"
2021,"Eibar","La Liga","Sergi Enrich","ESP","FW","30",1990,15.6,21,15,6,7,8,9,22,40.9,13,11,0,11,6,27,5,0,"https://fbref.com/en/players/bb4b1242/Sergi-Enrich"
2021,"Eibar","La Liga","Edu Expósito","ESP","MF","23",1996,27.3,51,30,16,31,4,20,66,30.3,46,25,4,21,22,73,17,0,"https://fbref.com/en/players/283c7121/Edu-Exposito"
2021,"Eibar","La Liga","Aleix García","ESP","MF","23",1997,4.9,5,4,2,2,1,1,10,10,9,5,0,5,8,13,2,0,"https://fbref.com/en/players/a10361d2/Aleix-Garcia"
2021,"Eibar","La Liga","Takashi Inui","JPN","MF,FW","32",1988,20.2,13,8,6,3,4,3,12,25,9,19,0,19,12,25,7,0,"https://fbref.com/en/players/61bd33d0/Takashi-Inui"
2021,"Eibar","La Liga","Damian Kądzior","POL","FW,MF","28",1992,2.2,1,0,0,1,0,1,5,20,4,1,0,1,0,1,0,0,"https://fbref.com/en/players/bb6c6331/Damian-Kadzior"
2021,"Eibar","La Liga","Kike","ESP","FW","30",1989,34.3,24,18,5,7,12,6,22,27.3,16,24,1,23,7,31,29,0,"https://fbref.com/en/players/e897d8ba/Kike"
2021,"Eibar","La Liga","Pedro León","ESP","MF,FW","33",1986,10.4,9,8,3,3,3,3,17,17.6,14,11,0,11,7,16,2,0,"https://fbref.com/en/players/d66b9872/Pedro-Leon"
2021,"Eibar","La Liga","Eñaut Mendía","ESP","FW","21",1999,0.7,2,1,2,0,0,1,2,50,1,1,1,0,0,2,0,0,"https://fbref.com/en/players/aa7da569/Enaut-Mendia"
2021,"Eibar","La Liga","Yoshinori Mutō","JPN","FW,MF","28",1992,12.5,12,7,1,4,7,3,8,37.5,5,5,0,5,3,15,2,0,"https://fbref.com/en/players/5343eb4e/Yoshinori-Muto"
2021,"Eibar","La Liga","Paulo Oliveira","POR","DF","28",1992,29.3,42,21,32,8,2,19,36,52.8,17,39,14,25,59,101,112,0,"https://fbref.com/en/players/a8fbae1d/Paulo-Oliveira"
2021,"Eibar","La Liga","Alejandro Pozo Pozo","ESP","DF,MF","21",1999,24.3,38,22,17,15,6,17,38,44.7,21,35,2,33,27,65,40,1,"https://fbref.com/en/players/3c16d927/Alejandro-Pozo-Pozo"
2021,"Eibar","La Liga","Quique","ESP","FW,MF","30",1990,1.9,0,0,0,0,0,0,1,0,1,2,0,2,0,0,0,0,"https://fbref.com/en/players/c966fce1/Quique"
2021,"Eibar","La Liga","Recio","ESP","MF","29",1991,8.2,17,5,4,8,5,8,18,44.4,10,6,0,6,4,21,1,0,"https://fbref.com/en/players/54073b28/Recio"
2021,"Eibar","La Liga","Kévin Rodrigues","POR","DF,MF","26",1994,12.2,16,8,8,5,3,7,23,30.4,16,10,1,9,20,36,15,1,"https://fbref.com/en/players/f1bed920/Kevin-Rodrigues"
2021,"Eibar","La Liga","Rafa Soares","POR","DF","25",1995,12.6,28,17,16,8,4,15,21,71.4,6,14,4,10,20,48,32,0,"https://fbref.com/en/players/062fc2e6/Rafa-Soares"
2021,"Eibar","La Liga","Álvaro Tejero","ESP","DF","24",1996,1.2,1,1,0,0,1,1,3,33.3,2,1,0,1,3,4,6,0,"https://fbref.com/en/players/868ce848/Alvaro-Tejero"
2021,"Eibar","La Liga","Yoel","ESP","GK","31",1988,3.3,0,0,0,0,0,0,0,NA,0,0,0,0,0,0,2,0,"https://fbref.com/en/players/61bb7498/Yoel"
2021,"Eint Frankfurt","Bundesliga","David Abraham","ARG","DF","34",1986,13.6,18,12,13,3,2,11,17,64.7,6,13,4,9,17,35,34,0,"https://fbref.com/en/players/565bf0da/David-Abraham"
2021,"Eint Frankfurt","Bundesliga","Ragnar Ache","GER","FW,DF","22",1998,1.1,2,0,0,1,1,0,0,NA,0,1,0,1,1,3,1,0,"https://fbref.com/en/players/dc38e3bc/Ragnar-Ache"
2021,"Eint Frankfurt","Bundesliga","Aymen Barkok","MAR","MF,DF","22",1998,10.9,29,15,11,9,9,10,31,32.3,21,15,1,14,10,39,9,1,"https://fbref.com/en/players/a2a85828/Aymen-Barkok"
2021,"Eint Frankfurt","Bundesliga","Elias Bördner","GER","GK","18",2002,1,1,0,1,0,0,1,1,100,0,0,0,0,2,3,1,0,"https://fbref.com/en/players/8758ddf4/Elias-Bordner"
2021,"Eint Frankfurt","Bundesliga","Timothy Chandler","USA","DF","30",1990,4.8,4,0,2,1,1,1,4,25,3,5,2,3,3,7,5,0,"https://fbref.com/en/players/b3b7f5a6/Timothy-Chandler"
2021,"Eint Frankfurt","Bundesliga","Danny da Costa","GER","DF","27",1993,1.2,0,0,0,0,0,0,1,0,1,3,1,2,0,0,4,0,"https://fbref.com/en/players/5ddb8f9f/Danny-da-Costa"
2021,"Eint Frankfurt","Bundesliga","Bas Dost","NED","FW","31",1989,9.1,3,2,1,1,1,2,5,40,3,5,1,4,2,5,8,0,"https://fbref.com/en/players/dc90cfbe/Bas-Dost"
2021,"Eint Frankfurt","Bundesliga","Erik Durm","GER","DF","28",1992,16.4,17,13,7,9,1,8,21,38.1,13,19,5,14,29,46,26,0,"https://fbref.com/en/players/cf623c78/Erik-Durm"
2021,"Eint Frankfurt","Bundesliga","Makoto Hasebe","JPN","DF,MF","36",1984,25.4,43,29,21,20,2,25,51,49,26,31,12,19,31,74,68,2,"https://fbref.com/en/players/9ab16552/Makoto-Hasebe"
2021,"Eint Frankfurt","Bundesliga","Martin Hinteregger","AUT","DF","27",1992,28.1,77,49,53,22,2,37,63,58.7,26,31,12,19,44,121,92,0,"https://fbref.com/en/players/080440a4/Martin-Hinteregger"
2021,"Eint Frankfurt","Bundesliga","Ajdin Hrustic","AUS","MF,DF","24",1996,3,6,5,2,3,1,3,10,30,7,2,0,2,4,10,3,0,"https://fbref.com/en/players/1f2d714c/Ajdin-Hrustic"
2021,"Eint Frankfurt","Bundesliga","Stefan Ilsanker","AUT","MF,DF","31",1989,17.5,33,20,17,15,1,21,42,50,21,30,8,22,30,63,51,2,"https://fbref.com/en/players/8494acc4/Stefan-Ilsanker"
2021,"Eint Frankfurt","Bundesliga","Luka Jović","SRB","FW","22",1997,9.9,2,0,0,2,0,0,4,0,4,3,0,3,1,3,7,0,"https://fbref.com/en/players/4d8cd038/Luka-Jovic"
2021,"Eint Frankfurt","Bundesliga","Daichi Kamada","JPN","MF","23",1996,26.2,48,28,21,16,11,16,49,32.7,33,18,1,17,14,62,22,0,"https://fbref.com/en/players/15b287da/Daichi-Kamada"
2021,"Eint Frankfurt","Bundesliga","Dominik Kohr","GER","MF,DF","26",1994,2.9,11,7,0,7,4,4,9,44.4,5,5,1,4,9,20,9,0,"https://fbref.com/en/players/0fbecd11/Dominik-Kohr"
2021,"Eint Frankfurt","Bundesliga","Filip Kostić","SRB","DF","27",1992,28.2,54,31,22,23,9,22,54,40.7,32,43,6,37,26,80,28,2,"https://fbref.com/en/players/b1cd37e6/Filip-Kostic"
2021,"Eint Frankfurt","Bundesliga","Obite N'Dicka","FRA","DF","20",1999,22.7,31,23,16,15,0,16,28,57.1,12,27,6,21,47,78,85,0,"https://fbref.com/en/players/441197b8/Obite-NDicka"
2021,"Eint Frankfurt","Bundesliga","Sebastian Rode","GER","MF","29",1990,18.1,44,25,21,16,7,14,46,30.4,32,30,3,27,47,91,18,0,"https://fbref.com/en/players/e12b0b5b/Sebastian-Rode"
2021,"Eint Frankfurt","Bundesliga","André Silva","POR","FW","24",1995,30.7,11,2,0,7,4,6,13,46.2,7,11,1,10,3,14,15,0,"https://fbref.com/en/players/3effaa34/Andre-Silva"
2021,"Eint Frankfurt","Bundesliga","Djibril Sow","SUI","MF","23",1997,24.2,58,33,19,32,7,18,41,43.9,23,31,8,23,51,109,17,0,"https://fbref.com/en/players/4c6facae/Djibril-Sow"
2021,"Eint Frankfurt","Bundesliga","Almamy Touré","MLI","DF","24",1996,7.8,18,12,8,7,3,10,14,71.4,4,5,1,4,8,26,22,0,"https://fbref.com/en/players/c8c60119/Almamy-Toure"
2021,"Eint Frankfurt","Bundesliga","Kevin Trapp","GER","GK","30",1990,33,0,0,0,0,0,0,1,0,1,1,0,1,3,3,11,3,"https://fbref.com/en/players/ce17b5eb/Kevin-Trapp"
2021,"Eint Frankfurt","Bundesliga","Tuta","BRA","DF","21",1999,16.2,35,20,22,13,0,24,43,55.8,19,19,2,17,29,64,53,0,"https://fbref.com/en/players/35d64857/Tuta"
2021,"Eint Frankfurt","Bundesliga","Amin Younes","GER","MF","26",1993,15.5,25,14,8,10,7,6,32,18.8,26,19,1,18,13,38,4,0,"https://fbref.com/en/players/228f73ae/Amin-Younes"
2021,"Eint Frankfurt","Bundesliga","Steven Zuber","SUI","DF,MF","28",1991,6.5,24,12,8,13,3,8,16,50,8,4,1,3,4,28,1,0,"https://fbref.com/en/players/b6a6e0a7/Steven-Zuber"
2021,"Elche","La Liga","Jony Álamo","ESP","MF","18",2001,0.8,2,1,1,0,1,0,1,0,1,0,0,0,1,3,0,0,"https://fbref.com/en/players/788be7f9/Jony-Alamo"
2021,"Elche","La Liga","Édgar Badía","ESP","GK","28",1992,30,1,0,1,0,0,1,3,33.3,2,0,0,0,0,1,17,3,"https://fbref.com/en/players/e4346678/Edgar-Badia"
2021,"Elche","La Liga","Antonio Barragán","ESP","DF","33",1987,24.8,28,14,21,5,2,12,21,57.1,9,22,8,14,33,61,67,1,"https://fbref.com/en/players/487d9b09/Antonio-Barragan"
2021,"Elche","La Liga","Lucas Boyé","ARG","FW","24",1996,29.9,47,31,13,27,7,10,49,20.4,39,37,2,35,19,66,21,0,"https://fbref.com/en/players/d49f3e6b/Lucas-Boye"
2021,"Elche","La Liga","Dani Calvo","ESP","DF","26",1994,19.8,20,13,13,7,0,7,10,70,3,18,12,6,11,31,71,0,"https://fbref.com/en/players/dd672e1f/Dani-Calvo"
2021,"Elche","La Liga","Guido Carrillo","ARG","FW","29",1991,11.1,9,8,1,7,1,2,8,25,6,2,1,1,4,13,14,0,"https://fbref.com/en/players/8f898ba8/Guido-Carrillo"
2021,"Elche","La Liga","Cifu","ESP","DF","29",1990,5,10,7,7,3,0,7,13,53.8,6,5,1,4,8,18,10,0,"https://fbref.com/en/players/90f83973/Cifu"
2021,"Elche","La Liga","John Donald","ESP","DF,MF","19",2000,0.6,0,0,0,0,0,0,0,NA,0,0,0,0,0,0,1,0,"https://fbref.com/en/players/5e95c000/John-Donald"
2021,"Elche","La Liga","Fidel","ESP","MF,DF","30",1989,26.6,46,30,28,15,3,25,64,39.1,39,22,2,20,16,62,14,0,"https://fbref.com/en/players/eb82b6f1/Fidel"
2021,"Elche","La Liga","Ramón Folch","ESP","MF","30",1989,0,0,0,0,0,0,0,0,NA,0,0,0,0,0,0,0,0,"https://fbref.com/en/players/dc56efc9/Ramon-Folch"
2021,"Elche","La Liga","Paulo Gazzaniga","ARG","GK","28",1992,8,1,1,1,0,0,0,0,NA,0,0,0,0,1,2,4,0,"https://fbref.com/en/players/63d17038/Paulo-Gazzaniga"
2021,"Elche","La Liga","Diego González","ESP","DF","25",1995,14.2,11,7,7,3,1,5,11,45.5,6,16,9,7,20,31,49,1,"https://fbref.com/en/players/4ac7608e/Diego-Gonzalez"
2021,"Elche","La Liga","Raúl Guti","ESP","MF","23",1996,31.8,48,28,21,22,5,16,52,30.8,36,25,3,22,49,97,25,0,"https://fbref.com/en/players/0b2c8585/Raul-Guti"
2021,"Elche","La Liga","Josan","ESP","MF,DF","30",1989,21.4,34,18,23,11,0,13,39,33.3,26,24,1,23,21,55,26,1,"https://fbref.com/en/players/5b28b2f6/Josan"
2021,"Elche","La Liga","Josema","ESP","DF","24",1996,21.8,43,28,33,10,0,10,18,55.6,8,17,7,10,37,80,92,0,"https://fbref.com/en/players/ed3f5f4c/Josema"
2021,"Elche","La Liga","Youssouf Koné","MLI","DF,MF","25",1995,0.8,2,0,1,0,1,0,1,0,1,0,0,0,0,2,0,0,"https://fbref.com/en/players/e6eadfb8/Youssouf-Kone"
2021,"Elche","La Liga","Jeison Lucumí","COL","MF","25",1995,0.5,1,1,0,1,0,0,0,NA,0,1,0,1,0,1,0,0,"https://fbref.com/en/players/8abefbcf/Jeison-Lucumi"
2021,"Elche","La Liga","Luismi","ESP","MF,DF","28",1992,1.9,4,2,1,3,0,1,2,50,1,2,0,2,4,8,0,0,"https://fbref.com/en/players/c2cfbfc9/Luismi"
2021,"Elche","La Liga","Iván Marcone","ARG","MF","30",1990,29.4,64,41,42,17,5,35,84,41.7,49,27,8,19,36,100,33,3,"https://fbref.com/en/players/b14f755d/Ivan-Marcone"
2021,"Elche","La Liga","Omenuke Mfulu","COD","MF","26",1994,8.8,18,12,10,8,0,5,15,33.3,10,7,1,6,11,29,18,0,"https://fbref.com/en/players/bdc14559/Omenuke-Mfulu"
2021,"Elche","La Liga","Pere Milla","ESP","FW,MF","27",1992,22,24,17,12,10,2,8,37,21.6,29,17,5,12,13,37,17,1,"https://fbref.com/en/players/335039a2/Pere-Milla"
2021,"Elche","La Liga","Johan Mojica","COL","DF","27",1992,13.4,21,10,15,5,1,8,18,44.4,10,15,4,11,15,36,27,0,"https://fbref.com/en/players/608f2092/Johan-Mojica"
2021,"Elche","La Liga","Tete Morente","ESP","MF,FW","23",1996,22.4,31,17,17,9,5,9,39,23.1,30,20,0,20,13,44,28,0,"https://fbref.com/en/players/004d185e/Tete-Morente"
2021,"Elche","La Liga","Nino","ESP","FW,MF","40",1980,3.2,0,0,0,0,0,0,1,0,1,1,0,1,0,0,0,0,"https://fbref.com/en/players/03dc5b1f/Nino"
2021,"Elche","La Liga","Helibelton Palacios","COL","DF","27",1993,8.3,20,10,16,3,1,8,13,61.5,5,9,1,8,5,25,21,0,"https://fbref.com/en/players/ac8b2421/Helibelton-Palacios"
2021,"Elche","La Liga","Pablo Piatti","ARG","MF,FW","31",1989,4,8,6,3,3,2,3,12,25,9,5,0,5,2,10,1,0,"https://fbref.com/en/players/48e89655/Pablo-Piatti"
2021,"Elche","La Liga","Emiliano Rigoni","ARG","MF","27",1993,12.7,12,7,3,8,1,3,15,20,12,16,1,15,6,18,9,0,"https://fbref.com/en/players/a1216563/Emiliano-Rigoni"
2021,"Elche","La Liga","Víctor Rodríguez","ESP","MF","31",1989,4.7,4,3,3,1,0,0,9,0,9,5,1,4,5,9,4,0,"https://fbref.com/en/players/15781606/Victor-Rodriguez"
2021,"Elche","La Liga","Juan Sánchez Miño","ARG","DF,MF","30",1990,5.5,8,5,5,3,0,6,14,42.9,8,4,0,4,4,12,7,0,"https://fbref.com/en/players/3ae7e4ea/Juan-Sanchez-Mino"
2021,"Elche","La Liga","Gonzalo Verdú","ESP","DF","31",1988,32.7,34,19,26,8,0,16,28,57.1,12,40,30,10,52,86,113,0,"https://fbref.com/en/players/1c2c55fc/Gonzalo-Verdu"
2021,"Everton","Premier League","Allan","BRA","MF","29",1991,22.8,80,45,39,37,4,28,95,29.5,67,31,12,19,19,99,25,1,"https://fbref.com/en/players/cc700722/Allan"
2021,"Everton","Premier League","Bernard","BRA","MF,FW","27",1992,5.1,8,3,3,3,2,7,15,46.7,8,5,0,5,8,16,6,0,"https://fbref.com/en/players/ab4b3e35/Bernard"
2021,"Everton","Premier League","Nathan Broadhead","WAL","FW","22",1998,0,1,1,0,1,0,0,0,NA,0,0,0,0,0,1,0,0,"https://fbref.com/en/players/43309491/Nathan-Broadhead"
2021,"Everton","Premier League","Dominic Calvert-Lewin","ENG","FW","23",1997,31.9,17,8,1,8,8,6,12,50,6,22,6,16,6,23,33,0,"https://fbref.com/en/players/59e6e5bf/Dominic-Calvert-Lewin"
2021,"Everton","Premier League","Séamus Coleman","IRL","DF,MF","31",1988,17.9,39,26,21,14,4,21,30,70,9,22,6,16,13,52,37,2,"https://fbref.com/en/players/0420d84f/Seamus-Coleman"
2021,"Everton","Premier League","Tom Davies","ENG","MF","22",1998,15.8,31,18,17,12,2,16,39,41,23,15,9,6,34,65,21,2,"https://fbref.com/en/players/9228b07c/Tom-Davies"
2021,"Everton","Premier League","Fabian Delph","ENG","MF,DF","30",1989,3,5,2,3,2,0,1,3,33.3,2,2,0,2,4,9,8,1,"https://fbref.com/en/players/111c3236/Fabian-Delph"
2021,"Everton","Premier League","Lucas Digne","FRA","DF,MF","27",1993,29.8,63,38,40,16,7,29,54,53.7,25,42,4,38,31,94,87,0,"https://fbref.com/en/players/1b84dbe1/Lucas-Digne"
2021,"Everton","Premier League","Abdoulaye Doucouré","MLI","MF","27",1993,27.1,52,32,25,19,8,14,43,32.6,29,24,7,17,39,91,31,1,"https://fbref.com/en/players/02b29014/Abdoulaye-Doucoure"
2021,"Everton","Premier League","Jean-Philippe Gbamin","CIV","MF","24",1995,0.1,1,0,0,1,0,0,0,NA,0,1,0,1,0,1,1,0,"https://fbref.com/en/players/6bd603db/Jean-Philippe-Gbamin"
2021,"Everton","Premier League","Ben Godfrey","ENG","DF","22",1998,29.8,55,33,37,15,3,27,41,65.9,14,56,37,19,33,88,120,0,"https://fbref.com/en/players/9f7c837d/Ben-Godfrey"
2021,"Everton","Premier League","André Gomes","POR","MF","27",1993,17.4,35,23,16,16,3,17,58,29.3,41,19,1,18,10,45,12,1,"https://fbref.com/en/players/1961b2aa/Andre-Gomes"
2021,"Everton","Premier League","Anthony Gordon","ENG","FW,MF","19",2001,1,3,3,3,0,0,0,2,0,2,1,0,1,1,4,3,0,"https://fbref.com/en/players/2bd83368/Anthony-Gordon"
2021,"Everton","Premier League","Mason Holgate","ENG","DF","23",1996,25.4,56,36,31,18,7,20,50,40,30,37,13,24,35,91,90,3,"https://fbref.com/en/players/d0042ab9/Mason-Holgate"
2021,"Everton","Premier League","Alex Iwobi","NGA","FW,MF","24",1996,17.1,27,10,10,14,3,13,25,52,12,20,1,19,16,43,14,0,"https://fbref.com/en/players/6ca5ec4b/Alex-Iwobi"
2021,"Everton","Premier League","Moise Kean","ITA","FW,MF","20",2000,0.2,0,0,0,0,0,0,0,NA,0,0,0,0,0,0,0,0,"https://fbref.com/en/players/3d50bcdb/Moise-Kean"
2021,"Everton","Premier League","Michael Keane","ENG","DF","27",1993,33.2,28,15,20,8,0,14,31,45.2,17,46,33,13,51,79,161,0,"https://fbref.com/en/players/c5b7c315/Michael-Keane"
2021,"Everton","Premier League","Jonjoe Kenny","ENG","DF","23",1997,0.9,2,1,1,0,1,2,2,100,0,0,0,0,1,3,3,0,"https://fbref.com/en/players/099e666f/Jonjoe-Kenny"
2021,"Everton","Premier League","Joshua King","NOR","MF,FW","28",1992,1.6,4,1,2,1,1,0,0,NA,0,3,0,3,1,5,1,0,"https://fbref.com/en/players/43458538/Joshua-King"
2021,"Everton","Premier League","Yerry Mina","COL","DF","25",1994,21.5,21,14,17,4,0,8,12,66.7,4,30,23,7,24,45,110,1,"https://fbref.com/en/players/6d5701f2/Yerry-Mina"
2021,"Everton","Premier League","Niels Nkounkou","FRA","DF,FW","19",2000,0.9,4,3,1,2,1,3,8,37.5,5,4,0,4,0,4,4,0,"https://fbref.com/en/players/f5b281e7/Niels-Nkounkou"
2021,"Everton","Premier League","Robin Olsen","SWE","GK","30",1990,7,0,0,0,0,0,0,0,NA,0,0,0,0,0,0,4,1,"https://fbref.com/en/players/e7ee38c3/Robin-Olsen"
2021,"Everton","Premier League","Jordan Pickford","ENG","GK","26",1994,30.5,0,0,0,0,0,0,2,0,2,2,0,2,3,3,16,4,"https://fbref.com/en/players/4806ec67/Jordan-Pickford"
2021,"Everton","Premier League","Richarlison","BRA","FW","23",1997,31.8,50,32,21,22,7,16,51,31.4,35,28,3,25,14,64,36,1,"https://fbref.com/en/players/fa031b34/Richarlison"
2021,"Everton","Premier League","James Rodríguez","COL","FW,MF","29",1991,19.6,28,17,8,15,5,11,46,23.9,35,17,0,17,15,43,3,0,"https://fbref.com/en/players/715bf047/James-Rodriguez"
2021,"Everton","Premier League","Gylfi Sigurðsson","ISL","MF,FW","30",1989,25,30,20,9,14,7,13,44,29.5,31,31,2,29,34,64,21,1,"https://fbref.com/en/players/76dd1480/Gylfi-Sigurdsson"
2021,"Everton","Premier League","Cenk Tosun","TUR","FW","29",1991,0.5,0,0,0,0,0,0,1,0,1,0,0,0,0,0,0,0,"https://fbref.com/en/players/9a104dee/Cenk-Tosun"
2021,"Everton","Premier League","João Virgínia","POR","GK","20",1999,0.5,0,0,0,0,0,0,0,NA,0,0,0,0,0,0,0,0,"https://fbref.com/en/players/728e9b2e/Joao-Virginia"
2021,"Everton","Premier League","Theo Walcott","ENG","FW","31",1989,0.1,0,0,0,0,0,0,0,NA,0,0,0,0,0,0,0,0,"https://fbref.com/en/players/1ecb65be/Theo-Walcott"
2021,"Fiorentina","Serie A","Sofyan Amrabat","MAR","MF","23",1996,27.1,39,22,11,24,4,18,48,37.5,30,30,5,25,23,62,12,0,"https://fbref.com/en/players/5a2cb25d/Sofyan-Amrabat"
2021,"Fiorentina","Serie A","Antonio Barreca","ITA","DF","25",1995,0.9,1,0,0,1,0,1,1,100,0,0,0,0,0,1,1,0,"https://fbref.com/en/players/6a189491/Antonio-Barreca"
2021,"Fiorentina","Serie A","Cristiano Biraghi","ITA","DF","27",1992,31.1,42,23,19,15,8,27,45,60,18,23,9,14,27,69,56,3,"https://fbref.com/en/players/9e1577aa/Cristiano-Biraghi"
2021,"Fiorentina","Serie A","Giacomo Bonaventura","ITA","MF","30",1989,25.1,34,19,16,13,5,16,53,30.2,37,26,2,24,39,73,12,0,"https://fbref.com/en/players/d995ed27/Giacomo-Bonaventura"
2021,"Fiorentina","Serie A","Martín Cáceres","URU","DF","33",1987,24.9,28,12,16,11,1,15,35,42.9,20,20,14,6,14,42,52,1,"https://fbref.com/en/players/e94d79e3/Martin-Caceres"
2021,"Fiorentina","Serie A","José Callejón","ESP","FW,MF","33",1987,7.4,10,7,0,6,4,5,9,55.6,4,4,1,3,4,14,5,0,"https://fbref.com/en/players/78841da9/Jose-Callejon"
2021,"Fiorentina","Serie A","Gaetano Castrovilli","ITA","MF","23",1997,25.9,33,19,15,11,7,11,42,26.2,31,25,2,23,34,67,14,0,"https://fbref.com/en/players/0728bebe/Gaetano-Castrovilli"
2021,"Fiorentina","Serie A","Federico Ceccherini","ITA","DF","28",1992,3,4,1,1,3,0,1,1,100,0,6,5,1,7,11,15,0,"https://fbref.com/en/players/d9624b51/Federico-Ceccherini"
2021,"Fiorentina","Serie A","Federico Chiesa","ITA","DF","22",1997,2.7,6,2,2,2,2,3,8,37.5,5,3,1,2,1,7,3,0,"https://fbref.com/en/players/b0f7e36c/Federico-Chiesa"
2021,"Fiorentina","Serie A","Patrick Cutrone","ITA","FW","22",1998,2.2,4,3,1,2,1,1,2,50,1,1,0,1,1,5,0,0,"https://fbref.com/en/players/a4fe8cda/Patrick-Cutrone"
2021,"Fiorentina","Serie A","Bartłomiej Drągowski","POL","GK","22",1997,35,1,0,1,0,0,1,1,100,0,0,0,0,1,2,13,1,"https://fbref.com/en/players/085e71a7/Bartlomiej-Dragowski"
2021,"Fiorentina","Serie A","Alfred Duncan","GHA","MF","27",1993,1.8,3,0,1,1,1,0,2,0,2,2,0,2,2,5,0,0,"https://fbref.com/en/players/528492ea/Alfred-Duncan"
2021,"Fiorentina","Serie A","Valentin Eysseric","FRA","MF,FW","28",1992,8.1,14,8,6,7,1,5,11,45.5,6,11,0,11,7,21,8,0,"https://fbref.com/en/players/ae82fa48/Valentin-Eysseric"
2021,"Fiorentina","Serie A","Igor","BRA","DF","22",1998,13,15,9,9,6,0,7,12,58.3,5,17,9,8,23,38,34,0,"https://fbref.com/en/players/a4e85758/Igor"
2021,"Fiorentina","Serie A","Aleksandr Kokorin","RUS","FW,MF","29",1991,1,1,0,0,1,0,0,1,0,1,1,0,1,0,1,0,0,"https://fbref.com/en/players/fec5accc/Aleksandr-Kokorin"
2021,"Fiorentina","Serie A","Christian Kouamé","CIV","FW","22",1997,11.1,9,4,2,4,3,4,12,33.3,8,9,1,8,5,14,4,0,"https://fbref.com/en/players/58e933d2/Christian-Kouame"
2021,"Fiorentina","Serie A","Pol Lirola","ESP","DF,FW","22",1997,5.5,13,8,8,2,3,6,12,50,6,6,3,3,6,19,9,0,"https://fbref.com/en/players/ff800ed8/Pol-Lirola"
2021,"Fiorentina","Serie A","Kévin Malcuit","MAR","DF","29",1991,2.3,5,3,2,2,1,0,1,0,1,5,0,5,3,8,6,0,"https://fbref.com/en/players/d6a889ea/Kevin-Malcuit"
2021,"Fiorentina","Serie A","Lucas Martínez Quarta","ARG","DF","24",1996,16.5,32,20,17,11,4,18,41,43.9,23,27,9,18,39,71,48,0,"https://fbref.com/en/players/3ec3c1c9/Lucas-Martinez-Quarta"
2021,"Fiorentina","Serie A","Nikola Milenković","SRB","DF","22",1997,33.7,49,29,33,14,2,21,33,63.6,12,42,33,9,44,93,122,1,"https://fbref.com/en/players/bee704fc/Nikola-Milenkovic"
2021,"Fiorentina","Serie A","Cristóbal Montiel","ESP","MF,FW","20",2000,0,0,0,0,0,0,0,1,0,1,0,0,0,0,0,0,0,"https://fbref.com/en/players/dd52d069/Cristobal-Montiel"
2021,"Fiorentina","Serie A","Maximiliano Olivera","URU","DF","28",1992,1,2,0,1,1,0,1,1,100,0,3,1,2,0,2,8,0,"https://fbref.com/en/players/32a33c68/Maximiliano-Olivera"
2021,"Fiorentina","Serie A","Germán Pezzella","ARG","DF","29",1991,30.5,34,20,22,12,0,18,32,56.3,14,26,14,12,36,70,109,1,"https://fbref.com/en/players/8c725b43/German-Pezzella"
2021,"Fiorentina","Serie A","Erick Pulgar","CHI","MF","26",1994,22.2,41,18,17,23,1,22,49,44.9,27,24,10,14,41,82,45,1,"https://fbref.com/en/players/4611e028/Erick-Pulgar"
2021,"Fiorentina","Serie A","Franck Ribéry","FRA","FW","37",1983,23.9,24,11,4,9,11,5,29,17.2,24,11,2,9,3,27,1,0,"https://fbref.com/en/players/f61c7c4e/Franck-Ribery"
2021,"Fiorentina","Serie A","Riccardo Saponara","ITA","MF","28",1991,0.6,2,1,0,2,0,1,3,33.3,2,0,0,0,1,3,0,0,"https://fbref.com/en/players/3bb7af3b/Riccardo-Saponara"
2021,"Fiorentina","Serie A","Pietro Terracciano","ITA","GK","30",1990,3,0,0,0,0,0,0,0,NA,0,0,0,0,0,0,1,0,"https://fbref.com/en/players/e1b0a70d/Pietro-Terracciano"
2021,"Fiorentina","Serie A","Borja Valero","ESP","MF,FW","35",1985,5.5,13,9,7,4,2,3,15,20,12,6,1,5,6,19,2,0,"https://fbref.com/en/players/0e21fc3c/Borja-Valero"
2021,"Fiorentina","Serie A","Lorenzo Venuti","ITA","DF","25",1995,19.5,24,11,14,7,3,14,28,50,14,18,3,15,17,41,24,0,"https://fbref.com/en/players/983ff2c7/Lorenzo-Venuti"
2021,"Fiorentina","Serie A","Dušan Vlahović","SRB","FW","20",2000,32.5,13,4,3,4,6,5,16,31.3,11,16,2,14,4,17,15,0,"https://fbref.com/en/players/79443529/Dusan-Vlahovic"
2021,"Freiburg","Bundesliga","Amir Abrashi","ALB","MF,DF","30",1990,0.7,1,1,1,0,0,0,0,NA,0,1,1,0,2,3,1,0,"https://fbref.com/en/players/1c08a3c8/Amir-Abrashi"
2021,"Freiburg","Bundesliga","Nishan Burkart","SUI","MF","20",2000,0.2,0,0,0,0,0,0,1,0,1,0,0,0,0,0,0,0,"https://fbref.com/en/players/c59b67ed/Nishan-Burkart"
2021,"Freiburg","Bundesliga","Kwon Chang-hoon","KOR","MF,FW","26",1994,2.4,3,1,1,0,2,1,3,33.3,2,3,1,2,7,10,2,1,"https://fbref.com/en/players/7961f7aa/Kwon-Chang-hoon"
2021,"Freiburg","Bundesliga","Ermedin Demirović","BIH","FW","22",1998,16.6,15,9,4,6,5,2,16,12.5,14,29,5,24,0,15,27,0,"https://fbref.com/en/players/ed79b7d3/Ermedin-Demirovic"
2021,"Freiburg","Bundesliga","Mark Flekken","NED","GK","27",1993,3,0,0,0,0,0,0,0,NA,0,0,0,0,0,0,1,0,"https://fbref.com/en/players/a92ab7be/Mark-Flekken"
2021,"Freiburg","Bundesliga","Vincenzo Grifo","ITA","MF,FW","27",1993,25.7,18,7,6,7,5,14,34,41.2,20,13,0,13,27,45,18,1,"https://fbref.com/en/players/54e4866f/Vincenzo-Grifo"
2021,"Freiburg","Bundesliga","Manuel Gulde","GER","DF","29",1991,21.7,27,15,12,12,3,5,21,23.8,16,25,15,10,37,64,64,0,"https://fbref.com/en/players/25ab9c9c/Manuel-Gulde"
2021,"Freiburg","Bundesliga","Christian Günter","GER","DF,MF","27",1993,34,34,19,18,13,3,15,43,34.9,28,38,9,29,29,63,40,0,"https://fbref.com/en/players/8593f88c/Christian-Gunter"
2021,"Freiburg","Bundesliga","Janik Haberer","GER","MF,FW","26",1994,5.4,7,4,4,3,0,3,15,20,12,4,1,3,7,14,9,0,"https://fbref.com/en/players/70dcf94d/Janik-Haberer"
2021,"Freiburg","Bundesliga","Dominique Heintz","GER","DF","26",1993,15.2,22,11,19,3,0,10,19,52.6,9,10,8,2,35,57,49,0,"https://fbref.com/en/players/699fb8db/Dominique-Heintz"
2021,"Freiburg","Bundesliga","Nicolas Höfler","GER","MF","30",1990,30.3,54,28,16,31,7,23,59,39,36,34,10,24,66,120,41,2,"https://fbref.com/en/players/5d8e331f/Nicolas-Hofler"
2021,"Freiburg","Bundesliga","Lucas Höler","GER","FW,MF","26",1994,23.2,36,24,13,19,4,12,32,37.5,20,19,2,17,16,52,14,0,"https://fbref.com/en/players/ca618d23/Lucas-Holer"
2021,"Freiburg","Bundesliga","Yannik Keitel","GER","MF","20",2000,5.5,12,8,7,4,1,7,9,77.8,2,9,3,6,10,22,8,0,"https://fbref.com/en/players/d2c580ce/Yannik-Keitel"
2021,"Freiburg","Bundesliga","Lukas Kübler","GER","DF,MF","27",1992,9.8,15,8,9,5,1,9,14,64.3,5,9,3,6,21,36,31,0,"https://fbref.com/en/players/2a29eb9b/Lukas-Kubler"
2021,"Freiburg","Bundesliga","Philipp Lienhart","AUT","DF","24",1996,33.3,21,13,12,7,2,9,20,45,11,30,21,9,42,63,100,0,"https://fbref.com/en/players/302527b2/Philipp-Lienhart"
2021,"Freiburg","Bundesliga","Florian Müller","GER","GK","22",1997,31,0,0,0,0,0,0,3,0,3,1,0,1,2,2,10,1,"https://fbref.com/en/players/cbac6ec9/Florian-Muller"
2021,"Freiburg","Bundesliga","Nils Petersen","GER","FW","31",1988,14.5,11,7,2,6,3,3,21,14.3,18,25,1,24,9,20,28,0,"https://fbref.com/en/players/f93e6e94/Nils-Petersen"
2021,"Freiburg","Bundesliga","Roland Sallai","HUN","MF,FW","23",1997,18.5,18,14,7,9,2,5,13,38.5,8,11,1,10,11,29,8,0,"https://fbref.com/en/players/bf075f6b/Roland-Sallai"
2021,"Freiburg","Bundesliga","Baptiste Santamaria","FRA","MF","25",1995,24.5,51,38,19,24,8,20,54,37,34,36,7,29,52,103,34,1,"https://fbref.com/en/players/5e22e2a4/Baptiste-Santamaria"
2021,"Freiburg","Bundesliga","Keven Schlotterbeck","GER","DF","23",1997,18.4,31,10,16,15,0,10,23,43.5,13,26,18,8,36,67,89,2,"https://fbref.com/en/players/f6bdc830/Keven-Schlotterbeck"
2021,"Freiburg","Bundesliga","Jonathan Schmid","FRA","MF,DF","30",1990,26.6,37,19,17,13,7,16,30,53.3,14,26,10,16,28,65,38,0,"https://fbref.com/en/players/088ca1bd/Jonathan-Schmid"
2021,"Freiburg","Bundesliga","Lino Tempelmann","GER","MF","21",1999,3,5,3,2,2,1,0,4,0,4,6,1,5,2,7,6,0,"https://fbref.com/en/players/4e3a947f/Lino-Tempelmann"
2021,"Freiburg","Bundesliga","Guus Til","NED","FW","22",1997,1.4,4,3,2,1,1,2,3,66.7,1,2,0,2,2,6,2,0,"https://fbref.com/en/players/6e44569a/Guus-Til"
2021,"Freiburg","Bundesliga","Jeong Woo-yeong","KOR","FW,MF","20",1999,9.1,9,5,1,6,2,2,11,18.2,9,8,1,7,11,20,11,0,"https://fbref.com/en/players/6190474d/Jeong-Woo-yeong"
2021,"Fulham","Premier League","Tosin Adarabioyo","ENG","DF","22",1997,32.8,37,19,30,6,1,19,40,47.5,21,26,20,6,42,79,197,2,"https://fbref.com/en/players/c81d773d/Tosin-Adarabioyo"
2021,"Fulham","Premier League","Ola Aina","NGA","DF","23",1996,29.6,37,20,22,7,8,21,43,48.8,22,22,6,16,45,82,94,2,"https://fbref.com/en/players/246d153b/Ola-Aina"
2021,"Fulham","Premier League","Joachim Andersen","DEN","DF","24",1996,30.3,33,19,18,11,4,15,28,53.6,13,24,13,11,44,77,151,1,"https://fbref.com/en/players/e34fc66d/Joachim-Andersen"
2021,"Fulham","Premier League","Alphonse Areola","FRA","GK","27",1993,36,1,0,1,0,0,1,5,20,4,0,0,0,1,2,13,3,"https://fbref.com/en/players/2f965a72/Alphonse-Areola"
2021,"Fulham","Premier League","Joe Bryan","ENG","DF,MF","26",1993,7.4,15,8,7,5,3,7,12,58.3,5,8,2,6,14,29,16,0,"https://fbref.com/en/players/af69e7f0/Joe-Bryan"
2021,"Fulham","Premier League","Tom Cairney","SCO","MF","29",1991,8.4,9,3,1,4,4,1,4,25,3,6,0,6,0,9,3,0,"https://fbref.com/en/players/a8748947/Tom-Cairney"
2021,"Fulham","Premier League","Fabio Carvalho","POR","MF,FW","17",2002,2.8,9,6,4,4,1,5,9,55.6,4,2,0,2,1,10,1,1,"https://fbref.com/en/players/966e28d0/Fabio-Carvalho"
2021,"Fulham","Premier League","Ivan Cavaleiro","POR","FW","26",1993,27.5,23,14,9,11,3,12,34,35.3,22,25,1,24,19,42,14,0,"https://fbref.com/en/players/979b811d/Ivan-Cavaleiro"
2021,"Fulham","Premier League","Tyrese Francois","AUS","DF","20",2000,0.2,0,0,0,0,0,0,0,NA,0,0,0,0,0,0,0,0,"https://fbref.com/en/players/6722d4f0/Tyrese-Francois"
2021,"Fulham","Premier League","Michael Hector","JAM","DF","28",1992,2.9,3,2,1,2,0,1,6,16.7,5,4,2,2,0,3,6,0,"https://fbref.com/en/players/5f1a2f31/Michael-Hector"
2021,"Fulham","Premier League","Aboubakar Kamara","MTN","FW,MF","25",1995,3.5,2,2,1,1,0,0,5,0,5,6,0,6,1,3,0,0,"https://fbref.com/en/players/4047c976/Aboubakar-Kamara"
2021,"Fulham","Premier League","Neeskens Kebano","COD","FW,MF","28",1992,1.3,0,0,0,0,0,0,1,0,1,3,0,3,0,0,0,0,"https://fbref.com/en/players/18b999f4/Neeskens-Kebano"
2021,"Fulham","Premier League","Terence Kongolo","NED","DF","26",1994,1,3,2,1,2,0,1,1,100,0,0,0,0,2,5,3,0,"https://fbref.com/en/players/1f9a3a04/Terence-Kongolo"
2021,"Fulham","Premier League","Maxime Le Marchand","FRA","DF","30",1989,1.4,2,2,2,0,0,2,2,100,0,0,0,0,0,2,3,0,"https://fbref.com/en/players/321a71a7/Maxime-Le-Marchand"
2021,"Fulham","Premier League","Mario Lemina","GAB","MF","26",1993,18.9,62,35,25,30,7,23,44,52.3,21,26,5,21,30,92,21,0,"https://fbref.com/en/players/2b471f99/Mario-Lemina"
2021,"Fulham","Premier League","Ruben Loftus-Cheek","ENG","MF,FW","24",1996,21.2,25,14,7,15,3,7,23,30.4,16,20,2,18,7,32,18,0,"https://fbref.com/en/players/e97fd090/Ruben-Loftus-Cheek"
2021,"Fulham","Premier League","Ademola Lookman","NGA","FW,MF","22",1997,30.5,35,11,18,9,8,13,44,29.5,31,31,1,30,20,55,9,0,"https://fbref.com/en/players/7c104bb7/Ademola-Lookman"
2021,"Fulham","Premier League","Josh Maja","NGA","FW","21",1998,9,7,4,0,3,4,4,10,40,6,3,1,2,4,11,1,0,"https://fbref.com/en/players/bc0bfc64/Josh-Maja"
2021,"Fulham","Premier League","Aleksandar Mitrović","SRB","FW","25",1994,15.6,7,4,0,3,4,2,8,25,6,12,3,9,3,10,8,0,"https://fbref.com/en/players/3925dbd6/Aleksandar-Mitrovic"
2021,"Fulham","Premier League","Denis Odoi","GHA","DF","32",1988,3,3,3,2,1,0,1,4,25,3,3,1,2,5,8,5,0,"https://fbref.com/en/players/f7750aa0/Denis-Odoi"
2021,"Fulham","Premier League","Josh Onomah","ENG","MF","23",1997,4.2,11,8,1,6,4,0,5,0,5,4,2,2,2,13,1,0,"https://fbref.com/en/players/6612cd8c/Josh-Onomah"
2021,"Fulham","Premier League","Tim Ream","USA","DF","32",1987,7,12,5,9,3,0,8,11,72.7,3,8,5,3,6,18,26,1,"https://fbref.com/en/players/28b40c9c/Tim-Ream"
2021,"Fulham","Premier League","Harrison Reed","ENG","MF","25",1995,25,63,38,28,28,7,29,73,39.7,44,34,11,23,50,113,31,1,"https://fbref.com/en/players/803ae100/Harrison-Reed"
2021,"Fulham","Premier League","Bobby Reid","JAM","MF,FW","27",1993,26.4,31,15,17,10,4,18,39,46.2,21,19,5,14,21,52,39,0,"https://fbref.com/en/players/0f7533cd/Bobby-Reid"
2021,"Fulham","Premier League","Antonee Robinson","USA","DF","22",1997,24,45,28,24,16,5,27,44,61.4,17,21,4,17,37,82,68,0,"https://fbref.com/en/players/289601e6/Antonee-Robinson"
2021,"Fulham","Premier League","Marek Rodák","SVK","GK","23",1996,2,0,0,0,0,0,0,0,NA,0,0,0,0,0,0,0,0,"https://fbref.com/en/players/17acc2ed/Marek-Rodak"
2021,"Fulham","Premier League","Kenny Tete","NED","DF,MF","24",1995,16.5,48,30,27,16,5,10,18,55.6,8,14,5,9,27,75,49,0,"https://fbref.com/en/players/77d7c96f/Kenny-Tete"
2021,"Fulham","Premier League","Andre-Frank Zambo Anguissa","CMR","MF","24",1995,28.7,78,37,27,38,13,27,68,39.7,41,35,6,29,56,134,17,2,"https://fbref.com/en/players/6bb2c084/Andre-Frank-Zambo-Anguissa"
2021,"Genoa","Serie A","Milan Badelj","CRO","MF","31",1989,26.8,56,27,27,22,7,26,84,31,58,51,10,41,87,143,45,1,"https://fbref.com/en/players/e8c930bb/Milan-Badelj"
2021,"Genoa","Serie A","Mattia Bani","ITA","DF","26",1993,10.2,10,5,5,5,0,5,12,41.7,7,16,11,5,27,37,44,0,"https://fbref.com/en/players/0821331c/Mattia-Bani"
2021,"Genoa","Serie A","Valon Behrami","SUI","MF","35",1985,9.9,21,9,9,10,2,9,26,34.6,17,13,5,8,9,30,13,0,"https://fbref.com/en/players/d3d758d8/Valon-Behrami"
2021,"Genoa","Serie A","Davide Biraschi","ITA","DF","26",1994,10.2,17,9,12,5,0,5,10,50,5,12,6,6,21,38,26,0,"https://fbref.com/en/players/64cd167d/Davide-Biraschi"
2021,"Genoa","Serie A","Giuseppe Caso","ITA","DF,FW","21",1998,0.6,0,0,0,0,0,0,0,NA,0,0,0,0,0,0,0,0,"https://fbref.com/en/players/099a2de5/Giuseppe-Caso"
2021,"Genoa","Serie A","Francesco Cassata","ITA","DF,FW","23",1997,2.5,7,6,7,0,0,4,7,57.1,3,0,0,0,3,10,1,0,"https://fbref.com/en/players/96960855/Francesco-Cassata"
2021,"Genoa","Serie A","Domenico Criscito","ITA","DF","33",1986,19.2,43,22,29,11,3,22,39,56.4,17,27,14,13,44,87,51,0,"https://fbref.com/en/players/35dd6d80/Domenico-Criscito"
2021,"Genoa","Serie A","Lennart-Marten Czyborra","GER","DF","21",1999,13,19,10,7,7,5,11,19,57.9,8,6,1,5,17,36,27,0,"https://fbref.com/en/players/7ba1f1ef/Lennart-Marten-Czyborra"
2021,"Genoa","Serie A","Mattia Destro","ITA","FW","29",1991,17.8,6,3,0,3,3,2,9,22.2,7,11,0,11,4,10,8,0,"https://fbref.com/en/players/d7d32194/Mattia-Destro"
2021,"Genoa","Serie A","Steeve-Mike Ebongue","FRA","MF","19",2001,0.6,2,1,1,0,1,0,3,0,3,1,0,1,0,2,0,0,"https://fbref.com/en/players/9d5ab351/Steeve-Mike-Ebongue"
2021,"Genoa","Serie A","Paolo Ghiglione","ITA","DF,MF","23",1997,15.1,27,15,17,8,2,13,28,46.4,15,14,2,12,13,40,25,0,"https://fbref.com/en/players/71dc23da/Paolo-Ghiglione"
2021,"Genoa","Serie A","Edoardo Goldaniga","ITA","DF","26",1993,20.6,28,18,21,7,0,14,23,60.9,9,17,7,10,38,66,62,1,"https://fbref.com/en/players/4b029b31/Edoardo-Goldaniga"
2021,"Genoa","Serie A","Yayah Kallon","SLE","FW","19",2001,0.5,0,0,0,0,0,0,0,NA,0,0,0,0,0,0,0,0,"https://fbref.com/en/players/f95f49d2/Yayah-Kallon"
2021,"Genoa","Serie A","Lukas Lerager","DEN","MF","27",1993,12.9,24,13,14,9,1,11,30,36.7,19,13,3,10,14,38,25,1,"https://fbref.com/en/players/1b82f8df/Lukas-Lerager"
2021,"Genoa","Serie A","Federico Marchetti","ITA","GK","37",1983,3.7,1,0,1,0,0,1,1,100,0,0,0,0,0,1,2,1,"https://fbref.com/en/players/f794b426/Federico-Marchetti"
2021,"Genoa","Serie A","Andrea Masiello","ITA","DF","34",1986,28.5,38,22,29,6,3,23,48,47.9,25,32,13,19,53,91,107,3,"https://fbref.com/en/players/e0314d87/Andrea-Masiello"
2021,"Genoa","Serie A","Filippo Melegoni","ITA","MF,DF","21",1999,4.3,7,6,2,5,0,3,6,50,3,5,0,5,5,12,8,0,"https://fbref.com/en/players/6604165d/Filippo-Melegoni"
2021,"Genoa","Serie A","Jérôme Onguéné","CMR","DF","22",1997,2,2,1,2,0,0,2,7,28.6,5,2,0,2,2,4,8,0,"https://fbref.com/en/players/e81f0356/Jerome-Onguene"
2021,"Genoa","Serie A","Alberto Paleari","ITA","GK","27",1992,2.3,0,0,0,0,0,0,0,NA,0,0,0,0,0,0,1,0,"https://fbref.com/en/players/94a3606c/Alberto-Paleari"
2021,"Genoa","Serie A","Goran Pandev","MKD","FW,MF","37",1983,15.6,9,5,1,6,2,4,10,40,6,6,0,6,2,11,7,1,"https://fbref.com/en/players/d711d04f/Goran-Pandev"
2021,"Genoa","Serie A","Vittorio Parigini","ITA","MF,DF","24",1996,0.6,5,2,4,0,1,0,1,0,1,0,0,0,0,5,0,0,"https://fbref.com/en/players/75efed2e/Vittorio-Parigini"
2021,"Genoa","Serie A","Luca Pellegrini","ITA","DF,MF","21",1999,7.1,9,6,6,2,1,4,10,40,6,11,2,9,8,17,13,1,"https://fbref.com/en/players/3b61c9ec/Luca-Pellegrini"
2021,"Genoa","Serie A","Mattia Perin","ITA","GK","27",1992,32,0,0,0,0,0,0,0,NA,0,0,0,0,1,1,6,0,"https://fbref.com/en/players/4c62d0c8/Mattia-Perin"
2021,"Genoa","Serie A","Marko Pjaca","CRO","FW,MF","25",1995,15.8,13,6,6,3,4,4,16,25,12,7,2,5,7,20,12,0,"https://fbref.com/en/players/2c38b327/Marko-Pjaca"
2021,"Genoa","Serie A","Manolo Portanova","ITA","MF,FW","20",2000,0.7,3,3,1,1,1,0,2,0,2,3,1,2,1,4,2,0,"https://fbref.com/en/players/c8c0dccd/Manolo-Portanova"
2021,"Genoa","Serie A","Ivan Radovanović","SRB","DF,MF","31",1988,24.8,18,15,13,5,0,12,31,38.7,19,39,21,18,37,55,114,2,"https://fbref.com/en/players/023937a9/Ivan-Radovanovic"
2021,"Genoa","Serie A","Nicolò Rovella","ITA","MF","18",2001,13.2,29,16,15,11,3,9,32,28.1,23,11,0,11,20,49,19,1,"https://fbref.com/en/players/e58cbfd5/Nicolo-Rovella"
2021,"Genoa","Serie A","Gianluca Scamacca","ITA","FW","21",1999,15,19,10,6,7,6,7,19,36.8,12,21,4,17,9,28,12,0,"https://fbref.com/en/players/8790f988/Gianluca-Scamacca"
2021,"Genoa","Serie A","Eldor Shomurodov","UZB","FW","25",1995,18.6,28,14,7,13,8,9,37,24.3,28,17,2,15,6,34,11,0,"https://fbref.com/en/players/57469b2d/Eldor-Shomurodov"
2021,"Genoa","Serie A","Kevin Strootman","NED","MF","30",1990,14.6,30,18,13,15,2,14,32,43.8,18,35,3,32,25,55,18,0,"https://fbref.com/en/players/ef2e5e1a/Kevin-Strootman"
2021,"Genoa","Serie A","Stefano Sturaro","ITA","MF","27",1993,4.9,11,5,3,6,2,3,15,20,12,5,0,5,7,18,2,0,"https://fbref.com/en/players/2334478a/Stefano-Sturaro"
2021,"Genoa","Serie A","Miha Zajc","SVN","MF","26",1994,20.7,22,14,9,10,3,13,39,33.3,26,30,4,26,27,49,19,0,"https://fbref.com/en/players/83e4643e/Miha-Zajc"
2021,"Genoa","Serie A","Cristián Zapata","COL","DF","33",1986,10.8,18,12,11,7,0,10,14,71.4,4,15,11,4,15,33,56,0,"https://fbref.com/en/players/b1deecf8/Cristian-Zapata"
2021,"Genoa","Serie A","Davide Zappacosta","ITA","DF","28",1992,22.7,33,16,15,13,5,15,30,50,15,17,1,16,18,51,41,0,"https://fbref.com/en/players/7fe90ccd/Davide-Zappacosta"
2021,"Getafe","La Liga","Sabit Abdulai","GHA","MF","21",1999,0.7,2,0,1,1,0,1,3,33.3,2,0,0,0,0,2,0,0,"https://fbref.com/en/players/9f9e1b9c/Sabit-Abdulai"
2021,"Getafe","La Liga","Carles Aleñá","ESP","MF,FW","22",1998,15.2,15,10,3,9,3,7,25,28,18,14,1,13,2,17,2,0,"https://fbref.com/en/players/6c811eb7/Carles-Alena"
2021,"Getafe","La Liga","Emmanuel Amankwaa Akurugu","GHA","DF","18",2001,0.5,0,0,0,0,0,0,1,0,1,1,0,1,2,2,1,0,"https://fbref.com/en/players/69c5633e/Emmanuel-Amankwaa-Akurugu"
2021,"Getafe","La Liga","José Antonio Miranda","EQG","MF,DF","22",1998,0.3,0,0,0,0,0,0,1,0,1,1,0,1,0,0,0,0,"https://fbref.com/en/players/683788fd/Jose-Antonio-Miranda"
2021,"Getafe","La Liga","Mauro Arambarri","URU","MF","24",1995,33.1,64,39,22,35,7,23,80,28.8,57,40,5,35,42,106,28,0,"https://fbref.com/en/players/58afe001/Mauro-Arambarri"
2021,"Getafe","La Liga","Erick Cabaco","URU","DF","25",1995,14.7,24,14,11,12,1,12,22,54.5,10,8,6,2,13,37,51,1,"https://fbref.com/en/players/e7ab4179/Erick-Cabaco"
2021,"Getafe","La Liga","Sofian Chakla","MAR","DF","26",1993,10,12,8,10,1,1,5,7,71.4,2,3,2,1,14,26,48,1,"https://fbref.com/en/players/37f04799/Sofian-Chakla"
2021,"Getafe","La Liga","Chema","ESP","DF,MF","28",1992,6.2,11,5,6,5,0,5,7,71.4,2,1,0,1,10,21,23,0,"https://fbref.com/en/players/7f203b54/Chema"
2021,"Getafe","La Liga","Cucho","COL","FW,MF","21",1999,16.3,19,10,1,14,4,2,23,8.7,21,18,1,17,6,25,8,0,"https://fbref.com/en/players/71b47ab9/Cucho"
2021,"Getafe","La Liga","Marc Cucurella","ESP","MF","22",1998,36,64,51,19,40,5,25,66,37.9,41,45,4,41,40,104,27,0,"https://fbref.com/en/players/1daec722/Marc-Cucurella"
2021,"Getafe","La Liga","Abdoulay Diaby","MLI","DF","29",1991,0.2,2,0,0,2,0,0,0,NA,0,2,0,2,0,2,0,0,"https://fbref.com/en/players/23c5db70/Abdoulay-Diaby"
2021,"Getafe","La Liga","Djené","TOG","DF","28",1991,32.7,61,39,31,26,4,26,34,76.5,8,24,11,13,42,103,96,0,"https://fbref.com/en/players/a4971d84/Djene"
2021,"Getafe","La Liga","Xabier Etxeita","ESP","DF","32",1987,9.8,8,4,5,3,0,7,14,50,7,6,3,3,13,21,38,0,"https://fbref.com/en/players/4a895384/Xabier-Etxeita"
2021,"Getafe","La Liga","Iglesias","ESP","DF,MF","22",1998,6.7,27,15,14,10,3,11,19,57.9,8,11,1,10,17,44,19,0,"https://fbref.com/en/players/974322dc/Iglesias"
2021,"Getafe","La Liga","John Joe","IRL","MF,FW","16",2003,0.7,2,0,0,2,0,0,0,NA,0,0,0,0,0,2,0,0,"https://fbref.com/en/players/fd01216a/John-Joe"
2021,"Getafe","La Liga","Takefusa Kubo","JPN","MF,FW","19",2001,8.9,7,4,2,3,2,1,14,7.1,13,14,0,14,14,21,4,0,"https://fbref.com/en/players/16aa3654/Takefusa-Kubo"
2021,"Getafe","La Liga","Nemanja Maksimović","SRB","MF","25",1995,30.3,50,28,22,24,4,19,46,41.3,27,40,9,31,57,107,46,1,"https://fbref.com/en/players/00b28772/Nemanja-Maksimovic"
2021,"Getafe","La Liga","Jaime Mata","ESP","FW","31",1988,22.6,12,7,1,3,8,3,18,16.7,15,13,2,11,6,18,16,0,"https://fbref.com/en/players/02319ad7/Jaime-Mata"
2021,"Getafe","La Liga","Victor Mollejo","ESP","MF,DF","19",2001,0.8,2,1,1,0,1,0,1,0,1,0,0,0,0,2,0,0,"https://fbref.com/en/players/23fffc06/Victor-Mollejo"
2021,"Getafe","La Liga","Mamor Niang","SEN","MF,FW","18",2002,0.2,1,1,0,1,0,0,0,NA,0,1,0,1,0,1,0,0,"https://fbref.com/en/players/64a76620/Mamor-Niang"
2021,"Getafe","La Liga","Allan Nyom","CMR","MF,DF","32",1988,25.8,38,23,14,19,5,15,30,50,15,16,2,14,22,60,42,0,"https://fbref.com/en/players/97572117/Allan-Nyom"
2021,"Getafe","La Liga","Mathías Olivera","URU","DF","22",1997,29,61,33,31,21,9,32,56,57.1,24,33,3,30,31,92,55,0,"https://fbref.com/en/players/41c12f75/Mathias-Olivera"
2021,"Getafe","La Liga","Ante Palaversa","CRO","MF","20",2000,0.1,0,0,0,0,0,0,1,0,1,0,0,0,0,0,0,0,"https://fbref.com/en/players/cd9b37a3/Ante-Palaversa"
2021,"Getafe","La Liga","Francisco Portillo","ESP","MF,FW","30",1990,4.6,5,3,1,4,0,2,14,14.3,12,3,0,3,5,10,1,0,"https://fbref.com/en/players/8e010ff4/Francisco-Portillo"
2021,"Getafe","La Liga","Darío Poveda","ESP","FW","23",1997,0.1,0,0,0,0,0,0,0,NA,0,1,0,1,0,0,0,0,"https://fbref.com/en/players/cbdf7d5c/Dario-Poveda"
2021,"Getafe","La Liga","Ángel Rodríguez","ESP","FW,MF","33",1987,15.3,7,4,1,4,2,1,16,6.3,15,7,0,7,2,9,8,0,"https://fbref.com/en/players/8cfc2f69/Angel-Rodriguez"
2021,"Getafe","La Liga","David Soria","ESP","GK","27",1993,28,2,2,2,0,0,1,3,33.3,2,0,0,0,1,3,12,0,"https://fbref.com/en/players/8f8c6934/David-Soria"
2021,"Getafe","La Liga","Damián Suárez","URU","DF","32",1988,27,59,39,29,23,7,30,81,37,51,43,2,41,31,90,42,0,"https://fbref.com/en/players/ba5004e1/Damian-Suarez"
2021,"Getafe","La Liga","David Timor","ESP","MF,DF","30",1989,15.5,13,9,5,6,2,9,21,42.9,12,5,1,4,19,32,32,1,"https://fbref.com/en/players/174651c8/David-Timor"
2021,"Getafe","La Liga","Enes Ünal","TUR","FW","23",1997,14.6,11,3,0,8,3,4,15,26.7,11,11,0,11,2,13,14,0,"https://fbref.com/en/players/f8eca1b6/Enes-Unal"
2021,"Getafe","La Liga","Rubén Yáñez","ESP","GK","26",1993,10,0,0,0,0,0,0,1,0,1,0,0,0,2,2,2,0,"https://fbref.com/en/players/039ae103/Ruben-Yanez"
2021,"Granada","La Liga","Ángel","ESP","GK","18",2002,1,0,0,0,0,0,0,0,NA,0,0,0,0,0,0,1,0,"https://fbref.com/en/players/b1e5bbec/Angel"
2021,"Granada","La Liga","Ramon Azeez","NGA","MF","27",1992,1.1,1,1,0,1,0,0,0,NA,0,0,0,0,1,2,1,0,"https://fbref.com/en/players/0cc474e7/Ramon-Azeez"
2021,"Granada","La Liga","Barcia","ESP","DF","19",2000,1,1,1,1,0,0,0,0,NA,0,1,1,0,3,4,9,0,"https://fbref.com/en/players/0c717ae6/Barcia"
2021,"Granada","La Liga","Álvaro Bravo","ESP","MF","22",1998,0.2,1,1,1,0,0,1,2,50,1,0,0,0,1,2,0,0,"https://fbref.com/en/players/b3f97139/Alvaro-Bravo"
2021,"Granada","La Liga","Yan Brice Eteki","CMR","MF","22",1997,14.7,23,15,10,12,1,8,19,42.1,11,13,3,10,13,36,16,1,"https://fbref.com/en/players/3d688b46/Yan-Brice-Eteki"
2021,"Granada","La Liga","Juan Brunet","ARG","MF","22",1998,0.3,0,0,0,0,0,0,0,NA,0,0,0,0,0,0,1,0,"https://fbref.com/en/players/c960cfdb/Juan-Brunet"
2021,"Granada","La Liga","Víctor Díaz","ESP","DF","32",1988,9.2,21,10,13,6,2,10,19,52.6,9,14,8,6,16,37,39,0,"https://fbref.com/en/players/3624ce4c/Victor-Diaz"
2021,"Granada","La Liga","Domingos Duarte","POR","DF","25",1995,26.3,32,20,18,12,2,14,21,66.7,7,29,20,9,29,61,86,0,"https://fbref.com/en/players/93090f69/Domingos-Duarte"
2021,"Granada","La Liga","Aarón Escandell","ESP","GK","24",1995,5,1,1,1,0,0,1,1,100,0,0,0,0,0,1,6,0,"https://fbref.com/en/players/67669ce7/Aaron-Escandell"
2021,"Granada","La Liga","Kingsley Fobi","GHA","DF","21",1998,0.5,0,0,0,0,0,0,0,NA,0,0,0,0,1,1,1,0,"https://fbref.com/en/players/954c26c9/Kingsley-Fobi"
2021,"Granada","La Liga","Dimitri Foulquier","FRA","DF","27",1993,29.6,35,21,20,12,3,15,26,57.7,11,24,7,17,26,61,60,0,"https://fbref.com/en/players/45e17712/Dimitri-Foulquier"
2021,"Granada","La Liga","Maxime Gonalons","FRA","MF","31",1989,16.4,53,37,18,33,2,15,37,40.5,22,17,0,17,25,78,21,1,"https://fbref.com/en/players/b8c1de25/Maxime-Gonalons"
2021,"Granada","La Liga","Yangel Herrera","VEN","MF","22",1998,25.7,59,26,19,32,8,11,41,26.8,30,53,17,36,26,85,32,1,"https://fbref.com/en/players/e778654a/Yangel-Herrera"
2021,"Granada","La Liga","Luis Javier Suárez","COL","FW,MF","22",1997,18.5,19,11,5,7,7,6,17,35.3,11,10,1,9,8,27,11,0,"https://fbref.com/en/players/eeba07f8/Luis-Javier-Suarez"
2021,"Granada","La Liga","Kenedy","BRA","FW,MF","24",1996,16.3,22,12,10,7,5,5,25,20,20,21,4,17,26,48,15,1,"https://fbref.com/en/players/5eebbfdf/Kenedy"
2021,"Granada","La Liga","Darwin Machís","VEN","FW,MF","27",1993,22.5,30,17,12,10,8,6,19,31.6,13,21,2,19,22,52,13,0,"https://fbref.com/en/players/ed6ea4d9/Darwin-Machis"
2021,"Granada","La Liga","Adrián Marín","ESP","DF,MF","23",1997,3,5,2,1,3,1,2,3,66.7,1,5,2,3,4,9,9,0,"https://fbref.com/en/players/b7f2edff/Adrian-Marin"
2021,"Granada","La Liga","Luis Milla","ESP","MF","25",1994,13.9,22,11,11,10,1,6,28,21.4,22,10,0,10,24,46,16,1,"https://fbref.com/en/players/19c36442/Luis-Milla"
2021,"Granada","La Liga","Jorge Molina","ESP","FW","38",1982,17.9,11,4,3,5,3,8,22,36.4,14,5,1,4,3,14,19,0,"https://fbref.com/en/players/43f71e77/Jorge-Molina"
2021,"Granada","La Liga","Ángel Montoro","ESP","MF","32",1988,15.1,15,9,7,7,1,4,16,25,12,13,3,10,22,37,21,0,"https://fbref.com/en/players/719384c1/Angel-Montoro"
2021,"Granada","La Liga","Carlos Neva","ESP","DF","24",1996,20,12,6,6,6,0,6,11,54.5,5,16,4,12,27,39,58,0,"https://fbref.com/en/players/8d47bb39/Carlos-Neva"
2021,"Granada","La Liga","Pepe","ESP","DF","20",2000,2.8,4,2,2,2,0,3,4,75,1,5,2,3,4,8,9,0,"https://fbref.com/en/players/6583a8a9/Pepe"
2021,"Granada","La Liga","Nehuén Pérez","ARG","DF","20",2000,8.2,6,3,6,0,0,4,6,66.7,2,5,4,1,12,18,33,0,"https://fbref.com/en/players/f7c491f1/Nehuen-Perez"
2021,"Granada","La Liga","Dani Plomer","ESP","FW","21",1998,0.5,0,0,0,0,0,0,1,0,1,0,0,0,0,0,1,0,"https://fbref.com/en/players/0d298637/Dani-Plomer"
2021,"Granada","La Liga","Antonio Puertas","ESP","FW,MF","28",1992,24.1,27,13,9,12,6,10,32,31.3,22,24,5,19,12,39,25,0,"https://fbref.com/en/players/c77a8043/Antonio-Puertas"
2021,"Granada","La Liga","Domingos Quina","POR","MF","20",1999,3.8,5,5,1,3,1,3,6,50,3,8,0,8,2,7,0,0,"https://fbref.com/en/players/41fb0f4e/Domingos-Quina"
2021,"Granada","La Liga","Quini","ESP","DF","30",1989,13.2,33,22,23,7,3,19,36,52.8,17,15,6,9,15,48,39,0,"https://fbref.com/en/players/7a538238/Quini"
2021,"Granada","La Liga","Isma Ruiz","ESP","MF","19",2001,0.7,1,0,0,1,0,0,1,0,1,0,0,0,0,1,3,0,"https://fbref.com/en/players/6e36226f/Isma-Ruiz"
2021,"Granada","La Liga","Germán Sánchez","ESP","DF","33",1986,29.3,24,11,13,9,2,11,23,47.8,12,28,26,2,38,62,130,1,"https://fbref.com/en/players/ea9b2ef9/German-Sanchez"
2021,"Granada","La Liga","Rui Silva","POR","GK","26",1994,32,1,0,1,0,0,1,3,33.3,2,0,0,0,2,3,14,0,"https://fbref.com/en/players/ea83bfa6/Rui-Silva"
2021,"Granada","La Liga","Roberto Soldado","ESP","FW","35",1985,16,7,4,1,4,2,2,11,18.2,9,8,0,8,4,11,13,1,"https://fbref.com/en/players/9d66fbe3/Roberto-Soldado"
2021,"Granada","La Liga","Alberto Soro","ESP","FW,MF","21",1999,4.4,7,2,2,4,1,4,10,40,6,7,0,7,1,8,2,0,"https://fbref.com/en/players/452c3055/Alberto-Soro"
2021,"Granada","La Liga","Jesús Vallejo","ESP","DF","23",1997,15,11,6,7,3,1,7,18,38.9,11,21,11,10,13,24,55,0,"https://fbref.com/en/players/c2111b45/Jesus-Vallejo"
2021,"Granada","La Liga","Fede Vico","ESP","MF,FW","26",1994,8.5,10,6,5,5,0,3,10,30,7,15,1,14,12,22,5,0,"https://fbref.com/en/players/f681a8ef/Fede-Vico"
2021,"Hellas Verona","Serie A","Philip Ankhrah","GHA","MF","17",2002,0.1,0,0,0,0,0,0,0,NA,0,1,0,1,0,0,0,0,"https://fbref.com/en/players/f5409698/Philip-Ankhrah"
2021,"Hellas Verona","Serie A","Antonín Barák","CZE","MF","25",1994,30.7,30,19,8,16,6,14,47,29.8,33,26,7,19,12,42,38,1,"https://fbref.com/en/players/01efac19/Antonin-Barak"
2021,"Hellas Verona","Serie A","Alessandro Berardi","ITA","GK","29",1991,0.3,0,0,0,0,0,0,0,NA,0,0,0,0,0,0,0,0,"https://fbref.com/en/players/ec1f737d/Alessandro-Berardi"
2021,"Hellas Verona","Serie A","Daniel Bessa","ITA","MF","27",1993,6.8,15,8,3,11,1,6,14,42.9,8,5,1,4,2,17,0,0,"https://fbref.com/en/players/88895312/Daniel-Bessa"
2021,"Hellas Verona","Serie A","Federico Ceccherini","ITA","DF","28",1992,19.3,16,12,10,6,0,2,7,28.6,5,15,8,7,40,56,60,0,"https://fbref.com/en/players/d9624b51/Federico-Ceccherini"
2021,"Hellas Verona","Serie A","Ebrima Colley","GAM","MF,FW","20",2000,8.2,11,4,2,6,3,3,11,27.3,8,6,0,6,6,17,1,0,"https://fbref.com/en/players/bf356094/Ebrima-Colley"
2021,"Hellas Verona","Serie A","Andrea Danzi","ITA","DF","21",1999,1.2,0,0,0,0,0,0,1,0,1,0,0,0,3,3,1,0,"https://fbref.com/en/players/263b855a/Andrea-Danzi"
2021,"Hellas Verona","Serie A","Paweł Dawidowicz","POL","DF","25",1995,20.7,42,28,30,10,2,14,24,58.3,10,28,19,9,27,69,62,1,"https://fbref.com/en/players/16bb656a/Pawel-Dawidowicz"
2021,"Hellas Verona","Serie A","Samuel Di Carmine","ITA","FW","31",1988,5.6,1,2,0,1,0,0,3,0,3,1,0,1,0,1,5,0,"https://fbref.com/en/players/ef94dc2f/Samuel-Di-Carmine"
2021,"Hellas Verona","Serie A","Federico Dimarco","ITA","DF","22",1997,29,32,19,23,7,2,13,28,46.4,15,18,9,9,47,79,50,1,"https://fbref.com/en/players/970b8574/Federico-Dimarco"
2021,"Hellas Verona","Serie A","Alan Empereur","BRA","DF","26",1994,2.4,0,0,0,0,0,0,0,NA,0,1,1,0,6,6,7,1,"https://fbref.com/en/players/825b8997/Alan-Empereur"
2021,"Hellas Verona","Serie A","Davide Faraoni","ITA","DF","28",1991,32.1,62,33,36,19,7,28,51,54.9,23,48,17,31,49,111,83,1,"https://fbref.com/en/players/aae9d04a/Davide-Faraoni"
2021,"Hellas Verona","Serie A","Andrea Favilli","ITA","FW","23",1997,3.8,3,1,0,1,2,2,3,66.7,1,2,0,2,0,3,2,0,"https://fbref.com/en/players/44510fde/Andrea-Favilli"
2021,"Hellas Verona","Serie A","Koray Günter","GER","DF","25",1994,19.6,20,10,10,9,1,4,9,44.4,5,27,21,6,70,90,87,0,"https://fbref.com/en/players/f1f1f238/Koray-Gunter"
2021,"Hellas Verona","Serie A","Ivan Ilić","SRB","MF","19",2001,20.4,26,14,11,11,4,7,21,33.3,14,17,5,12,27,53,26,0,"https://fbref.com/en/players/bb376bed/Ivan-Ilic"
2021,"Hellas Verona","Serie A","Nikola Kalinić","CRO","FW","32",1988,11.8,5,1,2,2,1,0,3,0,3,6,0,6,1,6,7,0,"https://fbref.com/en/players/d4931a5a/Nikola-Kalinic"
2021,"Hellas Verona","Serie A","Kevin Lasagna","ITA","FW","27",1992,14.1,7,3,0,5,2,1,5,20,4,12,1,11,1,8,11,0,"https://fbref.com/en/players/09538fdb/Kevin-Lasagna"
2021,"Hellas Verona","Serie A","Darko Lazović","SRB","DF,MF","29",1990,27.8,29,17,8,17,4,20,42,47.6,22,17,7,10,20,49,29,0,"https://fbref.com/en/players/5128bde4/Darko-Lazovic"
2021,"Hellas Verona","Serie A","Matteo Lovato","ITA","DF","20",2000,15.4,21,12,14,5,2,10,21,47.6,11,20,10,10,37,58,48,1,"https://fbref.com/en/players/5fa57166/Matteo-Lovato"
2021,"Hellas Verona","Serie A","Giangiacomo Magnani","ITA","DF","24",1995,16.8,26,15,14,9,3,9,16,56.3,7,25,16,9,44,70,105,1,"https://fbref.com/en/players/cce9f582/Giangiacomo-Magnani"
2021,"Hellas Verona","Serie A","Yıldırım Mert Çetin","TUR","DF","23",1997,4.6,8,4,3,5,0,2,6,33.3,4,7,5,2,14,22,11,1,"https://fbref.com/en/players/c730da00/Yildirim-Mert-Cetin"
2021,"Hellas Verona","Serie A","Ivor Pandur","CRO","GK","20",2000,3.7,0,0,0,0,0,0,0,NA,0,0,0,0,0,0,0,0,"https://fbref.com/en/players/457cb02f/Ivor-Pandur"
2021,"Hellas Verona","Serie A","Kevin Rüegg","SUI","DF,MF","21",1998,2.3,0,0,0,0,0,0,0,NA,0,3,0,3,2,2,3,0,"https://fbref.com/en/players/90573602/Kevin-Ruegg"
2021,"Hellas Verona","Serie A","Eddie Salcedo","ITA","MF,FW","18",2001,8.4,6,2,3,2,1,3,3,100,0,6,0,6,6,12,6,0,"https://fbref.com/en/players/0489bb30/Eddie-Salcedo"
2021,"Hellas Verona","Serie A","Marco Silvestri","ITA","GK","29",1991,34,0,0,0,0,0,0,0,NA,0,0,0,0,0,0,14,1,"https://fbref.com/en/players/0d422df7/Marco-Silvestri"
2021,"Hellas Verona","Serie A","Stefano Sturaro","ITA","MF","27",1993,4.7,4,3,3,0,1,2,8,25,6,5,1,4,5,9,10,0,"https://fbref.com/en/players/2334478a/Stefano-Sturaro"
2021,"Hellas Verona","Serie A","Adrien Tameze","CMR","MF","26",1994,25.6,39,25,23,15,1,11,27,40.7,16,31,8,23,32,71,46,2,"https://fbref.com/en/players/8da74c05/Adrien-Tameze"
2021,"Hellas Verona","Serie A","Ľubomír Tupta","SVK","FW","22",1998,0.6,0,0,0,0,0,0,0,NA,0,0,0,0,0,0,0,0,"https://fbref.com/en/players/b02af64f/Lubomir-Tupta"
2021,"Hellas Verona","Serie A","Iyenoma Udogie","ITA","DF,MF","17",2002,1.9,6,4,2,2,2,2,2,100,0,3,0,3,2,8,4,0,"https://fbref.com/en/players/7cd520e8/Iyenoma-Udogie"
2021,"Hellas Verona","Serie A","Miguel Veloso","POR","MF","34",1986,14.6,24,17,10,10,4,12,34,35.3,22,12,1,11,12,36,25,0,"https://fbref.com/en/players/ab1ca213/Miguel-Veloso"
2021,"Hellas Verona","Serie A","Ronaldo Vieira","GNB","MF","22",1998,2.5,NA,3,NA,NA,NA,NA,NA,NA,NA,NA,NA,NA,0,NA,NA,NA,"https://fbref.com/en/players/75e60d75/Ronaldo-Vieira"
2021,"Hellas Verona","Serie A","Mattia Zaccagni","ITA","MF","25",1995,29,27,13,8,11,8,8,25,32,17,28,4,24,27,54,13,1,"https://fbref.com/en/players/d85c238b/Mattia-Zaccagni"
2021,"Hertha BSC","Bundesliga","Omar Alderete","PAR","DF","23",1996,14.4,16,10,11,5,0,7,16,43.8,9,14,10,4,21,37,61,1,"https://fbref.com/en/players/bb08bce9/Omar-Alderete"
2021,"Hertha BSC","Bundesliga","Santiago Ascacíbar","ARG","MF","23",1997,8.5,30,15,15,14,1,15,28,53.6,13,23,2,21,13,43,14,0,"https://fbref.com/en/players/e26fcca3/Santiago-Ascacibar"
2021,"Hertha BSC","Bundesliga","Dedryck Boyata","BEL","DF","29",1990,17.2,14,7,10,3,1,7,15,46.7,8,23,20,3,26,40,68,1,"https://fbref.com/en/players/7c473e12/Dedryck-Boyata"
2021,"Hertha BSC","Bundesliga","Jhon Córdoba","COL","FW","27",1993,17.1,9,4,1,5,3,2,4,50,2,13,2,11,6,15,4,0,"https://fbref.com/en/players/9f381d8b/Jhon-Cordoba"
2021,"Hertha BSC","Bundesliga","Matheus Cunha","BRA","FW,MF","21",1999,23.9,36,16,10,19,7,13,49,26.5,36,29,2,27,31,67,9,0,"https://fbref.com/en/players/dc62b55d/Matheus-Cunha"
2021,"Hertha BSC","Bundesliga","Márton Dárdai","GER","DF,MF","18",2002,9.1,17,10,10,6,1,9,16,56.3,7,7,3,4,16,33,31,0,"https://fbref.com/en/players/41bff4fa/Marton-Dardai"
2021,"Hertha BSC","Bundesliga","Vladimír Darida","CZE","MF","29",1990,21.1,34,19,11,19,4,9,31,29,22,34,2,32,27,61,18,0,"https://fbref.com/en/players/3eb0f2df/Vladimir-Darida"
2021,"Hertha BSC","Bundesliga","Javairô Dilrosun","NED","FW,MF","22",1998,5.9,5,3,2,2,1,1,6,16.7,5,5,0,5,4,9,3,0,"https://fbref.com/en/players/34a0f5ff/Javairo-Dilrosun"
2021,"Hertha BSC","Bundesliga","Mattéo Guendouzi","FRA","MF","21",1999,20.2,24,13,10,12,2,9,25,36,16,15,4,11,21,45,24,1,"https://fbref.com/en/players/5ea8ef20/Matteo-Guendouzi"
2021,"Hertha BSC","Bundesliga","Rune Jarstein","NOR","GK","35",1984,8,0,0,0,0,0,0,0,NA,0,0,0,0,0,0,7,1,"https://fbref.com/en/players/27d2618c/Rune-Jarstein"
2021,"Hertha BSC","Bundesliga","Sami Khedira","GER","MF","33",1987,4.4,11,6,3,7,1,6,12,50,6,4,0,4,9,20,7,0,"https://fbref.com/en/players/38ac43d3/Sami-Khedira"
2021,"Hertha BSC","Bundesliga","Lukas Klünter","GER","DF","24",1996,11,10,5,6,4,0,5,10,50,5,3,1,2,11,21,29,1,"https://fbref.com/en/players/92948149/Lukas-Klunter"
2021,"Hertha BSC","Bundesliga","Mathew Leckie","AUS","FW,DF","29",1991,5.6,12,3,5,5,2,4,11,36.4,7,8,0,8,13,25,9,0,"https://fbref.com/en/players/b93b7882/Mathew-Leckie"
2021,"Hertha BSC","Bundesliga","Eduard Löwen","GER","MF,DF","23",1997,0.9,5,1,3,1,1,2,5,40,3,1,0,1,1,6,1,0,"https://fbref.com/en/players/70678132/Eduard-Lowen"
2021,"Hertha BSC","Bundesliga","Dodi Lukebakio","BEL","FW,MF","22",1997,20.6,21,14,13,5,3,9,20,45,11,14,1,13,12,33,8,0,"https://fbref.com/en/players/0c61c77c/Dodi-Lukebakio"
2021,"Hertha BSC","Bundesliga","Arne Maier","GER","MF","21",1999,0.3,1,1,0,1,0,0,1,0,1,0,0,0,0,1,0,0,"https://fbref.com/en/players/ab700320/Arne-Maier"
2021,"Hertha BSC","Bundesliga","Jonas Michel Dirkner","GER","MF","18",2002,0.2,0,0,0,0,0,0,0,NA,0,0,0,0,0,0,0,0,"https://fbref.com/en/players/d699d8ef/Jonas-Michel-Dirkner"
2021,"Hertha BSC","Bundesliga","Jonas Michelbrink","GER","MF","19",2001,0.4,0,0,0,0,0,0,0,NA,0,0,0,0,0,0,0,0,"https://fbref.com/en/players/f95d2f9d/Jonas-Michelbrink"
2021,"Hertha BSC","Bundesliga","Maximilian Mittelstädt","GER","DF,FW","23",1997,20,66,39,42,21,3,35,72,48.6,37,34,5,29,55,121,61,1,"https://fbref.com/en/players/88d4144a/Maximilian-Mittelstadt"
2021,"Hertha BSC","Bundesliga","Luca Netz","GER","DF,FW","17",2003,3.4,14,8,12,2,0,6,17,35.3,11,3,0,3,6,20,8,0,"https://fbref.com/en/players/e79269bd/Luca-Netz"
2021,"Hertha BSC","Bundesliga","Jessic Ngankam","GER","FW","20",2000,3.3,5,2,1,2,2,1,3,33.3,2,6,1,5,0,5,1,0,"https://fbref.com/en/players/bc249af8/Jessic-Ngankam"
2021,"Hertha BSC","Bundesliga","Peter Pekarík","SVK","DF","33",1986,18.8,24,18,17,7,0,17,31,54.8,14,19,8,11,27,51,41,0,"https://fbref.com/en/players/c18d22f5/Peter-Pekarik"
2021,"Hertha BSC","Bundesliga","Krzysztof Piątek","POL","FW","25",1995,18.1,9,4,1,7,1,3,22,13.6,19,11,0,11,6,15,14,0,"https://fbref.com/en/players/17f3620a/Krzysztof-Piatek"
2021,"Hertha BSC","Bundesliga","Marvin Plattenhardt","GER","DF","28",1992,11.9,15,10,6,7,2,5,9,55.6,4,9,1,8,1,16,19,1,"https://fbref.com/en/players/f7aa75bd/Marvin-Plattenhardt"
2021,"Hertha BSC","Bundesliga","Nemanja Radonjić","SRB","FW,MF","24",1996,6.8,5,3,2,2,1,1,5,20,4,1,0,1,2,7,1,0,"https://fbref.com/en/players/0630eb63/Nemanja-Radonjic"
2021,"Hertha BSC","Bundesliga","Daishawn Redan","NED","FW,MF","19",2001,1.1,0,0,0,0,0,0,0,NA,0,1,0,1,0,0,0,0,"https://fbref.com/en/players/16b4260e/Daishawn-Redan"
2021,"Hertha BSC","Bundesliga","Alexander Schwolow","GER","GK","28",1992,26,0,0,0,0,0,0,0,NA,0,1,0,1,0,0,6,0,"https://fbref.com/en/players/0d55d942/Alexander-Schwolow"
2021,"Hertha BSC","Bundesliga","Niklas Stark","GER","DF,MF","25",1995,31,49,28,20,27,2,13,31,41.9,18,43,16,27,42,91,101,0,"https://fbref.com/en/players/aad48be9/Niklas-Stark"
2021,"Hertha BSC","Bundesliga","Jordan Torunarigha","GER","DF","22",1997,10.8,7,4,7,0,0,5,8,62.5,3,8,2,6,15,22,54,1,"https://fbref.com/en/players/f86cabbd/Jordan-Torunarigha"
2021,"Hertha BSC","Bundesliga","Lucas Tousart","FRA","MF","23",1997,23.2,33,18,16,15,2,13,27,48.1,14,33,6,27,40,73,52,0,"https://fbref.com/en/players/71ec39ef/Lucas-Tousart"
2021,"Hertha BSC","Bundesliga","Marten Winkler","GER","FW","17",2002,0,0,0,0,0,0,0,0,NA,0,0,0,0,0,0,0,0,"https://fbref.com/en/players/e0d515ef/Marten-Winkler"
2021,"Hertha BSC","Bundesliga","Deyovaisio Zeefuik","NED","DF,FW","22",1998,10.1,13,9,8,3,2,8,19,42.1,11,15,3,12,12,25,36,0,"https://fbref.com/en/players/58a2e9f6/Deyovaisio-Zeefuik"
2021,"Hoffenheim","Bundesliga","Sargis Adamyan","ARM","FW,MF","27",1993,5.3,9,4,4,3,2,7,14,50,7,2,0,2,6,15,1,0,"https://fbref.com/en/players/22919e97/Sargis-Adamyan"
2021,"Hoffenheim","Bundesliga","Kevin Akpoguma","NGA","DF","25",1995,13.2,18,12,11,6,1,8,14,57.1,6,28,15,13,13,31,32,2,"https://fbref.com/en/players/6ec6fde0/Kevin-Akpoguma"
2021,"Hoffenheim","Bundesliga","Oliver Baumann","GER","GK","30",1990,31,0,0,0,0,0,0,1,0,1,0,0,0,2,2,14,0,"https://fbref.com/en/players/47064058/Oliver-Baumann"
2021,"Hoffenheim","Bundesliga","Christoph Baumgartner","AUT","MF,FW","20",1999,26.3,44,31,13,24,7,14,51,27.5,37,40,8,32,24,68,24,0,"https://fbref.com/en/players/437f2b00/Christoph-Baumgartner"
2021,"Hoffenheim","Bundesliga","Ihlas Bebou","TOG","FW,MF","26",1994,24.4,24,9,5,10,9,8,14,57.1,6,18,4,14,17,41,16,0,"https://fbref.com/en/players/a53b661f/Ihlas-Bebou"
2021,"Hoffenheim","Bundesliga","Maximilian Beier","GER","FW,DF","17",2002,0.1,0,0,0,0,0,0,1,0,1,0,0,0,0,0,0,0,"https://fbref.com/en/players/5db45ee5/Maximilian-Beier"
2021,"Hoffenheim","Bundesliga","Ishak Belfodil","ALG","FW,MF","28",1992,6.6,3,2,0,0,3,0,2,0,2,1,0,1,1,4,3,0,"https://fbref.com/en/players/ff182fdc/Ishak-Belfodil"
2021,"Hoffenheim","Bundesliga","Ermin Bičakčić","BIH","DF","30",1990,1.4,1,1,0,1,0,1,1,100,0,1,1,0,3,4,9,0,"https://fbref.com/en/players/7aac47fe/Ermin-Bicakcic"
2021,"Hoffenheim","Bundesliga","Melayro Bogarde","NED","DF,MF","18",2002,3.1,7,3,3,3,1,5,9,55.6,4,0,0,0,5,12,1,0,"https://fbref.com/en/players/1fda91b3/Melayro-Bogarde"
2021,"Hoffenheim","Bundesliga","Joshua Brenet","NED","DF","26",1994,0,0,0,0,0,0,0,0,NA,0,0,0,0,0,0,0,0,"https://fbref.com/en/players/2b5527c4/Joshua-Brenet"
2021,"Hoffenheim","Bundesliga","Jacob Bruun Larsen","DEN","MF,FW","21",1998,1,0,0,0,0,0,0,0,NA,0,0,0,0,0,0,0,0,"https://fbref.com/en/players/4e204552/Jacob-Bruun-Larsen"
2021,"Hoffenheim","Bundesliga","Moanes Dabbur","ISR","FW,MF","28",1992,11.1,6,3,3,1,2,1,13,7.7,12,6,0,6,9,15,7,0,"https://fbref.com/en/players/eac044ad/Moanes-Dabbur"
2021,"Hoffenheim","Bundesliga","Mijat Gaćinović","SRB","DF,MF","25",1995,9.1,18,10,6,11,1,9,24,37.5,15,13,0,13,18,36,15,0,"https://fbref.com/en/players/16daec92/Mijat-Gacinovic"
2021,"Hoffenheim","Bundesliga","Dennis Geiger","GER","MF","22",1998,7.3,13,10,3,8,2,5,8,62.5,3,10,0,10,3,16,0,0,"https://fbref.com/en/players/37f606f0/Dennis-Geiger"
2021,"Hoffenheim","Bundesliga","Florian Grillitsch","AUT","MF,DF","24",1995,20.9,37,21,21,13,3,19,52,36.5,33,38,7,31,51,88,47,1,"https://fbref.com/en/players/ffbbc83b/Florian-Grillitsch"
2021,"Hoffenheim","Bundesliga","Marco John","GER","DF","18",2002,11.1,21,15,9,5,7,10,22,45.5,12,18,1,17,16,37,21,0,"https://fbref.com/en/players/d9e196bf/Marco-John"
2021,"Hoffenheim","Bundesliga","Pavel Kadeřábek","CZE","DF,FW","28",1992,17.6,15,12,7,6,2,6,15,40,9,12,3,9,18,33,31,0,"https://fbref.com/en/players/79c90e45/Pavel-Kaderabek"
2021,"Hoffenheim","Bundesliga","Klauss","BRA","MF,FW","23",1997,0.6,1,0,0,0,1,0,1,0,1,0,0,0,0,1,0,0,"https://fbref.com/en/players/f5ae006d/Klauss"
2021,"Hoffenheim","Bundesliga","Andrej Kramarić","CRO","FW,MF","29",1991,26.4,7,4,4,0,3,3,8,37.5,5,8,1,7,7,14,5,1,"https://fbref.com/en/players/603cb947/Andrej-Kramaric"
2021,"Hoffenheim","Bundesliga","Håvard Nordtveit","NOR","DF","30",1990,7.8,6,2,5,1,0,6,8,75,2,4,2,2,13,19,42,0,"https://fbref.com/en/players/6cafd68d/Havard-Nordtveit"
2021,"Hoffenheim","Bundesliga","Kasim Nuhu","GHA","DF","25",1995,11,13,7,9,4,0,6,10,60,4,8,3,5,15,28,38,0,"https://fbref.com/en/players/93a50d2c/Kasim-Nuhu"
2021,"Hoffenheim","Bundesliga","Philipp Pentke","GER","GK","35",1985,3,0,0,0,0,0,0,0,NA,0,0,0,0,0,0,0,0,"https://fbref.com/en/players/c41f7379/Philipp-Pentke"
2021,"Hoffenheim","Bundesliga","Stefan Posch","AUT","DF","23",1997,23.5,52,24,29,17,6,27,47,57.4,20,27,8,19,37,89,73,1,"https://fbref.com/en/players/7f609bfc/Stefan-Posch"
2021,"Hoffenheim","Bundesliga","Chris Richards","USA","DF","20",2000,10.5,19,8,12,6,1,10,16,62.5,6,13,4,9,21,40,40,1,"https://fbref.com/en/players/0a3d6d2b/Chris-Richards"
2021,"Hoffenheim","Bundesliga","Sebastian Rudy","GER","MF,FW","30",1990,18.6,35,26,15,15,5,16,45,35.6,29,24,4,20,13,48,21,1,"https://fbref.com/en/players/80f36c88/Sebastian-Rudy"
2021,"Hoffenheim","Bundesliga","Georginio Rutter","FRA","FW","18",2002,2.7,4,4,2,2,0,1,2,50,1,2,0,2,0,4,2,0,"https://fbref.com/en/players/c64c01fc/Georginio-Rutter"
2021,"Hoffenheim","Bundesliga","Diadie Samassékou","MLI","MF","24",1996,28.5,71,41,22,42,7,33,90,36.7,57,41,12,29,78,149,50,0,"https://fbref.com/en/players/08593525/Diadie-Samassekou"
2021,"Hoffenheim","Bundesliga","Ryan Sessegnon","ENG","DF,FW","20",2000,17.5,47,25,26,13,8,15,34,44.1,19,26,3,23,30,77,46,0,"https://fbref.com/en/players/6aa3e78b/Ryan-Sessegnon"
2021,"Hoffenheim","Bundesliga","Robert Skov","DEN","FW,MF","24",1996,12.9,19,10,9,7,3,7,16,43.8,9,9,2,7,15,34,10,1,"https://fbref.com/en/players/ff98492b/Robert-Skov"
2021,"Hoffenheim","Bundesliga","Kevin Vogt","GER","DF","28",1991,20.5,18,12,11,6,1,12,21,57.1,9,21,12,9,16,34,71,0,"https://fbref.com/en/players/1d8e9add/Kevin-Vogt"
2021,"Huesca","La Liga","Juan Carlos","ESP","MF,FW","29",1991,3.2,5,3,4,1,0,2,15,13.3,13,7,0,7,1,6,1,0,"https://fbref.com/en/players/82803509/Juan-Carlos"
2021,"Huesca","La Liga","Idrissa Doumbia","CIV","MF","22",1998,8.7,15,8,6,7,2,5,13,38.5,8,6,3,3,7,22,9,0,"https://fbref.com/en/players/685857dc/Idrissa-Doumbia"
2021,"Huesca","La Liga","Dani Escriche","ESP","FW,MF","22",1998,9.5,9,7,5,2,2,3,10,30,7,11,0,11,8,17,5,0,"https://fbref.com/en/players/5a36f180/Dani-Escriche"
2021,"Huesca","La Liga","Álvaro Fernández","ESP","GK","22",1998,22,1,1,0,1,0,1,3,33.3,2,0,0,0,2,3,7,0,"https://fbref.com/en/players/f127d782/Alvaro-Fernandez"
2021,"Huesca","La Liga","Andrés Fernández","ESP","GK","33",1986,16,0,0,0,0,0,0,0,NA,0,0,0,0,0,0,3,2,"https://fbref.com/en/players/307fcd26/Andres-Fernandez"
2021,"Huesca","La Liga","David Ferreiro","ESP","MF,FW","32",1988,28.1,25,12,12,8,5,8,49,16.3,41,21,1,20,25,50,15,0,"https://fbref.com/en/players/8970907e/David-Ferreiro"
2021,"Huesca","La Liga","Javi Galán","ESP","DF","25",1994,34.1,88,54,47,35,6,46,72,63.9,26,30,4,26,39,127,61,0,"https://fbref.com/en/players/a4b00319/Javi-Galan"
2021,"Huesca","La Liga","Borja García","ESP","MF,FW","29",1990,12.4,13,7,4,6,3,6,12,50,6,12,0,12,10,23,4,1,"https://fbref.com/en/players/e7f4603c/Borja-Garcia"
2021,"Huesca","La Liga","Sergio Gómez","ESP","MF,FW","19",2000,8.8,29,10,17,9,3,11,22,50,11,15,0,15,14,43,9,0,"https://fbref.com/en/players/01e5f06e/Sergio-Gomez"
2021,"Huesca","La Liga","Pablo Insua","ESP","DF","26",1993,17.6,37,18,26,9,2,14,31,45.2,17,14,8,6,24,61,68,0,"https://fbref.com/en/players/4b5e7e90/Pablo-Insua"
2021,"Huesca","La Liga","Pedro López Muñoz","ESP","DF","36",1983,11.9,23,15,10,8,5,15,22,68.2,7,10,4,6,16,39,23,1,"https://fbref.com/en/players/a60823a4/Pedro-Lopez-Munoz"
2021,"Huesca","La Liga","Luisinho","POR","DF","35",1985,2,3,3,2,1,0,1,3,33.3,2,3,0,3,4,7,7,0,"https://fbref.com/en/players/a7f00c8c/Luisinho"
2021,"Huesca","La Liga","Pablo Maffeo","ESP","DF","23",1997,21.8,26,17,21,4,1,12,26,46.2,14,18,6,12,35,61,27,0,"https://fbref.com/en/players/5db04597/Pablo-Maffeo"
2021,"Huesca","La Liga","Rafa Mir","ESP","FW","23",1997,32,15,9,4,4,7,7,22,31.8,15,14,2,12,15,30,25,0,"https://fbref.com/en/players/bbf5c11b/Rafa-Mir"
2021,"Huesca","La Liga","Pedro Mosquera","ESP","MF","32",1988,22.8,38,18,19,18,1,13,53,24.5,40,23,6,17,31,69,38,1,"https://fbref.com/en/players/c5fa58ea/Pedro-Mosquera"
2021,"Huesca","La Liga","Joaquín Muñoz","ESP","FW","21",1999,0.5,0,0,0,0,0,0,2,0,2,0,0,0,1,1,0,0,"https://fbref.com/en/players/e9fbcc21/Joaquin-Munoz"
2021,"Huesca","La Liga","Kelechi Nwakali","NGA","MF,FW","22",1998,1.6,4,3,1,2,1,0,4,0,4,1,0,1,1,5,1,0,"https://fbref.com/en/players/877f31c2/Kelechi-Nwakali"
2021,"Huesca","La Liga","Shinji Okazaki","JPN","FW,MF","34",1986,12.5,7,5,5,0,2,0,5,0,5,5,0,5,4,11,6,0,"https://fbref.com/en/players/68796d61/Shinji-Okazaki"
2021,"Huesca","La Liga","Javier Ontiveros","ESP","FW,MF","22",1997,10.2,21,14,10,10,1,9,26,34.6,17,12,0,12,9,30,6,0,"https://fbref.com/en/players/a83d8b0c/Javier-Ontiveros"
2021,"Huesca","La Liga","Jorge Pulido","ESP","DF","29",1991,32.1,39,24,31,8,0,17,29,58.6,12,32,18,14,52,91,98,0,"https://fbref.com/en/players/978cd030/Jorge-Pulido"
2021,"Huesca","La Liga","Sandro Ramírez","ESP","FW","25",1995,14.3,13,9,3,8,2,4,11,36.4,7,11,1,10,10,23,2,0,"https://fbref.com/en/players/833fb62e/Sandro-Ramirez"
2021,"Huesca","La Liga","Mikel Rico","ESP","MF","35",1984,24.3,24,12,14,8,2,11,34,32.4,23,20,3,17,23,47,22,0,"https://fbref.com/en/players/def69cd0/Mikel-Rico"
2021,"Huesca","La Liga","Jaime Seoane","ESP","MF","23",1997,22.9,50,30,20,23,7,24,65,36.9,41,27,6,21,17,67,14,0,"https://fbref.com/en/players/a62b4888/Jaime-Seoane"
2021,"Huesca","La Liga","Gastón Silva","URU","DF","26",1994,6.7,16,12,11,5,0,8,14,57.1,6,10,4,6,11,27,16,0,"https://fbref.com/en/players/47d493c3/Gaston-Silva"
2021,"Huesca","La Liga","Dimitris Siovas","GRE","DF","31",1988,34.1,46,24,34,10,2,20,30,66.7,10,38,17,21,62,108,125,2,"https://fbref.com/en/players/92d38e6c/Dimitris-Siovas"
2021,"Huesca","La Liga","Eugeni Valderrama","ESP","MF,FW","26",1994,1.3,2,2,1,0,1,0,1,0,1,0,0,0,5,7,3,0,"https://fbref.com/en/players/a75b4071/Eugeni-Valderrama"
2021,"Huesca","La Liga","Denis Vavro","SVK","DF","24",1996,6.8,7,4,2,4,1,2,5,40,3,2,0,2,11,18,21,0,"https://fbref.com/en/players/08990838/Denis-Vavro"
2021,"Inter","Serie A","Nicolò Barella","ITA","MF","23",1997,32.2,58,31,23,29,6,23,72,31.9,49,29,4,25,26,84,14,0,"https://fbref.com/en/players/6928979a/Nicolo-Barella"
2021,"Inter","Serie A","Alessandro Bastoni","ITA","DF","21",1999,32.5,36,22,13,21,2,17,27,63,10,34,16,18,40,76,75,0,"https://fbref.com/en/players/75b86fb3/Alessandro-Bastoni"
2021,"Inter","Serie A","Marcelo Brozović","CRO","MF","27",1992,28.7,54,29,23,24,7,20,61,32.8,41,43,17,26,40,94,38,0,"https://fbref.com/en/players/33b8d077/Marcelo-Brozovic"
2021,"Inter","Serie A","Danilo D'Ambrosio","ITA","DF","31",1988,7.8,15,9,6,7,2,6,15,40,9,9,7,2,4,19,15,0,"https://fbref.com/en/players/44eb9093/Danilo-DAmbrosio"
2021,"Inter","Serie A","Matteo Darmian","ITA","DF","30",1989,12.9,30,16,12,7,11,16,28,57.1,12,9,2,7,17,47,35,0,"https://fbref.com/en/players/96e0490d/Matteo-Darmian"
2021,"Inter","Serie A","Christian Eriksen","DEN","MF","28",1992,15.4,12,6,6,4,2,7,20,35,13,16,1,15,9,21,13,1,"https://fbref.com/en/players/980522ec/Christian-Eriksen"
2021,"Inter","Serie A","Roberto Gagliardini","ITA","MF","26",1994,13.7,30,17,17,8,5,5,28,17.9,23,15,3,12,19,49,16,0,"https://fbref.com/en/players/ce30bfc8/Roberto-Gagliardini"
2021,"Inter","Serie A","Achraf Hakimi","MAR","DF","21",1998,29.6,53,32,23,19,11,23,48,47.9,25,31,1,30,22,75,23,1,"https://fbref.com/en/players/e42d61c7/Achraf-Hakimi"
2021,"Inter","Serie A","Samir Handanović","SVN","GK","36",1984,36,1,0,1,0,0,1,1,100,0,0,0,0,0,1,6,3,"https://fbref.com/en/players/74419746/Samir-Handanovic"
2021,"Inter","Serie A","Aleksandar Kolarov","SRB","DF","34",1985,4.3,4,4,0,4,0,1,2,50,1,2,0,2,7,11,8,0,"https://fbref.com/en/players/eda40760/Aleksandar-Kolarov"
2021,"Inter","Serie A","Romelu Lukaku","BEL","FW","27",1993,32,11,1,1,6,4,6,14,42.9,8,11,1,10,3,14,34,0,"https://fbref.com/en/players/5eae500a/Romelu-Lukaku"
2021,"Inter","Serie A","Lautaro Martínez","ARG","FW","22",1997,28.5,25,12,5,11,9,7,24,29.2,17,31,1,30,27,52,16,0,"https://fbref.com/en/players/f7036e1c/Lautaro-Martinez"
2021,"Inter","Serie A","Radja Nainggolan","BEL","MF","32",1988,0.5,0,0,0,0,0,0,0,NA,0,0,0,0,1,1,0,0,"https://fbref.com/en/players/1f9328da/Radja-Nainggolan"
2021,"Inter","Serie A","Daniele Padelli","ITA","GK","34",1985,0.5,0,0,0,0,0,0,0,NA,0,0,0,0,0,0,0,0,"https://fbref.com/en/players/cf1c23d8/Daniele-Padelli"
2021,"Inter","Serie A","Ivan Perišić","CRO","DF,FW","31",1989,19.9,22,13,11,6,5,12,33,36.4,21,33,4,29,19,41,36,1,"https://fbref.com/en/players/6fe90922/Ivan-Perisic"
2021,"Inter","Serie A","Andrea Pinamonti","ITA","FW","21",1999,1.9,0,0,0,0,0,0,0,NA,0,1,0,1,1,1,2,0,"https://fbref.com/en/players/08aa9cd1/Andrea-Pinamonti"
2021,"Inter","Serie A","Ionuț Radu","ROU","GK","23",1997,1.5,0,0,0,0,0,0,0,NA,0,0,0,0,0,0,1,0,"https://fbref.com/en/players/67f649be/Ionut-Radu"
2021,"Inter","Serie A","Andrea Ranocchia","ITA","DF","32",1988,7.8,13,10,6,6,1,7,8,87.5,1,5,3,2,12,25,19,0,"https://fbref.com/en/players/539230cf/Andrea-Ranocchia"
2021,"Inter","Serie A","Alexis Sánchez","CHI","FW","31",1988,12.7,14,8,4,4,6,5,18,27.8,13,11,0,11,7,21,1,1,"https://fbref.com/en/players/2c0f8e9e/Alexis-Sanchez"
2021,"Inter","Serie A","Stefano Sensi","ITA","MF","24",1995,6.7,9,6,3,5,1,4,11,36.4,7,6,1,5,7,16,1,0,"https://fbref.com/en/players/b70bde8f/Stefano-Sensi"
2021,"Inter","Serie A","Milan Škriniar","SVK","DF","25",1995,30.9,48,32,29,16,3,23,34,67.6,11,30,19,11,30,78,89,1,"https://fbref.com/en/players/30f5ffa9/Milan-Skriniar"
2021,"Inter","Serie A","Matías Vecino","URU","MF","28",1991,3.1,1,1,0,0,1,0,5,0,5,7,1,6,4,5,3,0,"https://fbref.com/en/players/44ac04e9/Matias-Vecino"
2021,"Inter","Serie A","Arturo Vidal","CHI","MF","33",1987,12.6,27,14,8,13,6,12,41,29.3,29,23,3,20,29,56,11,0,"https://fbref.com/en/players/67cdbc0e/Arturo-Vidal"
2021,"Inter","Serie A","Stefan de Vrij","NED","DF","28",1992,30.4,28,16,15,12,1,15,24,62.5,9,24,18,6,41,69,95,0,"https://fbref.com/en/players/d0d8dd44/Stefan-de-Vrij"
2021,"Inter","Serie A","Ashley Young","ENG","DF","35",1985,15.8,15,7,8,4,3,3,13,23.1,10,13,0,13,6,21,31,0,"https://fbref.com/en/players/be927d03/Ashley-Young"
2021,"Juventus","Serie A","Rodrigo Bentancur","URU","MF","23",1997,25.8,63,33,21,37,5,20,59,33.9,39,35,12,23,47,110,46,1,"https://fbref.com/en/players/3b8674e6/Rodrigo-Bentancur"
2021,"Juventus","Serie A","Federico Bernardeschi","ITA","MF,DF","26",1994,10.8,9,4,3,5,1,4,20,20,16,6,2,4,14,23,7,1,"https://fbref.com/en/players/ee93c1a9/Federico-Bernardeschi"
2021,"Juventus","Serie A","Leonardo Bonucci","ITA","DF","33",1987,22.5,19,14,10,8,1,6,14,42.9,8,24,13,11,33,52,67,0,"https://fbref.com/en/players/52ec54d0/Leonardo-Bonucci"
2021,"Juventus","Serie A","Gianluigi Buffon","ITA","GK","42",1978,8,0,0,0,0,0,0,0,NA,0,0,0,0,0,0,3,1,"https://fbref.com/en/players/e40d028b/Gianluigi-Buffon"
2021,"Juventus","Serie A","Giorgio Chiellini","ITA","DF","35",1984,15.4,12,9,9,3,0,5,11,45.5,6,18,13,5,27,39,56,0,"https://fbref.com/en/players/e85fb9b8/Giorgio-Chiellini"
2021,"Juventus","Serie A","Federico Chiesa","ITA","MF,DF","22",1997,24.6,47,26,21,14,12,19,50,38,31,23,1,22,12,59,16,0,"https://fbref.com/en/players/b0f7e36c/Federico-Chiesa"
2021,"Juventus","Serie A","Félix Correia","POR","MF","19",2001,0.1,0,0,0,0,0,0,0,NA,0,0,0,0,0,0,1,0,"https://fbref.com/en/players/c803c92a/Felix-Correia"
2021,"Juventus","Serie A","Douglas Costa","BRA","MF,FW","29",1990,0.5,1,0,1,0,0,1,3,33.3,2,0,0,0,0,1,0,0,"https://fbref.com/en/players/4fa7cb9b/Douglas-Costa"
2021,"Juventus","Serie A","Juan Cuadrado","COL","DF,MF","32",1988,24.2,43,25,22,15,6,29,60,48.3,31,16,2,14,43,86,22,2,"https://fbref.com/en/players/0ab1f153/Juan-Cuadrado"
2021,"Juventus","Serie A","Danilo","BRA","DF,MF","29",1991,32.4,62,31,37,16,9,35,66,53,31,32,12,20,66,128,68,2,"https://fbref.com/en/players/94b2001f/Danilo"
2021,"Juventus","Serie A","Mattia De Sciglio","ITA","DF","27",1992,0.3,0,0,0,0,0,0,0,NA,0,0,0,0,0,0,1,0,"https://fbref.com/en/players/ae4e2852/Mattia-De-Sciglio"
2021,"Juventus","Serie A","Merih Demiral","TUR","DF","22",1998,10.4,12,9,8,4,0,5,13,38.5,8,16,9,7,21,33,40,0,"https://fbref.com/en/players/e3cceee6/Merih-Demiral"
2021,"Juventus","Serie A","Alessandro Di Pardo","ITA","FW,DF","21",1999,0.2,0,0,0,0,0,0,0,NA,0,1,1,0,0,0,0,0,"https://fbref.com/en/players/e0ce7038/Alessandro-Di-Pardo"
2021,"Juventus","Serie A","Radu Drăgușin","ROU","DF","18",2002,0,0,0,0,0,0,0,0,NA,0,0,0,0,0,0,0,0,"https://fbref.com/en/players/620922ed/Radu-Dragusin"
2021,"Juventus","Serie A","Paulo Dybala","ARG","FW","26",1993,12.6,14,8,3,4,7,2,14,14.3,12,15,0,15,1,15,1,0,"https://fbref.com/en/players/e0921a4f/Paulo-Dybala"
2021,"Juventus","Serie A","Nicolò Fagioli","ITA","MF","19",2001,0.2,0,0,0,0,0,0,0,NA,0,0,0,0,0,0,1,0,"https://fbref.com/en/players/366be751/Nicolo-Fagioli"
2021,"Juventus","Serie A","Gianluca Frabotta","ITA","DF,MF","21",1999,7.7,7,4,5,0,2,5,12,41.7,7,9,1,8,14,21,15,0,"https://fbref.com/en/players/d80b1835/Gianluca-Frabotta"
2021,"Juventus","Serie A","Dejan Kulusevski","SWE","MF,FW","20",2000,21.4,33,19,12,10,11,14,43,32.6,29,22,0,22,9,42,2,1,"https://fbref.com/en/players/df3cda47/Dejan-Kulusevski"
2021,"Juventus","Serie A","Matthijs de Ligt","NED","DF","20",1999,24.7,37,19,20,16,1,18,28,64.3,10,42,21,21,31,68,64,0,"https://fbref.com/en/players/d6e53a3a/Matthijs-de-Ligt"
2021,"Juventus","Serie A","Weston McKennie","USA","MF","21",1998,18.9,34,19,9,20,5,12,33,36.4,21,21,3,18,28,62,26,0,"https://fbref.com/en/players/01c3aff5/Weston-McKennie"
2021,"Juventus","Serie A","Arthur Melo","BRA","MF","23",1996,12.9,17,9,7,10,0,12,31,38.7,19,6,1,5,18,35,9,1,"https://fbref.com/en/players/48b3dd60/Arthur-Melo"
2021,"Juventus","Serie A","Álvaro Morata","ESP","FW","27",1992,22.4,17,12,2,10,5,4,28,14.3,24,22,2,20,5,22,21,0,"https://fbref.com/en/players/129af0db/Alvaro-Morata"
2021,"Juventus","Serie A","Carlo Pinsoglio","ITA","GK","30",1990,0.3,0,0,0,0,0,0,0,NA,0,0,0,0,0,0,0,0,"https://fbref.com/en/players/f6a06749/Carlo-Pinsoglio"
2021,"Juventus","Serie A","Manolo Portanova","ITA","MF","20",2000,0.8,2,0,2,0,0,0,2,0,2,4,1,3,0,2,1,0,"https://fbref.com/en/players/c8c0dccd/Manolo-Portanova"
2021,"Juventus","Serie A","Adrien Rabiot","FRA","MF","25",1995,25.7,72,42,24,41,7,28,60,46.7,32,32,11,21,43,115,29,1,"https://fbref.com/en/players/8794e251/Adrien-Rabiot"
2021,"Juventus","Serie A","Aaron Ramsey","WAL","MF","29",1990,12.1,22,14,8,13,1,8,25,32,17,13,2,11,7,29,8,2,"https://fbref.com/en/players/ef619b0b/Aaron-Ramsey"
2021,"Juventus","Serie A","Cristiano Ronaldo","POR","FW","35",1985,31.1,6,3,1,3,2,3,15,20,12,11,3,8,5,11,15,1,"https://fbref.com/en/players/dea698d9/Cristiano-Ronaldo"
2021,"Juventus","Serie A","Alex Sandro","BRA","DF","29",1991,20.6,37,23,19,13,5,13,25,52,12,20,4,16,31,68,57,0,"https://fbref.com/en/players/0d82903c/Alex-Sandro"
2021,"Juventus","Serie A","Wojciech Szczęsny","POL","GK","30",1990,29.7,0,0,0,0,0,0,0,NA,0,2,0,2,3,3,5,1,"https://fbref.com/en/players/01b8a2b2/Wojciech-Szczesny"
2021,"Juventus","Serie A","Giacomo Vrioni","ALB","FW","21",1998,0,0,0,0,0,0,0,0,NA,0,0,0,0,0,0,0,0,"https://fbref.com/en/players/bf4d31d3/Giacomo-Vrioni"
2021,"Köln","Bundesliga","Sebastian Andersson","SWE","FW","29",1991,12.5,3,2,0,3,0,1,8,12.5,7,10,3,7,2,5,9,0,"https://fbref.com/en/players/b4cf5806/Sebastian-Andersson"
2021,"Köln","Bundesliga","Toluwalase Arokodare","NGA","FW,MF","19",2000,1.2,1,1,0,0,1,0,0,NA,0,1,0,1,1,2,0,0,"https://fbref.com/en/players/a42760bc/Toluwalase-Arokodare"
2021,"Köln","Bundesliga","Sebastiaan Bornauw","BEL","DF","21",1999,23.1,29,20,25,4,0,14,25,56,11,33,26,7,40,69,104,0,"https://fbref.com/en/players/01834aa0/Sebastiaan-Bornauw"
2021,"Köln","Bundesliga","Sava Cestic","SRB","DF","19",2001,10,20,9,12,6,2,8,17,47.1,9,13,4,9,18,38,40,0,"https://fbref.com/en/players/0b7dae21/Sava-Cestic"
2021,"Köln","Bundesliga","Rafael Czichos","GER","DF","30",1990,25.1,48,24,33,13,2,23,42,54.8,19,25,9,16,53,101,109,0,"https://fbref.com/en/players/b0a0698b/Rafael-Czichos"
2021,"Köln","Bundesliga","Emmanuel Dennis","NGA","FW","22",1997,5.3,13,7,6,5,2,1,6,16.7,5,6,0,6,0,13,0,1,"https://fbref.com/en/players/2c44a35d/Emmanuel-Dennis"
2021,"Köln","Bundesliga","Dominick Drexler","GER","MF,FW","30",1990,13.7,36,26,15,18,3,12,30,40,18,5,1,4,14,50,15,0,"https://fbref.com/en/players/809940aa/Dominick-Drexler"
2021,"Köln","Bundesliga","Ondrej Duda","SVK","FW,MF","25",1994,28.2,36,14,13,18,5,8,39,20.5,31,28,2,26,19,55,20,0,"https://fbref.com/en/players/79ca3e23/Ondrej-Duda"
2021,"Köln","Bundesliga","Kingsley Ehizibue","NED","DF","25",1995,12.6,32,19,22,9,1,10,17,58.8,7,19,5,14,18,50,42,0,"https://fbref.com/en/players/76b2817e/Kingsley-Ehizibue"
2021,"Köln","Bundesliga","Jonas Hector","GER","MF,FW","30",1990,14.3,34,22,8,21,5,15,35,42.9,20,24,5,19,19,53,20,1,"https://fbref.com/en/players/c2009df3/Jonas-Hector"
2021,"Köln","Bundesliga","Marco Höger","GER","DF,MF","30",1989,0.6,1,0,0,1,0,1,2,50,1,2,0,2,2,3,1,0,"https://fbref.com/en/players/4114f306/Marco-Hoger"
2021,"Köln","Bundesliga","Jannes Horn","GER","DF","23",1997,19.6,35,19,23,11,1,23,31,74.2,8,19,2,17,10,45,45,0,"https://fbref.com/en/players/2b83fa49/Jannes-Horn"
2021,"Köln","Bundesliga","Timo Horn","GER","GK","27",1993,33.4,1,0,1,0,0,1,4,25,3,1,0,1,0,1,11,2,"https://fbref.com/en/players/3cd9e95a/Timo-Horn"
2021,"Köln","Bundesliga","Ismail Jakobs","SEN","MF,FW","20",1999,19.2,25,10,17,4,4,11,21,52.4,10,18,1,17,16,41,36,0,"https://fbref.com/en/players/a0415710/Ismail-Jakobs"
2021,"Köln","Bundesliga","Florian Kainz","AUT","MF,FW","27",1992,5,4,2,0,4,0,2,8,25,6,7,0,7,3,7,3,0,"https://fbref.com/en/players/94c18565/Florian-Kainz"
2021,"Köln","Bundesliga","Noah Katterbach","GER","DF,MF","19",2001,12.3,18,11,11,6,1,13,21,61.9,8,7,3,4,23,41,22,0,"https://fbref.com/en/players/e27de4fa/Noah-Katterbach"
2021,"Köln","Bundesliga","Dimitris Limnios","GRE","MF,FW","22",1998,4.2,9,6,3,5,1,5,6,83.3,1,5,0,5,2,11,1,0,"https://fbref.com/en/players/62c7067a/Dimitris-Limnios"
2021,"Köln","Bundesliga","Jorge Meré","ESP","DF","23",1997,14.4,13,6,9,3,1,6,13,46.2,7,14,11,3,15,28,63,0,"https://fbref.com/en/players/9f979eb2/Jorge-Mere"
2021,"Köln","Bundesliga","Max Meyer","GER","MF","24",1995,3.9,7,4,3,3,1,4,8,50,4,4,1,3,3,10,1,0,"https://fbref.com/en/players/eba42d2b/Max-Meyer"
2021,"Köln","Bundesliga","Anthony Modeste","FRA","FW","32",1988,2.5,2,0,0,2,0,0,1,0,1,0,0,0,0,2,2,0,"https://fbref.com/en/players/34e4343c/Anthony-Modeste"
2021,"Köln","Bundesliga","Salih Özcan","TUR","MF","22",1998,15.2,21,13,11,10,0,12,33,36.4,21,11,2,9,20,41,14,1,"https://fbref.com/en/players/15413fa5/Salih-Ozcan"
2021,"Köln","Bundesliga","Elvis Rexhbeçaj","GER","MF,FW","22",1997,20.4,53,32,17,27,9,19,53,35.8,34,32,7,25,26,79,18,0,"https://fbref.com/en/players/1ae836b1/Elvis-Rexhbecaj"
2021,"Köln","Bundesliga","Benno Schmitz","GER","DF","25",1994,4.6,14,7,6,7,1,7,13,53.8,6,8,2,6,6,20,7,0,"https://fbref.com/en/players/ad00b1a8/Benno-Schmitz"
2021,"Köln","Bundesliga","Ellyes Skhiri","TUN","MF","25",1995,30.9,83,48,44,31,8,33,65,50.8,32,49,13,36,82,165,38,2,"https://fbref.com/en/players/c2211709/Ellyes-Skhiri"
2021,"Köln","Bundesliga","Frederik Sørensen","DEN","DF","28",1992,1.1,2,1,0,2,0,1,1,100,0,2,0,2,0,2,0,0,"https://fbref.com/en/players/68635c10/Frederik-Sorensen"
2021,"Köln","Bundesliga","Jan Thielmann","GER","FW,MF","18",2002,11.4,11,6,1,8,2,5,9,55.6,4,10,1,9,9,20,2,0,"https://fbref.com/en/players/fd53759d/Jan-Thielmann"
2021,"Köln","Bundesliga","Marius Wolf","GER","MF,DF","25",1995,28.3,35,19,19,13,3,13,38,34.2,25,29,3,26,28,63,47,1,"https://fbref.com/en/players/fa661778/Marius-Wolf"
2021,"Köln","Bundesliga","Ron-Robert Zieler","GER","GK","31",1989,0.6,0,0,0,0,0,0,0,NA,0,0,0,0,0,0,0,0,"https://fbref.com/en/players/a0606ae8/Ron-Robert-Zieler"
2021,"Lazio","Serie A","Francesco Acerbi","ITA","DF","32",1988,31.3,51,32,34,13,4,18,40,45,22,24,15,9,76,127,121,2,"https://fbref.com/en/players/b96b595c/Francesco-Acerbi"
2021,"Lazio","Serie A","Jean-Daniel Akpa-Akpro","CIV","MF","27",1992,11.7,38,25,13,22,3,8,27,29.6,19,24,6,18,18,56,13,0,"https://fbref.com/en/players/fdf4b948/Jean-Daniel-Akpa-Akpro"
2021,"Lazio","Serie A","Luis Alberto","ESP","MF","27",1992,29.1,43,24,15,19,9,15,73,20.5,58,41,2,39,13,56,11,1,"https://fbref.com/en/players/5294a83f/Luis-Alberto"
2021,"Lazio","Serie A","Djavan Anderson","NED","DF","25",1995,0.8,0,0,0,0,0,0,1,0,1,1,0,1,1,1,0,0,"https://fbref.com/en/players/ca241ad3/Djavan-Anderson"
2021,"Lazio","Serie A","Nicolò Armini","ITA","DF","19",2001,0.1,0,0,0,0,0,0,0,NA,0,0,0,0,0,0,0,0,"https://fbref.com/en/players/2f7407fa/Nicolo-Armini"
2021,"Lazio","Serie A","Bastos","ANG","DF","29",1991,0.7,3,1,2,0,1,3,5,60,2,1,0,1,0,3,3,0,"https://fbref.com/en/players/c01c66d9/Bastos"
2021,"Lazio","Serie A","Marco Bertini","ITA","MF","17",2002,0.1,1,0,1,0,0,0,0,NA,0,0,0,0,0,1,0,0,"https://fbref.com/en/players/4b520f96/Marco-Bertini"
2021,"Lazio","Serie A","Felipe Caicedo","ECU","FW","31",1988,10.3,10,7,4,4,2,1,8,12.5,7,7,0,7,4,14,2,0,"https://fbref.com/en/players/93b891d1/Felipe-Caicedo"
2021,"Lazio","Serie A","Danilo Cataldi","ITA","MF","25",1994,6.3,7,2,1,5,1,4,18,22.2,14,3,1,2,9,16,7,0,"https://fbref.com/en/players/ba3d3bea/Danilo-Cataldi"
2021,"Lazio","Serie A","Joaquín Correa","ARG","FW","25",1994,21.5,21,12,6,11,4,7,25,28,18,14,0,14,7,28,12,0,"https://fbref.com/en/players/45b9b619/Joaquin-Correa"
2021,"Lazio","Serie A","Gonzalo Escalante","ARG","MF","27",1993,8.1,26,13,11,14,1,8,28,28.6,20,10,3,7,19,45,13,0,"https://fbref.com/en/players/3f79a1c8/Gonzalo-Escalante"
2021,"Lazio","Serie A","Mohamed Fares","ALG","DF","24",1996,12.7,20,15,9,7,4,11,19,57.9,8,14,1,13,16,36,21,0,"https://fbref.com/en/players/b7a5bc86/Mohamed-Fares"
2021,"Lazio","Serie A","Luiz Felipe","ITA","DF","23",1997,10.1,32,20,19,11,2,16,24,66.7,8,20,9,11,21,53,29,1,"https://fbref.com/en/players/15d0c248/Luiz-Felipe"
2021,"Lazio","Serie A","Wesley Hoedt","NED","DF","26",1994,10.6,22,16,18,4,0,10,17,58.8,7,9,5,4,17,39,48,1,"https://fbref.com/en/players/875898c7/Wesley-Hoedt"
2021,"Lazio","Serie A","Ciro Immobile","ITA","FW","30",1990,31.7,14,13,4,6,4,7,22,31.8,15,13,1,12,6,20,9,0,"https://fbref.com/en/players/4431aed2/Ciro-Immobile"
2021,"Lazio","Serie A","Manuel Lazzari","ITA","DF","26",1993,29,24,14,15,4,5,14,39,35.9,25,22,3,19,18,42,28,0,"https://fbref.com/en/players/02caf6e0/Manuel-Lazzari"
2021,"Lazio","Serie A","Lucas Leiva","BRA","MF","33",1987,23.7,68,32,38,28,2,30,86,34.9,56,21,0,21,57,125,21,0,"https://fbref.com/en/players/4c78b5ed/Lucas-Leiva"
2021,"Lazio","Serie A","Senad Lulić","BIH","DF","34",1986,8,14,7,6,5,3,7,15,46.7,8,10,1,9,4,18,13,0,"https://fbref.com/en/players/7fd58fe3/Senad-Lulic"
2021,"Lazio","Serie A","Adam Marušić","MNE","DF","27",1992,33,38,22,22,15,1,20,40,50,20,38,6,32,40,78,54,0,"https://fbref.com/en/players/d4535821/Adam-Marusic"
2021,"Lazio","Serie A","Sergej Milinković-Savić","SRB","MF","25",1995,30.5,59,40,20,30,9,27,84,32.1,57,52,12,40,33,92,47,0,"https://fbref.com/en/players/4e6dbac4/Sergej-Milinkovic-Savic"
2021,"Lazio","Serie A","Raúl Moro","ESP","FW","17",2002,0.1,0,0,0,0,0,0,1,0,1,0,0,0,0,0,0,0,"https://fbref.com/en/players/919dd4b1/Raul-Moro"
2021,"Lazio","Serie A","Vedat Muriqi","KVX","FW","26",1994,9.2,3,1,0,2,1,0,8,0,8,9,2,7,3,6,20,0,"https://fbref.com/en/players/0cadc46d/Vedat-Muriqi"
2021,"Lazio","Serie A","Mateo Musacchio","ARG","DF","29",1990,2.5,1,1,1,0,0,0,0,NA,0,5,2,3,2,3,5,0,"https://fbref.com/en/players/91899ca8/Mateo-Musacchio"
2021,"Lazio","Serie A","Marco Parolo","ITA","DF,MF","35",1985,7.3,21,8,8,11,2,8,20,40,12,20,6,14,14,35,31,0,"https://fbref.com/en/players/ed5886d2/Marco-Parolo"
2021,"Lazio","Serie A","Patric","ESP","DF","27",1993,17.7,30,16,15,11,4,13,24,54.2,11,13,3,10,18,48,51,1,"https://fbref.com/en/players/f7223718/Patric"
2021,"Lazio","Serie A","Andreas Pereira","BRA","FW,MF","24",1996,6,5,0,1,3,1,2,12,16.7,10,6,0,6,1,6,4,0,"https://fbref.com/en/players/6639e500/Andreas-Pereira"
2021,"Lazio","Serie A","Ștefan Radu","ROU","DF","33",1986,27.3,43,24,20,19,4,25,40,62.5,15,27,14,13,45,88,73,1,"https://fbref.com/en/players/53de807a/Stefan-Radu"
2021,"Lazio","Serie A","Pepe Reina","ESP","GK","37",1982,29,0,0,0,0,0,0,1,0,1,0,0,0,1,1,6,0,"https://fbref.com/en/players/e358587b/Pepe-Reina"
2021,"Lazio","Serie A","Thomas Strakosha","ALB","GK","25",1995,9,1,1,1,0,0,0,0,NA,0,0,0,0,1,2,4,0,"https://fbref.com/en/players/339fe0e8/Thomas-Strakosha"
2021,"Lazio","Serie A","Denis Vavro","SVK","DF","24",1996,0.4,0,0,0,0,0,0,1,0,1,0,0,0,1,1,3,0,"https://fbref.com/en/players/08990838/Denis-Vavro"
2021,"Leeds United","Premier League","Ezgjan Alioski","MKD","DF,MF","28",1992,27.3,74,31,38,28,8,32,74,43.2,42,17,2,15,23,97,50,2,"https://fbref.com/en/players/1a7fcf39/Ezgjan-Alioski"
2021,"Leeds United","Premier League","Luke Ayling","ENG","DF","28",1991,37.8,108,61,69,30,9,49,87,56.3,38,53,36,17,36,144,96,5,"https://fbref.com/en/players/420d7c7d/Luke-Ayling"
2021,"Leeds United","Premier League","Patrick Bamford","ENG","FW","26",1993,33.9,21,9,2,11,8,8,27,29.6,19,14,4,10,10,31,37,0,"https://fbref.com/en/players/93feac6e/Patrick-Bamford"
2021,"Leeds United","Premier League","Gaetano Berardi","SUI","DF","31",1988,1.3,2,2,1,0,1,0,0,NA,0,2,1,1,1,3,2,0,"https://fbref.com/en/players/5348aada/Gaetano-Berardi"
2021,"Leeds United","Premier League","Ian Carlo Poveda","ENG","MF","20",2000,3.9,5,4,3,0,2,1,7,14.3,6,5,1,4,1,6,2,0,"https://fbref.com/en/players/55b4f1d6/Ian-Carlo-Poveda"
2021,"Leeds United","Premier League","Kiko Casilla","ESP","GK","33",1986,3,0,0,0,0,0,0,0,NA,0,0,0,0,0,0,0,0,"https://fbref.com/en/players/58bc7d18/Kiko-Casilla"
2021,"Leeds United","Premier League","Liam Cooper","SCO","DF","28",1991,24.3,68,45,39,27,2,37,59,62.7,22,39,32,7,61,129,70,1,"https://fbref.com/en/players/dc64b8b3/Liam-Cooper"
2021,"Leeds United","Premier League","Hélder Costa","ANG","MF,FW","26",1994,12.8,25,11,12,5,8,11,32,34.4,21,11,0,11,3,28,5,1,"https://fbref.com/en/players/f13d02a6/Helder-Costa"
2021,"Leeds United","Premier League","Stuart Dallas","NIR","MF,DF","29",1991,37.9,74,45,46,22,6,30,88,34.1,58,41,3,38,44,118,52,1,"https://fbref.com/en/players/67ca8566/Stuart-Dallas"
2021,"Leeds United","Premier League","Leif Davis","ENG","DF","20",2000,0.4,0,0,0,0,0,0,3,0,3,1,0,1,1,1,0,0,"https://fbref.com/en/players/8574c61f/Leif-Davis"
2021,"Leeds United","Premier League","Jack Harrison","ENG","MF,FW","23",1996,31.6,63,38,20,30,13,26,59,44.1,33,30,2,28,15,78,21,0,"https://fbref.com/en/players/aa849a12/Jack-Harrison"
2021,"Leeds United","Premier League","Pablo Hernández","ESP","MF","35",1985,4.7,5,3,2,1,2,5,16,31.3,11,2,0,2,0,5,0,1,"https://fbref.com/en/players/c0398aca/Pablo-Hernandez"
2021,"Leeds United","Premier League","Niall Huggins","WAL","DF","19",2000,0.4,0,0,0,0,0,0,1,0,1,0,0,0,0,0,1,0,"https://fbref.com/en/players/6d646ff7/Niall-Huggins"
2021,"Leeds United","Premier League","Mateusz Klich","POL","MF","30",1990,26.6,38,20,14,20,4,14,61,23,47,13,4,9,11,49,16,0,"https://fbref.com/en/players/282679b4/Mateusz-Klich"
2021,"Leeds United","Premier League","Robin Koch","GER","DF,MF","24",1996,12.6,27,16,17,10,0,10,19,52.6,9,18,12,6,27,54,34,2,"https://fbref.com/en/players/ea6bc03a/Robin-Koch"
2021,"Leeds United","Premier League","Diego Llorente","ESP","DF","26",1993,13.4,34,21,21,13,0,19,32,59.4,13,18,13,5,20,54,40,2,"https://fbref.com/en/players/bba30585/Diego-Llorente"
2021,"Leeds United","Premier League","Illan Meslier","FRA","GK","20",2000,35,0,0,0,0,0,0,1,0,1,0,0,0,0,0,17,8,"https://fbref.com/en/players/6b625ac2/Illan-Meslier"
2021,"Leeds United","Premier League","Kalvin Phillips","ENG","MF","24",1995,27,74,38,38,29,7,26,62,41.9,36,49,14,35,45,119,53,3,"https://fbref.com/en/players/4f565d77/Kalvin-Phillips"
2021,"Leeds United","Premier League","Raphinha","BRA","MF,FW","23",1996,26.2,34,17,13,16,5,12,58,20.7,46,31,1,30,29,63,27,0,"https://fbref.com/en/players/3423f250/Raphinha"
2021,"Leeds United","Premier League","Tyler Roberts","WAL","MF,FW","21",1999,14.9,15,13,1,11,3,5,22,22.7,17,17,2,15,9,24,12,0,"https://fbref.com/en/players/6c17e046/Tyler-Roberts"
2021,"Leeds United","Premier League","Rodrigo","ESP","MF,FW","29",1991,14.3,14,7,8,3,3,4,22,18.2,18,7,0,7,5,19,16,0,"https://fbref.com/en/players/1fb1c435/Rodrigo"
2021,"Leeds United","Premier League","Jamie Shackleton","ENG","MF,DF","20",1999,5.1,10,6,6,4,0,4,11,36.4,7,3,1,2,9,19,3,0,"https://fbref.com/en/players/8d03ca5a/Jamie-Shackleton"
2021,"Leeds United","Premier League","Pascal Struijk","NED","DF,MF","20",1999,23.1,49,30,28,19,2,17,28,60.7,11,35,21,14,47,96,92,0,"https://fbref.com/en/players/f4d296e4/Pascal-Struijk"
2021,"Leicester City","Premier League","Marc Albrighton","ENG","DF,FW","30",1989,19.4,33,19,14,15,4,16,45,35.6,29,29,3,26,17,50,27,1,"https://fbref.com/en/players/b827d5b3/Marc-Albrighton"
2021,"Leicester City","Premier League","Daniel Amartey","GHA","DF","25",1994,8,11,7,6,4,1,8,12,66.7,4,8,4,4,12,23,26,0,"https://fbref.com/en/players/1a4ef233/Daniel-Amartey"
2021,"Leicester City","Premier League","Harvey Barnes","ENG","FW,MF","22",1997,21.6,19,9,11,3,5,5,22,22.7,17,16,3,13,8,27,11,0,"https://fbref.com/en/players/3ea50f67/Harvey-Barnes"
2021,"Leicester City","Premier League","Timothy Castagne","BEL","DF","24",1995,26.1,52,32,29,18,5,24,44,54.5,20,29,5,24,29,81,62,1,"https://fbref.com/en/players/197640fd/Timothy-Castagne"
2021,"Leicester City","Premier League","Hamza Choudhury","ENG","MF","22",1997,3.5,8,7,3,5,0,4,10,40,6,4,1,3,4,12,9,1,"https://fbref.com/en/players/7d2d3329/Hamza-Choudhury"
2021,"Leicester City","Premier League","Jonny Evans","NIR","DF","32",1988,27.5,25,12,22,2,1,14,20,70,6,8,3,5,46,71,98,1,"https://fbref.com/en/players/f8fcd2a5/Jonny-Evans"
2021,"Leicester City","Premier League","Wesley Fofana","FRA","DF","19",2000,25.1,51,37,27,22,2,31,46,67.4,15,28,16,12,61,112,94,0,"https://fbref.com/en/players/132a82f1/Wesley-Fofana"
2021,"Leicester City","Premier League","Christian Fuchs","AUT","DF","34",1986,7.8,18,7,15,2,1,8,15,53.3,7,6,4,2,16,34,34,1,"https://fbref.com/en/players/a67a09fb/Christian-Fuchs"
2021,"Leicester City","Premier League","Demarai Gray","ENG","FW","24",1996,0.2,1,1,1,0,0,0,0,NA,0,0,0,0,0,1,0,0,"https://fbref.com/en/players/4468ec10/Demarai-Gray"
2021,"Leicester City","Premier League","Kelechi Iheanacho","NGA","FW","23",1996,16.2,12,5,2,4,6,4,17,23.5,13,14,0,14,2,14,1,1,"https://fbref.com/en/players/c92e1a31/Kelechi-Iheanacho"
2021,"Leicester City","Premier League","James Justin","ENG","DF","22",1998,23,61,37,38,18,5,20,41,48.8,21,36,10,26,30,91,58,1,"https://fbref.com/en/players/fb614c44/James-Justin"
2021,"Leicester City","Premier League","Khanya Leshabela","RSA","MF","20",1999,0.1,0,0,0,0,0,0,0,NA,0,0,0,0,0,0,0,0,"https://fbref.com/en/players/383e68b1/Khanya-Leshabela"
2021,"Leicester City","Premier League","James Maddison","ENG","MF","23",1996,23.3,32,16,5,16,11,14,41,34.1,27,14,1,13,9,41,5,0,"https://fbref.com/en/players/ee38d9c5/James-Maddison"
2021,"Leicester City","Premier League","Nampalys Mendy","SEN","MF","28",1992,16.2,26,17,18,6,2,7,20,35,13,12,1,11,14,40,8,0,"https://fbref.com/en/players/1598599e/Nampalys-Mendy"
2021,"Leicester City","Premier League","Wes Morgan","JAM","DF","36",1984,0.2,0,0,0,0,0,0,0,NA,0,0,0,0,0,0,1,0,"https://fbref.com/en/players/80c31c97/Wes-Morgan"
2021,"Leicester City","Premier League","Wilfred Ndidi","NGA","MF,DF","23",1996,24.2,96,63,45,44,7,26,66,39.4,40,38,11,27,61,157,55,0,"https://fbref.com/en/players/6b47c5db/Wilfred-Ndidi"
2021,"Leicester City","Premier League","Ricardo Pereira","POR","DF,FW","26",1993,10.7,31,22,16,8,7,14,35,40,21,24,1,23,15,46,23,0,"https://fbref.com/en/players/75a72a99/Ricardo-Pereira"
2021,"Leicester City","Premier League","Ayoze Pérez","ESP","MF,FW","27",1993,14.8,32,15,6,20,6,13,48,27.1,35,28,0,28,10,42,7,0,"https://fbref.com/en/players/819aa8e7/Ayoze-Perez"
2021,"Leicester City","Premier League","Dennis Praet","BEL","MF","26",1994,8,14,7,4,7,3,6,15,40,9,12,2,10,7,21,3,0,"https://fbref.com/en/players/86695068/Dennis-Praet"
2021,"Leicester City","Premier League","Kasper Schmeichel","DEN","GK","33",1986,38,0,0,0,0,0,0,0,NA,0,0,0,0,0,0,10,0,"https://fbref.com/en/players/53af52f3/Kasper-Schmeichel"
2021,"Leicester City","Premier League","Islam Slimani","ALG","FW","32",1988,0.2,0,0,0,0,0,0,0,NA,0,0,0,0,0,0,0,0,"https://fbref.com/en/players/ffec9769/Islam-Slimani"
2021,"Leicester City","Premier League","Çağlar Söyüncü","TUR","DF","24",1996,20.2,27,17,13,14,0,17,30,56.7,13,12,9,3,28,55,80,1,"https://fbref.com/en/players/21166ff4/Caglar-Soyuncu"
2021,"Leicester City","Premier League","Sidnei Tavares","POR","MF","18",2001,0.9,1,1,0,1,0,0,0,NA,0,1,1,0,0,1,0,0,"https://fbref.com/en/players/3add8ed8/Sidnei-Tavares"
2021,"Leicester City","Premier League","Luke Thomas","ENG","DF","19",2001,10.8,23,14,11,5,7,14,21,66.7,7,15,2,13,17,40,21,0,"https://fbref.com/en/players/fc027d02/Luke-Thomas"
2021,"Leicester City","Premier League","Youri Tielemans","BEL","MF","23",1997,37.3,86,45,32,38,16,45,108,41.7,63,35,8,27,46,132,20,1,"https://fbref.com/en/players/56f7a928/Youri-Tielemans"
2021,"Leicester City","Premier League","Cengiz Ünder","TUR","FW,MF","23",1997,3.1,4,1,0,3,1,3,5,60,2,3,0,3,2,6,0,0,"https://fbref.com/en/players/1880614f/Cengiz-Under"
2021,"Leicester City","Premier League","Jamie Vardy","ENG","FW","33",1987,31.6,18,12,1,8,9,2,15,13.3,13,14,5,9,4,22,32,0,"https://fbref.com/en/players/45963054/Jamie-Vardy"
2021,"Lens","Ligue 1","Loïc Bade","FRA","DF","20",2000,29,57,34,47,10,0,30,55,54.5,25,43,17,26,74,131,135,2,"https://fbref.com/en/players/114bbdee/Loic-Bade"
2021,"Lens","Ligue 1","Simon Banza","FRA","FW","23",1996,15.2,13,6,0,4,9,1,14,7.1,13,16,1,15,7,20,15,0,"https://fbref.com/en/players/be47b750/Simon-Banza"
2021,"Lens","Ligue 1","Ismaëlben Boura","FRA","DF","19",2000,9.1,11,7,8,2,1,3,9,33.3,6,7,2,5,21,32,12,0,"https://fbref.com/en/players/62e02107/Ismaelben-Boura"
2021,"Lens","Ligue 1","Yannick Cahuzac","FRA","MF","35",1985,25,26,12,12,10,4,9,27,33.3,18,18,5,13,33,59,72,0,"https://fbref.com/en/players/677ee102/Yannick-Cahuzac"
2021,"Lens","Ligue 1","Jonathan Clauss","FRA","DF","27",1992,28,43,20,12,20,11,17,38,44.7,21,24,1,23,45,88,46,0,"https://fbref.com/en/players/5219ab4a/Jonathan-Clauss"
2021,"Lens","Ligue 1","David Pereira da Costa","POR","MF,FW","19",2001,1.8,4,4,1,2,1,2,3,66.7,1,2,0,2,0,4,4,0,"https://fbref.com/en/players/59948ef7/David-Pereira-da-Costa"
2021,"Lens","Ligue 1","Cheick Doucouré","MLI","MF","20",2000,29.2,87,47,40,42,5,32,65,49.2,33,20,4,16,52,139,26,1,"https://fbref.com/en/players/ce4f40c7/Cheick-Doucoure"
2021,"Lens","Ligue 1","Wuilker Faríñez","VEN","GK","22",1998,1.2,0,0,0,0,0,0,0,NA,0,0,0,0,0,0,1,0,"https://fbref.com/en/players/2c127b6f/Wuilker-Farinez"
2021,"Lens","Ligue 1","Seko Fofana","CIV","MF","25",1995,25.7,16,8,3,10,3,4,26,15.4,22,16,5,11,34,50,23,1,"https://fbref.com/en/players/5313ed43/Seko-Fofana"
2021,"Lens","Ligue 1","Steven Fortes","CPV","DF","28",1992,15.9,33,20,20,10,3,16,22,72.7,6,25,10,15,27,60,52,0,"https://fbref.com/en/players/574aa9ec/Steven-Fortes"
2021,"Lens","Ligue 1","Ignatius Ganago","CMR","FW","21",1999,14.5,4,3,0,2,2,3,12,25,9,7,1,6,6,10,3,0,"https://fbref.com/en/players/23c63b7f/Ignatius-Ganago"
2021,"Lens","Ligue 1","Jonathan Gradit","FRA","DF","27",1992,31.4,60,39,26,28,6,22,38,57.9,16,37,19,18,56,116,81,1,"https://fbref.com/en/players/06c48679/Jonathan-Gradit"
2021,"Lens","Ligue 1","Massadio Haïdara","MLI","DF","27",1992,23.7,48,32,21,21,6,23,37,62.2,14,29,6,23,35,83,60,0,"https://fbref.com/en/players/5167c97e/Massadio-Haidara"
2021,"Lens","Ligue 1","Corentin Jean","FRA","FW,MF","25",1995,6.4,4,3,1,1,2,0,5,0,5,4,0,4,2,6,2,0,"https://fbref.com/en/players/7d9b37bf/Corentin-Jean"
2021,"Lens","Ligue 1","Gaël Kakuta","COD","MF,FW","29",1991,26.6,38,23,10,18,10,8,44,18.2,36,24,3,21,17,55,4,0,"https://fbref.com/en/players/5b1bf5e3/Gael-Kakuta"
2021,"Lens","Ligue 1","Arnaud Kalimuendo","FRA","FW,MF","18",2002,13.5,8,2,2,2,4,1,7,14.3,6,11,0,11,2,10,2,0,"https://fbref.com/en/players/bf4c41f9/Arnaud-Kalimuendo"
2021,"Lens","Ligue 1","Jean-Louis Leca","FRA","GK","34",1985,36.8,3,2,3,0,0,3,5,60,2,0,0,0,1,4,14,4,"https://fbref.com/en/players/edbe46dc/Jean-Louis-Leca"
2021,"Lens","Ligue 1","Adrien Louveau","FRA","MF","20",2000,0.1,0,0,0,0,0,0,0,NA,0,0,0,0,0,0,1,0,"https://fbref.com/en/players/85847c67/Adrien-Louveau"
2021,"Lens","Ligue 1","Tony Mauricio","FRA","MF","26",1994,5.6,19,12,7,8,4,11,17,64.7,6,8,1,7,3,22,4,0,"https://fbref.com/en/players/96e5168e/Tony-Mauricio"
2021,"Lens","Ligue 1","Facundo Medina","ARG","DF","21",1999,22.3,39,22,22,15,2,24,38,63.2,14,25,9,16,39,78,51,3,"https://fbref.com/en/players/6f5ec8bb/Facundo-Medina"
2021,"Lens","Ligue 1","Clément Michelin","FRA","DF","23",1997,12.8,25,19,13,9,3,9,16,56.3,7,13,4,9,25,50,32,0,"https://fbref.com/en/players/cb9ec45d/Clement-Michelin"
2021,"Lens","Ligue 1","Manuel Perez","FRA","MF,FW","29",1991,1.4,1,0,1,0,0,0,8,0,8,2,0,2,2,3,2,0,"https://fbref.com/en/players/88970207/Manuel-Perez"
2021,"Lens","Ligue 1","Aleksandar Radovanović","SRB","DF","26",1993,1,1,1,0,1,0,0,0,NA,0,2,1,1,0,1,2,0,"https://fbref.com/en/players/09507ffa/Aleksandar-Radovanovic"
2021,"Lens","Ligue 1","Florian Sotoca","FRA","FW","29",1990,26.8,31,20,3,20,8,6,22,27.3,16,27,0,27,9,40,24,0,"https://fbref.com/en/players/7a42d0df/Florian-Sotoca"
2021,"Lens","Ligue 1","Ansou Sow","FRA","MF","20",2000,0.1,0,0,0,0,0,0,0,NA,0,1,0,1,0,0,0,0,"https://fbref.com/en/players/754d5c33/Ansou-Sow"
2021,"Lens","Ligue 1","Issiaga Sylla","GUI","DF,MF","26",1994,12.4,28,20,11,17,0,11,21,52.4,10,13,3,10,16,44,21,0,"https://fbref.com/en/players/b99bec05/Issiaga-Sylla"
2021,"Lens","Ligue 1","Cheick Traoré","MLI","DF","25",1995,0.4,2,2,1,1,0,2,4,50,2,1,0,1,2,4,1,0,"https://fbref.com/en/players/bfcef334/Cheick-Traore"
2021,"Levante","La Liga","Enis Bardhi","MKD","MF","25",1995,18.7,28,12,8,16,4,10,36,27.8,26,8,2,6,21,49,14,0,"https://fbref.com/en/players/cac2537b/Enis-Bardhi"
2021,"Levante","La Liga","Alejandro Blesa","ESP","MF","18",2002,0.1,0,0,0,0,0,0,0,NA,0,0,0,0,0,0,0,0,"https://fbref.com/en/players/d2ed99b4/Alejandro-Blesa"
2021,"Levante","La Liga","José Campaña","ESP","MF","27",1993,8.3,14,6,3,6,5,5,14,35.7,9,2,0,2,13,27,4,0,"https://fbref.com/en/players/61220da2/Jose-Campana"
2021,"Levante","La Liga","Álex Cantero","ESP","FW","20",2000,2.6,2,1,0,2,0,1,2,50,1,1,0,1,0,2,3,0,"https://fbref.com/en/players/4aa253fd/Alex-Cantero"
2021,"Levante","La Liga","Cárdenas","ESP","GK","23",1997,8,0,0,0,0,0,0,1,0,1,0,0,0,3,3,5,1,"https://fbref.com/en/players/e1846dde/Cardenas"
2021,"Levante","La Liga","Carlos Clerc","ESP","DF","28",1992,30.9,56,29,33,16,7,22,39,56.4,17,26,4,22,37,93,55,1,"https://fbref.com/en/players/33a61a52/Carlos-Clerc"
2021,"Levante","La Liga","Coke","ESP","DF","33",1987,9.3,24,10,14,7,3,14,27,51.9,13,13,1,12,14,38,27,0,"https://fbref.com/en/players/6d8f8441/Coke"
2021,"Levante","La Liga","Cheick Doukouré","CIV","MF,FW","27",1992,1.1,5,4,2,1,2,3,4,75,1,2,0,2,3,8,0,0,"https://fbref.com/en/players/e208bcc8/Cheick-Doukoure"
2021,"Levante","La Liga","Óscar Duarte","CRC","DF","31",1989,22.9,22,13,17,5,0,10,18,55.6,8,23,15,8,36,58,97,1,"https://fbref.com/en/players/aa0ac32d/Oscar-Duarte"
2021,"Levante","La Liga","Aitor Fernández","ESP","GK","29",1991,29,0,0,0,0,0,0,0,NA,0,0,0,0,2,2,17,1,"https://fbref.com/en/players/a01c3d54/Aitor-Fernandez"
2021,"Levante","La Liga","Jorge de Frutos","ESP","MF","23",1997,24.3,48,24,21,21,6,11,41,26.8,30,25,2,23,16,64,18,0,"https://fbref.com/en/players/38ce1150/Jorge-de-Frutos"
2021,"Levante","La Liga","Dani Gómez","ESP","FW","22",1998,18.5,4,3,2,1,1,0,11,0,11,3,0,3,2,6,4,0,"https://fbref.com/en/players/0e5ddc7c/Dani-Gomez"
2021,"Levante","La Liga","Giorgi Kochorashvili","GEO","MF","21",1999,0.3,1,0,1,0,0,0,0,NA,0,0,0,0,0,1,0,0,"https://fbref.com/en/players/3da1b6ed/Giorgi-Kochorashvili"
2021,"Levante","La Liga","Sergio León","ESP","FW","31",1989,8.3,6,2,0,4,2,2,8,25,6,4,0,4,3,9,2,0,"https://fbref.com/en/players/0a0cc13c/Sergio-Leon"
2021,"Levante","La Liga","José Luis Morales","ESP","MF,FW","33",1987,27.1,18,10,7,9,2,8,36,22.2,28,17,0,17,11,29,11,0,"https://fbref.com/en/players/4a478107/Jose-Luis-Morales"
2021,"Levante","La Liga","Mickael Malsa","MTQ","MF","24",1995,26,55,26,28,24,3,23,51,45.1,28,38,9,29,43,98,36,2,"https://fbref.com/en/players/bbc19252/Mickael-Malsa"
2021,"Levante","La Liga","Roger Martí","ESP","FW","29",1991,24.4,11,7,5,4,2,6,23,26.1,17,10,3,7,4,15,6,0,"https://fbref.com/en/players/0ae4e09a/Roger-Marti"
2021,"Levante","La Liga","Gonzalo Melero","ESP","MF,FW","26",1994,20.6,24,15,11,6,7,10,39,25.6,29,14,5,9,18,42,22,1,"https://fbref.com/en/players/3902e91b/Gonzalo-Melero"
2021,"Levante","La Liga","Jorge Miramón","ESP","DF","31",1989,19.2,32,22,26,6,0,21,35,60,14,22,2,20,27,59,54,0,"https://fbref.com/en/players/7f4c7c9f/Jorge-Miramon"
2021,"Levante","La Liga","Sergio Postigo","ESP","DF","31",1988,18,16,12,12,3,1,7,18,38.9,11,21,10,11,33,49,84,1,"https://fbref.com/en/players/474ecac8/Sergio-Postigo"
2021,"Levante","La Liga","Nemanja Radoja","SRB","MF","27",1993,12.5,23,15,12,10,1,5,19,26.3,14,9,3,6,19,42,12,1,"https://fbref.com/en/players/b5dd3469/Nemanja-Radoja"
2021,"Levante","La Liga","Rober","ESP","DF,MF","25",1995,15.8,14,7,8,3,3,8,18,44.4,10,24,16,8,35,49,52,1,"https://fbref.com/en/players/c00097d2/Rober"
2021,"Levante","La Liga","Rubén Rochina","ESP","MF","29",1991,15.6,38,28,12,23,3,12,35,34.3,23,22,2,20,22,60,7,0,"https://fbref.com/en/players/ecd8c01e/Ruben-Rochina"
2021,"Levante","La Liga","Edgar Sevikyan","RUS","MF","18",2001,0.1,0,0,0,0,0,0,0,NA,0,0,0,0,0,0,0,0,"https://fbref.com/en/players/3e8bb8ce/Edgar-Sevikyan"
2021,"Levante","La Liga","Son","ESP","DF,MF","26",1994,12.3,18,10,11,6,1,9,19,47.4,10,11,2,9,12,30,20,0,"https://fbref.com/en/players/037dbd30/Son"
2021,"Levante","La Liga","Toño","ESP","DF,FW","30",1989,8.1,4,0,4,0,0,0,2,0,2,10,1,9,7,11,12,0,"https://fbref.com/en/players/d4ef9ac5/Tono"
2021,"Levante","La Liga","Koke Vegas","ESP","GK","24",1995,1,0,0,0,0,0,0,0,NA,0,0,0,0,0,0,1,1,"https://fbref.com/en/players/bfb15d99/Koke-Vegas"
2021,"Levante","La Liga","Rúben Vezo","POR","DF","26",1994,25.7,34,19,26,7,1,12,29,41.4,17,22,11,11,46,80,106,3,"https://fbref.com/en/players/c67cd65c/Ruben-Vezo"
2021,"Levante","La Liga","Nikola Vukčević","MNE","MF","28",1991,9,14,7,5,8,1,9,18,50,9,8,5,3,8,22,12,1,"https://fbref.com/en/players/4442fbcd/Nikola-Vukcevic"
2021,"Leverkusen","Bundesliga","Lucas Alario","ARG","FW","27",1992,13.8,8,2,2,5,1,2,4,50,2,9,1,8,2,10,10,0,"https://fbref.com/en/players/834d0be5/Lucas-Alario"
2021,"Leverkusen","Bundesliga","Nadiem Amiri","GER","MF","23",1996,21,12,7,4,8,0,7,33,21.2,26,18,3,15,12,24,7,0,"https://fbref.com/en/players/555d5edd/Nadiem-Amiri"
2021,"Leverkusen","Bundesliga","Charles Aránguiz","CHI","MF","31",1989,18.5,41,23,16,21,4,17,43,39.5,26,32,4,28,33,74,17,0,"https://fbref.com/en/players/56413b1f/Charles-Aranguiz"
2021,"Leverkusen","Bundesliga","Santiago Arias","COL","DF","28",1992,1,2,1,0,1,1,1,1,100,0,0,0,0,1,3,4,0,"https://fbref.com/en/players/fdd60087/Santiago-Arias"
2021,"Leverkusen","Bundesliga","Leon Bailey","JAM","FW,MF","22",1997,23.8,14,8,3,7,4,4,15,26.7,11,13,0,13,9,23,3,0,"https://fbref.com/en/players/3a233281/Leon-Bailey"
2021,"Leverkusen","Bundesliga","Julian Baumgartlinger","AUT","MF","32",1988,11.9,43,20,14,26,3,16,31,51.6,15,12,0,12,12,55,10,1,"https://fbref.com/en/players/69374ff5/Julian-Baumgartlinger"
2021,"Leverkusen","Bundesliga","Karim Bellarabi","GER","FW,MF","30",1990,8.9,12,10,3,4,5,4,17,23.5,13,12,0,12,12,24,4,0,"https://fbref.com/en/players/bee0bab1/Karim-Bellarabi"
2021,"Leverkusen","Bundesliga","Lars Bender","GER","DF","31",1989,10.4,19,13,12,6,1,9,21,42.9,12,19,5,14,16,35,19,0,"https://fbref.com/en/players/c50281a0/Lars-Bender"
2021,"Leverkusen","Bundesliga","Sven Bender","GER","DF","31",1989,13,17,9,8,8,1,7,20,35,13,20,9,11,21,38,41,1,"https://fbref.com/en/players/070ec0b1/Sven-Bender"
2021,"Leverkusen","Bundesliga","Kerem Demirbay","GER","MF","27",1993,19.4,46,31,15,26,5,19,38,50,19,21,4,17,8,54,6,1,"https://fbref.com/en/players/54b4dc4e/Kerem-Demirbay"
2021,"Leverkusen","Bundesliga","Moussa Diaby","FRA","FW,MF","21",1999,26.5,10,6,4,5,1,6,20,30,14,11,0,11,12,22,5,0,"https://fbref.com/en/players/aeed5c06/Moussa-Diaby"
2021,"Leverkusen","Bundesliga","Aleksandar Dragović","AUT","DF","29",1991,12.6,11,7,5,5,1,9,13,69.2,4,17,5,12,13,24,33,0,"https://fbref.com/en/players/6fd8a334/Aleksandar-Dragovic"
2021,"Leverkusen","Bundesliga","Timothy Fosu-Mensah","NED","DF","22",1998,4.5,4,2,1,2,1,2,4,50,2,7,3,4,7,11,4,0,"https://fbref.com/en/players/a9142dc3/Timothy-Fosu-Mensah"
2021,"Leverkusen","Bundesliga","Jeremie Frimpong","NED","DF,FW","19",2000,4.8,7,4,4,3,0,4,8,50,4,4,0,4,1,8,7,0,"https://fbref.com/en/players/74f2e748/Jeremie-Frimpong"
2021,"Leverkusen","Bundesliga","Emrehan Gedikli","GER","FW","17",2003,0.3,0,0,0,0,0,0,0,NA,0,0,0,0,0,0,0,0,"https://fbref.com/en/players/62f94e47/Emrehan-Gedikli"
2021,"Leverkusen","Bundesliga","Demarai Gray","ENG","FW","24",1996,4.9,3,2,1,2,0,1,1,100,0,3,0,3,4,7,3,0,"https://fbref.com/en/players/4468ec10/Demarai-Gray"
2021,"Leverkusen","Bundesliga","Lennart Grill","GER","GK","21",1999,4,0,0,0,0,0,0,0,NA,0,0,0,0,0,0,2,0,"https://fbref.com/en/players/37998008/Lennart-Grill"
2021,"Leverkusen","Bundesliga","Lukáš Hrádecký","FIN","GK","30",1989,28.5,0,0,0,0,0,0,1,0,1,0,0,0,1,1,11,3,"https://fbref.com/en/players/ad3389d5/Lukas-Hradecky"
2021,"Leverkusen","Bundesliga","Tin Jedvaj","CRO","DF","24",1995,1.7,5,2,2,3,0,1,3,33.3,2,2,1,1,2,7,9,0,"https://fbref.com/en/players/f820504e/Tin-Jedvaj"
2021,"Leverkusen","Bundesliga","Niklas Lomb","GER","GK","27",1993,1.5,0,0,0,0,0,0,0,NA,0,0,0,0,0,0,0,2,"https://fbref.com/en/players/9321b8ed/Niklas-Lomb"
2021,"Leverkusen","Bundesliga","Exequiel Palacios","ARG","MF","21",1998,6.4,31,17,12,16,3,17,30,56.7,13,13,0,13,12,43,7,0,"https://fbref.com/en/players/e82adcab/Exequiel-Palacios"
2021,"Leverkusen","Bundesliga","Paulinho","BRA","FW","20",2000,0.7,0,0,0,0,0,0,0,NA,0,0,0,0,0,0,0,0,"https://fbref.com/en/players/53070b63/Paulinho"
2021,"Leverkusen","Bundesliga","Joel Pohjanpalo","FIN","MF","25",1994,0.1,0,0,0,0,0,0,0,NA,0,0,0,0,0,0,0,0,"https://fbref.com/en/players/ea003d07/Joel-Pohjanpalo"
2021,"Leverkusen","Bundesliga","Patrik Schick","CZE","FW","24",1996,20.7,7,2,0,5,2,1,4,25,3,5,2,3,3,10,20,0,"https://fbref.com/en/players/5d4f7d61/Patrik-Schick"
2021,"Leverkusen","Bundesliga","Daley Sinkgraven","NED","DF","25",1995,17.4,32,17,13,16,3,18,35,51.4,17,22,5,17,23,55,23,0,"https://fbref.com/en/players/73000a79/Daley-Sinkgraven"
2021,"Leverkusen","Bundesliga","Jonathan Tah","GER","DF","24",1996,24.7,30,17,19,9,2,11,21,52.4,10,19,12,7,33,63,89,1,"https://fbref.com/en/players/bd142efb/Jonathan-Tah"
2021,"Leverkusen","Bundesliga","Edmond Tapsoba","BFA","DF","21",1999,29.5,54,28,35,18,1,21,45,46.7,24,55,29,26,48,102,96,0,"https://fbref.com/en/players/a73c8f95/Edmond-Tapsoba"
2021,"Leverkusen","Bundesliga","Mitchell Weiser","GER","DF","26",1994,2.5,4,1,1,2,1,2,4,50,2,1,0,1,3,7,4,0,"https://fbref.com/en/players/30c220c3/Mitchell-Weiser"
2021,"Leverkusen","Bundesliga","Wendell","BRA","DF","27",1993,16.2,53,35,27,18,8,23,49,46.9,26,26,3,23,25,78,39,1,"https://fbref.com/en/players/f9acca3a/Wendell"
2021,"Leverkusen","Bundesliga","Florian Wirtz","GER","MF","17",2003,24.7,35,18,8,22,5,11,37,29.7,26,27,1,26,9,44,8,0,"https://fbref.com/en/players/e7fcf289/Florian-Wirtz"
2021,"Lille","Ligue 1","Benjamin André","FRA","MF","29",1990,32.1,114,68,47,61,6,53,122,43.4,69,39,10,29,76,190,49,0,"https://fbref.com/en/players/ef9c1c95/Benjamin-Andre"
2021,"Lille","Ligue 1","Luiz Araújo","BRA","MF","24",1996,16.6,38,25,12,18,8,8,28,28.6,20,23,1,22,11,49,3,0,"https://fbref.com/en/players/fa18c72e/Luiz-Araujo"
2021,"Lille","Ligue 1","Jonathan Bamba","FRA","MF","24",1996,33.2,45,23,15,19,11,24,84,28.6,60,24,2,22,24,69,15,0,"https://fbref.com/en/players/b2bd0f6c/Jonathan-Bamba"
2021,"Lille","Ligue 1","Sven Botman","NED","DF","20",2000,36.8,31,21,18,12,1,14,26,53.8,12,31,21,10,57,88,126,2,"https://fbref.com/en/players/ccce7025/Sven-Botman"
2021,"Lille","Ligue 1","Domagoj Bradarić","CRO","DF","20",1999,14,28,18,11,13,4,12,27,44.4,15,14,4,10,26,54,21,0,"https://fbref.com/en/players/8bbe2df5/Domagoj-Bradaric"
2021,"Lille","Ligue 1","Zeki Çelik","TUR","DF","23",1997,26.5,72,33,30,30,12,44,81,54.3,37,32,6,26,38,110,52,0,"https://fbref.com/en/players/31a62dc7/Zeki-Celik"
2021,"Lille","Ligue 1","Jonathan David","CAN","FW","20",2000,26.2,17,10,5,5,7,9,24,37.5,15,19,1,18,3,20,9,0,"https://fbref.com/en/players/ce50fd99/Jonathan-David"
2021,"Lille","Ligue 1","Tiago Djaló","POR","DF","20",2000,9.7,22,13,14,5,3,15,23,65.2,8,10,4,6,9,31,23,0,"https://fbref.com/en/players/b2336681/Tiago-Djalo"
2021,"Lille","Ligue 1","José Fonte","POR","DF","36",1983,35.4,40,29,28,10,2,27,33,81.8,6,36,23,13,36,76,137,1,"https://fbref.com/en/players/90f87966/Jose-Fonte"
2021,"Lille","Ligue 1","Jonathan Ikone","FRA","MF,FW","22",1998,24.2,18,12,3,8,7,9,22,40.9,13,16,1,15,7,25,9,0,"https://fbref.com/en/players/42eaa028/Jonathan-Ikone"
2021,"Lille","Ligue 1","Isaac Lihadji","FRA","MF,FW","18",2002,2.2,11,4,2,6,3,4,5,80,1,5,1,4,1,12,0,1,"https://fbref.com/en/players/57a46f3f/Isaac-Lihadji"
2021,"Lille","Ligue 1","Mike Maignan","FRA","GK","25",1995,38,0,0,0,0,0,0,0,NA,0,0,0,0,0,0,7,2,"https://fbref.com/en/players/fcb38f57/Mike-Maignan"
2021,"Lille","Ligue 1","Reinildo Mandava","MOZ","DF","26",1994,24.2,79,43,39,32,8,35,58,60.3,23,26,3,23,45,124,53,0,"https://fbref.com/en/players/c20bdcd7/Reinildo-Mandava"
2021,"Lille","Ligue 1","Jérémy Pied","FRA","DF","31",1989,3.5,7,0,3,3,1,4,9,44.4,5,3,1,2,6,13,8,0,"https://fbref.com/en/players/a634b9d2/Jeremy-Pied"
2021,"Lille","Ligue 1","Renato Sanches","POR","MF","22",1997,14.1,13,7,4,8,1,5,25,20,20,13,2,11,13,26,8,0,"https://fbref.com/en/players/032f894e/Renato-Sanches"
2021,"Lille","Ligue 1","Adama Soumaoro","FRA","DF","28",1992,1.6,1,0,0,0,1,0,0,NA,0,1,1,0,2,3,2,0,"https://fbref.com/en/players/7b075c75/Adama-Soumaoro"
2021,"Lille","Ligue 1","Boubakary Soumaré","FRA","MF","21",1999,21.3,44,29,16,25,3,14,29,48.3,15,14,6,8,39,83,21,0,"https://fbref.com/en/players/ae59b359/Boubakary-Soumare"
2021,"Lille","Ligue 1","Timothy Weah","USA","FW,MF","20",2000,9.8,15,7,3,9,3,7,14,50,7,7,0,7,4,19,5,0,"https://fbref.com/en/players/8eec784d/Timothy-Weah"
2021,"Lille","Ligue 1","Xeka","POR","MF","25",1994,13.3,33,17,14,15,4,16,43,37.2,27,14,2,12,20,53,18,0,"https://fbref.com/en/players/f3600c02/Xeka"
2021,"Lille","Ligue 1","Yusuf Yazıcı","TUR","FW,MF","23",1997,12.1,12,5,6,2,4,1,24,4.2,23,5,1,4,2,14,2,0,"https://fbref.com/en/players/f5c8b425/Yusuf-Yazici"
2021,"Lille","Ligue 1","Burak Yılmaz","TUR","FW","35",1985,22.8,13,6,3,7,3,4,30,13.3,26,7,0,7,5,18,22,0,"https://fbref.com/en/players/165a2e40/Burak-Yilmaz"
2021,"Liverpool","Premier League","Adrián","ESP","GK","33",1987,3,0,0,0,0,0,0,0,NA,0,0,0,0,0,0,3,1,"https://fbref.com/en/players/f76e6b4e/Adrian"
2021,"Liverpool","Premier League","Thiago Alcántara","ESP","MF","29",1991,20.6,61,36,20,30,11,17,49,34.7,32,26,0,26,30,91,14,0,"https://fbref.com/en/players/77e84962/Thiago-Alcantara"
2021,"Liverpool","Premier League","Trent Alexander-Arnold","ENG","DF","21",1998,33.7,56,33,31,18,7,36,56,64.3,20,24,3,21,49,105,50,3,"https://fbref.com/en/players/cd1acf9d/Trent-Alexander-Arnold"
2021,"Liverpool","Premier League","Alisson","BRA","GK","27",1992,33,3,2,3,0,0,3,4,75,1,0,0,0,2,5,26,7,"https://fbref.com/en/players/7a2e46a8/Alisson"
2021,"Liverpool","Premier League","Fabinho","BRA","DF,MF","26",1993,28.5,58,31,21,29,8,27,54,50,27,28,10,18,44,102,66,1,"https://fbref.com/en/players/7f3b388c/Fabinho"
2021,"Liverpool","Premier League","Roberto Firmino","BRA","FW","28",1991,31.5,33,15,3,17,13,6,32,18.8,26,42,5,37,11,44,12,0,"https://fbref.com/en/players/4c370d81/Roberto-Firmino"
2021,"Liverpool","Premier League","Joe Gomez","ENG","DF","23",1997,6.6,3,2,1,1,1,0,4,0,4,3,2,1,4,7,29,0,"https://fbref.com/en/players/7a11550b/Joe-Gomez"
2021,"Liverpool","Premier League","Jordan Henderson","ENG","MF,DF","30",1990,18.9,24,15,12,9,3,10,26,38.5,16,12,1,11,34,58,30,0,"https://fbref.com/en/players/935e6b8f/Jordan-Henderson"
2021,"Liverpool","Premier League","Curtis Jones","ENG","MF","19",2001,13.1,16,6,6,7,3,12,25,48,13,13,0,13,19,35,11,1,"https://fbref.com/en/players/4fb9c88f/Curtis-Jones"
2021,"Liverpool","Premier League","Diogo Jota","POR","FW","23",1996,12.4,12,6,4,7,1,2,29,6.9,27,9,0,9,5,17,3,0,"https://fbref.com/en/players/178ae8f8/Diogo-Jota"
2021,"Liverpool","Premier League","Ozan Kabak","TUR","DF","20",2000,8.9,19,10,11,4,4,6,9,66.7,3,2,2,0,12,31,28,1,"https://fbref.com/en/players/2d61d13a/Ozan-Kabak"
2021,"Liverpool","Premier League","Naby Keïta","GUI","MF","25",1995,5.8,11,5,1,8,2,7,17,41.2,10,10,0,10,9,20,6,0,"https://fbref.com/en/players/f25c8e3a/Naby-Keita"
2021,"Liverpool","Premier League","Caoimhín Kelleher","IRL","GK","21",1998,2,0,0,0,0,0,0,0,NA,0,0,0,0,0,0,2,0,"https://fbref.com/en/players/62d7ef38/Caoimhin-Kelleher"
2021,"Liverpool","Premier League","Sadio Mané","SEN","FW","28",1992,31.2,48,30,6,22,20,12,33,36.4,21,30,0,30,15,63,11,0,"https://fbref.com/en/players/c691bfe2/Sadio-Mane"
2021,"Liverpool","Premier League","Joël Matip","CMR","DF","28",1991,7.7,14,9,7,7,0,7,8,87.5,1,6,0,6,7,21,22,0,"https://fbref.com/en/players/b217ef29/Joel-Matip"
2021,"Liverpool","Premier League","James Milner","ENG","MF,DF","34",1986,11.9,26,19,9,14,3,11,33,33.3,22,30,3,27,14,40,16,1,"https://fbref.com/en/players/2f90f6b8/James-Milner"
2021,"Liverpool","Premier League","Takumi Minamino","JPN","MF,FW","25",1995,3.3,4,3,1,2,1,0,12,0,12,1,0,1,2,6,3,0,"https://fbref.com/en/players/f833a830/Takumi-Minamino"
2021,"Liverpool","Premier League","Divock Origi","BEL","FW","25",1995,2.1,3,2,0,2,1,1,3,33.3,2,5,1,4,1,4,2,0,"https://fbref.com/en/players/43a166b4/Divock-Origi"
2021,"Liverpool","Premier League","Alex Oxlade-Chamberlain","ENG","MF,FW","26",1993,2.8,4,0,0,3,1,0,2,0,2,1,0,1,2,6,0,0,"https://fbref.com/en/players/38c7feef/Alex-Oxlade-Chamberlain"
2021,"Liverpool","Premier League","Nathaniel Phillips","ENG","DF","23",1997,16.2,22,14,15,7,0,11,24,45.8,13,17,14,3,20,42,81,0,"https://fbref.com/en/players/515ebe8d/Nathaniel-Phillips"
2021,"Liverpool","Premier League","Andrew Robertson","SCO","DF","26",1994,37.6,46,34,23,18,5,28,57,49.1,29,39,9,30,21,67,79,1,"https://fbref.com/en/players/2e4f5f03/Andrew-Robertson"
2021,"Liverpool","Premier League","Mohamed Salah","EGY","FW","28",1992,34.2,18,9,4,4,10,7,16,43.8,9,10,0,10,1,19,10,1,"https://fbref.com/en/players/e342ad68/Mohamed-Salah"
2021,"Liverpool","Premier League","Xherdan Shaqiri","SUI","MF,FW","28",1991,6.2,7,4,3,1,3,2,7,28.6,5,4,0,4,2,9,0,0,"https://fbref.com/en/players/6421ec64/Xherdan-Shaqiri"
2021,"Liverpool","Premier League","Kostas Tsimikas","GRE","DF,FW","24",1996,0.1,0,0,0,0,0,0,0,NA,0,0,0,0,0,0,0,0,"https://fbref.com/en/players/f315ca93/Kostas-Tsimikas"
2021,"Liverpool","Premier League","Virgil van Dijk","NED","DF","29",1991,4.1,3,2,1,2,0,0,0,NA,0,1,1,0,5,8,8,1,"https://fbref.com/en/players/e06683ca/Virgil-van-Dijk"
2021,"Liverpool","Premier League","Georginio Wijnaldum","NED","MF","29",1990,32.7,23,7,6,14,3,7,31,22.6,24,18,3,15,26,49,18,1,"https://fbref.com/en/players/eb58eef0/Georginio-Wijnaldum"
2021,"Liverpool","Premier League","Neco Williams","WAL","DF","19",2001,2.8,6,5,4,2,0,5,9,55.6,4,3,1,2,6,12,6,0,"https://fbref.com/en/players/dd323728/Neco-Williams"
2021,"Liverpool","Premier League","Rhys Williams","ENG","DF","19",2001,7.3,6,4,3,3,0,3,3,100,0,4,3,1,6,12,27,1,"https://fbref.com/en/players/012c975a/Rhys-Williams"
2021,"Lorient","Ligue 1","Laurent Abergel","FRA","MF","27",1993,32.9,145,84,64,69,12,54,162,33.3,108,64,6,58,46,191,12,0,"https://fbref.com/en/players/31626657/Laurent-Abergel"
2021,"Lorient","Ligue 1","Quentin Boisgard","FRA","MF,FW","23",1997,14.6,24,17,3,15,6,11,24,45.8,13,17,2,15,15,39,1,0,"https://fbref.com/en/players/f6496133/Quentin-Boisgard"
2021,"Lorient","Ligue 1","Umut Bozok","TUR","MF,FW","23",1996,0.7,0,0,0,0,0,0,2,0,2,0,0,0,0,0,0,0,"https://fbref.com/en/players/6e2c94ad/Umut-Bozok"
2021,"Lorient","Ligue 1","Trevoh Chalobah","ENG","DF,MF","21",1999,24.9,45,26,32,13,0,24,50,48,26,20,7,13,69,114,56,0,"https://fbref.com/en/players/5515376c/Trevoh-Chalobah"
2021,"Lorient","Ligue 1","Jonathan Delaplace","FRA","DF","34",1986,10.1,8,5,5,1,2,7,13,53.8,6,12,5,7,17,25,19,1,"https://fbref.com/en/players/79685569/Jonathan-Delaplace"
2021,"Lorient","Ligue 1","Stéphane Diarra","FRA","MF,FW","21",1998,2.2,0,0,0,0,0,0,7,0,7,6,1,5,4,4,1,0,"https://fbref.com/en/players/29939a1d/Stephane-Diarra"
2021,"Lorient","Ligue 1","Matthieu Dreyer","FRA","GK","31",1989,15,0,0,0,0,0,0,0,NA,0,0,0,0,0,0,4,2,"https://fbref.com/en/players/fbf83734/Matthieu-Dreyer"
2021,"Lorient","Ligue 1","Yoann Etienne","FRA","DF","23",1997,1,2,0,1,1,0,1,1,100,0,1,0,1,1,3,2,0,"https://fbref.com/en/players/a59d55b1/Yoann-Etienne"
2021,"Lorient","Ligue 1","Thomas Fontaine","MAD","DF","29",1991,3.6,5,2,5,0,0,2,2,100,0,3,2,1,5,10,14,0,"https://fbref.com/en/players/9f90c06b/Thomas-Fontaine"
2021,"Lorient","Ligue 1","Andrew Gravillon","GLP","DF","22",1998,25.2,26,17,17,9,0,13,28,46.4,15,44,31,13,59,85,118,4,"https://fbref.com/en/players/49136c42/Andrew-Gravillon"
2021,"Lorient","Ligue 1","Adrian Grbić","AUT","FW","23",1996,10.7,6,4,2,2,2,1,7,14.3,6,6,0,6,5,11,7,0,"https://fbref.com/en/players/4a987ffa/Adrian-Grbic"
2021,"Lorient","Ligue 1","Pierre-Yves Hamel","FRA","FW","26",1994,9.4,15,8,3,9,3,1,6,16.7,5,12,1,11,10,25,6,0,"https://fbref.com/en/players/a99da9ec/Pierre-Yves-Hamel"
2021,"Lorient","Ligue 1","Jérôme Hergault","FRA","DF,MF","34",1986,18.1,38,23,22,10,6,17,31,54.8,14,16,2,14,22,60,34,0,"https://fbref.com/en/players/a84f9a4b/Jerome-Hergault"
2021,"Lorient","Ligue 1","Julien Laporte","FRA","DF","26",1993,29.5,65,39,48,16,1,42,74,56.8,32,34,23,11,65,130,125,0,"https://fbref.com/en/players/f066022d/Julien-Laporte"
2021,"Lorient","Ligue 1","Armand Lauriente","FRA","MF,FW","21",1998,18,30,10,10,19,1,7,26,26.9,19,21,0,21,15,45,4,0,"https://fbref.com/en/players/2d22cea7/Armand-Lauriente"
2021,"Lorient","Ligue 1","Enzo Le Fée","FRA","MF","20",2000,20.2,51,28,23,23,5,27,73,37,46,30,6,24,25,76,10,0,"https://fbref.com/en/players/6f806d99/Enzo-Le-Fee"
2021,"Lorient","Ligue 1","Vincent Le Goff","FRA","DF","30",1989,25.6,42,29,16,24,2,18,49,36.7,31,27,5,22,44,86,44,0,"https://fbref.com/en/players/2321ea6e/Vincent-Le-Goff"
2021,"Lorient","Ligue 1","Fabien Lemoine","FRA","MF","33",1987,21.5,74,45,39,33,2,36,89,40.4,53,25,1,24,27,101,35,0,"https://fbref.com/en/players/54d51e22/Fabien-Lemoine"
2021,"Lorient","Ligue 1","Sylvain Marveaux","FRA","MF,FW","34",1986,2.2,6,3,1,4,1,3,3,100,0,2,0,2,1,7,2,0,"https://fbref.com/en/players/4ef705ab/Sylvain-Marveaux"
2021,"Lorient","Ligue 1","Houboulang Mendes","FRA","DF","22",1998,14.4,28,19,19,5,4,16,28,57.1,12,14,2,12,14,42,35,0,"https://fbref.com/en/players/1545cf15/Houboulang-Mendes"
2021,"Lorient","Ligue 1","Terem Moffi","NGA","FW","21",1999,23,13,8,0,8,5,4,19,21.1,15,5,2,3,4,17,8,0,"https://fbref.com/en/players/065dc209/Terem-Moffi"
2021,"Lorient","Ligue 1","Thomas Monconduit","FRA","MF","29",1991,12.8,28,15,9,16,3,15,41,36.6,26,10,3,7,13,41,21,1,"https://fbref.com/en/players/84d94b91/Thomas-Monconduit"
2021,"Lorient","Ligue 1","Jérémy Morel","MAD","DF","36",1984,27.7,31,19,21,10,0,20,39,51.3,19,26,11,15,44,75,81,1,"https://fbref.com/en/players/e97150c0/Jeremy-Morel"
2021,"Lorient","Ligue 1","Loris Mouyokolo","CGO","DF","19",2001,0.2,1,1,1,0,0,1,1,100,0,1,1,0,0,1,1,0,"https://fbref.com/en/players/96726741/Loris-Mouyokolo"
2021,"Lorient","Ligue 1","Paul Nardi","FRA","GK","26",1994,23,0,0,0,0,0,0,1,0,1,1,0,1,0,0,15,2,"https://fbref.com/en/players/2d70dbe5/Paul-Nardi"
2021,"Lorient","Ligue 1","Franklin Wadja","CMR","MF,FW","25",1995,0.4,4,2,0,2,2,2,2,100,0,0,0,0,2,6,1,0,"https://fbref.com/en/players/7cbf91b2/Franklin-Wadja"
2021,"Lorient","Ligue 1","Yoane Wissa","COD","MF,FW","23",1996,29.7,35,20,12,14,9,11,34,32.4,23,25,3,22,20,55,14,0,"https://fbref.com/en/players/2500cef9/Yoane-Wissa"
2021,"Lyon","Ligue 1","Joachim Andersen","DEN","DF","24",1996,2.1,2,1,1,1,0,2,2,100,0,1,1,0,2,4,6,0,"https://fbref.com/en/players/e34fc66d/Joachim-Andersen"
2021,"Lyon","Ligue 1","Houssem Aouar","FRA","MF,FW","22",1998,19.8,17,12,0,13,4,8,25,32,17,17,1,16,17,34,4,0,"https://fbref.com/en/players/a5db0bec/Houssem-Aouar"
2021,"Lyon","Ligue 1","Melvin Bard","FRA","DF","19",2000,4.8,12,8,7,4,1,6,11,54.5,5,10,2,8,6,18,14,0,"https://fbref.com/en/players/1ddbc7ca/Melvin-Bard"
2021,"Lyon","Ligue 1","Djamel Benlamri","ALG","DF","30",1989,1.7,5,3,5,0,0,3,6,50,3,3,2,1,6,11,11,0,"https://fbref.com/en/players/2ab14aaa/Djamel-Benlamri"
2021,"Lyon","Ligue 1","Maxence Caqueret","FRA","MF","20",2000,19.6,72,45,17,39,16,35,106,33,71,35,3,32,23,95,5,2,"https://fbref.com/en/players/f81ef10d/Maxence-Caqueret"
2021,"Lyon","Ligue 1","Rayan Cherki","FRA","FW,MF","16",2003,7.8,5,3,0,3,2,1,11,9.1,10,3,0,3,4,9,0,0,"https://fbref.com/en/players/b34c63a5/Rayan-Cherki"
2021,"Lyon","Ligue 1","Maxwel Cornet","CIV","DF,FW","23",1996,27.2,70,41,39,24,7,33,58,56.9,25,23,5,18,43,113,47,2,"https://fbref.com/en/players/beb391dd/Maxwel-Cornet"
2021,"Lyon","Ligue 1","Mattia De Sciglio","ITA","DF","27",1992,16.3,29,17,15,11,3,18,27,66.7,9,13,4,9,27,56,44,0,"https://fbref.com/en/players/ae4e2852/Mattia-De-Sciglio"
2021,"Lyon","Ligue 1","Moussa Dembélé","FRA","FW","24",1996,7.5,2,2,0,1,1,0,4,0,4,4,2,2,5,7,9,0,"https://fbref.com/en/players/e7986081/Moussa-Dembele"
2021,"Lyon","Ligue 1","Jason Denayer","BEL","DF","25",1995,29,25,16,16,9,0,6,13,46.2,7,36,25,11,27,52,91,1,"https://fbref.com/en/players/47af88b8/Jason-Denayer"
2021,"Lyon","Ligue 1","Sinaly Diomande","CIV","DF","19",2001,12.6,10,7,8,1,1,5,14,35.7,9,19,15,4,33,43,53,1,"https://fbref.com/en/players/6de23ab0/Sinaly-Diomande"
2021,"Lyon","Ligue 1","Leo Dubois","FRA","DF","25",1994,32.3,38,26,19,16,3,18,36,50,18,27,9,18,31,69,69,2,"https://fbref.com/en/players/ff0ab48c/Leo-Dubois"
2021,"Lyon","Ligue 1","Bruno Guimarães","BRA","MF","22",1997,19.5,76,34,26,41,9,30,64,46.9,34,24,4,20,14,90,13,0,"https://fbref.com/en/players/82518f62/Bruno-Guimaraes"
2021,"Lyon","Ligue 1","Malo Gusto","FRA","DF,MF","17",2003,0,0,0,0,0,0,0,0,NA,0,0,0,0,0,0,0,0,"https://fbref.com/en/players/d56b9520/Malo-Gusto"
2021,"Lyon","Ligue 1","Tino Kadewere","ZIM","FW","24",1996,22.3,35,22,12,16,7,17,49,34.7,32,16,3,13,21,56,31,0,"https://fbref.com/en/players/7d08063d/Tino-Kadewere"
2021,"Lyon","Ligue 1","Habib Keita","MLI","MF","18",2002,0.1,0,0,0,0,0,0,0,NA,0,0,0,0,0,0,0,0,"https://fbref.com/en/players/cc588cbe/Habib-Keita"
2021,"Lyon","Ligue 1","Anthony Lopes","POR","GK","29",1990,38,1,1,1,0,0,1,2,50,1,1,0,1,1,2,20,1,"https://fbref.com/en/players/f00de885/Anthony-Lopes"
2021,"Lyon","Ligue 1","Jean Lucas","BRA","MF","22",1998,1.9,3,2,2,1,0,1,4,25,3,3,1,2,2,5,1,0,"https://fbref.com/en/players/a99138af/Jean-Lucas"
2021,"Lyon","Ligue 1","Fernando Marçal","BRA","DF","31",1989,0.9,1,0,0,1,0,0,0,NA,0,0,0,0,2,3,0,0,"https://fbref.com/en/players/9ae9eaea/Fernando-Marcal"
2021,"Lyon","Ligue 1","Marcelo","BRA","DF","33",1987,32.3,44,29,30,12,2,26,37,70.3,11,35,25,10,49,93,122,2,"https://fbref.com/en/players/e3d0b0c4/Marcelo"
2021,"Lyon","Ligue 1","Memphis","NED","FW","26",1994,32.5,4,3,0,3,1,1,20,5,19,11,1,10,5,9,3,0,"https://fbref.com/en/players/8f696594/Memphis"
2021,"Lyon","Ligue 1","Thiago Mendes","BRA","MF","28",1992,24.9,37,22,13,20,4,18,38,47.4,20,33,7,26,39,76,21,2,"https://fbref.com/en/players/c6e5d20f/Thiago-Mendes"
2021,"Lyon","Ligue 1","Lucas Paquetá","BRA","MF","22",1997,25.3,70,36,30,28,12,23,66,34.8,43,28,3,25,20,90,16,1,"https://fbref.com/en/players/9b6f7fd5/Lucas-Paqueta"
2021,"Lyon","Ligue 1","Jeff Reine-Adélaïde","FRA","FW","22",1998,0.3,0,0,0,0,0,0,0,NA,0,0,0,0,0,0,0,0,"https://fbref.com/en/players/d504b3e1/Jeff-Reine-Adelaide"
2021,"Lyon","Ligue 1","Florent da Silva","FRA","FW","17",2003,0,0,0,0,0,0,0,0,NA,0,0,0,0,0,0,0,0,"https://fbref.com/en/players/8db95f95/Florent-da-Silva"
2021,"Lyon","Ligue 1","Islam Slimani","ALG","FW","32",1988,6.4,7,5,3,1,3,3,12,25,9,4,1,3,1,8,6,0,"https://fbref.com/en/players/ffec9769/Islam-Slimani"
2021,"Lyon","Ligue 1","Yaya Soumaré","FRA","MF","20",2000,0,NA,1,NA,NA,NA,NA,NA,NA,NA,NA,NA,NA,2,NA,NA,NA,"https://fbref.com/en/players/cb4e852b/Yaya-Soumare"
2021,"Lyon","Ligue 1","Kenny Tete","NED","DF","24",1995,0.2,2,0,1,1,0,0,0,NA,0,0,0,0,2,4,0,0,"https://fbref.com/en/players/77d7c96f/Kenny-Tete"
2021,"Lyon","Ligue 1","Karl Toko Ekambi","CMR","FW","27",1992,31.2,16,10,5,3,8,8,32,25,24,20,1,19,26,42,8,0,"https://fbref.com/en/players/5ceba7fc/Karl-Toko-Ekambi"
2021,"M'Gladbach","Bundesliga","László Bénes","SVK","MF","22",1997,1.7,6,2,5,1,0,2,4,50,2,0,0,0,2,8,1,0,"https://fbref.com/en/players/fe888e39/Laszlo-Benes"
2021,"M'Gladbach","Bundesliga","Ramy Bensebaini","ALG","DF","25",1995,20.1,43,24,27,13,3,26,42,61.9,16,39,7,32,47,90,66,0,"https://fbref.com/en/players/378825c7/Ramy-Bensebaini"
2021,"M'Gladbach","Bundesliga","Louis Beyer","GER","DF","20",2000,2.1,2,1,2,0,0,1,2,50,1,5,4,1,5,7,5,0,"https://fbref.com/en/players/9af1f9ff/Louis-Beyer"
2021,"M'Gladbach","Bundesliga","Nico Elvedi","SUI","DF","23",1996,28.2,49,35,36,12,1,25,37,67.6,12,38,22,16,65,114,123,0,"https://fbref.com/en/players/48035304/Nico-Elvedi"
2021,"M'Gladbach","Bundesliga","Breel Embolo","SUI","FW,MF","23",1997,16,15,10,1,13,1,0,6,0,6,16,1,15,8,23,8,0,"https://fbref.com/en/players/0b4f388a/Breel-Embolo"
2021,"M'Gladbach","Bundesliga","Matthias Ginter","GER","DF","26",1994,34,26,16,15,10,1,14,24,58.3,10,43,32,11,51,77,121,0,"https://fbref.com/en/players/f521b80a/Matthias-Ginter"
2021,"M'Gladbach","Bundesliga","Patrick Herrmann","GER","FW,MF","29",1991,9.7,9,6,4,3,2,2,14,14.3,12,16,0,16,10,19,8,0,"https://fbref.com/en/players/dfb6490a/Patrick-Herrmann"
2021,"M'Gladbach","Bundesliga","Jonas Hofmann","GER","FW,MF","28",1992,20.2,26,20,12,12,2,10,53,18.9,43,27,2,25,27,53,9,0,"https://fbref.com/en/players/2903a856/Jonas-Hofmann"
2021,"M'Gladbach","Bundesliga","Tony Jantschke","GER","DF","30",1990,3,2,2,1,1,0,1,3,33.3,2,6,4,2,4,6,7,0,"https://fbref.com/en/players/34b54da7/Tony-Jantschke"
2021,"M'Gladbach","Bundesliga","Christoph Kramer","GER","MF","29",1991,22.6,55,37,22,28,5,28,58,48.3,30,32,11,21,34,89,39,0,"https://fbref.com/en/players/496aeede/Christoph-Kramer"
2021,"M'Gladbach","Bundesliga","Stefan Lainer","AUT","DF","27",1992,30.8,62,37,30,22,10,27,60,45,33,34,5,29,35,97,85,1,"https://fbref.com/en/players/4aea5077/Stefan-Lainer"
2021,"M'Gladbach","Bundesliga","Valentino Lazaro","AUT","DF,FW","24",1996,13.8,17,11,7,5,5,12,19,63.2,7,18,1,17,15,32,20,0,"https://fbref.com/en/players/016ff750/Valentino-Lazaro"
2021,"M'Gladbach","Bundesliga","Florian Neuhaus","GER","MF","23",1997,29.1,48,28,19,26,3,19,63,30.2,44,35,7,28,50,98,20,1,"https://fbref.com/en/players/36a59ba4/Florian-Neuhaus"
2021,"M'Gladbach","Bundesliga","Alassane Pléa","FRA","FW","27",1993,20,19,9,4,10,5,5,20,25,15,1,0,1,5,24,7,0,"https://fbref.com/en/players/bc6bd723/Alassane-Plea"
2021,"M'Gladbach","Bundesliga","Rocco Reitz","GER","MF","18",2002,0.7,3,2,0,3,0,2,2,100,0,3,1,2,1,4,1,0,"https://fbref.com/en/players/cc971106/Rocco-Reitz"
2021,"M'Gladbach","Bundesliga","Tobias Sippel","GER","GK","32",1988,3.8,0,0,0,0,0,0,0,NA,0,0,0,0,1,1,4,0,"https://fbref.com/en/players/0d8a37c2/Tobias-Sippel"
2021,"M'Gladbach","Bundesliga","Yann Sommer","SUI","GK","31",1988,30.1,1,1,1,0,0,1,1,100,0,0,0,0,2,3,9,2,"https://fbref.com/en/players/420c18a1/Yann-Sommer"
2021,"M'Gladbach","Bundesliga","Lars Stindl","GER","MF,FW","31",1988,21.8,24,17,3,16,5,7,32,21.9,25,26,3,23,13,37,14,0,"https://fbref.com/en/players/7cd6badb/Lars-Stindl"
2021,"M'Gladbach","Bundesliga","Marcus Thuram","FRA","FW,MF","22",1997,19.2,24,14,9,10,5,10,23,43.5,13,27,4,23,15,39,13,1,"https://fbref.com/en/players/6f8cd6d0/Marcus-Thuram"
2021,"M'Gladbach","Bundesliga","Ibrahima Traoré","GUI","FW,DF","32",1988,1.1,4,1,1,2,1,0,0,NA,0,2,0,2,0,4,0,0,"https://fbref.com/en/players/096a77c4/Ibrahima-Traore"
2021,"M'Gladbach","Bundesliga","Oscar Wendt","SWE","DF","34",1985,13.9,12,6,2,9,1,4,12,33.3,8,18,4,14,14,26,23,0,"https://fbref.com/en/players/b69261a0/Oscar-Wendt"
2021,"M'Gladbach","Bundesliga","Hannes Wolf","AUT","MF,FW","21",1999,15.3,26,13,8,10,8,8,36,22.2,28,18,1,17,9,35,4,0,"https://fbref.com/en/players/be42a291/Hannes-Wolf"
2021,"M'Gladbach","Bundesliga","Denis Zakaria","SUI","MF,DF","23",1996,15.8,30,15,12,15,3,11,20,55,9,20,7,13,23,53,29,1,"https://fbref.com/en/players/384d58d9/Denis-Zakaria"
2021,"Mainz 05","Bundesliga","Issah Abbas","GHA","DF,FW","21",1998,0.2,0,0,0,0,0,0,0,NA,0,0,0,0,0,0,0,0,"https://fbref.com/en/players/2590ddf7/Issah-Abbas"
2021,"Mainz 05","Bundesliga","Ridle Baku","GER","DF","22",1998,2,4,2,3,1,0,2,6,33.3,4,3,1,2,3,7,6,0,"https://fbref.com/en/players/442b56fa/Ridle-Baku"
2021,"Mainz 05","Bundesliga","Leandro Barreiro Martins","LUX","MF","20",2000,25.6,58,32,19,26,13,20,50,40,30,34,9,25,57,115,55,0,"https://fbref.com/en/players/00242b75/Leandro-Barreiro-Martins"
2021,"Mainz 05","Bundesliga","Stefan Bell","GER","DF","28",1991,14.1,24,18,15,9,0,14,23,60.9,9,19,11,8,27,51,76,1,"https://fbref.com/en/players/857a5abe/Stefan-Bell"
2021,"Mainz 05","Bundesliga","Jean-Paul Boëtius","NED","MF,FW","26",1994,22.9,42,28,13,15,14,17,47,36.2,30,37,3,34,33,75,14,0,"https://fbref.com/en/players/635f2732/Jean-Paul-Boetius"
2021,"Mainz 05","Bundesliga","Daniel Brosinski","GER","DF,FW","32",1988,15.9,19,14,10,7,2,12,31,38.7,19,18,1,17,14,33,33,0,"https://fbref.com/en/players/a7813ac4/Daniel-Brosinski"
2021,"Mainz 05","Bundesliga","Jonathan Burkardt","GER","FW,MF","20",2000,15.3,27,13,15,10,2,11,19,57.9,8,20,3,17,8,35,15,0,"https://fbref.com/en/players/05f99a4a/Jonathan-Burkardt"
2021,"Mainz 05","Bundesliga","Danny da Costa","GER","DF,FW","27",1993,13.4,22,16,6,9,7,13,27,48.1,14,17,2,15,17,39,27,0,"https://fbref.com/en/players/5ddb8f9f/Danny-da-Costa"
2021,"Mainz 05","Bundesliga","Finn Dahmen","GER","GK","22",1998,3,0,0,0,0,0,0,1,0,1,0,0,0,0,0,1,0,"https://fbref.com/en/players/dee3013b/Finn-Dahmen"
2021,"Mainz 05","Bundesliga","Ji Dong-won","KOR","FW","29",1991,0.7,1,1,1,0,0,0,0,NA,0,1,0,1,2,3,0,0,"https://fbref.com/en/players/7d841904/Ji-Dong-won"
2021,"Mainz 05","Bundesliga","Edimilson Fernandes","SUI","MF,FW","24",1996,9.3,8,4,4,4,0,4,7,57.1,3,12,4,8,29,37,25,0,"https://fbref.com/en/players/3bb625ac/Edimilson-Fernandes"
2021,"Mainz 05","Bundesliga","Robert Glatzel","GER","FW","26",1994,4,1,0,1,0,0,0,2,0,2,2,0,2,0,1,2,0,"https://fbref.com/en/players/18a9efe4/Robert-Glatzel"
2021,"Mainz 05","Bundesliga","Alexander Hack","GER","DF","26",1993,15.2,32,21,23,8,1,18,31,58.1,13,26,17,9,41,73,91,2,"https://fbref.com/en/players/a5ec3ede/Alexander-Hack"
2021,"Mainz 05","Bundesliga","Luca Kilian","GER","DF","20",1999,4.2,14,7,10,4,0,9,17,52.9,8,3,1,2,13,27,12,0,"https://fbref.com/en/players/610aa1e9/Luca-Kilian"
2021,"Mainz 05","Bundesliga","Dominik Kohr","GER","MF","26",1994,14.1,47,31,14,26,7,20,39,51.3,19,18,5,13,27,74,15,0,"https://fbref.com/en/players/0fbecd11/Dominik-Kohr"
2021,"Mainz 05","Bundesliga","Pierre Kunde","CMR","MF","25",1995,5.7,8,4,1,5,2,2,9,22.2,7,6,0,6,10,18,9,0,"https://fbref.com/en/players/9ceb7642/Pierre-Kunde"
2021,"Mainz 05","Bundesliga","Danny Latza","GER","MF","30",1989,20,43,26,12,19,12,23,70,32.9,47,39,3,36,27,70,23,0,"https://fbref.com/en/players/33b554b7/Danny-Latza"
2021,"Mainz 05","Bundesliga","Aarón Martín","ESP","DF,FW","23",1997,2.9,3,2,2,1,0,2,4,50,2,1,0,1,2,5,2,0,"https://fbref.com/en/players/2f3e911a/Aaron-Martin"
2021,"Mainz 05","Bundesliga","Jean-Philippe Mateta","FRA","FW","23",1997,11.1,6,3,1,3,2,0,3,0,3,3,1,2,4,10,6,0,"https://fbref.com/en/players/50e6dc35/Jean-Philippe-Mateta"
2021,"Mainz 05","Bundesliga","Phillipp Mwene","AUT","DF,MF","26",1994,18.6,36,23,21,11,4,19,38,50,19,26,3,23,24,60,33,0,"https://fbref.com/en/players/2ff76adc/Phillipp-Mwene"
2021,"Mainz 05","Bundesliga","Paul Nebel","GER","MF,FW","17",2002,0.6,1,1,0,1,0,0,1,0,1,0,0,0,2,3,0,0,"https://fbref.com/en/players/1b6d8083/Paul-Nebel"
2021,"Mainz 05","Bundesliga","Moussa Niakhate","FRA","DF","24",1996,31.8,42,22,28,13,1,14,29,48.3,15,31,15,16,49,91,79,0,"https://fbref.com/en/players/00242715/Moussa-Niakhate"
2021,"Mainz 05","Bundesliga","Karim Onisiwo","AUT","FW,MF","28",1992,20.5,31,20,7,15,9,14,23,60.9,9,20,1,19,5,36,12,0,"https://fbref.com/en/players/f26834c7/Karim-Onisiwo"
2021,"Mainz 05","Bundesliga","Levin Öztunalı","GER","DF,FW","24",1996,8.4,24,18,14,8,2,8,17,47.1,9,15,0,15,15,39,16,0,"https://fbref.com/en/players/66385c46/Levin-Oztunali"
2021,"Mainz 05","Bundesliga","Matondo-Merveille Papela","GER","DF","19",2001,0,0,0,0,0,0,0,1,0,1,0,0,0,0,0,0,0,"https://fbref.com/en/players/b4b08774/Matondo-Merveille-Papela"
2021,"Mainz 05","Bundesliga","Robin Quaison","SWE","FW,MF","26",1993,16.4,14,6,3,6,5,7,14,50,7,10,0,10,13,27,10,0,"https://fbref.com/en/players/74c7c2db/Robin-Quaison"
2021,"Mainz 05","Bundesliga","Jerry St. Juste","NED","DF","23",1996,32,65,38,37,26,2,20,36,55.6,16,46,27,19,64,129,82,1,"https://fbref.com/en/players/90339309/Jerry-St-Juste"
2021,"Mainz 05","Bundesliga","Kevin Stöger","AUT","MF,FW","26",1993,6,12,6,2,9,1,5,16,31.3,11,5,0,5,6,18,4,0,"https://fbref.com/en/players/e5649a78/Kevin-Stoger"
2021,"Mainz 05","Bundesliga","Ádám Szalai","HUN","FW","32",1987,8.1,7,6,3,2,2,2,8,25,6,4,1,3,2,9,4,0,"https://fbref.com/en/players/53e07d0b/Adam-Szalai"
2021,"Mainz 05","Bundesliga","Niklas Tauer","GER","MF,DF","19",2001,0.8,1,1,0,1,0,1,2,50,1,3,1,2,3,4,1,0,"https://fbref.com/en/players/27270af4/Niklas-Tauer"
2021,"Mainz 05","Bundesliga","Robin Zentner","GER","GK","25",1994,31,1,1,1,0,0,1,3,33.3,2,0,0,0,3,4,9,2,"https://fbref.com/en/players/5c4bf6ba/Robin-Zentner"
2021,"Manchester City","Premier League","Sergio Agüero","ARG","FW","32",1988,6.2,4,1,0,2,2,2,11,18.2,9,2,0,2,2,6,0,0,"https://fbref.com/en/players/4d034881/Sergio-Aguero"
2021,"Manchester City","Premier League","Nathan Aké","NED","DF","25",1995,8.9,10,5,3,6,1,3,4,75,1,2,1,1,9,19,23,0,"https://fbref.com/en/players/eaeca114/Nathan-Ake"
2021,"Manchester City","Premier League","João Cancelo","POR","DF,MF","26",1994,25.5,68,41,42,19,7,43,83,51.8,40,23,2,21,41,109,33,2,"https://fbref.com/en/players/bd6351cd/Joao-Cancelo"
2021,"Manchester City","Premier League","Scott Carson","ENG","GK","34",1985,1,0,0,0,0,0,0,0,NA,0,0,0,0,0,0,0,0,"https://fbref.com/en/players/3e1550ee/Scott-Carson"
2021,"Manchester City","Premier League","Kevin De Bruyne","BEL","MF","29",1991,22.2,34,21,6,18,10,13,48,27.1,35,26,1,25,9,43,10,0,"https://fbref.com/en/players/e46012d4/Kevin-De-Bruyne"
2021,"Manchester City","Premier League","Liam Delap","ENG","FW","17",2003,0.4,0,0,0,0,0,0,0,NA,0,0,0,0,0,0,0,0,"https://fbref.com/en/players/dd897ee7/Liam-Delap"
2021,"Manchester City","Premier League","Rúben Dias","POR","DF","23",1997,31.6,24,13,13,8,3,4,16,25,12,31,23,8,35,59,92,0,"https://fbref.com/en/players/31c69ef1/Ruben-Dias"
2021,"Manchester City","Premier League","Ederson","BRA","GK","26",1993,36,3,1,3,0,0,3,4,75,1,0,0,0,0,3,11,4,"https://fbref.com/en/players/3bb7b8b4/Ederson"
2021,"Manchester City","Premier League","Fernandinho","BRA","MF","35",1985,13.2,31,17,8,14,9,20,43,46.5,23,11,2,9,23,54,17,0,"https://fbref.com/en/players/101da2b5/Fernandinho"
2021,"Manchester City","Premier League","Phil Foden","ENG","FW,MF","20",2000,18,22,11,12,8,2,9,23,39.1,14,9,0,9,11,33,11,0,"https://fbref.com/en/players/ed1e53f3/Phil-Foden"
2021,"Manchester City","Premier League","Eric García","ESP","DF","19",2001,4.3,8,7,5,3,0,5,7,71.4,2,4,1,3,4,12,10,0,"https://fbref.com/en/players/2bed3eab/Eric-Garcia"
2021,"Manchester City","Premier League","İlkay Gündoğan","GER","MF","29",1990,22.5,25,15,8,12,5,10,39,25.6,29,13,4,9,20,45,9,0,"https://fbref.com/en/players/819b3158/Ilkay-Gundogan"
2021,"Manchester City","Premier League","Gabriel Jesus","BRA","FW","23",1997,22.9,17,6,5,5,7,11,28,39.3,17,16,0,16,15,32,5,0,"https://fbref.com/en/players/b66315ae/Gabriel-Jesus"
2021,"Manchester City","Premier League","Aymeric Laporte","ESP","DF","26",1994,14.9,13,6,10,3,0,7,11,63.6,4,12,7,5,11,24,28,0,"https://fbref.com/en/players/119b9a8e/Aymeric-Laporte"
2021,"Manchester City","Premier League","Riyad Mahrez","ALG","FW","29",1991,21.7,20,5,2,10,8,6,30,20,24,19,0,19,8,28,4,0,"https://fbref.com/en/players/892d5bb1/Riyad-Mahrez"
2021,"Manchester City","Premier League","Benjamin Mendy","FRA","DF","26",1994,10.6,13,9,1,8,4,5,21,23.8,16,12,5,7,5,18,14,1,"https://fbref.com/en/players/5271c8f1/Benjamin-Mendy"
2021,"Manchester City","Premier League","Rodri","ESP","MF","24",1996,30.5,72,40,24,40,8,33,66,50,33,23,9,14,36,108,54,3,"https://fbref.com/en/players/6434f10d/Rodri"
2021,"Manchester City","Premier League","Bernardo Silva","POR","MF,FW","25",1994,22.9,26,14,7,12,7,11,52,21.2,41,17,1,16,17,43,8,0,"https://fbref.com/en/players/3eb22ec9/Bernardo-Silva"
2021,"Manchester City","Premier League","Zack Steffen","USA","GK","25",1995,1,0,0,0,0,0,0,0,NA,0,0,0,0,0,0,0,0,"https://fbref.com/en/players/42130443/Zack-Steffen"
2021,"Manchester City","Premier League","Raheem Sterling","ENG","FW","25",1994,28.2,21,10,5,12,4,5,12,41.7,7,15,0,15,15,36,4,0,"https://fbref.com/en/players/b400bde0/Raheem-Sterling"
2021,"Manchester City","Premier League","John Stones","ENG","DF","26",1994,21.5,21,10,13,5,3,9,14,64.3,5,23,15,8,18,39,56,1,"https://fbref.com/en/players/5eecec3d/John-Stones"
2021,"Manchester City","Premier League","Ferrán Torres","ESP","FW,MF","20",2000,14.5,12,5,4,6,2,5,16,31.3,11,16,0,16,3,15,8,0,"https://fbref.com/en/players/9e1035f8/Ferran-Torres"
2021,"Manchester City","Premier League","Kyle Walker","ENG","DF","30",1990,21.6,29,19,15,12,2,16,24,66.7,8,19,7,12,14,43,28,0,"https://fbref.com/en/players/86dd77d1/Kyle-Walker"
2021,"Manchester City","Premier League","Oleksandr Zinchenko","UKR","DF","23",1996,16.4,25,15,12,9,4,14,24,58.3,10,17,4,13,23,48,28,0,"https://fbref.com/en/players/51cf8561/Oleksandr-Zinchenko"
2021,"Manchester Utd","Premier League","Eric Bailly","CIV","DF","26",1994,10.2,5,5,3,1,1,0,1,0,1,13,11,2,13,18,36,2,"https://fbref.com/en/players/a1232f4e/Eric-Bailly"
2021,"Manchester Utd","Premier League","Donny van de Beek","NED","MF,FW","23",1997,5.8,15,10,2,11,2,7,15,46.7,8,10,1,9,6,21,7,0,"https://fbref.com/en/players/50dc94ce/Donny-van-de-Beek"
2021,"Manchester Utd","Premier League","Edinson Cavani","URU","FW","33",1987,15.3,12,8,1,8,3,2,13,15.4,11,2,0,2,6,18,11,0,"https://fbref.com/en/players/527f063d/Edinson-Cavani"
2021,"Manchester Utd","Premier League","Amad Diallo","CIV","FW","18",2002,1.8,3,3,1,2,0,0,0,NA,0,2,1,1,0,3,1,0,"https://fbref.com/en/players/9dc96f10/Amad-Diallo"
2021,"Manchester Utd","Premier League","Anthony Elanga","SWE","FW","18",2002,1.7,4,2,3,1,0,4,5,80,1,1,1,0,1,5,1,0,"https://fbref.com/en/players/2fba6108/Anthony-Elanga"
2021,"Manchester Utd","Premier League","Bruno Fernandes","POR","MF","25",1994,34.4,57,30,16,29,12,26,100,26,74,38,0,38,26,83,29,0,"https://fbref.com/en/players/507c7bdf/Bruno-Fernandes"
2021,"Manchester Utd","Premier League","Timothy Fosu-Mensah","NED","DF","22",1998,0.9,2,0,1,1,0,1,1,100,0,0,0,0,3,5,1,0,"https://fbref.com/en/players/a9142dc3/Timothy-Fosu-Mensah"
2021,"Manchester Utd","Premier League","Fred","BRA","MF","27",1993,26.6,81,39,39,38,4,29,89,32.6,60,49,9,40,45,126,26,1,"https://fbref.com/en/players/b853e0ad/Fred"
2021,"Manchester Utd","Premier League","David de Gea","ESP","GK","29",1990,25.5,0,0,0,0,0,0,0,NA,0,0,0,0,0,0,8,3,"https://fbref.com/en/players/7ba6d84e/David-de-Gea"
2021,"Manchester Utd","Premier League","Mason Greenwood","ENG","FW","18",2001,20.2,13,10,6,4,3,5,22,22.7,17,9,0,9,5,18,1,0,"https://fbref.com/en/players/58eee997/Mason-Greenwood"
2021,"Manchester Utd","Premier League","Dean Henderson","ENG","GK","23",1997,12.5,1,1,1,0,0,1,2,50,1,0,0,0,0,1,3,2,"https://fbref.com/en/players/e5a76dfe/Dean-Henderson"
2021,"Manchester Utd","Premier League","Odion Ighalo","NGA","FW","31",1989,0.1,0,0,0,0,0,0,1,0,1,0,0,0,0,0,0,0,"https://fbref.com/en/players/03622183/Odion-Ighalo"
2021,"Manchester Utd","Premier League","Daniel James","WAL","FW","22",1997,10.1,15,9,4,7,4,3,18,16.7,15,10,1,9,0,15,6,0,"https://fbref.com/en/players/c931d9f9/Daniel-James"
2021,"Manchester Utd","Premier League","Victor Lindelöf","SWE","DF","26",1994,28.7,22,10,12,10,0,12,24,50,12,22,14,8,30,52,95,1,"https://fbref.com/en/players/f5deef4c/Victor-Lindelof"
2021,"Manchester Utd","Premier League","Harry Maguire","ENG","DF","27",1993,33.9,29,17,19,10,0,18,29,62.1,11,28,23,5,60,89,122,4,"https://fbref.com/en/players/d8931174/Harry-Maguire"
2021,"Manchester Utd","Premier League","Anthony Martial","FRA","FW","24",1995,16.4,2,1,1,1,0,0,10,0,10,17,3,14,1,3,8,0,"https://fbref.com/en/players/8b788c01/Anthony-Martial"
2021,"Manchester Utd","Premier League","Juan Mata","ESP","FW,MF","32",1988,5.7,1,0,1,0,0,0,7,0,7,3,0,3,3,4,3,0,"https://fbref.com/en/players/29733c72/Juan-Mata"
2021,"Manchester Utd","Premier League","Nemanja Matić","SRB","MF","31",1988,12.3,25,11,13,12,0,13,31,41.9,18,19,5,14,22,47,10,3,"https://fbref.com/en/players/eb7822d7/Nemanja-Matic"
2021,"Manchester Utd","Premier League","Scott McTominay","SCO","MF","23",1996,23.7,51,24,23,25,3,23,36,63.9,13,35,10,25,29,80,46,0,"https://fbref.com/en/players/d93c2511/Scott-McTominay"
2021,"Manchester Utd","Premier League","Hannibal Mejbri","TUN","MF","17",2003,0.1,0,0,0,0,0,0,0,NA,0,0,0,0,0,0,0,0,"https://fbref.com/en/players/ca22ccb0/Hannibal-Mejbri"
2021,"Manchester Utd","Premier League","Paul Pogba","FRA","MF,FW","27",1993,21.1,36,26,15,16,5,11,33,33.3,22,24,2,22,26,62,37,0,"https://fbref.com/en/players/867239d3/Paul-Pogba"
2021,"Manchester Utd","Premier League","Marcus Rashford","ENG","FW","22",1997,32.4,18,9,2,8,8,7,27,25.9,20,22,2,20,8,26,10,0,"https://fbref.com/en/players/a1d5bd30/Marcus-Rashford"
2021,"Manchester Utd","Premier League","Luke Shaw","ENG","DF","25",1995,29.5,44,28,21,16,7,21,36,58.3,15,34,9,25,20,64,44,2,"https://fbref.com/en/players/9c94165b/Luke-Shaw"
2021,"Manchester Utd","Premier League","Shola Shoretire","ENG","FW","16",2004,0.1,0,0,0,0,0,0,0,NA,0,0,0,0,0,0,0,0,"https://fbref.com/en/players/00f0482f/Shola-Shoretire"
2021,"Manchester Utd","Premier League","Alex Telles","BRA","DF","27",1992,7.7,14,7,10,3,1,8,17,47.1,9,7,2,5,16,30,20,0,"https://fbref.com/en/players/e73c9bb2/Alex-Telles"
2021,"Manchester Utd","Premier League","William Thomas Fish","ENG","FW","17",2003,0,0,0,0,0,0,0,0,NA,0,0,0,0,0,0,0,0,"https://fbref.com/en/players/b2ee9d2c/William-Thomas-Fish"
2021,"Manchester Utd","Premier League","Axel Tuanzebe","ENG","DF","22",1997,4.5,13,7,5,7,1,8,9,88.9,1,7,5,2,3,16,18,0,"https://fbref.com/en/players/2baec6ce/Axel-Tuanzebe"
2021,"Manchester Utd","Premier League","Aaron Wan-Bissaka","ENG","DF","22",1997,34,88,54,53,29,6,32,45,71.1,13,65,17,48,62,150,84,2,"https://fbref.com/en/players/9e525177/Aaron-Wan-Bissaka"
2021,"Manchester Utd","Premier League","Brandon Williams","ENG","DF","19",2000,2.1,0,0,0,0,0,0,1,0,1,1,0,1,1,1,7,0,"https://fbref.com/en/players/5e74d6c8/Brandon-Williams"
2021,"Marseille","Ligue 1","Marley Aké","FRA","FW","19",2001,1.6,3,3,1,0,2,0,1,0,1,2,0,2,0,3,1,0,"https://fbref.com/en/players/414e1f69/Marley-Ake"
2021,"Marseille","Ligue 1","Jordan Amavi","FRA","DF","26",1994,9,11,9,9,1,1,9,12,75,3,12,2,10,27,38,33,1,"https://fbref.com/en/players/22721b88/Jordan-Amavi"
2021,"Marseille","Ligue 1","Leonardo Balerdi","ARG","DF","21",1999,18.2,29,18,19,7,3,14,31,45.2,17,17,9,8,28,57,65,3,"https://fbref.com/en/players/7c3ed041/Leonardo-Balerdi"
2021,"Marseille","Ligue 1","Darío Benedetto","ARG","FW","30",1990,17.5,6,4,1,4,1,5,13,38.5,8,9,2,7,3,9,17,0,"https://fbref.com/en/players/bef0a7ac/Dario-Benedetto"
2021,"Marseille","Ligue 1","Duje Ćaleta-Car","CRO","DF","23",1996,31.3,29,17,19,9,1,17,30,56.7,13,29,22,7,44,73,130,0,"https://fbref.com/en/players/94f8d10c/Duje-Caleta-Car"
2021,"Marseille","Ligue 1","Mickaël Cuisance","FRA","MF","20",1999,11.4,24,11,2,15,7,10,33,30.3,23,13,1,12,3,27,4,0,"https://fbref.com/en/players/5722eced/Mickael-Cuisance"
2021,"Marseille","Ligue 1","Bamba Dieng","SEN","FW,DF","20",2000,1.4,5,3,3,2,0,2,4,50,2,2,0,2,0,5,0,0,"https://fbref.com/en/players/40774c6b/Bamba-Dieng"
2021,"Marseille","Ligue 1","Valère Germain","FRA","FW,MF","30",1990,9.5,8,6,2,4,2,3,11,27.3,8,7,2,5,11,19,22,0,"https://fbref.com/en/players/ea0ff634/Valere-Germain"
2021,"Marseille","Ligue 1","Álvaro González","ESP","DF","30",1990,31.5,26,17,20,6,0,19,31,61.3,12,30,18,12,33,59,119,1,"https://fbref.com/en/players/42dcf26d/Alvaro-Gonzalez"
2021,"Marseille","Ligue 1","Pape Gueye","SEN","MF","21",1999,22.9,49,21,25,19,5,15,45,33.3,30,25,6,19,47,96,34,0,"https://fbref.com/en/players/7155e3e1/Pape-Gueye"
2021,"Marseille","Ligue 1","Luis Henrique","BRA","FW,DF","18",2001,7.5,5,4,3,1,1,4,9,44.4,5,5,1,4,7,12,4,0,"https://fbref.com/en/players/f36d5624/Luis-Henrique"
2021,"Marseille","Ligue 1","Boubacar Kamara","FRA","MF","20",1999,32.2,88,51,31,49,8,40,74,54.1,34,36,13,23,34,122,51,0,"https://fbref.com/en/players/cc77354e/Boubacar-Kamara"
2021,"Marseille","Ligue 1","Saîf-Eddine Khaoui","TUN","FW,DF","25",1995,6.7,19,11,7,6,6,7,16,43.8,9,8,0,8,12,31,1,0,"https://fbref.com/en/players/796b1c41/Saif-Eddine-Khaoui"
2021,"Marseille","Ligue 1","Pol Lirola","ESP","DF,FW","22",1997,17.3,28,16,11,15,2,16,28,57.1,12,18,5,13,25,53,26,0,"https://fbref.com/en/players/ff800ed8/Pol-Lirola"
2021,"Marseille","Ligue 1","Maxime Lopez","FRA","FW,MF","22",1997,1.5,1,1,1,0,0,0,2,0,2,0,0,0,2,3,2,0,"https://fbref.com/en/players/20094685/Maxime-Lopez"
2021,"Marseille","Ligue 1","Steve Mandanda","FRA","GK","35",1985,37,0,0,0,0,0,0,1,0,1,0,0,0,2,2,8,6,"https://fbref.com/en/players/1d2d5cc8/Steve-Mandanda"
2021,"Marseille","Ligue 1","Arkadiusz Milik","POL","FW","26",1994,13.6,14,9,0,7,7,2,12,16.7,10,5,1,4,2,16,9,0,"https://fbref.com/en/players/85613cf0/Arkadiusz-Milik"
2021,"Marseille","Ligue 1","Yuto Nagatomo","JPN","DF","33",1986,17.7,23,16,12,8,3,9,18,50,9,14,3,11,29,52,43,0,"https://fbref.com/en/players/4b6960d2/Yuto-Nagatomo"
2021,"Marseille","Ligue 1","Olivier Ntcham","CMR","MF","24",1996,1.3,1,0,0,1,0,1,3,33.3,2,3,1,2,2,3,3,0,"https://fbref.com/en/players/6554bb97/Olivier-Ntcham"
2021,"Marseille","Ligue 1","Dimitri Payet","FRA","FW,MF","33",1987,26.9,27,17,4,16,7,17,40,42.5,23,19,2,17,8,35,10,0,"https://fbref.com/en/players/58ae47b2/Dimitri-Payet"
2021,"Marseille","Ligue 1","Yohann Pelé","FRA","GK","37",1982,1,0,0,0,0,0,0,0,NA,0,0,0,0,0,0,0,0,"https://fbref.com/en/players/76806215/Yohann-Pele"
2021,"Marseille","Ligue 1","Lucas Perrin","FRA","DF","21",1998,3.4,7,4,4,3,0,5,12,41.7,7,5,4,1,8,15,16,0,"https://fbref.com/en/players/49070d66/Lucas-Perrin"
2021,"Marseille","Ligue 1","Nemanja Radonjić","SRB","FW","24",1996,4.4,6,5,1,2,3,2,12,16.7,10,8,0,8,3,9,1,0,"https://fbref.com/en/players/0630eb63/Nemanja-Radonjic"
2021,"Marseille","Ligue 1","Christopher Rocchia","FRA","DF,FW","22",1998,0.2,1,0,1,0,0,0,2,0,2,0,0,0,0,1,1,0,"https://fbref.com/en/players/aa21406e/Christopher-Rocchia"
2021,"Marseille","Ligue 1","Valentin Rongier","FRA","MF","25",1994,21,93,59,31,55,7,43,85,50.6,42,32,2,30,28,121,21,1,"https://fbref.com/en/players/ed45c4a5/Valentin-Rongier"
2021,"Marseille","Ligue 1","Hiroki Sakai","JPN","DF","30",1990,26.5,81,48,34,35,12,39,51,76.5,12,21,5,16,54,135,65,0,"https://fbref.com/en/players/d63e2912/Hiroki-Sakai"
2021,"Marseille","Ligue 1","Morgan Sanson","FRA","MF","25",1994,9.2,21,12,6,12,3,9,28,32.1,19,12,0,12,9,30,5,0,"https://fbref.com/en/players/6e7f1353/Morgan-Sanson"
2021,"Marseille","Ligue 1","Bouna Sarr","SEN","DF","28",1992,0.8,1,1,0,0,1,1,1,100,0,1,1,0,1,2,1,0,"https://fbref.com/en/players/1a4b9094/Bouna-Sarr"
2021,"Marseille","Ligue 1","Cheick Souaré","FRA","MF","17",2002,0.1,0,0,0,0,0,0,0,NA,0,1,1,0,1,1,0,0,"https://fbref.com/en/players/39c0c75b/Cheick-Souare"
2021,"Marseille","Ligue 1","Kevin Strootman","NED","MF,FW","30",1990,2.6,9,6,5,4,0,4,8,50,4,5,2,3,5,14,7,0,"https://fbref.com/en/players/ef2e5e1a/Kevin-Strootman"
2021,"Marseille","Ligue 1","Florian Thauvin","FRA","FW,MF","27",1993,30.4,40,22,14,21,5,20,54,37,34,26,2,24,14,54,11,0,"https://fbref.com/en/players/2b9fdeea/Florian-Thauvin"
2021,"Metz","Ligue 1","Thierry Ambrose","GLP","FW","23",1997,8.4,7,4,1,1,5,2,12,16.7,10,2,0,2,2,9,4,0,"https://fbref.com/en/players/2945f4b7/Thierry-Ambrose"
2021,"Metz","Ligue 1","Victorien Angban","CIV","MF","23",1996,18.6,36,24,17,15,4,17,42,40.5,25,17,4,13,19,55,9,1,"https://fbref.com/en/players/d8992b84/Victorien-Angban"
2021,"Metz","Ligue 1","Farid Boulaya","ALG","MF,FW","27",1993,31.3,24,16,4,17,3,13,51,25.5,38,19,3,16,12,36,7,0,"https://fbref.com/en/players/a0791826/Farid-Boulaya"
2021,"Metz","Ligue 1","John Boye","GHA","DF","33",1987,33.8,58,34,43,13,2,31,54,57.4,23,36,20,16,80,138,146,1,"https://fbref.com/en/players/861227d2/John-Boye"
2021,"Metz","Ligue 1","Dylan Bronn","TUN","DF","25",1995,37.9,57,37,38,19,0,24,44,54.5,20,31,14,17,44,101,112,0,"https://fbref.com/en/players/edd81e2a/Dylan-Bronn"
2021,"Metz","Ligue 1","Marc-Aurèle Caillard","FRA","GK","26",1994,4,0,0,0,0,0,0,0,NA,0,0,0,0,0,0,2,0,"https://fbref.com/en/players/5ee6e943/Marc-Aurele-Caillard"
2021,"Metz","Ligue 1","Fabien Centonze","FRA","DF","24",1996,35.8,104,68,64,30,10,43,73,58.9,30,62,17,45,112,216,119,1,"https://fbref.com/en/players/3c6bbbab/Fabien-Centonze"
2021,"Metz","Ligue 1","Thomas Delaine","FRA","DF,FW","28",1992,19.8,32,18,19,11,2,20,35,57.1,15,22,5,17,24,56,30,1,"https://fbref.com/en/players/8332db56/Thomas-Delaine"
2021,"Metz","Ligue 1","Habib Diallo","SEN","FW,MF","25",1995,1.6,1,1,0,1,0,1,1,100,0,0,0,0,0,1,5,0,"https://fbref.com/en/players/6605d143/Habib-Diallo"
2021,"Metz","Ligue 1","Mamadou Fofana","MLI","MF,DF","22",1998,11.9,25,11,17,8,0,7,31,22.6,24,14,2,12,18,43,36,0,"https://fbref.com/en/players/4c4ffacc/Mamadou-Fofana"
2021,"Metz","Ligue 1","Vagner Gonçalves","CPV","FW,MF","24",1996,10.7,16,9,5,5,6,2,15,13.3,13,6,0,6,4,20,1,1,"https://fbref.com/en/players/743fd71f/Vagner-Goncalves"
2021,"Metz","Ligue 1","Lamine Gueye","SEN","FW,MF","22",1998,16.2,18,9,4,11,3,7,24,29.2,17,7,2,5,21,39,5,0,"https://fbref.com/en/players/9d5dcc23/Lamine-Gueye"
2021,"Metz","Ligue 1","Boubakar Kouyaté","MLI","DF","23",1997,21.8,60,35,45,15,0,32,58,55.2,26,44,27,17,60,120,132,1,"https://fbref.com/en/players/562a4799/Boubakar-Kouyate"
2021,"Metz","Ligue 1","Aaron Leya Iseka","BEL","FW","22",1997,11.2,6,4,2,3,1,0,4,0,4,4,2,2,0,6,6,0,"https://fbref.com/en/players/29ef0f49/Aaron-Leya-Iseka"
2021,"Metz","Ligue 1","Habib Maïga","CIV","MF","24",1996,29.9,81,52,36,40,5,42,85,49.4,43,37,6,31,49,130,36,0,"https://fbref.com/en/players/e768de1f/Habib-Maiga"
2021,"Metz","Ligue 1","Pape Matar Sarr","SEN","MF","17",2002,17.7,45,29,19,21,5,20,38,52.6,18,24,4,20,27,72,16,0,"https://fbref.com/en/players/feb5d972/Pape-Matar-Sarr"
2021,"Metz","Ligue 1","Youssef Maziz","FRA","MF,FW","22",1998,2.9,2,0,1,1,0,1,5,20,4,1,0,1,6,8,1,0,"https://fbref.com/en/players/514270e8/Youssef-Maziz"
2021,"Metz","Ligue 1","Kévin N'Doram","FRA","MF","24",1996,3.4,3,2,0,3,0,1,3,33.3,2,0,0,0,6,9,2,0,"https://fbref.com/en/players/e50623a0/Kevin-NDoram"
2021,"Metz","Ligue 1","Papa Ndiaga Yade","SEN","FW,MF","20",2000,11.1,15,8,9,2,4,7,20,35,13,9,0,9,4,19,6,0,"https://fbref.com/en/players/87e9c7cd/Papa-Ndiaga-Yade"
2021,"Metz","Ligue 1","Opa Nguette","SEN","FW,MF","26",1994,12.6,15,8,2,8,5,3,10,30,7,14,2,12,1,16,1,0,"https://fbref.com/en/players/75a63397/Opa-Nguette"
2021,"Metz","Ligue 1","Ibrahima Niane","SEN","FW","21",1999,7.4,1,1,0,0,1,1,2,50,1,3,0,3,0,1,8,0,"https://fbref.com/en/players/46faabfa/Ibrahima-Niane"
2021,"Metz","Ligue 1","Alexandre Oukidja","ALG","GK","32",1988,34,0,0,0,0,0,0,1,0,1,1,0,1,0,0,17,3,"https://fbref.com/en/players/ae7d0ecd/Alexandre-Oukidja"
2021,"Metz","Ligue 1","Vincent Pajot","FRA","MF","29",1990,10.2,35,20,19,11,5,10,18,55.6,8,9,2,7,42,77,11,0,"https://fbref.com/en/players/f86ca403/Vincent-Pajot"
2021,"Metz","Ligue 1","Warren Tchimbembé","CGO","MF,FW","22",1998,5.5,7,4,4,3,0,3,9,33.3,6,6,1,5,2,9,3,0,"https://fbref.com/en/players/93b8f9f4/Warren-Tchimbembe"
2021,"Metz","Ligue 1","Cheikh Tidiane Sabaly","SEN","FW","21",1999,0.1,0,0,0,0,0,0,0,NA,0,0,0,0,0,0,0,0,"https://fbref.com/en/players/9ddf7fae/Cheikh-Tidiane-Sabaly"
2021,"Metz","Ligue 1","Boubacar Traoré","MLI","MF","18",2001,0.6,3,2,1,2,0,1,1,100,0,1,0,1,0,3,0,0,"https://fbref.com/en/players/999ceb5f/Boubacar-Traore"
2021,"Metz","Ligue 1","Matthieu Udol","FRA","DF","24",1996,19.2,34,21,18,12,4,17,39,43.6,22,25,5,20,39,73,30,0,"https://fbref.com/en/players/cc41f558/Matthieu-Udol"
2021,"Milan","Serie A","Ismaël Bennacer","ALG","MF","22",1997,14.7,39,18,17,21,1,15,32,46.9,17,10,1,9,20,59,12,0,"https://fbref.com/en/players/db092d3b/Ismael-Bennacer"
2021,"Milan","Serie A","Davide Calabria","ITA","DF","23",1996,29.4,101,64,61,32,8,54,90,60,36,42,9,33,37,138,82,1,"https://fbref.com/en/players/2146785a/Davide-Calabria"
2021,"Milan","Serie A","Hakan Çalhanoğlu","TUR","MF,FW","26",1994,29,26,7,3,17,6,7,28,25,21,21,6,15,15,41,24,1,"https://fbref.com/en/players/cd0fa27b/Hakan-Calhanoglu"
2021,"Milan","Serie A","Samu Castillejo","ESP","FW","25",1995,13.1,24,12,9,14,1,14,40,35,26,21,0,21,6,30,9,0,"https://fbref.com/en/players/130a7a3f/Samu-Castillejo"
2021,"Milan","Serie A","Lorenzo Colombo","ITA","FW","18",2002,1,2,1,1,1,0,0,3,0,3,0,0,0,0,2,3,0,"https://fbref.com/en/players/04df29a5/Lorenzo-Colombo"
2021,"Milan","Serie A","Andrea Conti","ITA","DF","26",1994,0.3,1,1,1,0,0,0,1,0,1,0,0,0,1,2,0,0,"https://fbref.com/en/players/8fef5412/Andrea-Conti"
2021,"Milan","Serie A","Diogo Dalot","POR","DF","21",1999,12.1,32,17,23,6,3,17,34,50,17,18,5,13,25,57,42,0,"https://fbref.com/en/players/d9565625/Diogo-Dalot"
2021,"Milan","Serie A","Brahim Díaz","ESP","MF,FW","20",1999,13.6,18,10,7,7,4,10,23,43.5,13,10,0,10,2,20,2,0,"https://fbref.com/en/players/407feb71/Brahim-Diaz"
2021,"Milan","Serie A","Gianluigi Donnarumma","ITA","GK","21",1999,37,0,0,0,0,0,0,1,0,1,1,0,1,1,1,23,2,"https://fbref.com/en/players/08f5afaa/Gianluigi-Donnarumma"
2021,"Milan","Serie A","Léo Duarte","BRA","DF","24",1996,0.2,1,1,0,1,0,0,0,NA,0,0,0,0,1,2,0,0,"https://fbref.com/en/players/73ddc40c/Leo-Duarte"
2021,"Milan","Serie A","Matteo Gabbia","ITA","DF","20",1999,6.2,9,5,3,6,0,2,2,100,0,8,6,2,3,12,21,0,"https://fbref.com/en/players/c235e803/Matteo-Gabbia"
2021,"Milan","Serie A","Theo Hernández","FRA","DF","22",1997,32.6,48,29,22,21,5,19,38,50,19,29,6,23,34,82,64,5,"https://fbref.com/en/players/d4c9725f/Theo-Hernandez"
2021,"Milan","Serie A","Zlatan Ibrahimović","SWE","FW","38",1981,16.6,5,4,0,4,1,3,6,50,3,5,3,2,6,11,27,1,"https://fbref.com/en/players/4cde5509/Zlatan-Ibrahimovic"
2021,"Milan","Serie A","Pierre Kalulu","FRA","DF","20",2000,8.1,18,14,11,6,1,10,14,71.4,4,9,3,6,19,37,20,0,"https://fbref.com/en/players/85f7d1be/Pierre-Kalulu"
2021,"Milan","Serie A","Franck Kessié","CIV","MF","23",1996,35.8,53,30,28,19,6,20,38,52.6,18,47,15,32,46,99,51,0,"https://fbref.com/en/players/05e19d6a/Franck-Kessie"
2021,"Milan","Serie A","Simon Kjær","DEN","DF","31",1989,26.6,45,26,23,20,2,18,30,60,12,42,26,16,42,87,125,0,"https://fbref.com/en/players/8b8a56ce/Simon-Kjaer"
2021,"Milan","Serie A","Rade Krunić","BIH","MF,FW","26",1993,8,15,12,6,6,3,7,17,41.2,10,12,2,10,10,25,9,0,"https://fbref.com/en/players/817c6964/Rade-Krunic"
2021,"Milan","Serie A","Rafael Leão","POR","FW","21",1999,21.4,13,6,4,7,2,6,15,40,9,17,0,17,4,17,14,1,"https://fbref.com/en/players/20730eae/Rafael-Leao"
2021,"Milan","Serie A","Daniel Maldini","ITA","FW,DF","18",2001,0.3,1,0,0,1,0,0,2,0,2,0,0,0,0,1,0,0,"https://fbref.com/en/players/801831fe/Daniel-Maldini"
2021,"Milan","Serie A","Mario Mandžukić","CRO","FW","34",1986,2.4,7,6,2,4,1,2,3,66.7,1,0,0,0,2,9,3,0,"https://fbref.com/en/players/afa0d4e0/Mario-Mandzukic"
2021,"Milan","Serie A","Soualiho Meïté","FRA","MF","26",1994,6.5,18,10,10,6,2,8,17,47.1,9,9,2,7,8,26,16,0,"https://fbref.com/en/players/5cec2c74/Soualiho-Meite"
2021,"Milan","Serie A","Mateo Musacchio","ARG","DF","29",1990,0.4,2,1,2,0,0,2,3,66.7,1,1,0,1,3,5,0,0,"https://fbref.com/en/players/91899ca8/Mateo-Musacchio"
2021,"Milan","Serie A","Jens Petter Hauge","NOR","FW","20",1999,5.9,7,4,3,3,1,6,10,60,4,4,0,4,1,8,3,0,"https://fbref.com/en/players/12c35abe/Jens-Petter-Hauge"
2021,"Milan","Serie A","Ante Rebić","CRO","FW","26",1993,19.7,26,9,4,8,14,8,37,21.6,29,21,1,20,7,33,17,0,"https://fbref.com/en/players/536cebe5/Ante-Rebic"
2021,"Milan","Serie A","Alessio Romagnoli","ITA","DF","25",1995,21.2,17,7,8,7,2,8,19,42.1,11,29,22,7,24,41,80,0,"https://fbref.com/en/players/3ead85f9/Alessio-Romagnoli"
2021,"Milan","Serie A","Alexis Saelemaekers","BEL","FW","21",1999,22.4,43,26,20,18,5,19,60,31.7,41,29,1,28,25,68,6,0,"https://fbref.com/en/players/ee251371/Alexis-Saelemaekers"
2021,"Milan","Serie A","Ciprian Tătărușanu","ROU","GK","34",1986,1,0,0,0,0,0,0,0,NA,0,0,0,0,0,0,0,1,"https://fbref.com/en/players/b056e3da/Ciprian-Tatarusanu"
2021,"Milan","Serie A","Fikayo Tomori","ENG","DF","22",1997,16.3,28,18,17,9,2,8,14,57.1,6,32,20,12,18,46,61,1,"https://fbref.com/en/players/7edfbb8a/Fikayo-Tomori"
2021,"Milan","Serie A","Sandro Tonali","ITA","MF","20",2000,14.8,28,19,14,13,1,13,28,46.4,15,18,5,13,22,50,18,0,"https://fbref.com/en/players/0db169ae/Sandro-Tonali"
2021,"Monaco","Ligue 1","Ruben Aguilar","FRA","DF,MF","27",1993,24.7,63,37,32,21,10,32,52,61.5,20,30,3,27,47,110,43,1,"https://fbref.com/en/players/3dd738a1/Ruben-Aguilar"
2021,"Monaco","Ligue 1","Jean-Eudes Aholou","CIV","MF","26",1994,0.4,1,0,0,1,0,1,3,33.3,2,0,0,0,1,2,1,0,"https://fbref.com/en/players/48b28bfd/Jean-Eudes-Aholou"
2021,"Monaco","Ligue 1","Benoît Badiashile","FRA","DF","19",2001,31.9,24,17,15,9,0,13,28,46.4,15,21,12,9,58,82,102,4,"https://fbref.com/en/players/06df8256/Benoit-Badiashile"
2021,"Monaco","Ligue 1","Fodé Ballo-Touré","SEN","DF","23",1997,7.4,21,17,9,11,1,6,13,46.2,7,7,0,7,6,27,11,1,"https://fbref.com/en/players/f449640d/Fode-Ballo-Toure"
2021,"Monaco","Ligue 1","Wissam Ben Yedder","FRA","FW","29",1990,29,18,9,2,10,6,3,13,23.1,10,16,0,16,13,31,3,0,"https://fbref.com/en/players/942b4f90/Wissam-Ben-Yedder"
2021,"Monaco","Ligue 1","Giulian Biancone","FRA","DF,MF","20",2000,1,3,3,1,1,1,2,3,66.7,1,1,0,1,1,4,4,0,"https://fbref.com/en/players/de40e38c/Giulian-Biancone"
2021,"Monaco","Ligue 1","Krépin Diatta","SEN","MF,DF","21",1999,4.3,4,3,1,1,2,1,3,33.3,2,5,1,4,4,8,1,0,"https://fbref.com/en/players/8104e41e/Krepin-Diatta"
2021,"Monaco","Ligue 1","Sofiane Diop","FRA","MF,FW","20",2000,22.5,49,34,17,25,7,18,53,34,35,25,1,24,31,80,15,0,"https://fbref.com/en/players/19053e31/Sofiane-Diop"
2021,"Monaco","Ligue 1","Axel Disasi","FRA","DF","22",1998,22.3,29,20,17,12,0,20,35,57.1,15,18,11,7,26,55,66,1,"https://fbref.com/en/players/ad82197c/Axel-Disasi"
2021,"Monaco","Ligue 1","Cesc Fàbregas","ESP","MF,FW","33",1987,9.7,20,12,6,9,5,9,22,40.9,13,11,1,10,13,33,3,0,"https://fbref.com/en/players/33508c78/Cesc-Fabregas"
2021,"Monaco","Ligue 1","Youssouf Fofana","FRA","MF","21",1999,31.9,90,51,31,51,8,42,82,51.2,40,43,7,36,34,124,14,2,"https://fbref.com/en/players/822d51d7/Youssouf-Fofana"
2021,"Monaco","Ligue 1","Willem Geubbels","FRA","MF,FW","18",2001,3.3,12,8,5,7,0,5,13,38.5,8,9,0,9,3,15,5,0,"https://fbref.com/en/players/9836e892/Willem-Geubbels"
2021,"Monaco","Ligue 1","Aleksandr Golovin","RUS","MF,FW","24",1996,11.9,28,16,6,18,4,8,39,20.5,31,21,0,21,11,39,3,0,"https://fbref.com/en/players/3708e9fa/Aleksandr-Golovin"
2021,"Monaco","Ligue 1","Stevan Jovetić","MNE","FW,MF","30",1989,8.9,8,4,2,3,3,3,13,23.1,10,1,0,1,3,11,3,0,"https://fbref.com/en/players/f36c432f/Stevan-Jovetic"
2021,"Monaco","Ligue 1","Benjamin Lecomte","FRA","GK","29",1991,28,0,0,0,0,0,0,2,0,2,1,0,1,2,2,20,1,"https://fbref.com/en/players/2fa2a875/Benjamin-Lecomte"
2021,"Monaco","Ligue 1","Florentino Luís","POR","MF","20",1999,2.7,7,2,4,2,1,6,10,60,4,1,0,1,6,13,2,1,"https://fbref.com/en/players/881cd6be/Florentino-Luis"
2021,"Monaco","Ligue 1","Radosław Majecki","POL","GK","20",1999,1,0,0,0,0,0,0,0,NA,0,0,0,0,0,0,1,0,"https://fbref.com/en/players/20de219a/Radoslaw-Majecki"
2021,"Monaco","Ligue 1","Vito Mannone","ITA","GK","32",1988,9,0,0,0,0,0,0,0,NA,0,0,0,0,0,0,3,1,"https://fbref.com/en/players/c4173f1a/Vito-Mannone"
2021,"Monaco","Ligue 1","Guillermo Maripán","CHI","DF","26",1994,23.2,26,11,17,9,0,15,27,55.6,12,18,11,7,27,53,66,1,"https://fbref.com/en/players/d9764034/Guillermo-Maripan"
2021,"Monaco","Ligue 1","Gelson Martins","POR","MF,FW","25",1995,17.2,41,26,12,16,13,15,37,40.5,22,20,0,20,13,54,8,0,"https://fbref.com/en/players/3ef0fa48/Gelson-Martins"
2021,"Monaco","Ligue 1","Eliot Matazo","BEL","MF","18",2002,3.5,11,5,6,5,0,3,7,42.9,4,1,0,1,1,12,2,0,"https://fbref.com/en/players/15944afd/Eliot-Matazo"
2021,"Monaco","Ligue 1","Chrislain Matsima","FRA","DF,FW","18",2002,3.9,5,4,3,2,0,4,7,57.1,3,3,0,3,4,9,12,0,"https://fbref.com/en/players/cf1ef7ec/Chrislain-Matsima"
2021,"Monaco","Ligue 1","Enzo Millot","FRA","MF","18",2002,0.5,2,0,0,1,1,1,1,100,0,0,0,0,2,4,0,0,"https://fbref.com/en/players/f76022e7/Enzo-Millot"
2021,"Monaco","Ligue 1","Henry Onyekuru","NGA","FW","23",1997,1.6,1,0,1,0,0,1,4,25,3,1,0,1,0,1,0,0,"https://fbref.com/en/players/e90dc1d5/Henry-Onyekuru"
2021,"Monaco","Ligue 1","Strahinja Pavlović","SRB","DF","19",2001,0,0,0,0,0,0,0,0,NA,0,0,0,0,0,0,0,0,"https://fbref.com/en/players/25146df0/Strahinja-Pavlovic"
2021,"Monaco","Ligue 1","Pietro Pellegri","ITA","FW,MF","19",2001,2.6,2,1,0,2,0,0,0,NA,0,1,0,1,0,2,0,0,"https://fbref.com/en/players/a44d3a3c/Pietro-Pellegri"
2021,"Monaco","Ligue 1","Djibril Sidibé","FRA","DF","28",1992,22,58,34,26,29,3,37,52,71.2,15,20,5,15,50,108,37,2,"https://fbref.com/en/players/4c5b714f/Djibril-Sidibe"
2021,"Monaco","Ligue 1","Caio Henrique Oliveira Silva","BRA","DF","23",1997,26.3,50,34,25,20,5,31,51,60.8,20,20,3,17,16,66,37,0,"https://fbref.com/en/players/30af8b93/Caio-Henrique-Oliveira-Silva"
2021,"Monaco","Ligue 1","Aurélien Tchouaméni","FRA","MF","20",2000,34,127,68,47,62,18,48,92,52.2,44,39,11,28,60,187,47,0,"https://fbref.com/en/players/4f255115/Aurelien-Tchouameni"
2021,"Monaco","Ligue 1","Kevin Volland","GER","FW,MF","28",1992,30.8,33,16,11,19,3,8,34,23.5,26,23,0,23,4,37,4,0,"https://fbref.com/en/players/64f69877/Kevin-Volland"
2021,"Montpellier","Ligue 1","Samy Benchamma","FRA","DF,MF","20",2000,0.5,1,1,1,0,0,0,0,NA,0,0,0,0,0,1,1,0,"https://fbref.com/en/players/90c99c5c/Samy-Benchamma"
2021,"Montpellier","Ligue 1","Dimitry Bertaud","FRA","GK","22",1998,8.3,0,0,0,0,0,0,0,NA,0,0,0,0,1,1,2,0,"https://fbref.com/en/players/380a15e2/Dimitry-Bertaud"
2021,"Montpellier","Ligue 1","Joris Chotard","FRA","MF","18",2001,12.9,12,8,5,6,1,6,31,19.4,25,12,3,9,11,23,15,0,"https://fbref.com/en/players/7909ffa4/Joris-Chotard"
2021,"Montpellier","Ligue 1","Daniel Congré","FRA","DF","35",1985,36.6,59,35,45,12,2,36,70,51.4,34,50,33,17,69,128,144,3,"https://fbref.com/en/players/3f5b4635/Daniel-Congre"
2021,"Montpellier","Ligue 1","Nicolas Cozza","FRA","DF","21",1999,15.2,39,30,27,11,1,20,40,50,20,20,11,9,26,65,62,0,"https://fbref.com/en/players/8f325097/Nicolas-Cozza"
2021,"Montpellier","Ligue 1","Sacha Delaye","FRA","MF","18",2002,0.1,0,0,0,0,0,0,1,0,1,0,0,0,1,1,1,0,"https://fbref.com/en/players/e4448c8c/Sacha-Delaye"
2021,"Montpellier","Ligue 1","Andy Delort","ALG","FW","28",1991,27.6,12,7,1,9,2,8,18,44.4,10,11,1,10,4,16,34,0,"https://fbref.com/en/players/d33c706e/Andy-Delort"
2021,"Montpellier","Ligue 1","Keagan Dolly","RSA","MF","27",1993,5,7,2,6,0,1,4,8,50,4,3,0,3,5,12,2,0,"https://fbref.com/en/players/ccb1c3af/Keagan-Dolly"
2021,"Montpellier","Ligue 1","Sepe Elye Wahi","FRA","FW","17",2003,6.2,4,3,2,1,1,1,6,16.7,5,4,0,4,2,6,5,0,"https://fbref.com/en/players/0d7b6576/Sepe-Elye-Wahi"
2021,"Montpellier","Ligue 1","Jordan Ferri","FRA","MF","28",1992,28.6,58,40,34,22,2,31,103,30.1,72,30,5,25,8,66,18,1,"https://fbref.com/en/players/375622c5/Jordan-Ferri"
2021,"Montpellier","Ligue 1","Vitorino Hilton","BRA","DF","42",1977,23.5,15,10,10,4,1,3,14,21.4,11,34,26,8,38,53,104,3,"https://fbref.com/en/players/c4bbea9f/Vitorino-Hilton"
2021,"Montpellier","Ligue 1","Yun Il-lok","KOR","MF,FW","28",1992,3.5,0,0,0,0,0,0,4,0,4,0,0,0,5,5,1,0,"https://fbref.com/en/players/23bf644d/Yun-Il-lok"
2021,"Montpellier","Ligue 1","Gaëtan Laborde","FRA","FW,MF","26",1994,36.2,43,22,21,17,5,16,60,26.7,44,29,3,26,16,59,25,1,"https://fbref.com/en/players/7cdda3bf/Gaetan-Laborde"
2021,"Montpellier","Ligue 1","Damien Le Tallec","FRA","MF,DF","30",1990,13.6,16,10,10,4,2,10,30,33.3,20,15,8,7,25,41,21,2,"https://fbref.com/en/players/8f4d116f/Damien-Le-Tallec"
2021,"Montpellier","Ligue 1","Stephy Mavididi","ENG","FW,MF","22",1998,22.6,18,5,7,10,1,8,23,34.8,15,12,0,12,14,32,6,0,"https://fbref.com/en/players/30144daa/Stephy-Mavididi"
2021,"Montpellier","Ligue 1","Pedro Mendes","POR","DF","29",1990,18.1,21,19,16,5,0,14,21,66.7,7,23,13,10,34,55,58,0,"https://fbref.com/en/players/6690ef25/Pedro-Mendes"
2021,"Montpellier","Ligue 1","Florent Mollet","FRA","MF","28",1991,26.2,20,15,7,11,2,12,47,25.5,35,18,4,14,32,52,9,1,"https://fbref.com/en/players/7e82a78f/Florent-Mollet"
2021,"Montpellier","Ligue 1","Jonas Omlin","SUI","GK","26",1994,29.7,1,1,1,0,0,1,4,25,3,0,0,0,0,1,9,1,"https://fbref.com/en/players/c631f952/Jonas-Omlin"
2021,"Montpellier","Ligue 1","Ambroise Oyongo","CMR","DF","29",1991,6.2,13,6,10,3,0,9,15,60,6,3,2,1,8,21,26,1,"https://fbref.com/en/players/e3e05edf/Ambroise-Oyongo"
2021,"Montpellier","Ligue 1","Mihailo Ristić","SRB","DF","24",1995,24.8,45,22,25,13,7,28,44,63.6,16,30,9,21,26,71,57,0,"https://fbref.com/en/players/ea0aa7e0/Mihailo-Ristic"
2021,"Montpellier","Ligue 1","Junior Sambia","FRA","DF,MF","23",1996,27.2,41,29,20,14,7,26,38,68.4,12,27,14,13,39,80,46,0,"https://fbref.com/en/players/24eb7ed6/Junior-Sambia"
2021,"Montpellier","Ligue 1","Téji Savanier","FRA","MF","28",1991,24.1,49,33,16,25,8,22,73,30.1,51,28,6,22,38,87,15,0,"https://fbref.com/en/players/6bde367b/Teji-Savanier"
2021,"Montpellier","Ligue 1","Petar Škuletić","SRB","FW,MF","30",1990,2.6,3,2,1,2,0,0,5,0,5,4,2,2,0,3,4,0,"https://fbref.com/en/players/d9a66c60/Petar-Skuletic"
2021,"Montpellier","Ligue 1","Arnaud Souquet","FRA","DF","28",1992,13.6,50,33,35,13,2,27,48,56.3,21,15,6,9,17,67,34,0,"https://fbref.com/en/players/4e0afc5d/Arnaud-Souquet"
2021,"Montpellier","Ligue 1","Clément Vidal","FRA","DF","20",2000,1,2,1,1,1,0,2,4,50,2,4,4,0,1,3,6,1,"https://fbref.com/en/players/b2791a55/Clement-Vidal"
2021,"Nantes","Ligue 1","Mehdi Abeid","ALG","MF","27",1992,14.7,34,19,16,14,4,15,30,50,15,9,2,7,20,54,10,0,"https://fbref.com/en/players/a4c3f7af/Mehdi-Abeid"
2021,"Nantes","Ligue 1","Dennis Appiah","FRA","DF","28",1992,17.3,55,34,33,15,7,32,59,54.2,27,23,6,17,25,80,43,0,"https://fbref.com/en/players/feb5d3ab/Dennis-Appiah"
2021,"Nantes","Ligue 1","Jean-Kévin Augustin","FRA","FW","23",1997,0.4,2,0,0,2,0,2,2,100,0,0,0,0,0,2,0,0,"https://fbref.com/en/players/97bfa797/Jean-Kevin-Augustin"
2021,"Nantes","Ligue 1","Ludovic Blas","FRA","MF,FW","22",1997,31,58,30,18,37,3,23,54,42.6,31,33,4,29,21,79,19,0,"https://fbref.com/en/players/6191093d/Ludovic-Blas"
2021,"Nantes","Ligue 1","Jean-Charles Castelletto","CMR","DF","25",1995,21.6,32,18,20,11,1,18,31,58.1,13,25,19,6,42,74,79,0,"https://fbref.com/en/players/e0f3a1f6/Jean-Charles-Castelletto"
2021,"Nantes","Ligue 1","Pedro Chirivella","ESP","MF","23",1997,25.3,26,8,7,13,6,14,49,28.6,35,23,4,19,41,67,19,0,"https://fbref.com/en/players/68a26d51/Pedro-Chirivella"
2021,"Nantes","Ligue 1","Marcus Coco","FRA","MF,FW","24",1996,16.4,36,21,17,15,4,16,36,44.4,20,16,3,13,20,56,17,0,"https://fbref.com/en/players/3010aefb/Marcus-Coco"
2021,"Nantes","Ligue 1","Sébastien Corchia","FRA","DF","29",1990,23,55,30,29,17,9,33,60,55,27,28,10,18,38,93,40,1,"https://fbref.com/en/players/0e7ccfc4/Sebastien-Corchia"
2021,"Nantes","Ligue 1","Kalifa Coulibaly","MLI","FW","28",1991,10.9,3,1,0,1,2,2,8,25,6,3,1,2,2,5,12,0,"https://fbref.com/en/players/9980269a/Kalifa-Coulibaly"
2021,"Nantes","Ligue 1","Renaud Emond","BEL","FW,MF","28",1991,3.9,0,0,0,0,0,0,1,0,1,2,0,2,0,0,1,0,"https://fbref.com/en/players/5c9ac7f0/Renaud-Emond"
2021,"Nantes","Ligue 1","Fábio","BRA","DF","30",1990,16.7,62,37,37,23,2,35,61,57.4,26,29,8,21,37,99,49,0,"https://fbref.com/en/players/bc7b4580/Fabio"
2021,"Nantes","Ligue 1","Andrei Girotto","BRA","DF,MF","28",1992,29.6,65,41,50,15,0,39,70,55.7,31,34,15,19,59,124,103,0,"https://fbref.com/en/players/3befc2b6/Andrei-Girotto"
2021,"Nantes","Ligue 1","Abdoul Kader Bamba","FRA","FW,MF","26",1994,10.2,18,3,7,8,3,11,18,61.1,7,10,0,10,7,25,4,1,"https://fbref.com/en/players/32f3d97e/Abdoul-Kader-Bamba"
2021,"Nantes","Ligue 1","Randal Kolo Muani","FRA","FW","21",1998,33.7,22,14,1,13,8,7,27,25.9,20,15,2,13,8,30,26,0,"https://fbref.com/en/players/c0b3669f/Randal-Kolo-Muani"
2021,"Nantes","Ligue 1","Alban Lafont","FRA","GK","21",1999,38,1,0,1,0,0,1,1,100,0,1,0,1,0,1,14,0,"https://fbref.com/en/players/4e7db402/Alban-Lafont"
2021,"Nantes","Ligue 1","Imran Louza","MAR","MF","21",1999,26.4,55,28,25,26,4,21,69,30.4,48,20,4,16,33,88,15,2,"https://fbref.com/en/players/e1df6989/Imran-Louza"
2021,"Nantes","Ligue 1","Batista Mendy","FRA","MF","20",2000,0.8,1,1,0,1,0,0,1,0,1,3,1,2,1,2,1,0,"https://fbref.com/en/players/e472a6f6/Batista-Mendy"
2021,"Nantes","Ligue 1","Samuel Moutoussamy","COD","FW","23",1996,0.9,0,0,0,0,0,0,1,0,1,1,0,1,0,0,0,0,"https://fbref.com/en/players/af0c835b/Samuel-Moutoussamy"
2021,"Nantes","Ligue 1","Bridge Ndilu","FRA","FW,MF","20",2000,0.5,0,0,0,0,0,0,2,0,2,2,0,2,0,0,0,0,"https://fbref.com/en/players/602fc7b5/Bridge-Ndilu"
2021,"Nantes","Ligue 1","Nicolas Pallois","FRA","DF","32",1987,30.8,58,36,42,14,2,38,72,52.8,34,44,20,24,37,95,155,1,"https://fbref.com/en/players/779847d6/Nicolas-Pallois"
2021,"Nantes","Ligue 1","Roli Pereira de Sa","FRA","FW,MF","23",1996,0.6,4,3,1,3,0,3,4,75,1,2,0,2,0,4,0,0,"https://fbref.com/en/players/60f58477/Roli-Pereira-de-Sa"
2021,"Nantes","Ligue 1","Moses Simon","NGA","FW,MF","25",1995,25.8,27,14,11,9,7,17,36,47.2,19,24,1,23,15,42,15,1,"https://fbref.com/en/players/5f3eaaf5/Moses-Simon"
2021,"Nantes","Ligue 1","Abdoulaye Sylla","GUI","DF","20",2000,0.1,2,1,2,0,0,1,1,100,0,1,0,1,0,2,1,0,"https://fbref.com/en/players/2aeb43f1/Abdoulaye-Sylla"
2021,"Nantes","Ligue 1","Abdoulaye Touré","FRA","MF","26",1994,18.7,28,12,10,16,2,14,31,45.2,17,17,2,15,22,50,19,0,"https://fbref.com/en/players/ef7cd87a/Abdoulaye-Toure"
2021,"Nantes","Ligue 1","Charles Traore","MLI","DF","28",1992,18.9,53,34,30,17,6,27,54,50,27,26,5,21,36,89,65,0,"https://fbref.com/en/players/de488e56/Charles-Traore"
2021,"Napoli","Serie A","Tiemoué Bakayoko","FRA","MF","25",1994,21.8,69,41,21,41,7,23,40,57.5,17,24,2,22,36,105,13,2,"https://fbref.com/en/players/59bf127b/Tiemoue-Bakayoko"
2021,"Napoli","Serie A","Antonio Cioffi","ITA","FW","17",2002,0.1,0,0,0,0,0,0,0,NA,0,1,0,1,1,1,0,0,"https://fbref.com/en/players/3f1107d5/Antonio-Cioffi"
2021,"Napoli","Serie A","Diego Demme","GER","MF","28",1991,17.7,56,32,26,22,8,23,63,36.5,40,14,1,13,11,67,15,1,"https://fbref.com/en/players/dc3fa3b5/Diego-Demme"
2021,"Napoli","Serie A","Giovanni Di Lorenzo","ITA","DF","26",1993,36,79,50,54,21,4,43,75,57.3,32,37,13,24,35,114,64,1,"https://fbref.com/en/players/230a2fac/Giovanni-Di-Lorenzo"
2021,"Napoli","Serie A","Elif Elmas","MKD","MF,FW","20",1999,8.2,15,4,3,6,6,7,12,58.3,5,11,1,10,2,17,10,0,"https://fbref.com/en/players/cf007308/Elif-Elmas"
2021,"Napoli","Serie A","Faouzi Ghoulam","ALG","DF,FW","29",1991,3.2,6,5,3,2,1,0,1,0,1,4,2,2,3,9,1,0,"https://fbref.com/en/players/c5adc293/Faouzi-Ghoulam"
2021,"Napoli","Serie A","Elseid Hysaj","ALB","DF","26",1994,19.6,29,17,16,11,2,17,33,51.5,16,18,4,14,30,59,52,0,"https://fbref.com/en/players/2f3452eb/Elseid-Hysaj"
2021,"Napoli","Serie A","Lorenzo Insigne","ITA","FW","29",1991,31.8,26,18,8,12,6,13,72,18.1,59,30,1,29,37,63,6,1,"https://fbref.com/en/players/2f557579/Lorenzo-Insigne"
2021,"Napoli","Serie A","Kalidou Koulibaly","SEN","DF","29",1991,24.5,36,24,25,7,4,19,32,59.4,13,46,26,20,29,65,64,2,"https://fbref.com/en/players/da974c7b/Kalidou-Koulibaly"
2021,"Napoli","Serie A","Fernando Llorente","ESP","FW,MF","35",1985,0.6,0,0,0,0,0,0,0,NA,0,0,0,0,0,0,0,0,"https://fbref.com/en/players/82dbf623/Fernando-Llorente"
2021,"Napoli","Serie A","Stanislav Lobotka","SVK","MF","25",1994,1.7,1,1,0,1,0,0,1,0,1,1,1,0,0,1,1,1,"https://fbref.com/en/players/e1cbb531/Stanislav-Lobotka"
2021,"Napoli","Serie A","Hirving Lozano","MEX","FW","25",1995,21.8,29,18,10,13,6,10,36,27.8,26,37,1,36,18,47,14,0,"https://fbref.com/en/players/a69e4806/Hirving-Lozano"
2021,"Napoli","Serie A","Nikola Maksimović","SRB","DF","28",1991,13.4,18,9,11,6,1,9,18,50,9,15,6,9,21,39,49,3,"https://fbref.com/en/players/16b9d5cf/Nikola-Maksimovic"
2021,"Napoli","Serie A","Kévin Malcuit","MAR","FW,MF","29",1991,0.4,2,1,2,0,0,0,1,0,1,0,0,0,2,4,2,0,"https://fbref.com/en/players/d6a889ea/Kevin-Malcuit"
2021,"Napoli","Serie A","Kostas Manolas","GRE","DF","29",1991,25.5,31,18,24,7,0,17,24,70.8,7,22,13,9,23,54,82,2,"https://fbref.com/en/players/c707411f/Kostas-Manolas"
2021,"Napoli","Serie A","Alex Meret","ITA","GK","23",1997,22,0,0,0,0,0,0,1,0,1,0,0,0,0,0,5,0,"https://fbref.com/en/players/9413b19f/Alex-Meret"
2021,"Napoli","Serie A","Dries Mertens","BEL","FW,MF","33",1987,16.2,16,14,4,7,5,5,25,20,20,7,1,6,9,25,3,1,"https://fbref.com/en/players/89b2c8a9/Dries-Mertens"
2021,"Napoli","Serie A","Victor Osimhen","NGA","FW","21",1998,17.5,22,15,2,6,14,3,15,20,12,6,0,6,7,29,10,0,"https://fbref.com/en/players/8c90fd7a/Victor-Osimhen"
2021,"Napoli","Serie A","David Ospina","COL","GK","31",1988,16,0,0,0,0,0,0,0,NA,0,0,0,0,0,0,4,0,"https://fbref.com/en/players/82b1198a/David-Ospina"
2021,"Napoli","Serie A","Andrea Petagna","ITA","FW","25",1995,10.7,2,0,0,2,0,2,7,28.6,5,4,0,4,1,3,7,0,"https://fbref.com/en/players/03f946ed/Andrea-Petagna"
2021,"Napoli","Serie A","Matteo Politano","ITA","FW,MF","26",1993,21.2,24,16,13,9,2,11,47,23.4,36,14,1,13,14,38,18,0,"https://fbref.com/en/players/5e861944/Matteo-Politano"
2021,"Napoli","Serie A","Amir Rrahmani","KVX","DF","26",1994,12.2,13,8,7,6,0,6,9,66.7,3,17,14,3,8,21,39,1,"https://fbref.com/en/players/4b3e1a38/Amir-Rrahmani"
2021,"Napoli","Serie A","Mário Rui","POR","DF","29",1991,18.5,24,13,17,6,1,17,33,51.5,16,17,4,13,28,52,29,1,"https://fbref.com/en/players/0b5a292a/Mario-Rui"
2021,"Napoli","Serie A","Fabián Ruiz Peña","ESP","MF","24",1996,28.5,58,31,26,21,11,25,70,35.7,45,33,3,30,36,94,32,1,"https://fbref.com/en/players/c0c7ff58/Fabian-Ruiz-Pena"
2021,"Napoli","Serie A","Piotr Zieliński","POL","MF","26",1994,28,18,10,8,7,3,7,20,35,13,23,4,19,18,36,12,0,"https://fbref.com/en/players/a5296e55/Piotr-Zielinski"
2021,"Newcastle Utd","Premier League","Miguel Almirón","PAR","MF,FW","26",1994,27,49,29,21,25,3,14,56,25,42,23,4,19,25,74,20,1,"https://fbref.com/en/players/862a1c15/Miguel-Almiron"
2021,"Newcastle Utd","Premier League","Elliot Anderson","SCO","MF","17",2002,0,0,0,0,0,0,0,0,NA,0,0,0,0,0,0,0,0,"https://fbref.com/en/players/de31038e/Elliot-Anderson"
2021,"Newcastle Utd","Premier League","Andy Carroll","ENG","FW","31",1989,4.4,3,1,1,1,1,1,8,12.5,7,1,0,1,0,3,14,0,"https://fbref.com/en/players/b581987a/Andy-Carroll"
2021,"Newcastle Utd","Premier League","Ciaran Clark","IRL","DF","30",1989,21,24,14,15,6,3,6,13,46.2,7,27,20,7,29,53,104,1,"https://fbref.com/en/players/2b91cf8e/Ciaran-Clark"
2021,"Newcastle Utd","Premier League","Karl Darlow","ENG","GK","29",1990,25,0,0,0,0,0,0,0,NA,0,0,0,0,0,0,17,0,"https://fbref.com/en/players/cde3309f/Karl-Darlow"
2021,"Newcastle Utd","Premier League","Martin Dúbravka","SVK","GK","31",1989,13,0,0,0,0,0,0,0,NA,0,0,0,0,0,0,3,0,"https://fbref.com/en/players/3a949a25/Martin-Dubravka"
2021,"Newcastle Utd","Premier League","Paul Dummett","WAL","DF","28",1991,13.9,16,7,11,5,0,13,21,61.9,8,12,7,5,16,32,74,0,"https://fbref.com/en/players/3fe6bd8c/Paul-Dummett"
2021,"Newcastle Utd","Premier League","Federico Fernández","ARG","DF","31",1989,23.1,29,22,23,5,1,17,21,81,4,41,31,10,17,46,147,0,"https://fbref.com/en/players/f25b010f/Federico-Fernandez"
2021,"Newcastle Utd","Premier League","Ryan Fraser","SCO","FW,MF","26",1994,10.3,4,1,3,1,0,2,5,40,3,1,0,1,6,10,7,0,"https://fbref.com/en/players/d56543a0/Ryan-Fraser"
2021,"Newcastle Utd","Premier League","Dwight Gayle","ENG","FW,MF","29",1990,5.7,2,0,1,1,0,0,7,0,7,3,1,2,1,3,2,0,"https://fbref.com/en/players/e58a03c6/Dwight-Gayle"
2021,"Newcastle Utd","Premier League","Isaac Hayden","ENG","MF,DF","25",1995,21.6,52,29,23,22,7,14,35,40,21,32,9,23,43,95,47,0,"https://fbref.com/en/players/c951a6df/Isaac-Hayden"
2021,"Newcastle Utd","Premier League","Jeff Hendrick","IRL","MF","28",1992,15.8,8,3,5,3,0,1,13,7.7,12,14,9,5,19,27,18,0,"https://fbref.com/en/players/989d5705/Jeff-Hendrick"
2021,"Newcastle Utd","Premier League","Joelinton","BRA","FW,MF","23",1996,22,33,21,7,21,5,14,37,37.8,23,30,2,28,9,42,24,0,"https://fbref.com/en/players/c17bfb65/Joelinton"
2021,"Newcastle Utd","Premier League","Emil Krafth","SWE","DF","25",1994,14.3,19,8,9,9,1,12,25,48,13,15,9,6,15,34,52,2,"https://fbref.com/en/players/77cf6852/Emil-Krafth"
2021,"Newcastle Utd","Premier League","Jamaal Lascelles","ENG","DF","26",1993,18.1,14,7,5,9,0,3,6,50,3,27,17,10,12,26,86,0,"https://fbref.com/en/players/450ab6fc/Jamaal-Lascelles"
2021,"Newcastle Utd","Premier League","Jamal Lewis","NIR","DF","22",1998,20.4,37,20,23,13,1,16,38,42.1,22,21,7,14,11,48,44,1,"https://fbref.com/en/players/efb9215a/Jamal-Lewis"
2021,"Newcastle Utd","Premier League","Matthew Longstaff","ENG","MF","20",2000,4.2,3,2,2,1,0,2,8,25,6,7,0,7,7,10,2,0,"https://fbref.com/en/players/c0027d2d/Matthew-Longstaff"
2021,"Newcastle Utd","Premier League","Sean Longstaff","ENG","MF","22",1997,15.7,31,14,13,15,3,18,42,42.9,24,26,5,21,19,50,14,2,"https://fbref.com/en/players/a2b105e0/Sean-Longstaff"
2021,"Newcastle Utd","Premier League","Javier Manquillo","ESP","DF","26",1994,9.2,24,14,8,14,2,11,17,64.7,6,8,1,7,9,33,15,1,"https://fbref.com/en/players/758dd7f0/Javier-Manquillo"
2021,"Newcastle Utd","Premier League","Jacob Murphy","ENG","DF,MF","25",1995,18.1,39,24,25,12,2,24,49,49,25,27,3,24,14,53,29,0,"https://fbref.com/en/players/de112b84/Jacob-Murphy"
2021,"Newcastle Utd","Premier League","Matt Ritchie","SCO","DF,MF","30",1989,15,10,3,5,3,2,3,17,17.6,14,17,2,15,12,22,47,0,"https://fbref.com/en/players/71ef519e/Matt-Ritchie"
2021,"Newcastle Utd","Premier League","Allan Saint-Maximin","FRA","FW,MF","23",1997,17.3,16,9,6,9,1,4,9,44.4,5,10,0,10,4,20,2,0,"https://fbref.com/en/players/2b16cb1a/Allan-Saint-Maximin"
2021,"Newcastle Utd","Premier League","Fabian Schär","SUI","DF","28",1991,13.8,13,4,8,5,0,7,19,36.8,12,19,12,7,27,40,52,1,"https://fbref.com/en/players/c8aa95da/Fabian-Schar"
2021,"Newcastle Utd","Premier League","Jonjo Shelvey","ENG","MF","28",1992,29.1,39,14,18,19,2,10,37,27,27,26,14,12,36,75,42,0,"https://fbref.com/en/players/3727dd3c/Jonjo-Shelvey"
2021,"Newcastle Utd","Premier League","Joe Willock","ENG","MF","20",1999,10.9,26,13,16,7,3,9,42,21.4,33,21,3,18,17,43,15,1,"https://fbref.com/en/players/a3b03921/Joe-Willock"
2021,"Newcastle Utd","Premier League","Callum Wilson","ENG","FW","28",1992,23.2,12,5,1,6,5,2,12,16.7,10,10,3,7,7,19,14,0,"https://fbref.com/en/players/c596fcb0/Callum-Wilson"
2021,"Newcastle Utd","Premier League","DeAndre Yedlin","USA","DF","27",1993,4.8,9,4,8,1,0,4,10,40,6,5,1,4,7,16,17,0,"https://fbref.com/en/players/ae0a7ddf/DeAndre-Yedlin"
2021,"Nice","Ligue 1","Youcef Atal","ALG","DF,FW","24",1996,10.6,25,12,11,14,0,13,26,50,13,10,2,8,26,51,12,0,"https://fbref.com/en/players/6a827d8e/Youcef-Atal"
2021,"Nice","Ligue 1","Robson Bambu","BRA","DF","22",1997,11.6,16,11,14,2,0,11,14,78.6,3,8,7,1,10,26,57,0,"https://fbref.com/en/players/d4fa7d01/Robson-Bambu"
2021,"Nice","Ligue 1","Danilo Barbosa","BRA","DF","24",1996,2.8,6,3,5,1,0,4,6,66.7,2,2,1,1,2,8,11,2,"https://fbref.com/en/players/0557ff4f/Danilo-Barbosa"
2021,"Nice","Ligue 1","Salim Ben Seghir","FRA","DF","17",2003,0.1,0,0,0,0,0,0,0,NA,0,0,0,0,0,0,0,0,"https://fbref.com/en/players/1f6298f2/Salim-Ben-Seghir"
2021,"Nice","Ligue 1","Walter Benítez","ARG","GK","27",1993,38,1,1,1,0,0,1,3,33.3,2,1,0,1,1,2,7,2,"https://fbref.com/en/players/8a2248b4/Walter-Benitez"
2021,"Nice","Ligue 1","Hicham Boudaoui","ALG","MF","20",1999,19.3,52,35,20,24,8,26,68,38.2,42,14,4,10,23,75,26,1,"https://fbref.com/en/players/f9d5908e/Hicham-Boudaoui"
2021,"Nice","Ligue 1","Patrick Burner","MTQ","DF","24",1996,0,0,0,0,0,0,0,0,NA,0,0,0,0,0,0,0,0,"https://fbref.com/en/players/8746d5d0/Patrick-Burner"
2021,"Nice","Ligue 1","Alexis Claude-Maurice","FRA","MF,FW","22",1998,21.2,40,19,17,14,9,14,48,29.2,34,16,2,14,14,54,3,0,"https://fbref.com/en/players/741418c3/Alexis-Claude-Maurice"
2021,"Nice","Ligue 1","Racine Coly","SEN","MF","24",1995,0.2,0,0,0,0,0,0,0,NA,0,0,0,0,0,0,0,0,"https://fbref.com/en/players/166a981d/Racine-Coly"
2021,"Nice","Ligue 1","Flavius Daniliuc","AUT","DF","19",2001,16.4,23,15,15,5,3,10,21,47.6,11,17,6,11,14,37,32,0,"https://fbref.com/en/players/7ef972c3/Flavius-Daniliuc"
2021,"Nice","Ligue 1","Dante","BRA","DF","36",1983,8.6,10,5,6,4,0,3,7,42.9,4,6,4,2,10,20,20,0,"https://fbref.com/en/players/fd2bc67d/Dante"
2021,"Nice","Ligue 1","Kasper Dolberg","DEN","FW","22",1997,21.4,6,2,1,3,2,2,11,18.2,9,11,2,9,6,12,19,1,"https://fbref.com/en/players/cc83b74d/Kasper-Dolberg"
2021,"Nice","Ligue 1","Amine Gouiri","FRA","FW,MF","20",2000,30.5,31,18,7,16,8,10,41,24.4,31,22,6,16,17,48,23,0,"https://fbref.com/en/players/aad56ca3/Amine-Gouiri"
2021,"Nice","Ligue 1","Evann Guessand","FRA","FW","19",2001,0.3,0,0,0,0,0,0,1,0,1,1,1,0,1,1,1,0,"https://fbref.com/en/players/b73f17f8/Evann-Guessand"
2021,"Nice","Ligue 1","Hassane Kamara","CIV","DF,FW","26",1994,32.9,65,39,40,16,9,27,49,55.1,22,39,12,27,55,120,61,1,"https://fbref.com/en/players/19a12bed/Hassane-Kamara"
2021,"Nice","Ligue 1","Pierre Lees-Melou","FRA","MF","27",1993,22.9,67,39,33,31,3,25,83,30.1,58,50,14,36,29,96,31,1,"https://fbref.com/en/players/f5044e54/Pierre-Lees-Melou"
2021,"Nice","Ligue 1","Rony Lopes","POR","FW,MF","24",1995,19.8,20,14,4,13,3,6,27,22.2,21,14,3,11,8,28,6,0,"https://fbref.com/en/players/7c2965bb/Rony-Lopes"
2021,"Nice","Ligue 1","Jordan Lotomba","SUI","DF,MF","21",1998,23.6,35,25,19,11,5,20,34,58.8,14,19,7,12,33,68,52,1,"https://fbref.com/en/players/fc4cf6a7/Jordan-Lotomba"
2021,"Nice","Ligue 1","Hicham Mahou","FRA","FW","21",1999,0.4,1,1,1,0,0,1,2,50,1,2,0,2,1,2,0,0,"https://fbref.com/en/players/f329ec76/Hicham-Mahou"
2021,"Nice","Ligue 1","Myziane Maolida","FRA","FW,MF","21",1999,12,13,8,4,4,5,4,11,36.4,7,6,1,5,6,19,4,0,"https://fbref.com/en/players/706a60e1/Myziane-Maolida"
2021,"Nice","Ligue 1","Stanley N'Soki","FRA","DF","21",1999,13.8,27,19,15,9,3,13,22,59.1,9,17,4,13,26,53,38,2,"https://fbref.com/en/players/61590953/Stanley-NSoki"
2021,"Nice","Ligue 1","Dan Ndoye","SUI","FW,MF","19",2000,6.1,7,6,3,4,0,1,8,12.5,7,4,0,4,7,14,4,0,"https://fbref.com/en/players/8e697a8f/Dan-Ndoye"
2021,"Nice","Ligue 1","Andy Pelmard","FRA","DF","20",2000,13.4,18,12,12,5,1,9,12,75,3,11,3,8,20,38,35,0,"https://fbref.com/en/players/f18d7ab2/Andy-Pelmard"
2021,"Nice","Ligue 1","Jeff Reine-Adélaïde","FRA","MF,FW","22",1998,11.8,7,4,1,4,2,2,9,22.2,7,10,1,9,4,11,6,0,"https://fbref.com/en/players/d504b3e1/Jeff-Reine-Adelaide"
2021,"Nice","Ligue 1","William Saliba","FRA","DF","19",2001,20,15,9,8,5,2,5,6,83.3,1,17,16,1,26,41,80,2,"https://fbref.com/en/players/972aeb2a/William-Saliba"
2021,"Nice","Ligue 1","Morgan Schneiderlin","FRA","MF","30",1989,24.4,51,31,21,24,6,20,54,37,34,21,11,10,53,104,46,0,"https://fbref.com/en/players/51b41c5c/Morgan-Schneiderlin"
2021,"Nice","Ligue 1","Malik Sellouki","FRA","FW,MF","20",2000,0.7,0,0,0,0,0,0,1,0,1,2,0,2,2,2,0,0,"https://fbref.com/en/players/c0f706f3/Malik-Sellouki"
2021,"Nice","Ligue 1","Eddy Sylvestre","FRA","FW,MF","20",1999,1.1,1,1,1,0,0,0,1,0,1,1,0,1,1,2,0,0,"https://fbref.com/en/players/ff3a6a60/Eddy-Sylvestre"
2021,"Nice","Ligue 1","Khéphren Thuram-Ulie","FRA","MF","19",2001,16.6,32,16,5,21,6,9,27,33.3,18,21,9,12,18,50,22,1,"https://fbref.com/en/players/7d9397f8/Khephren-Thuram-Ulie"
2021,"Nice","Ligue 1","Jean-Clair Todibo","FRA","DF","20",1999,14.8,25,15,16,9,0,16,31,51.6,15,13,7,6,19,44,48,1,"https://fbref.com/en/players/88f130ed/Jean-Clair-Todibo"
2021,"Nice","Ligue 1","Alexis Trouillet","FRA","MF,FW","19",2000,1.2,5,4,1,4,0,4,5,80,1,0,0,0,3,8,0,0,"https://fbref.com/en/players/0a8d6b91/Alexis-Trouillet"
2021,"Nîmes","Ligue 1","Matteo Ahlinvi","BEN","MF","21",1999,10,26,20,10,14,2,11,39,28.2,28,6,0,6,2,28,8,0,"https://fbref.com/en/players/5ea9ebd4/Matteo-Ahlinvi"
2021,"Nîmes","Ligue 1","Sofiane Alakouch","MAR","DF","22",1998,16.7,53,33,30,16,7,29,45,64.4,16,17,2,15,21,74,38,0,"https://fbref.com/en/players/5314e067/Sofiane-Alakouch"
2021,"Nîmes","Ligue 1","Karim Aribi","ALG","FW","26",1994,3.3,2,2,0,1,1,0,5,0,5,1,0,1,0,2,3,0,"https://fbref.com/en/players/08534272/Karim-Aribi"
2021,"Nîmes","Ligue 1","Sami Ben Amar","MAR","MF","22",1998,0.1,0,0,0,0,0,0,0,NA,0,1,0,1,0,0,0,0,"https://fbref.com/en/players/c05d65d1/Sami-Ben-Amar"
2021,"Nîmes","Ligue 1","Yassine Benrahou","FRA","MF","21",1999,13.8,16,9,8,6,2,7,25,28,18,9,0,9,4,20,5,1,"https://fbref.com/en/players/fbf76716/Yassine-Benrahou"
2021,"Nîmes","Ligue 1","Anthony Briançon","FRA","DF","25",1994,13.6,12,7,9,3,0,9,19,47.4,10,19,12,7,33,45,57,2,"https://fbref.com/en/players/16324e1d/Anthony-Briancon"
2021,"Nîmes","Ligue 1","Lucas Buadés","FRA","MF","22",1997,0.2,1,0,0,1,0,0,0,NA,0,0,0,0,0,1,0,0,"https://fbref.com/en/players/f9921b7f/Lucas-Buades"
2021,"Nîmes","Ligue 1","Patrick Burner","MTQ","DF","24",1996,14.6,25,11,14,10,1,13,26,50,13,10,3,7,24,49,41,1,"https://fbref.com/en/players/8746d5d0/Patrick-Burner"
2021,"Nîmes","Ligue 1","Nassim Chadli","FRA","FW,MF","19",2001,0.3,2,1,2,0,0,0,1,0,1,1,0,1,0,2,0,0,"https://fbref.com/en/players/5c61496e/Nassim-Chadli"
2021,"Nîmes","Ligue 1","Andrés Cubas","PAR","MF","24",1996,24.9,80,47,30,44,6,33,74,44.6,41,37,10,27,50,130,29,3,"https://fbref.com/en/players/9b40a6ea/Andres-Cubas"
2021,"Nîmes","Ligue 1","Lucas Deaux","FRA","MF,DF","31",1988,19.5,47,32,20,22,5,16,49,32.7,33,20,3,17,20,67,30,4,"https://fbref.com/en/players/44f8c299/Lucas-Deaux"
2021,"Nîmes","Ligue 1","Kevin Denkey","TOG","FW","19",2000,5.8,4,2,0,3,1,0,3,0,3,2,0,2,1,5,2,0,"https://fbref.com/en/players/0d3585b5/Kevin-Denkey"
2021,"Nîmes","Ligue 1","Clément Depres","FRA","FW","25",1994,0.2,0,0,0,0,0,0,0,NA,0,0,0,0,0,0,0,0,"https://fbref.com/en/players/e53ab10b/Clement-Depres"
2021,"Nîmes","Ligue 1","Mahamadou Doucouré","MLI","FW,MF","20",2000,0.5,1,1,1,0,0,1,1,100,0,0,0,0,0,1,0,0,"https://fbref.com/en/players/9826ea33/Mahamadou-Doucoure"
2021,"Nîmes","Ligue 1","Haris Duljević","BIH","MF,FW","26",1993,8.6,15,9,4,7,4,6,22,27.3,16,3,0,3,8,23,1,0,"https://fbref.com/en/players/9b6556d2/Haris-Duljevic"
2021,"Nîmes","Ligue 1","Niclas Eliasson","SWE","MF,FW","24",1995,20,28,14,9,12,7,11,24,45.8,13,20,1,19,23,51,16,0,"https://fbref.com/en/players/0033fb1b/Niclas-Eliasson"
2021,"Nîmes","Ligue 1","Zinedine Ferhat","ALG","FW,MF","27",1993,32.9,36,21,18,9,9,18,39,46.2,21,22,0,22,32,68,38,0,"https://fbref.com/en/players/005c0807/Zinedine-Ferhat"
2021,"Nîmes","Ligue 1","Lamine Fomba","FRA","MF","22",1998,24.2,66,36,30,25,11,30,65,46.2,35,48,19,29,59,125,39,2,"https://fbref.com/en/players/2145368f/Lamine-Fomba"
2021,"Nîmes","Ligue 1","Kelyan Guessoum","FRA","DF","21",1999,12.5,13,7,11,1,1,11,16,68.8,5,8,6,2,24,37,51,0,"https://fbref.com/en/players/fe296c72/Kelyan-Guessoum"
2021,"Nîmes","Ligue 1","Moussa Koné","SEN","FW","23",1996,19.5,13,6,1,8,4,2,9,22.2,7,7,1,6,2,15,7,0,"https://fbref.com/en/players/3ef68782/Moussa-Kone"
2021,"Nîmes","Ligue 1","Loïck Landre","FRA","DF","28",1992,18.1,14,7,9,5,0,13,28,46.4,15,22,19,3,31,45,52,0,"https://fbref.com/en/players/08082af0/Loick-Landre"
2021,"Nîmes","Ligue 1","Marco Majouga","FRA","FW,MF","19",2001,1.4,1,1,1,0,0,1,3,33.3,2,0,0,0,0,1,0,0,"https://fbref.com/en/players/a27ecdc2/Marco-Majouga"
2021,"Nîmes","Ligue 1","Pablo Martinez","FRA","DF","31",1989,6,10,7,7,3,0,7,7,100,0,6,4,2,11,21,28,0,"https://fbref.com/en/players/1ad8cb67/Pablo-Martinez"
2021,"Nîmes","Ligue 1","Birger Meling","NOR","DF","25",1994,25.9,49,31,27,15,7,33,50,66,17,43,9,34,36,85,70,0,"https://fbref.com/en/players/70c52749/Birger-Meling"
2021,"Nîmes","Ligue 1","Florian Miguel","FRA","DF","23",1996,17.1,14,13,12,2,0,9,17,52.9,8,21,13,8,45,59,66,1,"https://fbref.com/en/players/b66d1d8a/Florian-Miguel"
2021,"Nîmes","Ligue 1","Gaëtan Paquiez","FRA","DF","26",1994,11.6,21,12,12,7,2,12,29,41.4,17,10,3,7,16,37,28,0,"https://fbref.com/en/players/475583ff/Gaetan-Paquiez"
2021,"Nîmes","Ligue 1","Romain Philippoteaux","FRA","FW,MF","32",1988,2.4,1,1,1,0,0,1,5,20,4,2,0,2,2,3,1,0,"https://fbref.com/en/players/f98b15f0/Romain-Philippoteaux"
2021,"Nîmes","Ligue 1","Baptiste Reynet","FRA","GK","29",1990,38,2,1,2,0,0,2,4,50,2,1,0,1,1,3,9,2,"https://fbref.com/en/players/bcf1b2e9/Baptiste-Reynet"
2021,"Nîmes","Ligue 1","Renaud Ripart","FRA","MF,FW","27",1993,33.9,52,30,25,19,8,26,84,31,58,58,12,46,36,88,53,0,"https://fbref.com/en/players/beae3a73/Renaud-Ripart"
2021,"Nîmes","Ligue 1","Nolan Roux","FRA","FW","32",1988,7.2,7,3,1,4,2,3,8,37.5,5,6,0,6,5,12,4,0,"https://fbref.com/en/players/3071a619/Nolan-Roux"
2021,"Nîmes","Ligue 1","Sidy Sarr","SEN","MF","24",1996,5.1,10,6,4,6,0,2,5,40,3,1,1,0,7,17,4,0,"https://fbref.com/en/players/a0b65401/Sidy-Sarr"
2021,"Nîmes","Ligue 1","Naomichi Ueda","JPN","DF","25",1994,7.9,4,2,3,1,0,4,6,66.7,2,5,4,1,6,10,30,1,"https://fbref.com/en/players/539b4f25/Naomichi-Ueda"
2021,"Nîmes","Ligue 1","Antoine Valerio","FRA","MF","20",1999,0.8,0,0,0,0,0,0,1,0,1,1,0,1,2,2,0,0,"https://fbref.com/en/players/95981861/Antoine-Valerio"
2021,"Osasuna","La Liga","Ezequiel Ávila","ARG","FW,MF","26",1994,2.2,6,2,3,1,2,2,4,50,2,1,0,1,1,7,0,0,"https://fbref.com/en/players/253a06b9/Ezequiel-Avila"
2021,"Osasuna","La Liga","Kike Barja","ESP","MF,FW","23",1997,15.9,10,5,6,1,3,5,24,20.8,19,10,1,9,16,26,8,0,"https://fbref.com/en/players/aad53e64/Kike-Barja"
2021,"Osasuna","La Liga","Darko Brašanac","SRB","MF","28",1992,10.1,10,6,6,4,0,5,16,31.3,11,8,1,7,7,17,10,0,"https://fbref.com/en/players/4accb7e0/Darko-Brasanac"
2021,"Osasuna","La Liga","Ante Budimir","CRO","FW","29",1991,18.1,20,12,2,11,7,4,15,26.7,11,17,4,13,2,22,17,1,"https://fbref.com/en/players/8f3565b3/Ante-Budimir"
2021,"Osasuna","La Liga","Jonathan Calleri","ARG","FW","26",1993,17.2,15,6,2,4,9,3,17,17.6,14,18,2,16,1,16,10,1,"https://fbref.com/en/players/6922f806/Jonathan-Calleri"
2021,"Osasuna","La Liga","Marc Cardona","ESP","FW,DF","25",1995,0.6,1,0,1,0,0,1,1,100,0,0,0,0,0,1,0,0,"https://fbref.com/en/players/b92b456a/Marc-Cardona"
2021,"Osasuna","La Liga","Juan Cruz Armada","ESP","DF","28",1992,21.8,36,22,17,16,3,19,35,54.3,16,19,5,14,15,51,50,0,"https://fbref.com/en/players/a56da3ba/Juan-Cruz-Armada"
2021,"Osasuna","La Liga","Enric Gallego","ESP","FW","33",1986,9,6,3,2,2,2,2,14,14.3,12,5,1,4,1,7,9,0,"https://fbref.com/en/players/82e9b89d/Enric-Gallego"
2021,"Osasuna","La Liga","David García","ESP","DF","26",1994,35,26,17,13,13,0,13,24,54.2,11,36,19,17,59,85,171,0,"https://fbref.com/en/players/3e42f707/David-Garcia"
2021,"Osasuna","La Liga","Rubén García","ESP","MF,FW","27",1993,30.2,50,29,21,22,7,14,45,31.1,31,28,2,26,29,79,20,0,"https://fbref.com/en/players/5c96b017/Ruben-Garcia"
2021,"Osasuna","La Liga","Unai García","ESP","DF","28",1992,13.8,19,9,14,4,1,9,15,60,6,16,8,8,14,33,40,0,"https://fbref.com/en/players/4a633cfe/Unai-Garcia"
2021,"Osasuna","La Liga","Aridane Hernández","EQG","DF","31",1989,22.5,20,11,13,6,1,7,12,58.3,5,22,19,3,34,54,127,1,"https://fbref.com/en/players/132ac341/Aridane-Hernandez"
2021,"Osasuna","La Liga","Sergio Herrera","ESP","GK","27",1993,32.9,0,0,0,0,0,0,2,0,2,0,0,0,3,3,29,3,"https://fbref.com/en/players/a4995f48/Sergio-Herrera"
2021,"Osasuna","La Liga","Jony","ESP","MF,FW","29",1991,9.7,7,3,1,2,4,5,20,25,15,5,0,5,14,21,3,0,"https://fbref.com/en/players/244f57b9/Jony"
2021,"Osasuna","La Liga","Adrián López","ESP","FW,MF","32",1988,5.3,3,3,0,1,2,1,5,20,4,3,0,3,0,3,3,0,"https://fbref.com/en/players/88a359d4/Adrian-Lopez"
2021,"Osasuna","La Liga","Javi Martínez","ESP","MF,FW","20",1999,5.1,9,4,1,6,2,5,12,41.7,7,9,0,9,5,14,4,0,"https://fbref.com/en/players/3672b352/Javi-Martinez"
2021,"Osasuna","La Liga","Jon Moncayola","ESP","MF","22",1998,29.6,61,36,27,23,11,24,67,35.8,43,27,9,18,23,84,38,0,"https://fbref.com/en/players/9939e168/Jon-Moncayola"
2021,"Osasuna","La Liga","Raúl Navas","ESP","DF","32",1988,1.9,6,3,5,1,0,4,6,66.7,2,0,0,0,3,9,13,0,"https://fbref.com/en/players/ad178594/Raul-Navas"
2021,"Osasuna","La Liga","Iñigo Pérez","ESP","MF,DF","32",1988,15,20,10,9,6,5,10,16,62.5,6,12,0,12,15,35,8,1,"https://fbref.com/en/players/bc61cc65/Inigo-Perez"
2021,"Osasuna","La Liga","Juan Pérez","ESP","GK","24",1996,3,0,0,0,0,0,0,0,NA,0,0,0,0,0,0,1,0,"https://fbref.com/en/players/8f29e08b/Juan-Perez"
2021,"Osasuna","La Liga","Jonás Ramalho","ESP","DF","27",1993,3.4,5,4,4,0,1,1,3,33.3,2,3,0,3,2,7,7,0,"https://fbref.com/en/players/be3a0121/Jonas-Ramalho"
2021,"Osasuna","La Liga","Facundo Roncaglia","ARG","DF","33",1987,13.7,25,14,14,11,0,11,20,55,9,11,6,5,25,50,26,0,"https://fbref.com/en/players/51e3954c/Facundo-Roncaglia"
2021,"Osasuna","La Liga","Rubén","ESP","GK","36",1984,2.1,0,0,0,0,0,0,0,NA,0,0,0,0,0,0,1,0,"https://fbref.com/en/players/24279b8b/Ruben"
2021,"Osasuna","La Liga","Manuel Sánchez","ESP","DF","19",2000,10.8,27,15,10,10,7,11,25,44,14,8,0,8,8,35,14,0,"https://fbref.com/en/players/ffacd3d5/Manuel-Sanchez"
2021,"Osasuna","La Liga","Oier Sanjurjo","ESP","MF","34",1986,23.2,39,16,8,27,4,17,60,28.3,43,24,6,18,29,68,41,0,"https://fbref.com/en/players/466824fb/Oier-Sanjurjo"
2021,"Osasuna","La Liga","Roberto Torres","ESP","MF,FW","31",1989,21,15,8,6,5,4,8,29,27.6,21,12,0,12,16,31,13,0,"https://fbref.com/en/players/d733aa38/Roberto-Torres"
2021,"Osasuna","La Liga","Lucas Torró","ESP","MF","26",1994,17.2,32,15,11,19,2,21,34,61.8,13,16,7,9,27,59,43,0,"https://fbref.com/en/players/0e4fef6e/Lucas-Torro"
2021,"Osasuna","La Liga","Nacho Vidal","ESP","DF","25",1995,26.1,56,28,27,22,7,22,31,71,9,39,10,29,43,99,68,0,"https://fbref.com/en/players/3a9c4b7b/Nacho-Vidal"
2021,"Paris S-G","Ligue 1","Mitchel Bakker","NED","DF","20",2000,18.8,38,30,15,14,9,17,26,65.4,9,22,2,20,22,60,20,0,"https://fbref.com/en/players/a8567629/Mitchel-Bakker"
2021,"Paris S-G","Ligue 1","Juan Bernat","ESP","DF","27",1993,2.2,5,3,0,4,1,3,5,60,2,4,0,4,1,6,6,0,"https://fbref.com/en/players/433dc9a2/Juan-Bernat"
2021,"Paris S-G","Ligue 1","Marcin Bułka","POL","GK","20",1999,1,0,0,0,0,0,0,0,NA,0,0,0,0,0,0,0,1,"https://fbref.com/en/players/db87a2c4/Marcin-Bulka"
2021,"Paris S-G","Ligue 1","Colin Dagba","FRA","DF","21",1998,15.1,23,11,4,17,2,14,19,73.7,5,18,5,13,16,39,18,1,"https://fbref.com/en/players/29c02c9f/Colin-Dagba"
2021,"Paris S-G","Ligue 1","Ángel Di María","ARG","FW,MF","32",1988,20.6,26,17,6,8,12,11,45,24.4,34,14,1,13,6,32,7,0,"https://fbref.com/en/players/19cda00b/Angel-Di-Maria"
2021,"Paris S-G","Ligue 1","Abdou Diallo","SEN","DF","24",1996,16.6,16,11,9,5,2,8,13,61.5,5,15,8,7,25,41,36,0,"https://fbref.com/en/players/fc62f087/Abdou-Diallo"
2021,"Paris S-G","Ligue 1","Julian Draxler","GER","MF,FW","26",1993,11.8,13,6,5,6,2,5,20,25,15,4,0,4,14,27,0,0,"https://fbref.com/en/players/1a992676/Julian-Draxler"
2021,"Paris S-G","Ligue 1","Bandiougou Fadiga","FRA","FW,MF","19",2001,0.7,1,0,1,0,0,0,0,NA,0,0,0,0,0,1,0,0,"https://fbref.com/en/players/45bb4303/Bandiougou-Fadiga"
2021,"Paris S-G","Ligue 1","Alessandro Florenzi","ITA","DF","29",1991,17.1,24,16,9,9,6,12,29,41.4,17,7,1,6,17,41,25,0,"https://fbref.com/en/players/e288d4b3/Alessandro-Florenzi"
2021,"Paris S-G","Ligue 1","Idrissa Gana Gueye","SEN","MF","30",1989,17.6,63,35,20,34,9,26,50,52,24,26,7,19,20,83,9,3,"https://fbref.com/en/players/72c812f3/Idrissa-Gana-Gueye"
2021,"Paris S-G","Ligue 1","Ander Herrera","ESP","MF","30",1989,20.6,53,35,17,26,10,30,77,39,47,31,5,26,31,84,22,1,"https://fbref.com/en/players/436a9dd0/Ander-Herrera"
2021,"Paris S-G","Ligue 1","Mauro Icardi","ARG","FW","27",1993,12,6,2,1,2,3,4,13,30.8,9,3,1,2,3,9,7,0,"https://fbref.com/en/players/43b78598/Mauro-Icardi"
2021,"Paris S-G","Ligue 1","Jesé","ESP","FW","27",1993,0.3,0,0,0,0,0,0,1,0,1,0,0,0,0,0,0,0,"https://fbref.com/en/players/4a537185/Jese"
2021,"Paris S-G","Ligue 1","Arnaud Kalimuendo","FRA","FW","18",2002,0.8,0,0,0,0,0,0,0,NA,0,0,0,0,0,0,0,0,"https://fbref.com/en/players/bf4c41f9/Arnaud-Kalimuendo"
2021,"Paris S-G","Ligue 1","Moise Kean","ITA","FW","20",2000,18.9,11,8,2,6,3,3,12,25,9,7,1,6,8,19,10,0,"https://fbref.com/en/players/3d50bcdb/Moise-Kean"
2021,"Paris S-G","Ligue 1","Thilo Kehrer","GER","DF","23",1996,18,31,26,17,11,3,10,26,38.5,16,16,4,12,15,46,37,1,"https://fbref.com/en/players/51dbeea9/Thilo-Kehrer"
2021,"Paris S-G","Ligue 1","Presnel Kimpembe","FRA","DF","24",1995,25.6,46,28,23,19,4,24,34,70.6,10,19,11,8,30,76,61,4,"https://fbref.com/en/players/aef6e670/Presnel-Kimpembe"
2021,"Paris S-G","Ligue 1","Layvin Kurzawa","FRA","DF","27",1992,14.2,26,19,10,10,6,9,28,32.1,19,20,5,15,28,54,26,1,"https://fbref.com/en/players/41e7ef1c/Layvin-Kurzawa"
2021,"Paris S-G","Ligue 1","Marquinhos","BRA","DF","26",1994,23.6,27,21,14,10,3,15,26,57.7,11,21,9,12,27,54,75,2,"https://fbref.com/en/players/d5f2f82b/Marquinhos"
2021,"Paris S-G","Ligue 1","Kylian Mbappé","FRA","FW","21",1998,26.4,4,2,0,1,3,2,9,22.2,7,7,1,6,3,7,4,1,"https://fbref.com/en/players/42fd9c7f/Kylian-Mbappe"
2021,"Paris S-G","Ligue 1","Edouard Michut","FRA","MF","17",2003,0,0,0,0,0,0,0,0,NA,0,0,0,0,0,0,0,0,"https://fbref.com/en/players/fe6c1add/Edouard-Michut"
2021,"Paris S-G","Ligue 1","Kenny Nagera","FRA","FW","18",2002,0,0,0,0,0,0,0,0,NA,0,0,0,0,0,0,0,0,"https://fbref.com/en/players/833ce5f0/Kenny-Nagera"
2021,"Paris S-G","Ligue 1","Keylor Navas","CRC","GK","33",1986,28,0,0,0,0,0,0,0,NA,0,0,0,0,0,0,10,0,"https://fbref.com/en/players/ecada4fc/Keylor-Navas"
2021,"Paris S-G","Ligue 1","Neymar","BRA","MF,FW","28",1992,15.7,14,11,1,6,7,8,37,21.6,29,8,0,8,9,23,0,0,"https://fbref.com/en/players/69384e5d/Neymar"
2021,"Paris S-G","Ligue 1","Leandro Paredes","ARG","MF","26",1994,14.5,30,18,12,15,3,19,39,48.7,20,17,5,12,17,47,13,1,"https://fbref.com/en/players/dff153a4/Leandro-Paredes"
2021,"Paris S-G","Ligue 1","Timothee Pembele","FRA","DF","17",2002,4.3,8,7,4,4,0,5,14,35.7,9,4,0,4,5,13,8,1,"https://fbref.com/en/players/f8ce97ca/Timothee-Pembele"
2021,"Paris S-G","Ligue 1","Danilo Pereira","POR","MF,DF","28",1991,15.9,21,11,6,11,4,6,14,42.9,8,14,6,8,29,50,33,4,"https://fbref.com/en/players/8fd9996f/Danilo-Pereira"
2021,"Paris S-G","Ligue 1","Rafinha","BRA","MF,FW","27",1993,15.1,54,26,18,28,8,28,49,57.1,21,18,3,15,13,67,6,0,"https://fbref.com/en/players/0c2ac3cb/Rafinha"
2021,"Paris S-G","Ligue 1","Sergio Rico","ESP","GK","26",1993,9,0,0,0,0,0,0,0,NA,0,0,0,0,0,0,1,0,"https://fbref.com/en/players/5f0241b2/Sergio-Rico"
2021,"Paris S-G","Ligue 1","Kays Ruiz","MAR","FW,MF","17",2002,2.1,1,1,0,1,0,0,4,0,4,1,0,1,3,4,2,0,"https://fbref.com/en/players/90a9cc01/Kays-Ruiz"
2021,"Paris S-G","Ligue 1","Pablo Sarabia","ESP","FW,MF","28",1992,14.7,15,11,6,6,3,10,38,26.3,28,9,1,8,5,20,8,0,"https://fbref.com/en/players/9744ff80/Pablo-Sarabia"
2021,"Paris S-G","Ligue 1","Xavi Simons","NED","MF","17",2003,0,0,0,0,0,0,0,0,NA,0,0,0,0,0,0,0,0,"https://fbref.com/en/players/da4d670f/Xavi-Simons"
2021,"Paris S-G","Ligue 1","Marco Verratti","ITA","MF","27",1992,16.6,53,30,17,25,11,24,72,33.3,48,22,5,17,26,79,4,1,"https://fbref.com/en/players/1467af0d/Marco-Verratti"
2021,"Parma","Serie A","Andrea Adorante","ITA","FW","20",2000,0.1,0,0,0,0,0,0,0,NA,0,0,0,0,0,0,0,0,"https://fbref.com/en/players/7005ac66/Andrea-Adorante"
2021,"Parma","Serie A","Bruno Alves","POR","DF","38",1981,18.1,13,10,10,3,0,7,9,77.8,2,17,12,5,26,39,81,0,"https://fbref.com/en/players/585a73a8/Bruno-Alves"
2021,"Parma","Serie A","Botond Balogh","HUN","DF","18",2002,1.8,9,7,9,0,0,2,5,40,3,4,3,1,2,11,8,0,"https://fbref.com/en/players/348bafd4/Botond-Balogh"
2021,"Parma","Serie A","Mattia Bani","ITA","DF","26",1993,12.7,20,11,15,4,1,4,8,50,4,10,6,4,33,53,50,0,"https://fbref.com/en/players/0821331c/Mattia-Bani"
2021,"Parma","Serie A","Gastón Brugman","URU","MF","27",1992,18,35,19,18,15,2,11,44,25,33,33,4,29,45,80,34,0,"https://fbref.com/en/players/e947ee4a/Gaston-Brugman"
2021,"Parma","Serie A","Juan Brunetta","ARG","FW,MF","23",1997,5.3,2,2,0,2,0,1,6,16.7,5,5,0,5,1,3,2,0,"https://fbref.com/en/players/d60099bc/Juan-Brunetta"
2021,"Parma","Serie A","Maxime Busi","BEL","DF","20",1999,13.3,23,13,19,3,1,11,28,39.3,17,14,1,13,16,39,32,0,"https://fbref.com/en/players/7b082ec2/Maxime-Busi"
2021,"Parma","Serie A","Drissa Camara","CIV","MF","18",2002,0.2,0,0,0,0,0,0,0,NA,0,0,0,0,0,0,0,0,"https://fbref.com/en/players/543d9d2b/Drissa-Camara"
2021,"Parma","Serie A","Simone Colombi","ITA","GK","29",1991,2,0,0,0,0,0,0,0,NA,0,0,0,0,0,0,2,0,"https://fbref.com/en/players/72be9309/Simone-Colombi"
2021,"Parma","Serie A","Andrea Conti","ITA","DF","26",1994,9,21,10,16,4,1,13,26,50,13,13,4,9,16,37,23,0,"https://fbref.com/en/players/8fef5412/Andrea-Conti"
2021,"Parma","Serie A","Andreas Cornelius","DEN","FW","27",1993,21.1,11,4,1,5,5,2,12,16.7,10,9,2,7,1,12,25,1,"https://fbref.com/en/players/c693347d/Andreas-Cornelius"
2021,"Parma","Serie A","Wylan Cyprien","FRA","MF","25",1995,4.6,9,4,5,3,1,2,4,50,2,13,8,5,5,14,6,1,"https://fbref.com/en/players/3e092724/Wylan-Cyprien"
2021,"Parma","Serie A","Matteo Darmian","ITA","DF","30",1989,2.3,6,5,3,3,0,4,7,57.1,3,2,0,2,6,12,7,0,"https://fbref.com/en/players/96e0490d/Matteo-Darmian"
2021,"Parma","Serie A","Kastriot Dermaku","ALB","DF,MF","28",1992,1.1,1,1,1,0,0,0,0,NA,0,2,1,1,2,3,8,0,"https://fbref.com/en/players/2990c466/Kastriot-Dermaku"
2021,"Parma","Serie A","Jacopo Dezi","ITA","FW,MF","28",1992,0.9,4,3,0,2,2,3,6,50,3,2,0,2,0,4,0,0,"https://fbref.com/en/players/e921b9db/Jacopo-Dezi"
2021,"Parma","Serie A","Daan Dierckx","BEL","DF","17",2003,5.2,5,4,5,0,0,3,5,60,2,10,6,4,13,18,21,0,"https://fbref.com/en/players/3a35db3d/Daan-Dierckx"
2021,"Parma","Serie A","Riccardo Gagliolo","SWE","DF","30",1990,21.7,45,18,35,8,2,28,45,62.2,17,34,7,27,36,81,64,1,"https://fbref.com/en/players/173061c0/Riccardo-Gagliolo"
2021,"Parma","Serie A","Gervinho","CIV","FW","33",1987,22.5,5,1,2,2,1,1,14,7.1,13,11,1,10,10,15,3,0,"https://fbref.com/en/players/e468c053/Gervinho"
2021,"Parma","Serie A","Alberto Grassi","ITA","MF,DF","25",1995,13.1,30,11,14,13,3,8,29,27.6,21,22,9,13,26,56,32,0,"https://fbref.com/en/players/6cc97b6a/Alberto-Grassi"
2021,"Parma","Serie A","Hernani","BRA","MF","26",1994,24.3,51,25,21,27,3,29,66,43.9,37,35,4,31,31,82,40,1,"https://fbref.com/en/players/6f5ead86/Hernani"
2021,"Parma","Serie A","Simone Iacoponi","ITA","DF","33",1987,13.3,22,12,16,5,1,13,26,50,13,9,4,5,11,33,42,1,"https://fbref.com/en/players/63071a3f/Simone-Iacoponi"
2021,"Parma","Serie A","Roberto Inglese","ITA","FW","28",1991,6.4,5,2,1,2,2,2,11,18.2,9,10,0,10,0,5,3,0,"https://fbref.com/en/players/6c1f7328/Roberto-Inglese"
2021,"Parma","Serie A","Yann Karamoh","FRA","FW,MF","22",1998,14.4,27,17,8,12,7,11,31,35.5,20,6,0,6,4,31,11,0,"https://fbref.com/en/players/8b66d9cc/Yann-Karamoh"
2021,"Parma","Serie A","Márk Kosznovszky","HUN","MF","18",2002,1,2,2,1,1,0,1,4,25,3,2,0,2,1,3,1,0,"https://fbref.com/en/players/185bf610/Mark-Kosznovszky"
2021,"Parma","Serie A","Juraj Kucka","SVK","MF,FW","33",1987,25.9,67,36,21,37,9,26,74,35.1,48,25,3,22,28,95,25,0,"https://fbref.com/en/players/5aaef9ef/Juraj-Kucka"
2021,"Parma","Serie A","Jasmin Kurtić","SVN","MF","31",1989,30.4,46,28,22,21,3,21,70,30,49,22,2,20,33,79,57,1,"https://fbref.com/en/players/144607cc/Jasmin-Kurtic"
2021,"Parma","Serie A","Vincent Laurini","FRA","DF","31",1989,9.7,16,11,8,6,2,7,9,77.8,2,8,4,4,17,33,22,1,"https://fbref.com/en/players/3535098b/Vincent-Laurini"
2021,"Parma","Serie A","Dennis Man","ROU","FW,MF","21",1998,7.8,12,6,6,4,2,6,21,28.6,15,5,0,5,2,14,6,0,"https://fbref.com/en/players/2079b3cc/Dennis-Man"
2021,"Parma","Serie A","Valentin Mihaila","ROU","FW,MF","20",2000,7.8,2,1,1,1,0,0,10,0,10,8,1,7,5,7,8,0,"https://fbref.com/en/players/81a4c239/Valentin-Mihaila"
2021,"Parma","Serie A","Yordan Osorio","VEN","DF","26",1994,20.1,22,14,13,9,0,9,24,37.5,15,30,18,12,53,75,77,1,"https://fbref.com/en/players/4d17df3e/Yordan-Osorio"
2021,"Parma","Serie A","Graziano Pellè","ITA","FW","35",1985,6.8,2,2,0,1,1,1,8,12.5,7,3,0,3,2,4,8,0,"https://fbref.com/en/players/9654d8de/Graziano-Pelle"
2021,"Parma","Serie A","Giuseppe Pezzella","ITA","DF","22",1997,20.3,34,19,23,9,2,22,41,53.7,19,22,9,13,12,46,52,3,"https://fbref.com/en/players/149c5f5d/Giuseppe-Pezzella"
2021,"Parma","Serie A","Giacomo Ricci","ITA","DF","23",1996,0.7,3,1,1,2,0,0,0,NA,0,2,2,0,1,4,4,0,"https://fbref.com/en/players/cfb38237/Giacomo-Ricci"
2021,"Parma","Serie A","Matteo Scozzarella","ITA","MF","32",1988,1.7,4,0,3,1,0,2,3,66.7,1,3,1,2,6,10,0,0,"https://fbref.com/en/players/ea164f99/Matteo-Scozzarella"
2021,"Parma","Serie A","Luigi Sepe","ITA","GK","29",1991,36,0,0,0,0,0,0,2,0,2,0,0,0,2,2,13,2,"https://fbref.com/en/players/343f753a/Luigi-Sepe"
2021,"Parma","Serie A","Luca Siligardi","ITA","FW,MF","32",1988,0.4,0,0,0,0,0,0,2,0,2,0,0,0,0,0,0,0,"https://fbref.com/en/players/1cac99dc/Luca-Siligardi"
2021,"Parma","Serie A","Simon Sohm","SUI","MF","19",2001,10,18,12,11,6,1,11,26,42.3,15,8,0,8,5,23,7,0,"https://fbref.com/en/players/a5f458d9/Simon-Sohm"
2021,"Parma","Serie A","Mattia Sprocati","ITA","MF,FW","27",1993,0.2,1,0,0,1,0,1,1,100,0,0,0,0,1,2,0,0,"https://fbref.com/en/players/bdd0692f/Mattia-Sprocati"
2021,"Parma","Serie A","Chaka Traorè","CIV","FW,DF","15",2004,0.2,0,0,0,0,0,0,0,NA,0,0,0,0,0,0,1,1,"https://fbref.com/en/players/ee6e2b92/Chaka-Traore"
2021,"Parma","Serie A","Lautaro Valenti","ARG","DF","21",1999,5.5,10,4,7,2,1,6,15,40,9,11,3,8,11,21,30,0,"https://fbref.com/en/players/55db5c36/Lautaro-Valenti"
2021,"Parma","Serie A","Vasilios Zagaritis","GRE","DF","19",2001,0.7,0,0,0,0,0,0,0,NA,0,1,0,1,0,0,0,0,"https://fbref.com/en/players/b4a3d61a/Vasilios-Zagaritis"
2021,"Parma","Serie A","Joshua Zirkzee","NED","FW,MF","19",2001,1.3,2,2,1,1,0,1,3,33.3,2,1,1,0,0,2,1,0,"https://fbref.com/en/players/028e70b9/Joshua-Zirkzee"
2021,"RB Leipzig","Bundesliga","Tyler Adams","USA","MF,DF","21",1999,20.6,35,24,12,15,8,17,31,54.8,14,22,5,17,29,64,30,0,"https://fbref.com/en/players/2b09d998/Tyler-Adams"
2021,"RB Leipzig","Bundesliga","Angeliño","ESP","DF,FW","23",1997,24,31,19,10,18,3,13,24,54.2,11,22,1,21,30,61,40,0,"https://fbref.com/en/players/30941e96/Angelino"
2021,"RB Leipzig","Bundesliga","Dennis Borkowski","GER","MF,FW","18",2002,0.1,0,0,0,0,0,0,0,NA,0,1,0,1,0,0,0,0,"https://fbref.com/en/players/78b9e99c/Dennis-Borkowski"
2021,"RB Leipzig","Bundesliga","Emil Forsberg","SWE","FW,MF","28",1991,17.1,11,6,1,6,4,5,27,18.5,22,10,1,9,11,22,4,0,"https://fbref.com/en/players/9a2e0ccc/Emil-Forsberg"
2021,"RB Leipzig","Bundesliga","Péter Gulácsi","HUN","GK","30",1990,33,1,0,1,0,0,1,2,50,1,0,0,0,2,3,7,0,"https://fbref.com/en/players/bcb2ccd8/Peter-Gulacsi"
2021,"RB Leipzig","Bundesliga","Amadou Haidara","MLI","MF,FW","22",1998,21.2,50,28,20,21,9,11,36,30.6,25,33,1,32,30,80,24,0,"https://fbref.com/en/players/92432bc6/Amadou-Haidara"
2021,"RB Leipzig","Bundesliga","Marcel Halstenberg","GER","DF","28",1991,18.3,29,18,20,8,1,19,41,46.3,22,15,3,12,16,45,35,0,"https://fbref.com/en/players/8ff2354e/Marcel-Halstenberg"
2021,"RB Leipzig","Bundesliga","Hwang Hee-chan","KOR","FW,MF","24",1996,5.1,3,2,1,0,2,1,7,14.3,6,4,0,4,1,4,1,0,"https://fbref.com/en/players/169fd162/Hwang-Hee-chan"
2021,"RB Leipzig","Bundesliga","Benjamin Henrichs","GER","DF,MF","23",1997,6,12,7,4,5,3,2,9,22.2,7,9,1,8,8,20,8,0,"https://fbref.com/en/players/0a89e877/Benjamin-Henrichs"
2021,"RB Leipzig","Bundesliga","Kevin Kampl","SVN","MF","29",1990,21.5,38,26,9,24,5,18,35,51.4,17,20,2,18,29,67,14,0,"https://fbref.com/en/players/b825a650/Kevin-Kampl"
2021,"RB Leipzig","Bundesliga","Lukas Klostermann","GER","DF","24",1996,16.1,23,19,8,12,3,11,18,61.1,7,16,6,10,18,41,44,1,"https://fbref.com/en/players/ca8033cb/Lukas-Klostermann"
2021,"RB Leipzig","Bundesliga","Justin Kluivert","NED","FW,MF","21",1999,9,2,1,1,1,0,0,2,0,2,4,0,4,5,7,3,0,"https://fbref.com/en/players/4c3a6744/Justin-Kluivert"
2021,"RB Leipzig","Bundesliga","Ibrahima Konaté","FRA","DF","21",1999,7.7,6,4,2,3,1,2,8,25,6,6,3,3,8,14,24,0,"https://fbref.com/en/players/5ed9b537/Ibrahima-Konate"
2021,"RB Leipzig","Bundesliga","Konrad Laimer","AUT","DF,MF","23",1997,0.9,2,0,0,1,1,0,4,0,4,2,0,2,1,3,0,0,"https://fbref.com/en/players/c1b7847c/Konrad-Laimer"
2021,"RB Leipzig","Bundesliga","Josep Martinez","ESP","GK","22",1998,1,0,0,0,0,0,0,0,NA,0,0,0,0,0,0,0,0,"https://fbref.com/en/players/11d8aff0/Josep-Martinez"
2021,"RB Leipzig","Bundesliga","Nordi Mukiele","FRA","DF","22",1997,18.6,44,30,14,28,2,21,37,56.8,16,33,1,32,23,67,33,2,"https://fbref.com/en/players/ac73ec79/Nordi-Mukiele"
2021,"RB Leipzig","Bundesliga","Christopher Nkunku","FRA","FW,MF","22",1997,21,16,11,3,7,6,8,18,44.4,10,27,1,26,9,25,14,0,"https://fbref.com/en/players/7c56da38/Christopher-Nkunku"
2021,"RB Leipzig","Bundesliga","Dani Olmo","ESP","MF","22",1998,24.4,23,14,6,13,4,4,23,17.4,19,15,0,15,13,36,21,0,"https://fbref.com/en/players/ae44e8e2/Dani-Olmo"
2021,"RB Leipzig","Bundesliga","Willi Orban","HUN","DF","27",1992,26.3,40,26,19,15,6,23,37,62.2,14,29,20,9,40,80,74,0,"https://fbref.com/en/players/20030c06/Willi-Orban"
2021,"RB Leipzig","Bundesliga","Yussuf Poulsen","DEN","FW","26",1994,15,10,6,1,6,3,1,17,5.9,16,16,0,16,6,16,13,0,"https://fbref.com/en/players/d2416c2e/Yussuf-Poulsen"
2021,"RB Leipzig","Bundesliga","Marcel Sabitzer","AUT","MF","26",1994,22.5,29,21,12,16,1,12,37,32.4,25,7,2,5,35,64,27,0,"https://fbref.com/en/players/e280527c/Marcel-Sabitzer"
2021,"RB Leipzig","Bundesliga","Lazar Samardzic","GER","MF","18",2002,2.2,10,7,4,6,0,5,13,38.5,8,6,0,6,2,12,1,0,"https://fbref.com/en/players/217c93a1/Lazar-Samardzic"
2021,"RB Leipzig","Bundesliga","Alexander Sørloth","NOR","FW","24",1995,16,7,5,0,5,2,2,14,14.3,12,13,2,11,3,10,13,0,"https://fbref.com/en/players/e92cd3f7/Alexander-Sorloth"
2021,"RB Leipzig","Bundesliga","Dayot Upamecano","FRA","DF","21",1998,25.9,37,30,18,19,0,14,20,70,6,25,14,11,33,70,74,2,"https://fbref.com/en/players/d248cd8f/Dayot-Upamecano"
2021,"RB Leipzig","Bundesliga","Joscha Wosz","GER","DF","18",2002,0.4,1,1,1,0,0,0,0,NA,0,1,0,1,1,2,0,0,"https://fbref.com/en/players/80c9e555/Joscha-Wosz"
2021,"Real Madrid","La Liga","Sergio Arribas","ESP","MF,FW","18",2001,1.5,3,1,2,1,0,1,3,33.3,2,2,0,2,4,7,2,0,"https://fbref.com/en/players/1e465e70/Sergio-Arribas"
2021,"Real Madrid","La Liga","Marco Asensio","ESP","FW,MF","24",1996,20.8,12,6,7,4,1,3,24,12.5,21,15,0,15,11,23,10,0,"https://fbref.com/en/players/45af8a54/Marco-Asensio"
2021,"Real Madrid","La Liga","Karim Benzema","FRA","FW","32",1987,32.2,8,6,4,2,2,5,15,33.3,10,9,2,7,8,16,24,0,"https://fbref.com/en/players/70d74ece/Karim-Benzema"
2021,"Real Madrid","La Liga","Blanco","ESP","MF,FW","20",2000,2.4,7,2,4,2,1,3,7,42.9,4,6,2,4,3,10,5,0,"https://fbref.com/en/players/506daeac/Blanco"
2021,"Real Madrid","La Liga","Dani Carvajal","ESP","DF","28",1992,10.6,27,20,12,10,5,11,20,55,9,19,1,18,13,40,27,0,"https://fbref.com/en/players/4958bfb2/Dani-Carvajal"
2021,"Real Madrid","La Liga","Casemiro","BRA","MF","28",1992,32.2,84,49,50,30,4,33,73,45.2,40,50,17,33,70,154,62,0,"https://fbref.com/en/players/4d224fe8/Casemiro"
2021,"Real Madrid","La Liga","Víctor Chust","ESP","DF","20",2000,1.1,1,1,0,1,0,0,2,0,2,2,2,0,1,2,5,0,"https://fbref.com/en/players/ec1a731e/Victor-Chust"
2021,"Real Madrid","La Liga","Thibaut Courtois","BEL","GK","28",1992,38,0,0,0,0,0,0,1,0,1,1,0,1,1,1,17,2,"https://fbref.com/en/players/1840e36d/Thibaut-Courtois"
2021,"Real Madrid","La Liga","Hugo Duro","ESP","FW","20",1999,0.6,0,0,0,0,0,0,0,NA,0,1,0,1,0,0,0,0,"https://fbref.com/en/players/37e103f8/Hugo-Duro"
2021,"Real Madrid","La Liga","Miguel Gutiérrez","ESP","DF","19",2001,3.5,4,0,0,3,1,1,7,14.3,6,3,0,3,5,9,5,0,"https://fbref.com/en/players/7e98cff1/Miguel-Gutierrez"
2021,"Real Madrid","La Liga","Eden Hazard","BEL","FW,MF","29",1991,5.9,3,2,1,2,0,0,3,0,3,3,0,3,3,6,0,0,"https://fbref.com/en/players/a39bb753/Eden-Hazard"
2021,"Real Madrid","La Liga","Isco","ESP","MF","28",1992,10.1,13,9,5,5,3,2,14,14.3,12,7,1,6,2,15,2,0,"https://fbref.com/en/players/a0b4bb3e/Isco"
2021,"Real Madrid","La Liga","Luka Jović","SRB","FW","22",1997,1.7,0,0,0,0,0,0,0,NA,0,0,0,0,0,0,0,0,"https://fbref.com/en/players/4d8cd038/Luka-Jovic"
2021,"Real Madrid","La Liga","Vinicius Júnior","BRA","FW","20",2000,21.9,32,22,14,10,8,11,43,25.6,32,28,0,28,7,39,4,0,"https://fbref.com/en/players/7111d552/Vinicius-Junior"
2021,"Real Madrid","La Liga","Toni Kroos","GER","MF","30",1990,23.5,42,22,15,15,12,11,44,25,33,26,6,20,15,57,10,3,"https://fbref.com/en/players/6ce1f46f/Toni-Kroos"
2021,"Real Madrid","La Liga","Marcelo","BRA","DF,MF","32",1988,11.7,25,21,11,6,8,11,24,45.8,13,13,1,12,10,35,15,0,"https://fbref.com/en/players/603116a7/Marcelo"
2021,"Real Madrid","La Liga","Mariano","DOM","FW","26",1993,5.7,4,2,2,1,1,0,9,0,9,3,1,2,0,4,3,0,"https://fbref.com/en/players/5c4dc0ff/Mariano"
2021,"Real Madrid","La Liga","Marvin","ESP","DF,MF","20",2000,1.5,3,2,0,3,0,1,2,50,1,1,0,1,2,5,3,0,"https://fbref.com/en/players/efaefda0/Marvin"
2021,"Real Madrid","La Liga","Borja Mayoral","ESP","FW","23",1997,0.3,0,0,0,0,0,0,1,0,1,0,0,0,0,0,0,0,"https://fbref.com/en/players/64e8ed6d/Borja-Mayoral"
2021,"Real Madrid","La Liga","Ferland Mendy","FRA","DF","25",1995,24.5,26,16,17,6,3,12,24,50,12,16,4,12,26,52,32,1,"https://fbref.com/en/players/3cefcaef/Ferland-Mendy"
2021,"Real Madrid","La Liga","Éder Militão","BRA","DF","22",1998,12.6,20,8,13,6,1,8,14,57.1,6,19,6,13,19,39,42,0,"https://fbref.com/en/players/2784f898/Eder-Militao"
2021,"Real Madrid","La Liga","Luka Modrić","CRO","MF","34",1985,30.4,37,23,18,16,3,13,36,36.1,23,14,2,12,48,85,14,1,"https://fbref.com/en/players/6025fab1/Luka-Modric"
2021,"Real Madrid","La Liga","Nacho","ESP","DF","30",1990,22.2,27,14,13,11,3,12,35,34.3,23,19,9,10,40,67,58,0,"https://fbref.com/en/players/2946f9a1/Nacho"
2021,"Real Madrid","La Liga","Álvaro Odriozola","ESP","DF","24",1995,9.2,14,7,5,8,1,3,5,60,2,6,3,3,6,20,12,1,"https://fbref.com/en/players/1d1691ad/Alvaro-Odriozola"
2021,"Real Madrid","La Liga","Sergio Ramos","ESP","DF","34",1986,14.2,15,12,8,6,1,6,10,60,4,9,5,4,19,34,39,1,"https://fbref.com/en/players/08511d65/Sergio-Ramos"
2021,"Real Madrid","La Liga","Rodrygo","BRA","FW","19",2001,10.9,15,6,10,4,1,2,17,11.8,15,15,0,15,7,22,4,0,"https://fbref.com/en/players/8f5e92a6/Rodrygo"
2021,"Real Madrid","La Liga","Federico Valverde","URU","MF","22",1998,14.8,25,16,9,8,8,10,26,38.5,16,16,2,14,22,47,4,0,"https://fbref.com/en/players/0959c2a2/Federico-Valverde"
2021,"Real Madrid","La Liga","Raphaël Varane","FRA","DF","27",1993,30.2,22,14,16,5,1,10,19,52.6,9,26,18,8,36,58,114,2,"https://fbref.com/en/players/9f8e9423/Raphael-Varane"
2021,"Real Madrid","La Liga","Lucas Vázquez","ESP","DF,FW","29",1991,20.5,61,37,30,22,9,22,52,42.3,30,14,1,13,19,80,31,1,"https://fbref.com/en/players/fd51b456/Lucas-Vazquez"
2021,"Real Madrid","La Liga","Martin Ødegaard","NOR","MF","21",1998,2.6,1,0,0,1,0,1,2,50,1,1,0,1,1,2,0,0,"https://fbref.com/en/players/79300479/Martin-Odegaard"
2021,"Real Sociedad","La Liga","Aritz Arambarri","ESP","DF","22",1998,0.3,1,1,0,1,0,1,2,50,1,0,0,0,0,1,0,0,"https://fbref.com/en/players/f28876e5/Aritz-Arambarri"
2021,"Real Sociedad","La Liga","Ander Barrenetxea","ESP","MF,FW","18",2001,14.5,29,19,5,18,6,9,24,37.5,15,20,0,20,6,35,8,0,"https://fbref.com/en/players/200e89e1/Ander-Barrenetxea"
2021,"Real Sociedad","La Liga","Jon Bautista","ESP","FW","25",1995,4.1,5,3,0,2,3,0,3,0,3,3,1,2,2,7,4,0,"https://fbref.com/en/players/debc6b55/Jon-Bautista"
2021,"Real Sociedad","La Liga","Aritz Elustondo","ESP","DF","26",1994,20.9,30,16,21,7,2,18,22,81.8,4,12,5,7,15,45,63,0,"https://fbref.com/en/players/f7dc2ae5/Aritz-Elustondo"
2021,"Real Sociedad","La Liga","Carlos Fernández","ESP","FW,MF","24",1996,4.3,3,2,0,2,1,1,8,12.5,7,6,1,5,0,3,6,0,"https://fbref.com/en/players/e08647d6/Carlos-Fernandez"
2021,"Real Sociedad","La Liga","Urko González","ESP","MF","19",2001,0.5,0,0,0,0,0,0,1,0,1,1,1,0,0,0,1,0,"https://fbref.com/en/players/c4f5eb61/Urko-Gonzalez"
2021,"Real Sociedad","La Liga","Andoni Gorosabel","ESP","DF","23",1996,26.5,76,43,45,20,11,27,64,42.2,37,25,4,21,23,99,42,0,"https://fbref.com/en/players/6f5f82c0/Andoni-Gorosabel"
2021,"Real Sociedad","La Liga","Ander Guevara","ESP","MF","23",1997,23.1,35,23,15,16,4,15,30,50,15,19,5,14,25,60,35,1,"https://fbref.com/en/players/8e48dc61/Ander-Guevara"
2021,"Real Sociedad","La Liga","Jon Guridi","ESP","MF","25",1995,9.2,19,9,10,6,3,8,22,36.4,14,8,1,7,10,29,9,0,"https://fbref.com/en/players/4c0a6a48/Jon-Guridi"
2021,"Real Sociedad","La Liga","Asier Illarramendi","ESP","MF","30",1990,3.7,5,2,1,4,0,1,5,20,4,2,0,2,5,10,7,0,"https://fbref.com/en/players/5ce0b5ba/Asier-Illarramendi"
2021,"Real Sociedad","La Liga","Alexander Isak","SWE","FW","20",1999,26,9,5,0,3,6,3,8,37.5,5,17,1,16,3,12,7,0,"https://fbref.com/en/players/8e92be30/Alexander-Isak"
2021,"Real Sociedad","La Liga","Adnan Januzaj","BEL","FW,MF","25",1995,11.3,9,8,0,6,3,3,8,37.5,5,7,2,5,3,12,4,0,"https://fbref.com/en/players/4737cebe/Adnan-Januzaj"
2021,"Real Sociedad","La Liga","Willian José","BRA","FW","28",1991,7.7,3,1,0,3,0,1,3,33.3,2,3,1,2,0,3,8,0,"https://fbref.com/en/players/d87e2cae/Willian-Jose"
2021,"Real Sociedad","La Liga","Robin Le Normand","FRA","DF","23",1996,30.5,34,20,25,8,1,9,19,47.4,10,35,24,11,36,70,87,1,"https://fbref.com/en/players/9a64e67e/Robin-Le-Normand"
2021,"Real Sociedad","La Liga","Diego Llorente","ESP","DF","26",1993,1,1,0,1,0,0,1,2,50,1,1,1,0,2,3,5,0,"https://fbref.com/en/players/bba30585/Diego-Llorente"
2021,"Real Sociedad","La Liga","Roberto López","ESP","MF,FW","20",2000,5.6,5,1,1,2,2,2,5,40,3,2,0,2,4,9,6,0,"https://fbref.com/en/players/2a8c9f98/Roberto-Lopez"
2021,"Real Sociedad","La Liga","Mikel Merino","ESP","MF","24",1996,23.9,61,36,14,36,11,18,45,40,27,36,8,28,32,93,26,0,"https://fbref.com/en/players/d080ed5e/Mikel-Merino"
2021,"Real Sociedad","La Liga","Martín Merquelanz","ESP","MF,FW","25",1995,6.1,9,3,3,2,4,2,7,28.6,5,7,1,6,3,12,4,0,"https://fbref.com/en/players/ddd5348b/Martin-Merquelanz"
2021,"Real Sociedad","La Liga","Nacho Monreal","ESP","DF","34",1986,23.1,31,19,17,11,3,7,20,35,13,14,3,11,31,62,43,0,"https://fbref.com/en/players/d4cb83cc/Nacho-Monreal"
2021,"Real Sociedad","La Liga","Aihen Muñoz","ESP","DF","22",1997,13.4,23,16,15,5,3,11,19,57.9,8,12,2,10,10,33,31,0,"https://fbref.com/en/players/228b0d9d/Aihen-Munoz"
2021,"Real Sociedad","La Liga","Roberto Navarro","ESP","MF","18",2002,0.4,1,1,1,0,0,0,2,0,2,0,0,0,1,2,0,0,"https://fbref.com/en/players/c997b942/Roberto-Navarro"
2021,"Real Sociedad","La Liga","Mikel Oyarzabal","ESP","FW,MF","23",1997,26.8,30,17,14,12,4,10,31,32.3,21,30,5,25,15,45,17,0,"https://fbref.com/en/players/8c3c640c/Mikel-Oyarzabal"
2021,"Real Sociedad","La Liga","Jon Pacheco","ESP","DF","19",2001,0.4,0,0,0,0,0,0,0,NA,0,0,0,0,1,1,0,0,"https://fbref.com/en/players/44150beb/Jon-Pacheco"
2021,"Real Sociedad","La Liga","Portu","ESP","FW,MF","28",1992,24.3,18,8,4,10,4,7,36,19.4,29,24,2,22,8,26,5,0,"https://fbref.com/en/players/1bda5842/Portu"
2021,"Real Sociedad","La Liga","Álex Remiro","ESP","GK","25",1995,38,0,0,0,0,0,0,1,0,1,0,0,0,3,3,14,0,"https://fbref.com/en/players/374ee424/Alex-Remiro"
2021,"Real Sociedad","La Liga","Modibo Sagnan","FRA","DF","21",1999,6.9,12,7,6,6,0,4,6,66.7,2,7,2,5,6,18,25,1,"https://fbref.com/en/players/76d679c7/Modibo-Sagnan"
2021,"Real Sociedad","La Liga","David Silva","ESP","MF","34",1986,15.5,19,12,2,14,3,8,21,38.1,13,14,1,13,13,32,8,2,"https://fbref.com/en/players/e2716bd0/David-Silva"
2021,"Real Sociedad","La Liga","Joseba Zaldúa","ESP","DF","28",1992,7.1,15,12,7,5,3,6,18,33.3,12,6,2,4,6,21,13,0,"https://fbref.com/en/players/5ca20b7a/Joseba-Zaldua"
2021,"Real Sociedad","La Liga","Igor Zubeldia","ESP","DF","23",1997,21.8,23,16,15,8,0,8,14,57.1,6,20,13,7,12,35,46,0,"https://fbref.com/en/players/5c7845f6/Igor-Zubeldia"
2021,"Real Sociedad","La Liga","Martín Zubimendi","ESP","MF","21",1999,20.9,41,22,18,20,3,20,34,58.8,14,22,10,12,40,81,39,0,"https://fbref.com/en/players/3ee0dd59/Martin-Zubimendi"
2021,"Reims","Ligue 1","Yunis Abdelhamid","MAR","DF","32",1987,32.1,59,37,36,23,0,26,42,61.9,16,34,15,19,61,120,132,0,"https://fbref.com/en/players/32c2d95f/Yunis-Abdelhamid"
2021,"Reims","Ligue 1","Valon Berisha","KVX","MF","27",1993,18.3,40,23,19,17,4,11,47,23.4,36,14,2,12,25,65,21,1,"https://fbref.com/en/players/d5575935/Valon-Berisha"
2021,"Reims","Ligue 1","El Bilal Touré","MLI","FW","18",2001,13.8,22,12,3,16,3,8,18,44.4,10,8,3,5,6,28,10,1,"https://fbref.com/en/players/47c609d5/El-Bilal-Toure"
2021,"Reims","Ligue 1","Mathieu Cafaro","FRA","MF,FW","23",1997,23,40,17,15,19,6,13,43,30.2,30,11,0,11,17,57,12,0,"https://fbref.com/en/players/2a657da0/Mathieu-Cafaro"
2021,"Reims","Ligue 1","Moreto Cassamã","GNB","MF","22",1998,22.6,49,36,24,23,2,27,49,55.1,22,19,6,13,36,85,33,4,"https://fbref.com/en/players/f54d2149/Moreto-Cassama"
2021,"Reims","Ligue 1","Xavier Chavalerin","FRA","MF","29",1991,28.3,92,50,47,38,7,26,74,35.1,48,43,9,34,43,135,29,1,"https://fbref.com/en/players/279ddf6a/Xavier-Chavalerin"
2021,"Reims","Ligue 1","Thibault De Smet","BEL","DF","22",1998,5.5,11,6,8,3,0,6,15,40,9,8,1,7,6,17,16,0,"https://fbref.com/en/players/5fdcb075/Thibault-De-Smet"
2021,"Reims","Ligue 1","Boulaye Dia","SEN","FW,MF","23",1996,32.6,23,12,3,11,9,4,22,18.2,18,19,5,14,12,35,37,1,"https://fbref.com/en/players/244bc2c8/Boulaye-Dia"
2021,"Reims","Ligue 1","Tristan Dingomé","CMR","MF","29",1991,0.2,0,0,0,0,0,0,1,0,1,0,0,0,0,0,0,0,"https://fbref.com/en/players/92b56413/Tristan-Dingome"
2021,"Reims","Ligue 1","Yehvann Diouf","FRA","GK","20",1999,1.5,0,0,0,0,0,0,0,NA,0,0,0,0,0,0,0,0,"https://fbref.com/en/players/eedea60b/Yehvann-Diouf"
2021,"Reims","Ligue 1","Anastasios Donis","GRE","MF","23",1996,1.1,4,1,2,0,2,1,1,100,0,0,0,0,0,4,0,0,"https://fbref.com/en/players/0f26fd24/Anastasios-Donis"
2021,"Reims","Ligue 1","Fodé Doucouré","MLI","DF","19",2001,3.7,11,8,7,4,0,4,9,44.4,5,2,0,2,4,15,11,0,"https://fbref.com/en/players/1bfe34dc/Fode-Doucoure"
2021,"Reims","Ligue 1","Moussa Doumbia","MLI","MF,FW","25",1994,10,10,6,4,4,2,4,22,18.2,18,5,1,4,10,20,4,0,"https://fbref.com/en/players/6481421d/Moussa-Doumbia"
2021,"Reims","Ligue 1","Mouhamadou Drammeh","FRA","MF","21",1999,1.9,0,0,0,0,0,0,2,0,2,0,0,0,2,2,7,0,"https://fbref.com/en/players/309937e7/Mouhamadou-Drammeh"
2021,"Reims","Ligue 1","Hugo Ekitike","FRA","FW,MF","18",2002,1,1,1,0,0,1,0,1,0,1,0,0,0,0,1,0,0,"https://fbref.com/en/players/5b92d896/Hugo-Ekitike"
2021,"Reims","Ligue 1","Wout Faes","BEL","DF","22",1998,32.2,35,22,26,9,0,20,39,51.3,19,40,31,9,68,103,144,1,"https://fbref.com/en/players/9c221d14/Wout-Faes"
2021,"Reims","Ligue 1","Alexis Flips","FRA","MF,FW","20",2000,0.5,0,0,0,0,0,0,2,0,2,0,0,0,0,0,1,0,"https://fbref.com/en/players/caef7840/Alexis-Flips"
2021,"Reims","Ligue 1","Thomas Foket","BEL","DF","25",1994,36.9,77,43,50,20,7,40,69,58,29,28,7,21,69,146,92,2,"https://fbref.com/en/players/90eb507d/Thomas-Foket"
2021,"Reims","Ligue 1","Fraser Hornby","SCO","FW,MF","20",1999,0.4,0,0,0,0,0,0,0,NA,0,0,0,0,1,1,0,0,"https://fbref.com/en/players/29aee77c/Fraser-Hornby"
2021,"Reims","Ligue 1","Ghislain Konan","CIV","DF","24",1995,29,57,32,35,17,5,32,56,57.1,24,25,11,14,30,87,67,0,"https://fbref.com/en/players/6b2c894b/Ghislain-Konan"
2021,"Reims","Ligue 1","Dereck Kutesa","SUI","MF,FW","22",1997,7.6,15,7,7,3,5,5,14,35.7,9,7,1,6,7,22,3,0,"https://fbref.com/en/players/1b6862e8/Dereck-Kutesa"
2021,"Reims","Ligue 1","Dion Lopy","SEN","MF","18",2002,2.8,1,1,0,1,0,0,0,NA,0,0,0,0,2,3,1,0,"https://fbref.com/en/players/64c14d49/Dion-Lopy"
2021,"Reims","Ligue 1","Dario Maresic","AUT","DF","20",1999,5.7,12,7,8,4,0,8,14,57.1,6,7,2,5,10,22,17,1,"https://fbref.com/en/players/5d93ccee/Dario-Maresic"
2021,"Reims","Ligue 1","Nathanael Mbuku","FRA","MF,FW","18",2002,24.6,33,19,9,13,11,8,28,28.6,20,17,0,17,14,47,10,0,"https://fbref.com/en/players/46750e9c/Nathanael-Mbuku"
2021,"Reims","Ligue 1","Marshall Munetsi","ZIM","MF,DF","24",1996,21.4,35,19,19,14,2,21,41,51.2,20,33,25,8,57,92,85,3,"https://fbref.com/en/players/2acf0cd7/Marshall-Munetsi"
2021,"Reims","Ligue 1","Predrag Rajković","SRB","GK","24",1995,36.5,2,1,2,0,0,2,5,40,3,1,0,1,2,4,17,3,"https://fbref.com/en/players/58ad9383/Predrag-Rajkovic"
2021,"Reims","Ligue 1","Moïse Sakava","CMR","MF","19",2000,0.1,0,0,0,0,0,0,0,NA,0,0,0,0,0,0,0,0,"https://fbref.com/en/players/329e7a13/Moise-Sakava"
2021,"Reims","Ligue 1","Kaj Sierhuis","NED","FW,MF","22",1998,7.2,7,2,1,2,4,2,9,22.2,7,2,1,1,2,9,5,0,"https://fbref.com/en/players/9c2b1f11/Kaj-Sierhuis"
2021,"Reims","Ligue 1","Arber Zeneli","KVX","MF,FW","25",1995,14.3,20,10,11,1,8,8,22,36.4,14,12,1,11,3,23,8,0,"https://fbref.com/en/players/095e4199/Arber-Zeneli"
2021,"Rennes","Ligue 1","Matthis Abline","FRA","FW","17",2003,0,0,0,0,0,0,0,0,NA,0,0,0,0,0,0,0,0,"https://fbref.com/en/players/0e46fa2f/Matthis-Abline"
2021,"Rennes","Ligue 1","Nayef Aguerd","MAR","DF","24",1996,35,37,30,28,9,0,21,33,63.6,12,34,22,12,47,84,102,0,"https://fbref.com/en/players/288e1e13/Nayef-Aguerd"
2021,"Rennes","Ligue 1","Sacha Boey","FRA","DF","19",2000,1.4,3,3,2,1,0,3,4,75,1,0,0,0,2,5,2,0,"https://fbref.com/en/players/6c8ddd52/Sacha-Boey"
2021,"Rennes","Ligue 1","Benjamin Bourigeaud","FRA","MF,FW","26",1994,28.4,40,23,17,16,7,21,71,29.6,50,37,1,36,19,59,25,0,"https://fbref.com/en/players/20e73fac/Benjamin-Bourigeaud"
2021,"Rennes","Ligue 1","Eduardo Camavinga","FRA","MF","17",2002,26.7,98,58,39,48,11,38,77,49.4,39,36,2,34,23,121,15,1,"https://fbref.com/en/players/7b9c2d84/Eduardo-Camavinga"
2021,"Rennes","Ligue 1","Damien Da Silva","FRA","DF","32",1988,29.6,22,13,13,8,1,12,18,66.7,6,17,13,4,44,66,99,1,"https://fbref.com/en/players/1ec7e1c5/Damien-Da-Silva"
2021,"Rennes","Ligue 1","Romain Del Castillo","FRA","MF,FW","24",1996,7.2,30,11,5,14,11,5,25,20,20,6,0,6,3,33,4,1,"https://fbref.com/en/players/0be95d34/Romain-Del-Castillo"
2021,"Rennes","Ligue 1","Andy Diouf","FRA","FW","17",2003,0.1,0,0,0,0,0,0,0,NA,0,0,0,0,0,0,0,0,"https://fbref.com/en/players/9b5237b1/Andy-Diouf"
2021,"Rennes","Ligue 1","Jeremy Doku","BEL","MF,FW","18",2002,25.7,44,25,9,24,11,11,26,42.3,15,18,1,17,11,55,1,0,"https://fbref.com/en/players/fffea3e5/Jeremy-Doku"
2021,"Rennes","Ligue 1","Yann Gboho","FRA","MF,FW","19",2001,3.4,6,3,3,1,2,3,8,37.5,5,1,0,1,1,7,3,1,"https://fbref.com/en/players/6be41a31/Yann-Gboho"
2021,"Rennes","Ligue 1","Alfred Gomis","SEN","GK","26",1993,22,1,1,1,0,0,1,1,100,0,0,0,0,3,4,10,1,"https://fbref.com/en/players/cecbce23/Alfred-Gomis"
2021,"Rennes","Ligue 1","Clément Grenier","FRA","MF,FW","29",1991,12,20,8,9,8,3,7,31,22.6,24,7,0,7,5,25,3,0,"https://fbref.com/en/players/8b298f56/Clement-Grenier"
2021,"Rennes","Ligue 1","Sehrou Guirassy","GUI","FW","24",1996,19.6,4,1,1,3,0,1,3,33.3,2,10,1,9,5,9,17,0,"https://fbref.com/en/players/923f4dda/Sehrou-Guirassy"
2021,"Rennes","Ligue 1","Dalbert Henrique","BRA","DF","26",1993,4.1,7,6,4,2,1,6,8,75,2,8,2,6,5,12,8,0,"https://fbref.com/en/players/f45f9427/Dalbert-Henrique"
2021,"Rennes","Ligue 1","Adrien Hunou","FRA","FW,MF","26",1994,6.5,6,3,2,2,2,2,8,25,6,7,0,7,1,7,2,0,"https://fbref.com/en/players/d14229f3/Adrien-Hunou"
2021,"Rennes","Ligue 1","James Lea Siliki","CMR","MF","24",1996,2.8,5,2,1,3,1,2,2,100,0,3,0,3,1,6,1,1,"https://fbref.com/en/players/7cf431a5/James-Lea-Siliki"
2021,"Rennes","Ligue 1","Faitout Maouassa","FRA","DF","22",1998,13,20,11,10,8,2,11,19,57.9,8,9,1,8,17,37,36,0,"https://fbref.com/en/players/e54a9890/Faitout-Maouassa"
2021,"Rennes","Ligue 1","Jonas Martin","FRA","MF","30",1990,5.4,11,9,5,4,2,5,14,35.7,9,11,2,9,13,24,2,1,"https://fbref.com/en/players/468fdbad/Jonas-Martin"
2021,"Rennes","Ligue 1","Edouard Mendy","SEN","GK","28",1992,1,0,0,0,0,0,0,0,NA,0,0,0,0,0,0,0,0,"https://fbref.com/en/players/33887998/Edouard-Mendy"
2021,"Rennes","Ligue 1","M'Baye Niang","SEN","FW","25",1994,4.7,3,2,2,1,0,0,0,NA,0,2,0,2,1,4,2,0,"https://fbref.com/en/players/2054d037/MBaye-Niang"
2021,"Rennes","Ligue 1","Gerzino Nyamsi","FRA","DF","23",1997,9.7,12,10,2,8,2,4,6,66.7,2,8,5,3,10,22,32,1,"https://fbref.com/en/players/6043997c/Gerzino-Nyamsi"
2021,"Rennes","Ligue 1","Steven Nzonzi","FRA","MF","31",1988,32.3,34,16,15,16,3,12,31,38.7,19,24,10,14,16,50,26,0,"https://fbref.com/en/players/c7526c18/Steven-Nzonzi"
2021,"Rennes","Ligue 1","Raphinha","BRA","FW,MF","23",1996,4.5,5,2,1,3,1,1,4,25,3,5,0,5,3,8,4,0,"https://fbref.com/en/players/3423f250/Raphinha"
2021,"Rennes","Ligue 1","Daniele Rugani","ITA","DF","26",1994,1,0,0,0,0,0,0,1,0,1,1,1,0,1,1,1,0,"https://fbref.com/en/players/14b8fcdf/Daniele-Rugani"
2021,"Rennes","Ligue 1","Georginio Rutter","FRA","FW,MF","18",2002,0.5,2,2,0,1,1,1,3,33.3,2,2,0,2,0,2,0,0,"https://fbref.com/en/players/c64c01fc/Georginio-Rutter"
2021,"Rennes","Ligue 1","Romain Salin","FRA","GK","36",1984,15,0,0,0,0,0,0,1,0,1,0,0,0,1,1,6,3,"https://fbref.com/en/players/74733221/Romain-Salin"
2021,"Rennes","Ligue 1","Brandon Soppy","FRA","DF","18",2002,6.2,21,15,16,5,0,10,16,62.5,6,3,0,3,6,27,12,0,"https://fbref.com/en/players/28f66c2e/Brandon-Soppy"
2021,"Rennes","Ligue 1","Flavien Tait","FRA","MF,FW","27",1993,15.2,26,11,11,12,3,10,32,31.3,22,17,3,14,13,39,2,0,"https://fbref.com/en/players/a0f9b535/Flavien-Tait"
2021,"Rennes","Ligue 1","Martin Terrier","FRA","FW,MF","23",1997,27.1,33,15,5,15,13,10,36,27.8,26,23,0,23,16,49,7,0,"https://fbref.com/en/players/5148dcc5/Martin-Terrier"
2021,"Rennes","Ligue 1","Hamari Traoré","MLI","DF","28",1992,33.3,56,38,23,27,6,22,59,37.3,37,31,5,26,76,132,50,0,"https://fbref.com/en/players/a4b1028a/Hamari-Traore"
2021,"Rennes","Ligue 1","Adrien Truffert","FRA","DF,MF","18",2001,21.7,38,18,18,12,8,13,24,54.2,11,26,5,21,18,56,38,1,"https://fbref.com/en/players/5d0e0a1f/Adrien-Truffert"
2021,"Rennes","Ligue 1","Chimuanya Ugochukwu","FRA","MF","16",2004,0.7,3,1,0,3,0,2,3,66.7,1,1,0,1,0,3,0,0,"https://fbref.com/en/players/1df4a109/Chimuanya-Ugochukwu"
2021,"Roma","Serie A","Edoardo Bove","ITA","MF","18",2002,0.1,0,0,0,0,0,0,1,0,1,0,0,0,0,0,0,0,"https://fbref.com/en/players/ae94a6c5/Edoardo-Bove"
2021,"Roma","Serie A","Riccardo Calafiori","ITA","DF","18",2002,0.7,1,0,1,0,0,1,4,25,3,1,0,1,0,1,0,0,"https://fbref.com/en/players/aded8e6f/Riccardo-Calafiori"
2021,"Roma","Serie A","Bryan Cristante","ITA","DF,MF","25",1995,23.9,27,20,10,14,3,10,28,35.7,18,21,7,14,40,67,61,1,"https://fbref.com/en/players/16657b95/Bryan-Cristante"
2021,"Roma","Serie A","Ebrima Darboe","GAM","MF","19",2001,3.6,5,2,3,1,1,3,10,30,7,3,0,3,8,13,0,1,"https://fbref.com/en/players/cf043a33/Ebrima-Darboe"
2021,"Roma","Serie A","Amadou Diawara","GUI","MF","23",1997,7.3,10,8,4,6,0,2,8,25,6,11,2,9,12,22,4,0,"https://fbref.com/en/players/bf309d24/Amadou-Diawara"
2021,"Roma","Serie A","Edin Džeko","BIH","FW","34",1986,20.3,8,6,2,3,3,3,9,33.3,6,9,4,5,1,9,11,0,"https://fbref.com/en/players/3bb7f478/Edin-Dzeko"
2021,"Roma","Serie A","Federico Fazio","ARG","DF","33",1987,4.5,3,2,3,0,0,3,4,75,1,3,3,0,7,10,18,1,"https://fbref.com/en/players/4e358a2d/Federico-Fazio"
2021,"Roma","Serie A","Daniel Fuzato","BRA","GK","23",1997,5,0,0,0,0,0,0,0,NA,0,1,0,1,0,0,1,1,"https://fbref.com/en/players/82328faf/Daniel-Fuzato"
2021,"Roma","Serie A","Roger Ibanez","BRA","DF","21",1998,26.6,59,37,28,25,6,25,45,55.6,20,38,17,21,68,127,78,3,"https://fbref.com/en/players/82efe6fa/Roger-Ibanez"
2021,"Roma","Serie A","Juan Jesus","BRA","DF","29",1991,1.7,3,1,2,1,0,2,4,50,2,1,0,1,2,5,5,0,"https://fbref.com/en/players/79083382/Juan-Jesus"
2021,"Roma","Serie A","Rick Karsdorp","NED","DF","25",1995,28.3,36,23,19,12,5,21,48,43.8,27,18,1,17,30,66,32,0,"https://fbref.com/en/players/9f84febe/Rick-Karsdorp"
2021,"Roma","Serie A","Justin Kluivert","NED","MF","21",1999,0.2,0,0,0,0,0,0,0,NA,0,0,0,0,0,0,0,0,"https://fbref.com/en/players/4c3a6744/Justin-Kluivert"
2021,"Roma","Serie A","Marash Kumbulla","ALB","DF","20",2000,15.1,16,11,8,7,1,5,17,29.4,12,12,5,7,24,40,38,1,"https://fbref.com/en/players/a40819d9/Marash-Kumbulla"
2021,"Roma","Serie A","Pau López","ESP","GK","25",1994,20.2,2,0,2,0,0,2,2,100,0,1,0,1,0,2,7,4,"https://fbref.com/en/players/20b9f052/Pau-Lopez"
2021,"Roma","Serie A","Gianluca Mancini","ITA","DF","24",1996,31.7,50,29,29,19,2,18,31,58.1,13,38,18,20,72,122,77,3,"https://fbref.com/en/players/5aa53281/Gianluca-Mancini"
2021,"Roma","Serie A","Borja Mayoral","ESP","FW","23",1997,17.2,3,2,0,0,3,1,10,10,9,5,0,5,0,3,5,2,"https://fbref.com/en/players/64e8ed6d/Borja-Mayoral"
2021,"Roma","Serie A","Antonio Mirante","ITA","GK","37",1983,12.8,0,0,0,0,0,0,1,0,1,1,0,1,0,0,7,2,"https://fbref.com/en/players/30223b33/Antonio-Mirante"
2021,"Roma","Serie A","Henrikh Mkhitaryan","ARM","MF,FW","31",1989,30.5,58,24,13,27,18,13,62,21,49,34,0,34,39,97,10,0,"https://fbref.com/en/players/dd0daf32/Henrikh-Mkhitaryan"
2021,"Roma","Serie A","Javier Pastore","ARG","MF,FW","31",1989,0.9,2,2,2,0,0,2,2,100,0,0,0,0,0,2,0,0,"https://fbref.com/en/players/881ef58c/Javier-Pastore"
2021,"Roma","Serie A","Pedro","ESP","MF,FW","33",1987,17.7,22,14,6,11,5,7,35,20,28,10,0,10,9,31,2,1,"https://fbref.com/en/players/3ca7254a/Pedro"
2021,"Roma","Serie A","Lorenzo Pellegrini","ITA","MF","24",1996,28.9,40,24,13,20,7,21,60,35,39,37,2,35,42,82,23,1,"https://fbref.com/en/players/4a5a45c7/Lorenzo-Pellegrini"
2021,"Roma","Serie A","Bruno Peres","BRA","DF","30",1990,15.9,21,11,11,7,3,13,24,54.2,11,18,4,14,27,48,11,0,"https://fbref.com/en/players/852351df/Bruno-Peres"
2021,"Roma","Serie A","Carles Pérez","ESP","MF,FW","22",1998,8.6,9,4,3,6,0,6,31,19.4,25,9,0,9,6,15,1,0,"https://fbref.com/en/players/a8f21b9f/Carles-Perez"
2021,"Roma","Serie A","Bryan Reynolds","USA","DF","19",2001,3.1,4,2,1,1,2,1,5,20,4,4,0,4,6,10,4,0,"https://fbref.com/en/players/2306bf5c/Bryan-Reynolds"
2021,"Roma","Serie A","Davide Santon","ITA","DF","29",1991,6.5,4,3,2,2,0,3,7,42.9,4,10,1,9,4,8,12,0,"https://fbref.com/en/players/88c89891/Davide-Santon"
2021,"Roma","Serie A","Stephan El Shaarawy","ITA","MF,FW","27",1992,6.4,4,3,0,3,1,2,9,22.2,7,3,1,2,3,7,2,0,"https://fbref.com/en/players/d3aaad90/Stephan-El-Shaarawy"
2021,"Roma","Serie A","Chris Smalling","ENG","DF","30",1989,12.3,14,8,5,7,2,6,10,60,4,17,11,6,28,42,46,1,"https://fbref.com/en/players/b6964eb6/Chris-Smalling"
2021,"Roma","Serie A","Leonardo Spinazzola","ITA","DF","27",1993,23.6,12,6,3,9,0,8,20,40,12,16,1,15,25,37,31,0,"https://fbref.com/en/players/3626daea/Leonardo-Spinazzola"
2021,"Roma","Serie A","Jordan Veretout","FRA","MF","27",1993,22.8,20,12,8,12,0,9,33,27.3,24,14,3,11,14,34,21,3,"https://fbref.com/en/players/4a56052c/Jordan-Veretout"
2021,"Roma","Serie A","Gonzalo Villar","ESP","MF","22",1998,20.7,44,18,14,24,6,18,61,29.5,43,25,3,22,22,66,14,1,"https://fbref.com/en/players/bdc74a8f/Gonzalo-Villar"
2021,"Roma","Serie A","Nicola Zalewski","POL","MF","18",2002,0.1,1,1,0,1,0,1,1,100,0,0,0,0,0,1,0,0,"https://fbref.com/en/players/45191c29/Nicola-Zalewski"
2021,"Saint-Étienne","Ligue 1","Charles Abi","FRA","FW,MF","20",2000,10.1,8,2,5,0,3,3,12,25,9,6,2,4,4,12,5,0,"https://fbref.com/en/players/469d3d84/Charles-Abi"
2021,"Saint-Étienne","Ligue 1","Pape Abou Cissé","SEN","DF","24",1995,14,15,13,10,5,0,6,10,60,4,7,4,3,27,42,87,0,"https://fbref.com/en/players/8bc373ea/Pape-Abou-Cisse"
2021,"Saint-Étienne","Ligue 1","Adil Aouchiche","FRA","MF,FW","18",2002,19.2,38,20,12,17,9,13,49,26.5,36,15,1,14,10,48,6,0,"https://fbref.com/en/players/b94b8be1/Adil-Aouchiche"
2021,"Saint-Étienne","Ligue 1","Stefan Bajic","FRA","GK","18",2001,1,0,0,0,0,0,0,0,NA,0,0,0,0,0,0,1,0,"https://fbref.com/en/players/be13e5a8/Stefan-Bajic"
2021,"Saint-Étienne","Ligue 1","Bilal Benkhedim","FRA","FW","19",2001,0.8,0,0,0,0,0,0,1,0,1,1,0,1,0,0,0,0,"https://fbref.com/en/players/b6047994/Bilal-Benkhedim"
2021,"Saint-Étienne","Ligue 1","Denis Bouanga","GAB","MF,FW","25",1994,30.2,52,28,22,24,6,16,58,27.6,42,32,3,29,20,72,36,0,"https://fbref.com/en/players/0b0cbe5b/Denis-Bouanga"
2021,"Saint-Étienne","Ligue 1","Ryad Boudebouz","ALG","MF,FW","30",1990,7.2,9,4,1,7,1,4,8,50,4,3,0,3,5,14,5,0,"https://fbref.com/en/players/1001ae82/Ryad-Boudebouz"
2021,"Saint-Étienne","Ligue 1","Mahdi Camara","FRA","MF,DF","22",1998,36.6,99,67,43,46,10,33,60,55,27,50,12,38,78,177,51,0,"https://fbref.com/en/players/8577e60a/Mahdi-Camara"
2021,"Saint-Étienne","Ligue 1","Mathieu Debuchy","FRA","DF","35",1985,23.4,58,33,37,17,4,40,62,64.5,22,27,9,18,45,103,61,0,"https://fbref.com/en/players/92232aad/Mathieu-Debuchy"
2021,"Saint-Étienne","Ligue 1","Assane Dioussé","SEN","DF","22",1997,0,0,0,0,0,0,0,0,NA,0,0,0,0,0,0,0,0,"https://fbref.com/en/players/7f622eef/Assane-Diousse"
2021,"Saint-Étienne","Ligue 1","Wesley Fofana","FRA","DF","19",2000,3.5,6,4,6,0,0,3,4,75,1,3,3,0,8,14,14,1,"https://fbref.com/en/players/132a82f1/Wesley-Fofana"
2021,"Saint-Étienne","Ligue 1","Baptiste Gabard","FRA","MF","20",2000,1.5,4,3,1,3,0,1,5,20,4,4,0,4,1,5,0,0,"https://fbref.com/en/players/bc224243/Baptiste-Gabard"
2021,"Saint-Étienne","Ligue 1","Lucas Gourna-Douath","FRA","MF","16",2003,14.7,32,22,18,11,3,15,28,53.6,13,10,0,10,24,56,18,0,"https://fbref.com/en/players/3cd7820a/Lucas-Gourna-Douath"
2021,"Saint-Étienne","Ligue 1","Etienne Green","ENG","GK","20",2000,8,0,0,0,0,0,0,0,NA,0,0,0,0,0,0,3,0,"https://fbref.com/en/players/667b65da/Etienne-Green"
2021,"Saint-Étienne","Ligue 1","Romain Hamouma","FRA","FW,MF","33",1987,19.7,12,7,5,6,1,4,24,16.7,20,17,1,16,7,19,11,0,"https://fbref.com/en/players/0b4d8274/Romain-Hamouma"
2021,"Saint-Étienne","Ligue 1","Wahbi Khazri","TUN","FW","29",1991,13.1,24,15,12,7,5,12,24,50,12,10,1,9,4,28,11,0,"https://fbref.com/en/players/2677a1de/Wahbi-Khazri"
2021,"Saint-Étienne","Ligue 1","Timothée Kolodziejczak","FRA","DF","28",1991,22.6,28,15,23,5,0,19,27,70.4,8,24,15,9,36,64,80,1,"https://fbref.com/en/players/ab096c6f/Timothee-Kolodziejczak"
2021,"Saint-Étienne","Ligue 1","Jean-Philippe Krasso","CIV","FW","23",1997,2.5,5,3,1,4,0,2,4,50,2,5,0,5,1,6,3,0,"https://fbref.com/en/players/037f2523/Jean-Philippe-Krasso"
2021,"Saint-Étienne","Ligue 1","Yanis Lhery","FRA","MF","17",2003,0.3,0,0,0,0,0,0,0,NA,0,0,0,0,0,0,0,0,"https://fbref.com/en/players/cc972842/Yanis-Lhery"
2021,"Saint-Étienne","Ligue 1","Yann M'Vila","FRA","MF","30",1990,0.2,0,0,0,0,0,0,2,0,2,0,0,0,1,1,0,0,"https://fbref.com/en/players/d4133fa1/Yann-MVila"
2021,"Saint-Étienne","Ligue 1","Yvann Macon","FRA","DF","21",1998,6,30,20,20,8,2,7,19,36.8,12,6,2,4,9,39,13,0,"https://fbref.com/en/players/0bb6e193/Yvann-Macon"
2021,"Saint-Étienne","Ligue 1","Anthony Modeste","FRA","FW,MF","32",1988,3.3,2,1,0,2,0,1,4,25,3,3,1,2,0,2,3,0,"https://fbref.com/en/players/34e4343c/Anthony-Modeste"
2021,"Saint-Étienne","Ligue 1","Kévin Monnet-Paquet","FRA","MF,FW","31",1988,6.3,11,7,7,2,2,5,10,50,5,5,0,5,6,17,7,0,"https://fbref.com/en/players/4a57580c/Kevin-Monnet-Paquet"
2021,"Saint-Étienne","Ligue 1","Aimen Moueffek","FRA","DF,MF","19",2001,8.3,25,15,16,6,3,13,32,40.6,19,17,2,15,9,34,18,0,"https://fbref.com/en/players/2591b066/Aimen-Moueffek"
2021,"Saint-Étienne","Ligue 1","Harold Moukoudi","CMR","DF","22",1997,25.3,46,27,37,8,1,28,38,73.7,10,24,10,14,42,88,78,1,"https://fbref.com/en/players/5f26e0c5/Harold-Moukoudi"
2021,"Saint-Étienne","Ligue 1","Jessy Moulin","FRA","GK","34",1986,29,2,1,2,0,0,2,3,66.7,1,0,0,0,2,4,9,2,"https://fbref.com/en/players/28a65a2c/Jessy-Moulin"
2021,"Saint-Étienne","Ligue 1","Yvan Neyou","CMR","MF","23",1997,27.1,58,31,24,33,1,25,60,41.7,35,34,5,29,31,89,13,1,"https://fbref.com/en/players/0ad37003/Yvan-Neyou"
2021,"Saint-Étienne","Ligue 1","Arnaud Nordin","FRA","MF,FW","22",1998,19.7,14,8,5,5,4,6,21,28.6,15,13,2,11,9,23,10,0,"https://fbref.com/en/players/7b9a9e25/Arnaud-Nordin"
2021,"Saint-Étienne","Ligue 1","Panagiotis Retsos","GRE","DF","21",1998,3,5,3,5,0,0,3,7,42.9,4,1,1,0,3,8,12,0,"https://fbref.com/en/players/4bd00a50/Panagiotis-Retsos"
2021,"Saint-Étienne","Ligue 1","Maxence Rivera","FRA","MF,FW","18",2002,2.7,12,10,6,4,2,4,10,40,6,5,0,5,1,13,0,0,"https://fbref.com/en/players/46a7b605/Maxence-Rivera"
2021,"Saint-Étienne","Ligue 1","Mathys Saban","FRA","FW","18",2002,0.1,0,0,0,0,0,0,0,NA,0,0,0,0,0,0,0,0,"https://fbref.com/en/players/7d9f3d69/Mathys-Saban"
2021,"Saint-Étienne","Ligue 1","Abdoulaye Sidibé","FRA","MF","18",2002,0.1,1,1,1,0,0,1,2,50,1,0,0,0,0,1,0,0,"https://fbref.com/en/players/a13028f6/Abdoulaye-Sidibe"
2021,"Saint-Étienne","Ligue 1","Gabriel Silva","BRA","DF","29",1991,3.9,7,6,7,0,0,1,2,50,1,4,1,3,6,13,8,0,"https://fbref.com/en/players/4914ed4a/Gabriel-Silva"
2021,"Saint-Étienne","Ligue 1","Nelson Sissoko","FRA","DF","23",1997,5.3,12,6,6,3,3,7,12,58.3,5,2,1,1,12,24,16,1,"https://fbref.com/en/players/12bd0579/Nelson-Sissoko"
2021,"Saint-Étienne","Ligue 1","Rayan Souici","FRA","DF","22",1998,0.1,0,0,0,0,0,0,0,NA,0,0,0,0,0,0,0,0,"https://fbref.com/en/players/e3ad3368/Rayan-Souici"
2021,"Saint-Étienne","Ligue 1","Saidou Sow","GUI","DF","18",2002,11.1,23,12,17,6,0,13,19,68.4,6,12,8,4,14,37,39,1,"https://fbref.com/en/players/f6b94e8d/Saidou-Sow"
2021,"Saint-Étienne","Ligue 1","Tyron Tormin","FRA","FW,MF","19",2001,0.2,0,0,0,0,0,0,0,NA,0,0,0,0,0,0,0,0,"https://fbref.com/en/players/0d99c6e1/Tyron-Tormin"
2021,"Saint-Étienne","Ligue 1","Miguel Trauco","PER","DF","27",1992,22.6,47,29,25,14,8,23,43,53.5,20,19,4,15,30,77,34,1,"https://fbref.com/en/players/e4b72e34/Miguel-Trauco"
2021,"Saint-Étienne","Ligue 1","Marvin Tshibuabua","FRA","DF","18",2002,0.5,1,0,1,0,0,0,0,NA,0,0,0,0,1,2,1,0,"https://fbref.com/en/players/7a0b1e96/Marvin-Tshibuabua"
2021,"Saint-Étienne","Ligue 1","Zaydou Youssouf","FRA","MF","21",1999,13.7,30,15,19,10,1,16,40,40,24,15,0,15,25,55,12,1,"https://fbref.com/en/players/e2f9bb5f/Zaydou-Youssouf"
2021,"Sampdoria","Serie A","Kristoffer Askildsen","NOR","MF","19",2001,1.1,0,0,0,0,0,0,0,NA,0,2,0,2,3,3,3,0,"https://fbref.com/en/players/a69cc629/Kristoffer-Askildsen"
2021,"Sampdoria","Serie A","Emil Audero","ITA","GK","23",1997,37,1,1,1,0,0,1,2,50,1,0,0,0,1,2,16,0,"https://fbref.com/en/players/649b01d8/Emil-Audero"
2021,"Sampdoria","Serie A","Tommaso Augello","ITA","DF","25",1994,35.7,42,30,27,10,5,23,39,59,16,22,2,20,32,74,76,1,"https://fbref.com/en/players/3cd3b384/Tommaso-Augello"
2021,"Sampdoria","Serie A","Keita Baldé","SEN","FW","25",1995,13.3,9,6,2,6,1,4,10,40,6,10,1,9,0,9,3,0,"https://fbref.com/en/players/509a4ccb/Keita-Balde"
2021,"Sampdoria","Serie A","Bartosz Bereszyński","POL","DF","28",1992,29,66,44,37,22,7,41,73,56.2,32,40,20,20,42,108,88,0,"https://fbref.com/en/players/61b3978f/Bartosz-Bereszynski"
2021,"Sampdoria","Serie A","Federico Bonazzoli","ITA","FW","23",1997,1.5,0,0,0,0,0,0,0,NA,0,1,0,1,0,0,0,0,"https://fbref.com/en/players/bf57eaab/Federico-Bonazzoli"
2021,"Sampdoria","Serie A","Antonio Candreva","ITA","MF","33",1987,27.8,28,19,17,9,2,21,53,39.6,32,24,3,21,9,37,27,1,"https://fbref.com/en/players/356c9002/Antonio-Candreva"
2021,"Sampdoria","Serie A","Omar Colley","GAM","DF","27",1992,28.8,28,16,19,8,1,13,23,56.5,10,43,29,14,68,96,133,1,"https://fbref.com/en/players/8b95acda/Omar-Colley"
2021,"Sampdoria","Serie A","Mikkel Damsgaard","DEN","MF,FW","20",2000,19.7,42,21,14,20,8,22,70,31.4,48,40,4,36,24,66,17,0,"https://fbref.com/en/players/215f3907/Mikkel-Damsgaard"
2021,"Sampdoria","Serie A","Fabio Depaoli","ITA","MF","23",1997,0.9,1,0,0,1,0,0,2,0,2,0,0,0,1,2,1,0,"https://fbref.com/en/players/d97f2e8d/Fabio-Depaoli"
2021,"Sampdoria","Serie A","Albin Ekdal","SWE","MF","31",1989,25.5,56,29,21,32,3,23,65,35.4,42,31,12,19,49,105,35,0,"https://fbref.com/en/players/f503ea63/Albin-Ekdal"
2021,"Sampdoria","Serie A","Alex Ferrari","ITA","DF","26",1994,9.8,27,15,16,9,2,15,24,62.5,9,18,6,12,23,50,26,0,"https://fbref.com/en/players/d0dbca9f/Alex-Ferrari"
2021,"Sampdoria","Serie A","Manolo Gabbiadini","ITA","FW","28",1991,9.7,2,2,0,2,0,0,1,0,1,3,1,2,3,5,5,0,"https://fbref.com/en/players/8f866fe8/Manolo-Gabbiadini"
2021,"Sampdoria","Serie A","Jakub Jankto","CZE","MF","24",1996,26.8,28,17,14,7,7,11,35,31.4,24,16,1,15,24,52,34,0,"https://fbref.com/en/players/1ea5f91c/Jakub-Jankto"
2021,"Sampdoria","Serie A","Antonino La Gumina","ITA","FW","24",1996,3.8,3,2,0,1,2,0,3,0,3,5,1,4,3,6,5,0,"https://fbref.com/en/players/822a7761/Antonino-La-Gumina"
2021,"Sampdoria","Serie A","Mehdi Léris","ALG","DF,MF","22",1998,4.3,11,5,6,4,1,6,16,37.5,10,12,2,10,12,23,15,0,"https://fbref.com/en/players/7d3cbc67/Mehdi-Leris"
2021,"Sampdoria","Serie A","Karlo Letica","CRO","GK","23",1997,1,0,0,0,0,0,0,0,NA,0,0,0,0,0,0,2,0,"https://fbref.com/en/players/4a6914ff/Karlo-Letica"
2021,"Sampdoria","Serie A","Antonio Palumbo","ITA","MF","23",1996,0.1,0,0,0,0,0,0,1,0,1,0,0,0,0,0,0,0,"https://fbref.com/en/players/33e98344/Antonio-Palumbo"
2021,"Sampdoria","Serie A","Fabio Quagliarella","ITA","FW","37",1983,24.5,12,8,4,4,4,2,19,10.5,17,14,1,13,7,19,10,0,"https://fbref.com/en/players/ee4f2f3b/Fabio-Quagliarella"
2021,"Sampdoria","Serie A","Gastón Ramírez","URU","FW,MF","29",1990,10.8,31,15,10,17,4,8,27,29.6,19,19,3,16,4,35,13,0,"https://fbref.com/en/players/2c851997/Gaston-Ramirez"
2021,"Sampdoria","Serie A","Vasco Regini","ITA","DF","29",1990,1,2,2,2,0,0,2,2,100,0,1,1,0,1,3,5,0,"https://fbref.com/en/players/339c6ed4/Vasco-Regini"
2021,"Sampdoria","Serie A","Adrien Silva","POR","MF","31",1989,17.8,49,22,21,22,6,18,54,33.3,36,34,1,33,30,79,10,1,"https://fbref.com/en/players/d6f88a1d/Adrien-Silva"
2021,"Sampdoria","Serie A","Morten Thorsby","NOR","MF","24",1996,29.4,76,42,32,36,8,20,60,33.3,40,51,16,35,25,101,30,0,"https://fbref.com/en/players/d1b49282/Morten-Thorsby"
2021,"Sampdoria","Serie A","Lorenzo Tonelli","ITA","DF","30",1990,19.8,33,18,20,11,2,10,21,47.6,11,21,14,7,25,58,94,1,"https://fbref.com/en/players/8cc29864/Lorenzo-Tonelli"
2021,"Sampdoria","Serie A","Ernesto Torregrossa","VEN","FW","28",1992,1.9,1,1,0,0,1,0,2,0,2,4,0,4,1,2,1,0,"https://fbref.com/en/players/bf39bdec/Ernesto-Torregrossa"
2021,"Sampdoria","Serie A","Valerio Verre","ITA","FW,MF","26",1994,11.1,11,7,2,7,2,4,19,21.1,15,14,2,12,9,20,3,0,"https://fbref.com/en/players/33ecf462/Valerio-Verre"
2021,"Sampdoria","Serie A","Maya Yoshida","JPN","DF","31",1988,25.3,17,4,10,7,0,7,13,53.8,6,45,34,11,57,74,93,1,"https://fbref.com/en/players/caffaf5a/Maya-Yoshida"
2021,"Sassuolo","Serie A","Kaan Ayhan","TUR","DF","25",1994,8.8,15,9,8,5,2,8,13,61.5,5,9,5,4,16,31,33,0,"https://fbref.com/en/players/2200181e/Kaan-Ayhan"
2021,"Sassuolo","Serie A","Domenico Berardi","ITA","FW","25",1994,27.5,42,22,17,11,14,21,62,33.9,41,23,1,22,26,68,34,0,"https://fbref.com/en/players/53a0e358/Domenico-Berardi"
2021,"Sassuolo","Serie A","Jeremie Boga","CIV","FW,MF","23",1997,19.8,11,9,5,0,6,3,11,27.3,8,10,0,10,8,19,7,0,"https://fbref.com/en/players/fe012aca/Jeremie-Boga"
2021,"Sassuolo","Serie A","Mehdi Bourabia","MAR","MF","28",1991,5.9,6,5,1,4,1,2,7,28.6,5,14,6,8,12,18,8,0,"https://fbref.com/en/players/0d077b88/Mehdi-Bourabia"
2021,"Sassuolo","Serie A","Francesco Caputo","ITA","FW","32",1987,18.9,0,0,0,0,0,0,2,0,2,4,0,4,1,1,3,0,"https://fbref.com/en/players/5bd72174/Francesco-Caputo"
2021,"Sassuolo","Serie A","Vlad Chiricheș","ROU","DF","30",1989,20.4,38,23,34,3,1,21,35,60,14,31,21,10,50,88,59,2,"https://fbref.com/en/players/c316607a/Vlad-Chiriches"
2021,"Sassuolo","Serie A","Andrea Consigli","ITA","GK","33",1987,37,2,2,2,0,0,2,2,100,0,0,0,0,0,2,14,4,"https://fbref.com/en/players/8cabdc1e/Andrea-Consigli"
2021,"Sassuolo","Serie A","Grégoire Defrel","MTQ","MF,FW","29",1991,14.8,13,8,5,5,3,5,13,38.5,8,9,0,9,7,20,5,0,"https://fbref.com/en/players/854ee61a/Gregoire-Defrel"
2021,"Sassuolo","Serie A","Lukáš Haraslín","SVK","FW,MF","24",1996,3.7,8,4,2,5,1,2,5,40,3,1,0,1,0,8,2,0,"https://fbref.com/en/players/5c397195/Lukas-Haraslin"
2021,"Sassuolo","Serie A","Hamed Junior Traorè","CIV","MF,FW","20",2000,19.9,29,17,10,10,9,14,35,40,21,27,3,24,18,47,9,0,"https://fbref.com/en/players/570bb4b9/Hamed-Junior-Traore"
2021,"Sassuolo","Serie A","Isaac Karamoko","FRA","DF","18",2002,0,1,0,0,0,1,1,1,100,0,0,0,0,0,1,0,0,"https://fbref.com/en/players/4c7919df/Isaac-Karamoko"
2021,"Sassuolo","Serie A","Giorgos Kyriakopoulos","GRE","DF","24",1996,16.2,35,18,17,12,6,8,28,28.6,20,16,5,11,15,50,42,0,"https://fbref.com/en/players/0a483542/Giorgos-Kyriakopoulos"
2021,"Sassuolo","Serie A","Manuel Locatelli","ITA","MF","22",1998,32,81,47,43,28,10,29,56,51.8,27,35,15,20,51,132,65,1,"https://fbref.com/en/players/a8a874f1/Manuel-Locatelli"
2021,"Sassuolo","Serie A","Maxime Lopez","FRA","MF","22",1997,20.7,24,13,15,6,3,14,41,34.1,27,9,0,9,16,40,10,1,"https://fbref.com/en/players/20094685/Maxime-Lopez"
2021,"Sassuolo","Serie A","Francesco Magnanelli","ITA","MF","35",1984,4.9,7,5,2,5,0,3,10,30,7,6,2,4,13,20,10,0,"https://fbref.com/en/players/07767f42/Francesco-Magnanelli"
2021,"Sassuolo","Serie A","Gian Marco Ferrari","ITA","DF","28",1992,33.5,32,20,15,14,3,10,23,43.5,13,46,37,9,50,82,100,1,"https://fbref.com/en/players/8650af85/Gian-Marco-Ferrari"
2021,"Sassuolo","Serie A","Marlon","BRA","DF","24",1995,19.4,19,13,13,6,0,13,18,72.2,5,23,17,6,27,46,44,2,"https://fbref.com/en/players/cdf65d12/Marlon"
2021,"Sassuolo","Serie A","Mert Müldür","TUR","DF","21",1999,18.6,43,20,26,9,8,27,53,50.9,26,17,1,16,36,79,41,0,"https://fbref.com/en/players/1295552e/Mert-Muldur"
2021,"Sassuolo","Serie A","Pedro Obiang","EQG","MF","28",1992,16.3,35,22,17,15,3,12,35,34.3,23,26,7,19,22,57,27,0,"https://fbref.com/en/players/ba1e04b3/Pedro-Obiang"
2021,"Sassuolo","Serie A","Brian Oddei","ITA","FW,MF","17",2002,0.5,2,1,1,1,0,2,3,66.7,1,1,0,1,0,2,1,0,"https://fbref.com/en/players/97e8ea97/Brian-Oddei"
2021,"Sassuolo","Serie A","Gianluca Pegolo","ITA","GK","39",1981,1,0,0,0,0,0,0,0,NA,0,0,0,0,0,0,1,0,"https://fbref.com/en/players/f058ed1f/Gianluca-Pegolo"
2021,"Sassuolo","Serie A","Federico Peluso","ITA","DF","36",1984,2.3,1,1,1,0,0,1,2,50,1,2,2,0,3,4,12,0,"https://fbref.com/en/players/4f2908e5/Federico-Peluso"
2021,"Sassuolo","Serie A","Giacomo Raspadori","ITA","FW,MF","20",2000,13.7,5,3,1,1,3,0,4,0,4,13,5,8,2,7,9,0,"https://fbref.com/en/players/6e058f06/Giacomo-Raspadori"
2021,"Sassuolo","Serie A","Federico Ricci","ITA","FW","26",1994,0,0,0,0,0,0,0,0,NA,0,0,0,0,0,0,0,0,"https://fbref.com/en/players/524eb8c5/Federico-Ricci"
2021,"Sassuolo","Serie A","Rogério","BRA","DF","22",1998,20.9,26,13,19,5,2,19,27,70.4,8,26,5,21,31,57,53,0,"https://fbref.com/en/players/10e7f486/Rogerio"
2021,"Sassuolo","Serie A","Nicolás Schiappacasse","URU","MF","21",1999,0.2,0,0,0,0,0,0,0,NA,0,0,0,0,0,0,0,0,"https://fbref.com/en/players/afe31d55/Nicolas-Schiappacasse"
2021,"Sassuolo","Serie A","Jeremy Toljan","GER","DF","25",1994,16.6,21,12,16,3,2,12,27,44.4,15,15,7,8,13,34,28,0,"https://fbref.com/en/players/a96e5dc0/Jeremy-Toljan"
2021,"Sassuolo","Serie A","Filip Đuričić","SRB","MF,FW","28",1992,23.1,32,23,6,16,10,12,30,40,18,20,2,18,9,41,12,0,"https://fbref.com/en/players/eccbe56a/Filip-Djuricic"
2021,"Schalke 04","Bundesliga","Mehmet-Can Aydin","GER","DF","18",2002,5.6,15,7,9,6,0,4,10,40,6,6,1,5,6,21,16,0,"https://fbref.com/en/players/fe46e261/Mehmet-Can-Aydin"
2021,"Schalke 04","Bundesliga","Timo Becker","GER","DF","23",1997,18.2,34,23,28,6,0,16,25,64,9,18,4,14,22,56,58,0,"https://fbref.com/en/players/543ddcaf/Timo-Becker"
2021,"Schalke 04","Bundesliga","Nabil Bentaleb","ALG","MF","25",1994,6.1,14,8,7,6,1,4,15,26.7,11,5,2,3,6,20,8,0,"https://fbref.com/en/players/3189f61a/Nabil-Bentaleb"
2021,"Schalke 04","Bundesliga","Nassim Boujellab","MAR","MF,FW","21",1999,6.7,13,9,2,10,1,2,12,16.7,10,10,3,7,7,20,9,0,"https://fbref.com/en/players/541127d5/Nassim-Boujellab"
2021,"Schalke 04","Bundesliga","Can Bozdogan","GER","MF,FW","19",2001,7.2,13,5,6,6,1,4,15,26.7,11,10,2,8,7,20,5,0,"https://fbref.com/en/players/b797f558/Can-Bozdogan"
2021,"Schalke 04","Bundesliga","Kerim Calhanoglu","GER","DF","17",2002,3.3,3,3,1,1,1,0,3,0,3,4,0,4,7,10,6,0,"https://fbref.com/en/players/d1db4b83/Kerim-Calhanoglu"
2021,"Schalke 04","Bundesliga","Ralf Fährmann","GER","GK","31",1988,20.8,2,1,2,0,0,1,2,50,1,0,0,0,1,3,9,3,"https://fbref.com/en/players/1e43fad8/Ralf-Fahrmann"
2021,"Schalke 04","Bundesliga","Florian Flick","GER","MF","20",2000,4,10,7,4,6,0,7,16,43.8,9,4,3,1,7,17,5,1,"https://fbref.com/en/players/9642c929/Florian-Flick"
2021,"Schalke 04","Bundesliga","Amine Harit","MAR","MF,FW","23",1997,23.3,22,13,8,11,3,10,23,43.5,13,9,1,8,17,39,7,1,"https://fbref.com/en/players/e7d59f4f/Amine-Harit"
2021,"Schalke 04","Bundesliga","Matthew Hoppe","USA","FW","19",2001,14.5,6,6,1,3,2,2,12,16.7,10,8,2,6,4,10,15,0,"https://fbref.com/en/players/1bc432b7/Matthew-Hoppe"
2021,"Schalke 04","Bundesliga","Klaas-Jan Huntelaar","NED","FW","36",1983,6.5,4,2,0,2,2,0,2,0,2,3,1,2,2,6,3,0,"https://fbref.com/en/players/5042e5c2/Klaas-Jan-Huntelaar"
2021,"Schalke 04","Bundesliga","Vedad Ibišević","BIH","FW","35",1984,1.7,0,0,0,0,0,0,0,NA,0,1,0,1,1,1,1,0,"https://fbref.com/en/players/c3fd9887/Vedad-Ibisevic"
2021,"Schalke 04","Bundesliga","Blendi Idrizi","KVX","MF","22",1998,2.6,8,4,1,6,1,1,1,100,0,6,2,4,3,11,1,0,"https://fbref.com/en/players/58450270/Blendi-Idrizi"
2021,"Schalke 04","Bundesliga","Ozan Kabak","TUR","DF","20",2000,13.8,17,9,11,5,1,6,13,46.2,7,20,11,9,13,30,57,0,"https://fbref.com/en/players/2d61d13a/Ozan-Kabak"
2021,"Schalke 04","Bundesliga","Jimmy Kaparos","GER","MF","18",2001,0.2,0,0,0,0,0,0,1,0,1,0,0,0,0,0,0,0,"https://fbref.com/en/players/11bc43f4/Jimmy-Kaparos"
2021,"Schalke 04","Bundesliga","Sead Kolašinac","BIH","DF,MF","27",1993,15.8,20,17,10,7,3,8,18,44.4,10,17,5,12,20,40,17,0,"https://fbref.com/en/players/3935e52e/Sead-Kolasinac"
2021,"Schalke 04","Bundesliga","Ahmed Kutucu","TUR","FW,MF","20",2000,1.2,1,0,0,0,1,1,2,50,1,1,0,1,0,1,0,0,"https://fbref.com/en/players/beda9675/Ahmed-Kutucu"
2021,"Schalke 04","Bundesliga","Michael Langer","AUT","GK","35",1985,2.7,0,0,0,0,0,0,0,NA,0,0,0,0,0,0,3,0,"https://fbref.com/en/players/d20f088b/Michael-Langer"
2021,"Schalke 04","Bundesliga","Jan Luca Schuler","GER","FW","21",1999,0.4,2,2,1,1,0,0,1,0,1,1,0,1,0,2,0,0,"https://fbref.com/en/players/6ca598d5/Jan-Luca-Schuler"
2021,"Schalke 04","Bundesliga","Kilian Ludewig","GER","DF,FW","20",2000,5.8,16,6,10,5,1,8,25,32,17,7,0,7,3,19,14,0,"https://fbref.com/en/players/9b1b7d78/Kilian-Ludewig"
2021,"Schalke 04","Bundesliga","Mikail Maden","NOR","FW","18",2002,0.1,0,0,0,0,0,0,0,NA,0,0,0,0,0,0,0,0,"https://fbref.com/en/players/fc0f3ef3/Mikail-Maden"
2021,"Schalke 04","Bundesliga","Omar Mascarell","ESP","MF","27",1993,19.6,41,24,15,19,7,21,54,38.9,33,40,14,26,37,78,32,1,"https://fbref.com/en/players/11fd2b75/Omar-Mascarell"
2021,"Schalke 04","Bundesliga","Rabbi Matondo","WAL","FW,MF","19",2000,2.4,3,2,0,3,0,2,3,66.7,1,1,0,1,1,4,1,0,"https://fbref.com/en/players/33144cc5/Rabbi-Matondo"
2021,"Schalke 04","Bundesliga","Henning Matriciani","GER","DF","20",2000,0.3,1,1,1,0,0,1,1,100,0,1,0,1,0,1,1,0,"https://fbref.com/en/players/ab3f1bdf/Henning-Matriciani"
2021,"Schalke 04","Bundesliga","Hamza Mendyl","MAR","FW,DF","22",1997,1.1,2,2,2,0,0,0,2,0,2,2,0,2,0,2,2,0,"https://fbref.com/en/players/f99fe221/Hamza-Mendyl"
2021,"Schalke 04","Bundesliga","Levent Mercan","GER","FW","19",2000,0.1,0,0,0,0,0,0,0,NA,0,0,0,0,0,0,0,0,"https://fbref.com/en/players/33340bd6/Levent-Mercan"
2021,"Schalke 04","Bundesliga","Shkodran Mustafi","GER","DF","28",1992,11.5,16,5,15,1,0,3,12,25,9,20,15,5,32,48,76,1,"https://fbref.com/en/players/3f2d59fe/Shkodran-Mustafi"
2021,"Schalke 04","Bundesliga","Matija Nastasić","SRB","DF","27",1993,13.6,11,7,9,2,0,9,16,56.3,7,22,18,4,26,37,51,1,"https://fbref.com/en/players/f35430a4/Matija-Nastasic"
2021,"Schalke 04","Bundesliga","Bastian Oczipka","GER","DF,FW","31",1989,21.4,33,20,22,10,1,7,21,33.3,14,22,4,18,24,57,41,0,"https://fbref.com/en/players/d1661819/Bastian-Oczipka"
2021,"Schalke 04","Bundesliga","Gonçalo Paciência","POR","FW","25",1994,8.3,8,3,4,1,3,4,16,25,12,4,1,3,1,9,3,0,"https://fbref.com/en/players/962e54cb/Goncalo-Paciencia"
2021,"Schalke 04","Bundesliga","Vasileios Pavlidis","GRE","FW","17",2002,0,0,0,0,0,0,0,0,NA,0,0,0,0,0,0,0,0,"https://fbref.com/en/players/75422cbf/Vasileios-Pavlidis"
2021,"Schalke 04","Bundesliga","Benito Raman","BEL","FW,MF","25",1994,13.8,19,13,11,6,2,6,29,20.7,23,11,0,11,5,24,5,0,"https://fbref.com/en/players/867501bf/Benito-Raman"
2021,"Schalke 04","Bundesliga","Sebastian Rudy","GER","DF","30",1990,2,4,2,2,0,2,4,7,57.1,3,6,4,2,1,5,4,0,"https://fbref.com/en/players/80f36c88/Sebastian-Rudy"
2021,"Schalke 04","Bundesliga","Frederik Rønnow","DEN","GK","27",1992,10.5,0,0,0,0,0,0,0,NA,0,0,0,0,1,1,9,1,"https://fbref.com/en/players/a70b8345/Frederik-Ronnow"
2021,"Schalke 04","Bundesliga","Salif Sané","SEN","DF","29",1990,11.9,17,9,9,7,1,13,23,56.5,10,25,13,12,25,42,66,0,"https://fbref.com/en/players/791abba1/Salif-Sane"
2021,"Schalke 04","Bundesliga","Alessandro Schöpf","AUT","FW,MF","26",1994,10.5,11,9,3,7,1,1,6,16.7,5,15,1,14,6,17,6,0,"https://fbref.com/en/players/106bca06/Alessandro-Schopf"
2021,"Schalke 04","Bundesliga","Suat Serdar","GER","MF","23",1997,21.7,55,35,18,33,4,17,52,32.7,35,29,4,25,23,78,21,0,"https://fbref.com/en/players/b3325a30/Suat-Serdar"
2021,"Schalke 04","Bundesliga","Steven Skrzybski","GER","FW,DF","27",1992,4.7,5,4,0,5,0,1,7,14.3,6,13,1,12,5,10,1,1,"https://fbref.com/en/players/58ce23e5/Steven-Skrzybski"
2021,"Schalke 04","Bundesliga","Benjamin Stambouli","FRA","DF,MF","29",1990,21.7,45,29,24,18,3,15,37,40.5,22,42,14,28,49,94,45,1,"https://fbref.com/en/players/5939baa2/Benjamin-Stambouli"
2021,"Schalke 04","Bundesliga","Malick Thiaw","GER","DF","18",2001,16.1,42,27,24,17,1,15,26,57.7,11,17,12,5,33,75,70,0,"https://fbref.com/en/players/ff5ea0bf/Malick-Thiaw"
2021,"Schalke 04","Bundesliga","Mark Uth","GER","FW,MF","28",1991,16.6,25,13,13,10,2,5,23,21.7,18,21,0,21,5,30,10,0,"https://fbref.com/en/players/a3ddb1b9/Mark-Uth"
2021,"Schalke 04","Bundesliga","William","BRA","DF,FW","25",1995,5.3,14,10,10,4,0,5,15,33.3,10,16,5,11,11,25,15,1,"https://fbref.com/en/players/d4d0a9ad/William"
2021,"Sevilla","La Liga","Marcos Acuña","ARG","DF","28",1991,25.9,62,42,34,20,8,23,41,56.1,18,23,2,21,23,85,30,1,"https://fbref.com/en/players/81442ecb/Marcos-Acuna"
2021,"Sevilla","La Liga","Yassine Bounou","MAR","GK","29",1991,33,1,1,1,0,0,0,2,0,2,0,0,0,0,1,12,2,"https://fbref.com/en/players/f6798fc3/Yassine-Bounou"
2021,"Sevilla","La Liga","Bryan","ESP","FW","19",2001,0.1,1,1,0,1,0,0,0,NA,0,0,0,0,0,1,0,0,"https://fbref.com/en/players/7b5ab7f2/Bryan"
2021,"Sevilla","La Liga","Diego Carlos","BRA","DF","27",1993,31,22,13,17,4,1,8,16,50,8,35,27,8,31,53,114,1,"https://fbref.com/en/players/b4a014b1/Diego-Carlos"
2021,"Sevilla","La Liga","Youssef En-Nesyri","MAR","FW","23",1997,25.7,17,11,2,9,6,4,21,19,17,15,0,15,8,25,23,0,"https://fbref.com/en/players/04e17fd5/Youssef-En-Nesyri"
2021,"Sevilla","La Liga","Sergio Escudero","ESP","DF","30",1989,6.3,12,8,6,5,1,6,12,50,6,5,2,3,9,21,7,0,"https://fbref.com/en/players/b0616e3d/Sergio-Escudero"
2021,"Sevilla","La Liga","Carlos Fernández","ESP","FW","24",1996,1.6,1,0,1,0,0,0,2,0,2,3,1,2,1,2,0,0,"https://fbref.com/en/players/e08647d6/Carlos-Fernandez"
2021,"Sevilla","La Liga","Fernando","BRA","MF","33",1987,28.3,54,28,24,25,5,23,43,53.5,20,25,11,14,41,95,70,0,"https://fbref.com/en/players/41f32541/Fernando"
2021,"Sevilla","La Liga","Papu Gómez","ARG","MF,FW","32",1988,10.2,9,6,2,4,3,2,12,16.7,10,13,2,11,7,16,6,0,"https://fbref.com/en/players/6e4df551/Papu-Gomez"
2021,"Sevilla","La Liga","Sergi Gómez","ESP","DF","28",1992,8,4,3,2,2,0,1,1,100,0,5,4,1,6,10,34,0,"https://fbref.com/en/players/bc6f5f06/Sergi-Gomez"
2021,"Sevilla","La Liga","Nemanja Gudelj","SRB","MF,DF","28",1991,11.6,23,12,16,5,2,4,10,40,6,10,6,4,24,47,24,2,"https://fbref.com/en/players/0076ab7f/Nemanja-Gudelj"
2021,"Sevilla","La Liga","Munir El Haddadi","MAR","FW","24",1995,9.4,12,8,5,5,2,2,12,16.7,10,6,0,6,5,17,6,0,"https://fbref.com/en/players/8696bc90/Munir-El-Haddadi"
2021,"Sevilla","La Liga","Oussama Idrissi","MAR","FW,MF","24",1996,0.3,1,1,0,1,0,1,2,50,1,2,0,2,1,2,0,0,"https://fbref.com/en/players/34caa4b3/Oussama-Idrissi"
2021,"Sevilla","La Liga","Luuk de Jong","NED","FW","29",1990,14.1,9,5,3,2,4,1,7,14.3,6,11,3,8,5,14,15,0,"https://fbref.com/en/players/abb3bb95/Luuk-de-Jong"
2021,"Sevilla","La Liga","Joan Jordán","ESP","MF","26",1994,26.7,52,28,17,29,6,17,76,22.4,59,22,3,19,27,79,25,0,"https://fbref.com/en/players/2a0c8ba4/Joan-Jordan"
2021,"Sevilla","La Liga","Jules Koundé","FRA","DF","21",1998,33.1,27,15,14,11,2,10,24,41.7,14,24,16,8,40,67,104,0,"https://fbref.com/en/players/4d1666ff/Jules-Kounde"
2021,"Sevilla","La Liga","Jesús Navas","ESP","DF","34",1985,31.4,27,21,15,11,1,15,22,68.2,7,10,3,7,37,64,62,1,"https://fbref.com/en/players/3f10bd22/Jesus-Navas"
2021,"Sevilla","La Liga","Lucas Ocampos","ARG","FW","26",1994,29.2,36,24,12,16,8,13,37,35.1,24,33,1,32,19,55,30,1,"https://fbref.com/en/players/a08b974a/Lucas-Ocampos"
2021,"Sevilla","La Liga","Ivan Rakitić","CRO","MF","32",1988,24.8,32,18,18,10,4,12,41,29.3,29,19,4,15,26,58,29,1,"https://fbref.com/en/players/89f951b5/Ivan-Rakitic"
2021,"Sevilla","La Liga","Karim Rekik","NED","DF","25",1994,7.3,7,5,2,5,0,1,4,25,3,8,3,5,6,13,17,0,"https://fbref.com/en/players/3376a776/Karim-Rekik"
2021,"Sevilla","La Liga","Óscar Rodríguez Arnaiz","ESP","MF,FW","22",1998,5.7,15,9,3,8,4,6,13,46.2,7,2,0,2,10,25,1,0,"https://fbref.com/en/players/19709006/Oscar-Rodriguez-Arnaiz"
2021,"Sevilla","La Liga","Suso","ESP","FW","26",1993,24.6,20,10,8,6,6,10,41,24.4,31,12,0,12,8,28,8,0,"https://fbref.com/en/players/4e219ad2/Suso"
2021,"Sevilla","La Liga","Óliver Torres","ESP","MF,FW","25",1994,15.6,34,22,13,15,6,19,53,35.8,34,15,0,15,15,49,9,0,"https://fbref.com/en/players/58a9a4d9/Oliver-Torres"
2021,"Sevilla","La Liga","Tomáš Vaclík","CZE","GK","31",1989,5,0,0,0,0,0,0,1,0,1,0,0,0,0,0,0,1,"https://fbref.com/en/players/7b456af7/Tomas-Vaclik"
2021,"Sevilla","La Liga","Franco Vázquez","ARG","FW,MF","31",1989,1.8,5,1,0,3,2,1,5,20,4,2,1,1,1,6,1,0,"https://fbref.com/en/players/467bae22/Franco-Vazquez"
2021,"Sevilla","La Liga","Aleix Vidal","ESP","DF","30",1989,6.6,9,5,5,3,1,5,12,41.7,7,10,1,9,12,21,9,0,"https://fbref.com/en/players/04965583/Aleix-Vidal"
2021,"Sheffield Utd","Premier League","Ethan Ampadu","WAL","DF,MF","19",2000,23.2,57,36,31,24,2,20,46,43.5,26,40,19,21,49,106,87,3,"https://fbref.com/en/players/10b9fa99/Ethan-Ampadu"
2021,"Sheffield Utd","Premier League","George Baldock","GRE","DF","27",1993,31,47,34,28,14,5,21,50,42,29,26,7,19,25,72,70,1,"https://fbref.com/en/players/394854c4/George-Baldock"
2021,"Sheffield Utd","Premier League","Chris Basham","ENG","DF,MF","32",1988,28.6,69,42,41,23,5,41,67,61.2,26,36,15,21,49,118,105,1,"https://fbref.com/en/players/1aa84968/Chris-Basham"
2021,"Sheffield Utd","Premier League","Sander Berge","NOR","MF","22",1998,12.4,16,7,8,5,3,7,15,46.7,8,11,2,9,4,20,18,0,"https://fbref.com/en/players/d0b6129f/Sander-Berge"
2021,"Sheffield Utd","Premier League","Jayden Bogle","ENG","DF,MF","20",2000,12.3,33,23,21,10,2,20,39,51.3,19,14,4,10,14,47,22,0,"https://fbref.com/en/players/ae5019e6/Jayden-Bogle"
2021,"Sheffield Utd","Premier League","Rhian Brewster","ENG","FW,MF","20",2000,12.5,8,5,1,4,3,1,13,7.7,12,15,2,13,5,13,5,0,"https://fbref.com/en/players/30e81a88/Rhian-Brewster"
2021,"Sheffield Utd","Premier League","Kean Bryan","ENG","DF","23",1996,11.2,20,10,9,11,0,9,19,47.4,10,16,10,6,13,33,39,1,"https://fbref.com/en/players/c684d3c9/Kean-Bryan"
2021,"Sheffield Utd","Premier League","Oliver Burke","SCO","FW","23",1997,14.1,16,8,6,9,1,5,24,20.8,19,24,0,24,2,18,6,0,"https://fbref.com/en/players/f631c17f/Oliver-Burke"
2021,"Sheffield Utd","Premier League","John Egan","IRL","DF","27",1992,29.2,41,21,29,12,0,22,39,56.4,17,43,31,12,41,82,131,0,"https://fbref.com/en/players/debe38a0/John-Egan"
2021,"Sheffield Utd","Premier League","John Fleck","SCO","MF","28",1991,28.6,51,33,28,18,5,26,83,31.3,57,26,4,22,28,79,12,1,"https://fbref.com/en/players/b63e789d/John-Fleck"
2021,"Sheffield Utd","Premier League","Antwoine Hackford","ENG","DF","16",2004,0.1,0,0,0,0,0,0,0,NA,0,0,0,0,0,0,0,0,"https://fbref.com/en/players/a7588cdc/Antwoine-Hackford"
2021,"Sheffield Utd","Premier League","Phil Jagielka","ENG","DF","37",1982,5.8,5,4,4,0,1,2,7,28.6,5,11,5,6,10,15,26,2,"https://fbref.com/en/players/3233eefd/Phil-Jagielka"
2021,"Sheffield Utd","Premier League","Daniel Jebbison","ENG","FW","17",2003,3.2,6,2,1,3,2,3,7,42.9,4,6,1,5,1,7,0,0,"https://fbref.com/en/players/03edb878/Daniel-Jebbison"
2021,"Sheffield Utd","Premier League","Max Lowe","ENG","DF","23",1997,6.1,26,11,18,6,2,9,21,42.9,12,12,4,8,5,31,11,0,"https://fbref.com/en/players/7af88b33/Max-Lowe"
2021,"Sheffield Utd","Premier League","John Lundstram","ENG","MF","26",1994,22.6,25,16,12,11,2,13,47,27.7,34,26,8,18,14,39,29,1,"https://fbref.com/en/players/0df2b165/John-Lundstram"
2021,"Sheffield Utd","Premier League","Oliver McBurnie","SCO","FW","24",1996,14.7,15,7,7,7,1,5,17,29.4,12,10,3,7,6,21,30,0,"https://fbref.com/en/players/78b8ac63/Oliver-McBurnie"
2021,"Sheffield Utd","Premier League","David McGoldrick","IRL","FW,MF","32",1987,26.6,33,21,8,15,10,13,31,41.9,18,19,3,16,2,35,25,0,"https://fbref.com/en/players/dbe56a33/David-McGoldrick"
2021,"Sheffield Utd","Premier League","Lys Mousset","FRA","FW,MF","24",1996,3.3,1,0,0,0,1,0,2,0,2,1,0,1,0,1,1,1,"https://fbref.com/en/players/d9cfca3d/Lys-Mousset"
2021,"Sheffield Utd","Premier League","Iliman Ndiaye","SEN","MF","20",2000,0.1,1,1,0,1,0,1,1,100,0,0,0,0,0,1,0,0,"https://fbref.com/en/players/5ed97752/Iliman-Ndiaye"
2021,"Sheffield Utd","Premier League","Oliver Norwood","NIR","MF","29",1991,24.7,49,22,16,28,5,21,72,29.2,51,29,12,17,36,85,51,1,"https://fbref.com/en/players/43439614/Oliver-Norwood"
2021,"Sheffield Utd","Premier League","Jack O'Connell","ENG","DF","26",1994,2,3,1,1,1,1,0,1,0,1,4,3,1,2,5,7,0,"https://fbref.com/en/players/312626c1/Jack-OConnell"
2021,"Sheffield Utd","Premier League","Ben Osborn","ENG","MF,DF","25",1994,17.8,33,18,15,10,8,13,40,32.5,27,20,3,17,12,45,17,0,"https://fbref.com/en/players/79bc4c45/Ben-Osborn"
2021,"Sheffield Utd","Premier League","Aaron Ramsdale","ENG","GK","22",1998,38,1,1,1,0,0,1,1,100,0,0,0,0,2,3,22,6,"https://fbref.com/en/players/466fb2c5/Aaron-Ramsdale"
2021,"Sheffield Utd","Premier League","Jack Robinson","ENG","DF","26",1993,9.7,14,6,8,5,1,6,11,54.5,5,10,4,6,9,23,42,0,"https://fbref.com/en/players/7399c7a8/Jack-Robinson"
2021,"Sheffield Utd","Premier League","Femi Seriki","ENG","MF","18",2002,0,0,0,0,0,0,0,0,NA,0,0,0,0,0,0,0,0,"https://fbref.com/en/players/e4e0deaa/Femi-Seriki"
2021,"Sheffield Utd","Premier League","Billy Sharp","ENG","FW","34",1986,8.2,5,1,0,3,2,2,9,22.2,7,2,0,2,0,5,2,0,"https://fbref.com/en/players/e8c9f4e9/Billy-Sharp"
2021,"Sheffield Utd","Premier League","Enda Stevens","IRL","DF","30",1990,30,59,26,32,19,8,33,58,56.9,25,41,12,29,22,81,81,1,"https://fbref.com/en/players/17d4507a/Enda-Stevens"
2021,"Southampton","Premier League","Che Adams","SCO","FW","24",1996,29.6,25,16,4,15,6,6,17,35.3,11,20,2,18,4,29,19,1,"https://fbref.com/en/players/f2bf1b0f/Che-Adams"
2021,"Southampton","Premier League","Stuart Armstrong","SCO","MF","28",1992,30.7,60,41,19,32,9,27,75,36,48,26,1,25,24,84,19,0,"https://fbref.com/en/players/97333cf5/Stuart-Armstrong"
2021,"Southampton","Premier League","Jan Bednarek","POL","DF","24",1996,34.4,37,19,25,11,1,25,49,51,24,44,27,17,84,121,132,0,"https://fbref.com/en/players/4115ce4e/Jan-Bednarek"
2021,"Southampton","Premier League","Ryan Bertrand","ENG","DF","30",1989,28.9,60,32,26,27,7,30,48,62.5,18,19,1,18,30,90,41,1,"https://fbref.com/en/players/01226327/Ryan-Bertrand"
2021,"Southampton","Premier League","Ibrahima Diallo","FRA","MF","21",1999,11.3,29,16,11,17,1,9,16,56.3,7,10,1,9,10,39,12,2,"https://fbref.com/en/players/11ff3d56/Ibrahima-Diallo"
2021,"Southampton","Premier League","Moussa Djenepo","MLI","MF","22",1998,13.8,52,27,27,17,8,28,63,44.4,35,24,2,22,10,62,14,0,"https://fbref.com/en/players/254147d4/Moussa-Djenepo"
2021,"Southampton","Premier League","Fraser Forster","ENG","GK","32",1988,8,1,0,1,0,0,1,2,50,1,0,0,0,0,1,9,0,"https://fbref.com/en/players/c3e39f12/Fraser-Forster"
2021,"Southampton","Premier League","Danny Ings","ENG","FW","28",1992,24.1,22,13,3,16,3,12,28,42.9,16,39,2,37,3,25,27,1,"https://fbref.com/en/players/07802f7f/Danny-Ings"
2021,"Southampton","Premier League","Alexandre Jankewitz","SUI","MF","18",2001,0,2,1,2,0,0,1,1,100,0,0,0,0,0,2,0,0,"https://fbref.com/en/players/7c39363f/Alexandre-Jankewitz"
2021,"Southampton","Premier League","Shane Long","IRL","FW","33",1987,2.3,2,1,0,0,2,2,3,66.7,1,0,0,0,3,5,1,0,"https://fbref.com/en/players/9f472354/Shane-Long"
2021,"Southampton","Premier League","Alex McCarthy","ENG","GK","30",1989,30,1,0,1,0,0,1,4,25,3,0,0,0,0,1,11,1,"https://fbref.com/en/players/36c2ca73/Alex-McCarthy"
2021,"Southampton","Premier League","Takumi Minamino","JPN","MF","25",1995,7.9,7,3,2,5,0,2,19,10.5,17,13,1,12,4,11,9,0,"https://fbref.com/en/players/f833a830/Takumi-Minamino"
2021,"Southampton","Premier League","Dan Nlundulu","ENG","FW,MF","21",1999,1.2,0,0,0,0,0,0,1,0,1,2,0,2,0,0,2,0,"https://fbref.com/en/players/30040f5d/Dan-Nlundulu"
2021,"Southampton","Premier League","Michael Obafemi","IRL","FW","20",2000,0.7,1,0,0,1,0,0,1,0,1,1,0,1,0,1,0,0,"https://fbref.com/en/players/caa1a7f0/Michael-Obafemi"
2021,"Southampton","Premier League","Kayne Ramsey","ENG","DF","19",2000,1,5,2,4,1,0,3,3,100,0,0,0,0,0,5,3,0,"https://fbref.com/en/players/dc31b84c/Kayne-Ramsey"
2021,"Southampton","Premier League","Nathan Redmond","ENG","MF,FW","26",1994,19.3,30,17,14,12,4,8,24,33.3,16,24,2,22,11,41,9,0,"https://fbref.com/en/players/ab651565/Nathan-Redmond"
2021,"Southampton","Premier League","Oriol Romeu","ESP","MF","28",1991,19.6,69,35,25,39,5,26,68,38.2,42,28,7,21,30,99,18,0,"https://fbref.com/en/players/4b511457/Oriol-Romeu"
2021,"Southampton","Premier League","Mohammed Salisu","GHA","DF","21",1999,9.4,38,21,20,16,2,25,34,73.5,9,22,5,17,17,55,30,0,"https://fbref.com/en/players/0b33f6ad/Mohammed-Salisu"
2021,"Southampton","Premier League","William Smallbone","IRL","MF","20",2000,1.9,6,3,2,4,0,1,3,33.3,2,5,0,5,2,8,1,0,"https://fbref.com/en/players/5e105217/William-Smallbone"
2021,"Southampton","Premier League","Jack Stephens","ENG","DF","26",1994,17.1,34,19,19,15,0,17,38,44.7,21,25,14,11,28,62,64,2,"https://fbref.com/en/players/6adbc307/Jack-Stephens"
2021,"Southampton","Premier League","Allan Tchaptchet","FRA","DF","18",2001,0.1,0,0,0,0,0,0,0,NA,0,0,0,0,0,0,0,0,"https://fbref.com/en/players/ab7d7882/Allan-Tchaptchet"
2021,"Southampton","Premier League","Nathan Tella","ENG","FW,MF","21",1999,8.3,8,5,1,4,3,6,15,40,9,13,0,13,3,11,2,0,"https://fbref.com/en/players/f1e94cd6/Nathan-Tella"
2021,"Southampton","Premier League","Yan Valery","TUN","DF,MF","21",1999,1.1,5,3,2,3,0,1,5,20,4,2,0,2,2,7,5,0,"https://fbref.com/en/players/531a4aa8/Yan-Valery"
2021,"Southampton","Premier League","Jannik Vestergaard","DEN","DF","27",1992,28.6,50,31,31,15,4,35,52,67.3,17,29,16,13,42,92,122,0,"https://fbref.com/en/players/1900032e/Jannik-Vestergaard"
2021,"Southampton","Premier League","Jake Vokins","ENG","DF","20",2000,0.7,0,0,0,0,0,0,1,0,1,0,0,0,0,0,0,0,"https://fbref.com/en/players/d484c261/Jake-Vokins"
2021,"Southampton","Premier League","Theo Walcott","ENG","MF,FW","31",1989,18,23,11,8,9,6,11,32,34.4,21,16,0,16,14,37,5,0,"https://fbref.com/en/players/1ecb65be/Theo-Walcott"
2021,"Southampton","Premier League","Kyle Walker-Peters","ENG","DF","23",1997,29.4,83,53,56,25,2,34,57,59.6,23,41,10,31,38,121,66,2,"https://fbref.com/en/players/984a5a64/Kyle-Walker-Peters"
2021,"Southampton","Premier League","James Ward-Prowse","ENG","MF","25",1994,38,75,49,30,41,4,29,70,41.4,41,36,4,32,42,117,60,0,"https://fbref.com/en/players/3515d404/James-Ward-Prowse"
2021,"Southampton","Premier League","Caleb Watts","AUS","MF","18",2002,0.4,2,1,2,0,0,1,2,50,1,0,0,0,0,2,0,0,"https://fbref.com/en/players/c7170b46/Caleb-Watts"
2021,"Spezia","Serie A","Gennaro Acampora","ITA","MF,FW","26",1994,4.9,6,4,1,4,1,2,7,28.6,5,4,1,3,4,10,4,0,"https://fbref.com/en/players/01040647/Gennaro-Acampora"
2021,"Spezia","Serie A","Lucien Agoume","FRA","MF","18",2002,8.9,18,10,11,7,0,6,19,31.6,13,10,5,5,15,33,10,0,"https://fbref.com/en/players/8bc8829a/Lucien-Agoume"
2021,"Spezia","Serie A","Kevin Agudelo","COL","FW","21",1998,15.1,39,28,9,15,15,12,34,35.3,22,30,0,30,10,49,2,0,"https://fbref.com/en/players/46fa7204/Kevin-Agudelo"
2021,"Spezia","Serie A","Paolo Bartolomei","ITA","MF","30",1989,3.6,6,2,3,1,2,4,7,57.1,3,1,0,1,1,7,2,0,"https://fbref.com/en/players/6029a945/Paolo-Bartolomei"
2021,"Spezia","Serie A","Simone Bastoni","ITA","DF","23",1996,16.9,50,29,26,22,2,27,52,51.9,25,19,1,18,16,66,31,0,"https://fbref.com/en/players/1ac232b8/Simone-Bastoni"
2021,"Spezia","Serie A","Elio Capradossi","ITA","DF","24",1996,1,2,1,2,0,0,2,2,100,0,0,0,0,1,3,5,0,"https://fbref.com/en/players/174944a3/Elio-Capradossi"
2021,"Spezia","Serie A","Julian Chabot","GER","DF","22",1998,18.4,48,34,28,16,4,23,37,62.2,14,25,13,12,37,85,43,1,"https://fbref.com/en/players/ae7058f9/Julian-Chabot"
2021,"Spezia","Serie A","Alessandro Deiola","ITA","MF","24",1995,4,6,3,2,3,1,5,13,38.5,8,3,1,2,3,9,1,0,"https://fbref.com/en/players/7f267d66/Alessandro-Deiola"
2021,"Spezia","Serie A","Cristian Dell'Orco","ITA","DF","26",1994,2.9,1,0,1,0,0,1,3,33.3,2,8,5,3,7,8,9,1,"https://fbref.com/en/players/b0243215/Cristian-DellOrco"
2021,"Spezia","Serie A","Martin Erlic","CRO","DF","22",1998,20,23,14,16,6,1,11,20,55,9,22,16,6,41,64,71,2,"https://fbref.com/en/players/0fee6bda/Martin-Erlic"
2021,"Spezia","Serie A","Nahuel Estévez","ARG","MF","24",1995,19.6,13,5,4,6,3,5,32,15.6,27,23,5,18,20,33,22,1,"https://fbref.com/en/players/cec60a2f/Nahuel-Estevez"
2021,"Spezia","Serie A","Diego Farias","BRA","FW","30",1990,16.8,9,5,4,1,4,4,21,19,17,12,0,12,13,22,3,0,"https://fbref.com/en/players/157d29b6/Diego-Farias"
2021,"Spezia","Serie A","Salvador Ferrer","ESP","DF","22",1998,13.2,20,10,10,8,2,8,22,36.4,14,13,4,9,24,44,37,1,"https://fbref.com/en/players/eb76987d/Salvador-Ferrer"
2021,"Spezia","Serie A","Andrey Galabinov","BUL","FW","31",1988,4.8,2,1,1,1,0,1,3,33.3,2,2,0,2,0,2,5,0,"https://fbref.com/en/players/0a1efd3c/Andrey-Galabinov"
2021,"Spezia","Serie A","Emmanuel Gyasi","GHA","FW","26",1994,31.7,30,16,16,10,4,9,31,29,22,13,2,11,14,44,8,0,"https://fbref.com/en/players/f9758dae/Emmanuel-Gyasi"
2021,"Spezia","Serie A","Ardian Ismajli","ALB","DF","23",1996,14.4,19,9,10,8,1,8,13,61.5,5,10,7,3,23,42,52,1,"https://fbref.com/en/players/6b635f5c/Ardian-Ismajli"
2021,"Spezia","Serie A","Giulio Maggiore","ITA","MF","22",1998,24.6,61,36,26,28,7,21,53,39.6,32,33,6,27,19,80,25,1,"https://fbref.com/en/players/957e4c87/Giulio-Maggiore"
2021,"Spezia","Serie A","Juan Manuel Ramos","URU","DF","23",1996,3.3,5,0,3,0,2,4,7,57.1,3,1,0,1,2,7,6,0,"https://fbref.com/en/players/36d7971a/Juan-Manuel-Ramos"
2021,"Spezia","Serie A","Riccardo Marchizza","ITA","DF","22",1998,17.3,20,11,12,5,3,12,21,57.1,9,13,4,9,11,31,27,0,"https://fbref.com/en/players/91d0fabf/Riccardo-Marchizza"
2021,"Spezia","Serie A","Giuseppe Mastinu","ITA","FW","28",1991,0.4,1,1,0,0,1,1,1,100,0,1,0,1,0,1,0,0,"https://fbref.com/en/players/26cd1bff/Giuseppe-Mastinu"
2021,"Spezia","Serie A","Federico Mattiello","ITA","DF","25",1995,0.4,0,0,0,0,0,0,0,NA,0,0,0,0,0,0,0,0,"https://fbref.com/en/players/fba81826/Federico-Mattiello"
2021,"Spezia","Serie A","Luca Mora","ITA","MF","32",1988,1.3,3,1,1,2,0,2,4,50,2,2,1,1,0,3,2,0,"https://fbref.com/en/players/42fff925/Luca-Mora"
2021,"Spezia","Serie A","M'Bala Nzola","ANG","FW","23",1996,21.1,12,5,2,6,4,4,7,57.1,3,15,1,14,3,15,20,0,"https://fbref.com/en/players/a4948e67/MBala-Nzola"
2021,"Spezia","Serie A","Roberto Piccoli","ITA","FW","19",2001,7.8,7,3,0,4,3,2,4,50,2,4,0,4,2,9,5,0,"https://fbref.com/en/players/1cadaf34/Roberto-Piccoli"
2021,"Spezia","Serie A","Tommaso Pobega","ITA","MF","21",1999,13.7,24,13,7,13,4,11,31,35.5,20,10,2,8,9,33,22,0,"https://fbref.com/en/players/55a1cac2/Tommaso-Pobega"
2021,"Spezia","Serie A","Ivan Provedel","ITA","GK","26",1994,29,2,0,2,0,0,2,6,33.3,4,0,0,0,2,4,20,1,"https://fbref.com/en/players/277da414/Ivan-Provedel"
2021,"Spezia","Serie A","Rafael","BRA","GK","38",1982,2.3,0,0,0,0,0,0,0,NA,0,0,0,0,0,0,0,0,"https://fbref.com/en/players/dd06d56c/Rafael"
2021,"Spezia","Serie A","Matteo Ricci","ITA","MF","26",1994,24.8,40,23,14,24,2,27,52,51.9,25,24,4,20,34,74,13,0,"https://fbref.com/en/players/3cf7dc7e/Matteo-Ricci"
2021,"Spezia","Serie A","Jacopo Sala","ITA","DF","28",1991,4.2,17,9,14,1,2,8,22,36.4,14,5,2,3,5,22,6,0,"https://fbref.com/en/players/da5a981b/Jacopo-Sala"
2021,"Spezia","Serie A","Riccardo Saponara","ITA","FW,MF","28",1991,4.3,4,1,1,0,3,1,3,33.3,2,1,0,1,1,5,4,0,"https://fbref.com/en/players/3bb7af3b/Riccardo-Saponara"
2021,"Spezia","Serie A","Léo Sena","BRA","MF","24",1995,9.8,22,12,7,10,5,12,26,46.2,14,19,4,15,11,33,5,0,"https://fbref.com/en/players/1de40dae/Leo-Sena"
2021,"Spezia","Serie A","Claudio Terzi","ITA","DF","36",1984,20.8,34,21,19,14,1,19,28,67.9,9,23,12,11,35,69,55,1,"https://fbref.com/en/players/5570e6fb/Claudio-Terzi"
2021,"Spezia","Serie A","Daniele Verde","ITA","FW","24",1996,10.9,5,4,2,2,1,4,10,40,6,5,0,5,9,14,7,0,"https://fbref.com/en/players/d3298c99/Daniele-Verde"
2021,"Spezia","Serie A","Luca Vignali","ITA","DF","24",1996,17.7,19,9,10,6,3,7,25,28,18,13,5,8,22,41,25,0,"https://fbref.com/en/players/c1e8e74e/Luca-Vignali"
2021,"Spezia","Serie A","Jeroen Zoet","NED","GK","29",1991,6.7,0,0,0,0,0,0,1,0,1,0,0,0,0,0,4,2,"https://fbref.com/en/players/cc1a0c57/Jeroen-Zoet"
2021,"Strasbourg","Ligue 1","Ismael Aaneba","FRA","DF","21",1999,0.1,0,0,0,0,0,0,0,NA,0,0,0,0,1,1,1,0,"https://fbref.com/en/players/a7e4760c/Ismael-Aaneba"
2021,"Strasbourg","Ligue 1","Jean-Eudes Aholou","CIV","MF","26",1994,23.8,46,25,18,25,3,19,48,39.6,29,17,5,12,53,99,32,0,"https://fbref.com/en/players/48b28bfd/Jean-Eudes-Aholou"
2021,"Strasbourg","Ligue 1","Ludovic Ajorque","FRA","FW","26",1994,33,30,18,6,18,6,7,31,22.6,24,14,5,9,11,41,54,0,"https://fbref.com/en/players/462475ed/Ludovic-Ajorque"
2021,"Strasbourg","Ligue 1","Jean-Ricner Bellegarde","FRA","MF,FW","22",1998,23.2,56,39,22,25,9,14,23,60.9,9,20,2,18,19,75,16,0,"https://fbref.com/en/players/10f0fdd3/Jean-Ricner-Bellegarde"
2021,"Strasbourg","Ligue 1","Anthony Caci","FRA","DF","23",1997,31.1,80,46,47,27,6,35,69,50.7,34,30,4,26,55,135,65,1,"https://fbref.com/en/players/0118c54c/Anthony-Caci"
2021,"Strasbourg","Ligue 1","Lionel Carole","FRA","DF","29",1991,14.9,37,25,18,14,5,16,29,55.2,13,3,1,2,38,75,28,0,"https://fbref.com/en/players/5b5724d2/Lionel-Carole"
2021,"Strasbourg","Ligue 1","Mehdi Chahiri","MAR","FW,MF","24",1996,8.9,18,8,7,5,6,8,20,40,12,9,0,9,6,24,5,0,"https://fbref.com/en/players/1787195f/Mehdi-Chahiri"
2021,"Strasbourg","Ligue 1","Habib Diallo","SEN","FW","25",1995,25.8,11,6,3,6,2,7,18,38.9,11,12,2,10,13,24,12,0,"https://fbref.com/en/players/6605d143/Habib-Diallo"
2021,"Strasbourg","Ligue 1","Alexander Djiku","GHA","DF,MF","25",1994,28.4,60,41,45,13,2,32,52,61.5,20,28,10,18,91,151,104,0,"https://fbref.com/en/players/43e7a164/Alexander-Djiku"
2021,"Strasbourg","Ligue 1","Frederic Guilbert","FRA","DF","25",1994,12.4,37,19,23,11,3,21,34,61.8,13,14,1,13,33,70,32,0,"https://fbref.com/en/players/5d8d7454/Frederic-Guilbert"
2021,"Strasbourg","Ligue 1","Bingourou Kamara","SEN","GK","23",1996,8,1,1,1,0,0,1,3,33.3,2,0,0,0,1,2,2,1,"https://fbref.com/en/players/3814120d/Bingourou-Kamara"
2021,"Strasbourg","Ligue 1","Eiji Kawashima","JPN","GK","37",1983,24,1,0,1,0,0,1,1,100,0,0,0,0,0,1,4,2,"https://fbref.com/en/players/a4527d33/Eiji-Kawashima"
2021,"Strasbourg","Ligue 1","Lamine Koné","CIV","DF","31",1989,11.6,9,6,5,4,0,5,8,62.5,3,4,3,1,15,24,36,0,"https://fbref.com/en/players/a46472d0/Lamine-Kone"
2021,"Strasbourg","Ligue 1","Kenny Lala","FRA","DF","28",1991,20.4,22,13,13,8,1,11,22,50,11,12,6,6,23,45,33,1,"https://fbref.com/en/players/770d7eb8/Kenny-Lala"
2021,"Strasbourg","Ligue 1","Dimitri Liénard","FRA","MF","32",1988,20.3,39,27,17,19,3,24,55,43.6,31,23,1,22,18,57,10,0,"https://fbref.com/en/players/f7691f63/Dimitri-Lienard"
2021,"Strasbourg","Ligue 1","Abdul Majeed Waris","GHA","FW,MF","28",1991,6.1,1,1,1,0,0,1,6,16.7,5,0,0,0,2,3,2,0,"https://fbref.com/en/players/46907171/Abdul-Majeed-Waris"
2021,"Strasbourg","Ligue 1","Stefan Mitrović","SRB","DF","30",1990,30.9,36,27,29,7,0,24,37,64.9,13,23,13,10,31,67,108,5,"https://fbref.com/en/players/e6777e6b/Stefan-Mitrovic"
2021,"Strasbourg","Ligue 1","Dion Moise Sahi","CIV","FW,MF","18",2001,1,1,0,0,1,0,1,1,100,0,1,0,1,0,1,0,0,"https://fbref.com/en/players/cdc4458b/Dion-Moise-Sahi"
2021,"Strasbourg","Ligue 1","Sanjin Prcić","BIH","MF","26",1993,3.9,3,2,0,3,0,2,5,40,3,4,3,1,4,7,2,1,"https://fbref.com/en/players/51c30111/Sanjin-Prcic"
2021,"Strasbourg","Ligue 1","Idriss Saadi","ALG","MF,FW","28",1992,1.4,0,0,0,0,0,0,2,0,2,0,0,0,0,0,0,0,"https://fbref.com/en/players/17f29fb0/Idriss-Saadi"
2021,"Strasbourg","Ligue 1","Matz Sels","BEL","GK","28",1992,6,0,0,0,0,0,0,0,NA,0,0,0,0,0,0,4,0,"https://fbref.com/en/players/834b5c4c/Matz-Sels"
2021,"Strasbourg","Ligue 1","Mahame Siby","MLI","MF","24",1996,0.2,0,0,0,0,0,0,1,0,1,0,0,0,0,0,1,0,"https://fbref.com/en/players/6d075c67/Mahame-Siby"
2021,"Strasbourg","Ligue 1","Mohamed Simakan","FRA","DF","20",2000,17.9,32,22,21,6,5,9,18,50,9,17,11,6,31,63,41,0,"https://fbref.com/en/players/fcb27134/Mohamed-Simakan"
2021,"Strasbourg","Ligue 1","Ibrahima Sissoko","FRA","MF","22",1997,28.7,68,48,25,35,8,28,68,41.2,40,22,5,17,48,116,44,0,"https://fbref.com/en/players/0f8418aa/Ibrahima-Sissoko"
2021,"Strasbourg","Ligue 1","Adrien Thomasson","FRA","MF,FW","26",1993,29.2,36,17,8,16,12,12,58,20.7,46,44,5,39,22,58,2,0,"https://fbref.com/en/players/c76b7567/Adrien-Thomasson"
2021,"Strasbourg","Ligue 1","Kévin Zohi","MLI","FW,MF","23",1996,4.8,9,5,3,4,2,2,6,33.3,4,6,0,6,6,15,3,0,"https://fbref.com/en/players/775185ae/Kevin-Zohi"
2021,"Stuttgart","Bundesliga","Naouirou Ahamada","FRA","MF","18",2002,2.8,4,1,3,1,0,1,1,100,0,2,0,2,1,5,1,0,"https://fbref.com/en/players/a6c58494/Naouirou-Ahamada"
2021,"Stuttgart","Bundesliga","Waldemar Anton","GER","DF","24",1996,30.1,31,20,17,14,0,12,31,38.7,19,28,18,10,47,78,114,0,"https://fbref.com/en/players/5e66fa06/Waldemar-Anton"
2021,"Stuttgart","Bundesliga","Fabian Bredlow","GER","GK","25",1995,1,0,0,0,0,0,0,0,NA,0,0,0,0,0,0,0,0,"https://fbref.com/en/players/d28339cb/Fabian-Bredlow"
2021,"Stuttgart","Bundesliga","Gonzalo Castro","GER","MF","33",1987,19.2,21,7,6,9,6,8,23,34.8,15,16,3,13,8,29,12,0,"https://fbref.com/en/players/68829001/Gonzalo-Castro"
2021,"Stuttgart","Bundesliga","Darko Churlinov","MKD","DF,MF","20",2000,2.4,2,2,2,0,0,1,3,33.3,2,5,1,4,0,2,2,0,"https://fbref.com/en/players/c6608135/Darko-Churlinov"
2021,"Stuttgart","Bundesliga","Tanguy Coulibaly","FRA","DF,FW","19",2001,16.7,26,15,10,7,9,11,23,47.8,12,20,0,20,10,36,11,0,"https://fbref.com/en/players/05ba9d7c/Tanguy-Coulibaly"
2021,"Stuttgart","Bundesliga","Daniel Didavi","GER","MF,FW","30",1990,10.8,16,6,2,9,5,7,12,58.3,5,10,0,10,3,19,8,0,"https://fbref.com/en/players/d3096421/Daniel-Didavi"
2021,"Stuttgart","Bundesliga","Lilian Egloff","GER","MF","17",2002,0.2,0,0,0,0,0,0,0,NA,0,0,0,0,0,0,0,0,"https://fbref.com/en/players/2f7fec15/Lilian-Egloff"
2021,"Stuttgart","Bundesliga","Wataru Endo","JPN","MF","27",1993,32.8,65,44,25,34,6,29,71,40.8,42,53,14,39,51,116,59,0,"https://fbref.com/en/players/c149016b/Wataru-Endo"
2021,"Stuttgart","Bundesliga","Philipp Förster","GER","MF","25",1995,16.8,22,13,7,12,3,6,25,24,19,18,1,17,15,37,2,0,"https://fbref.com/en/players/76fa965f/Philipp-Forster"
2021,"Stuttgart","Bundesliga","Hamadi Al Ghaddioui","MAR","FW","29",1990,0.5,0,0,0,0,0,0,1,0,1,0,0,0,0,0,0,0,"https://fbref.com/en/players/5723931e/Hamadi-Al-Ghaddioui"
2021,"Stuttgart","Bundesliga","Nicolás González","ARG","FW,MF","22",1998,10.4,5,5,1,2,2,0,6,0,6,10,3,7,4,9,6,0,"https://fbref.com/en/players/2374aaca/Nicolas-Gonzalez"
2021,"Stuttgart","Bundesliga","Sasa Kalajdzic","AUT","FW","23",1997,23.7,16,12,4,5,7,2,17,11.8,15,10,1,9,9,25,21,0,"https://fbref.com/en/players/15f24fe7/Sasa-Kalajdzic"
2021,"Stuttgart","Bundesliga","Marcin Kamiński","POL","DF","28",1992,2.4,1,1,0,0,1,0,0,NA,0,2,1,1,1,2,10,0,"https://fbref.com/en/players/463503e2/Marcin-Kaminski"
2021,"Stuttgart","Bundesliga","Atakan Karazor","GER","DF,MF","23",1996,11.5,20,12,12,7,1,13,22,59.1,9,18,8,10,21,41,50,2,"https://fbref.com/en/players/5762be5c/Atakan-Karazor"
2021,"Stuttgart","Bundesliga","Silas Katompa","COD","DF,FW","21",1998,21.3,48,29,19,19,10,21,44,47.7,23,29,1,28,22,70,11,2,"https://fbref.com/en/players/de4cac2d/Silas-Katompa"
2021,"Stuttgart","Bundesliga","Marc-Oliver Kempf","GER","DF","25",1995,30.3,49,26,28,18,3,29,49,59.2,20,40,25,15,68,117,103,1,"https://fbref.com/en/players/815c314f/Marc-Oliver-Kempf"
2021,"Stuttgart","Bundesliga","Philipp Klement","GER","MF,FW","27",1992,4.7,7,3,6,0,1,3,7,42.9,4,9,2,7,6,13,7,0,"https://fbref.com/en/players/0cddeaa7/Philipp-Klement"
2021,"Stuttgart","Bundesliga","Mateo Klimowicz","GER","MF,FW","20",2000,13.3,20,15,6,10,4,5,18,27.8,13,5,1,4,2,22,2,0,"https://fbref.com/en/players/2b7c56b4/Mateo-Klimowicz"
2021,"Stuttgart","Bundesliga","Gregor Kobel","SUI","GK","22",1997,33,2,2,2,0,0,2,2,100,0,0,0,0,2,4,8,1,"https://fbref.com/en/players/cd59b9df/Gregor-Kobel"
2021,"Stuttgart","Bundesliga","Luca Mack","GER","MF","20",2000,0.1,0,0,0,0,0,0,0,NA,0,0,0,0,0,0,1,0,"https://fbref.com/en/players/81868f73/Luca-Mack"
2021,"Stuttgart","Bundesliga","Orel Mangala","BEL","MF","22",1998,23.4,27,15,13,11,3,17,28,60.7,11,27,10,17,26,53,30,0,"https://fbref.com/en/players/a572e291/Orel-Mangala"
2021,"Stuttgart","Bundesliga","Roberto Massimo","GER","DF,FW","19",2000,8.4,21,11,13,5,3,11,24,45.8,13,5,1,4,11,32,13,0,"https://fbref.com/en/players/fc62fdf4/Roberto-Massimo"
2021,"Stuttgart","Bundesliga","Konstantinos Mavropanos","GRE","DF","22",1997,16.3,42,29,29,12,1,27,46,58.7,19,25,10,15,59,101,66,1,"https://fbref.com/en/players/00963611/Konstantinos-Mavropanos"
2021,"Stuttgart","Bundesliga","Alkhaly Momo Cissé","GUI","FW,DF","17",2002,0.4,1,1,1,0,0,0,0,NA,0,1,0,1,0,1,0,0,"https://fbref.com/en/players/c51e68be/Alkhaly-Momo-Cisse"
2021,"Stuttgart","Bundesliga","Mohamed Sankoh","NED","MF","16",2003,0.2,0,0,0,0,0,0,0,NA,0,1,0,1,0,0,0,0,"https://fbref.com/en/players/be625686/Mohamed-Sankoh"
2021,"Stuttgart","Bundesliga","Borna Sosa","CRO","DF,FW","22",1998,22.7,14,10,6,6,2,8,25,32,17,23,4,19,31,45,74,0,"https://fbref.com/en/players/af0d79a9/Borna-Sosa"
2021,"Stuttgart","Bundesliga","Pascal Stenzel","GER","DF","24",1996,14.2,33,14,15,17,1,22,50,44,28,19,4,15,26,59,39,1,"https://fbref.com/en/players/99f7e9aa/Pascal-Stenzel"
2021,"Stuttgart","Bundesliga","Erik Thommy","GER","MF,DF","25",1994,3.5,3,1,0,3,0,0,3,0,3,3,0,3,3,6,4,0,"https://fbref.com/en/players/df8e7b62/Erik-Thommy"
2021,"Torino","Serie A","Cristian Ansaldi","ARG","DF,FW","33",1986,21.6,48,33,25,14,9,24,38,63.2,14,21,7,14,16,64,38,0,"https://fbref.com/en/players/bbafc0c4/Cristian-Ansaldi"
2021,"Torino","Serie A","Daniele Baselli","ITA","MF","28",1992,4.4,12,7,3,6,3,6,10,60,4,2,0,2,9,21,5,0,"https://fbref.com/en/players/ea06dd97/Daniele-Baselli"
2021,"Torino","Serie A","Andrea Belotti","ITA","FW","26",1993,32.1,30,18,4,16,10,11,35,31.4,24,27,4,23,12,42,21,0,"https://fbref.com/en/players/d705ba44/Andrea-Belotti"
2021,"Torino","Serie A","Álex Berenguer","ESP","MF","25",1995,1.5,2,0,0,0,2,2,5,40,3,2,0,2,0,2,1,0,"https://fbref.com/en/players/dc1c2fce/Alex-Berenguer"
2021,"Torino","Serie A","Federico Bonazzoli","ITA","FW","23",1997,6.3,6,4,0,4,2,2,13,15.4,11,3,0,3,2,8,3,0,"https://fbref.com/en/players/bf57eaab/Federico-Bonazzoli"
2021,"Torino","Serie A","Gleison Bremer","BRA","DF","23",1997,32.6,51,34,36,14,1,21,36,58.3,15,54,21,33,70,121,142,1,"https://fbref.com/en/players/5fd5ed86/Gleison-Bremer"
2021,"Torino","Serie A","Alessandro Buongiorno","ITA","DF","21",1999,9.5,12,5,8,4,0,7,12,58.3,5,15,9,6,11,23,44,1,"https://fbref.com/en/players/4ae67f27/Alessandro-Buongiorno"
2021,"Torino","Serie A","Simone Edera","ITA","DF,MF","23",1997,0.6,3,1,2,1,0,3,4,75,1,0,0,0,1,4,1,0,"https://fbref.com/en/players/8697c095/Simone-Edera"
2021,"Torino","Serie A","Amer Gojak","BIH","MF,FW","23",1997,5.3,1,0,1,0,0,1,7,14.3,6,5,0,5,3,4,1,0,"https://fbref.com/en/players/51ffa295/Amer-Gojak"
2021,"Torino","Serie A","Armando Izzo","ITA","DF","28",1992,22.3,30,16,13,13,4,13,33,39.4,20,22,9,13,53,83,62,0,"https://fbref.com/en/players/89976232/Armando-Izzo"
2021,"Torino","Serie A","Karol Linetty","POL","MF","25",1995,20.4,38,28,13,19,6,16,45,35.6,29,19,5,14,15,53,7,0,"https://fbref.com/en/players/d023d70f/Karol-Linetty"
2021,"Torino","Serie A","Saša Lukić","SRB","MF","23",1996,23.4,32,13,11,18,3,15,50,30,35,23,5,18,17,49,17,0,"https://fbref.com/en/players/c6e8cf1f/Sasa-Lukic"
2021,"Torino","Serie A","Lyanco","BRA","DF","23",1997,21.8,21,14,13,6,2,8,14,57.1,6,36,26,10,46,67,76,0,"https://fbref.com/en/players/b5bf1770/Lyanco"
2021,"Torino","Serie A","Rolando Mandragora","ITA","MF","23",1997,16.9,19,4,4,9,6,7,30,23.3,23,19,6,13,20,39,19,0,"https://fbref.com/en/players/c7259b83/Rolando-Mandragora"
2021,"Torino","Serie A","Soualiho Meïté","FRA","MF","26",1994,10.2,11,7,6,4,1,5,16,31.3,11,18,1,17,10,21,9,1,"https://fbref.com/en/players/5cec2c74/Soualiho-Meite"
2021,"Torino","Serie A","Vanja Milinković-Savić","SRB","GK","23",1997,5,1,1,1,0,0,1,1,100,0,0,0,0,0,1,1,3,"https://fbref.com/en/players/9fa26bc2/Vanja-Milinkovic-Savic"
2021,"Torino","Serie A","Vincenzo Millico","ITA","FW,MF","19",2000,0.2,0,0,0,0,0,0,0,NA,0,0,0,0,0,0,0,0,"https://fbref.com/en/players/6817095b/Vincenzo-Millico"
2021,"Torino","Serie A","Nicola Murru","ITA","DF","25",1994,6.3,9,6,1,5,3,3,5,60,2,11,1,10,12,21,24,0,"https://fbref.com/en/players/d183e9d6/Nicola-Murru"
2021,"Torino","Serie A","Nicolas Nkoulou","CMR","DF","30",1990,15.1,14,9,11,3,0,7,12,58.3,5,28,14,14,33,47,71,1,"https://fbref.com/en/players/93cf32a8/Nicolas-Nkoulou"
2021,"Torino","Serie A","Tomás Rincón","VEN","MF","32",1988,31.6,68,38,27,33,8,36,71,50.7,35,32,7,25,31,99,44,0,"https://fbref.com/en/players/f1cfc209/Tomas-Rincon"
2021,"Torino","Serie A","Ricardo Rodríguez","SUI","DF","27",1992,13.8,21,14,11,8,2,13,22,59.1,9,16,5,11,20,41,43,0,"https://fbref.com/en/players/7f78ad23/Ricardo-Rodriguez"
2021,"Torino","Serie A","Antonio Sanabria","PAR","FW","24",1996,10.9,8,3,0,4,4,2,9,22.2,7,5,0,5,5,13,8,0,"https://fbref.com/en/players/0a447501/Antonio-Sanabria"
2021,"Torino","Serie A","Jacopo Segre","ITA","MF","23",1997,2.1,5,2,2,1,2,2,5,40,3,0,0,0,0,5,1,0,"https://fbref.com/en/players/3cb132e6/Jacopo-Segre"
2021,"Torino","Serie A","Wilfried Singo","CIV","DF","19",2000,20.6,29,14,16,6,7,17,33,51.5,16,13,3,10,29,58,40,0,"https://fbref.com/en/players/8b609c34/Wilfried-Singo"
2021,"Torino","Serie A","Salvatore Sirigu","ITA","GK","33",1987,32,1,0,1,0,0,1,2,50,1,0,0,0,0,1,6,2,"https://fbref.com/en/players/10dc46f0/Salvatore-Sirigu"
2021,"Torino","Serie A","Samir Ujkani","KVX","GK","32",1988,1,0,0,0,0,0,0,0,NA,0,0,0,0,0,0,1,0,"https://fbref.com/en/players/96640846/Samir-Ujkani"
2021,"Torino","Serie A","Simone Verdi","ITA","MF,FW","28",1992,18,19,12,10,6,3,6,19,31.6,13,8,0,8,8,27,2,2,"https://fbref.com/en/players/0375723e/Simone-Verdi"
2021,"Torino","Serie A","Mërgim Vojvoda","KVX","DF,FW","25",1995,15.1,24,14,18,5,1,12,22,54.5,10,19,4,15,18,42,35,1,"https://fbref.com/en/players/be2706c0/Mergim-Vojvoda"
2021,"Torino","Serie A","Simone Zaza","ITA","FW","29",1991,16.6,15,9,4,6,5,6,20,30,14,14,0,14,3,18,5,1,"https://fbref.com/en/players/9592289a/Simone-Zaza"
2021,"Tottenham","Premier League","Toby Alderweireld","BEL","DF","31",1989,24.9,35,22,22,11,2,18,30,60,12,40,28,12,10,45,121,0,"https://fbref.com/en/players/f7d50789/Toby-Alderweireld"
2021,"Tottenham","Premier League","Dele Alli","ENG","MF","24",1996,6.9,18,11,8,6,4,7,19,36.8,12,9,0,9,7,25,3,0,"https://fbref.com/en/players/cea4ee8f/Dele-Alli"
2021,"Tottenham","Premier League","Serge Aurier","CIV","DF","27",1992,17.8,55,33,33,17,5,15,40,37.5,25,28,5,23,19,74,44,3,"https://fbref.com/en/players/5c2b4f07/Serge-Aurier"
2021,"Tottenham","Premier League","Gareth Bale","WAL","FW","31",1989,10.2,17,10,4,9,4,7,14,50,7,13,2,11,8,25,16,0,"https://fbref.com/en/players/a58bb1e1/Gareth-Bale"
2021,"Tottenham","Premier League","Steven Bergwijn","NED","FW,MF","22",1997,13.4,15,7,8,3,4,7,20,35,13,7,1,6,5,20,9,0,"https://fbref.com/en/players/a29b1131/Steven-Bergwijn"
2021,"Tottenham","Premier League","Ben Davies","WAL","DF","27",1993,15,27,17,10,11,6,13,30,43.3,17,10,5,5,18,45,49,2,"https://fbref.com/en/players/44781702/Ben-Davies"
2021,"Tottenham","Premier League","Eric Dier","ENG","DF","26",1994,28,23,14,13,10,0,11,18,61.1,7,37,31,6,23,46,123,3,"https://fbref.com/en/players/ac861941/Eric-Dier"
2021,"Tottenham","Premier League","Matt Doherty","IRL","DF","28",1992,13.8,29,15,15,10,4,13,33,39.4,20,20,5,15,23,52,46,0,"https://fbref.com/en/players/d557d734/Matt-Doherty"
2021,"Tottenham","Premier League","Son Heung-min","KOR","FW","28",1992,34.6,32,18,11,14,7,18,72,25,54,28,3,25,14,46,8,0,"https://fbref.com/en/players/92e7e919/Son-Heung-min"
2021,"Tottenham","Premier League","Pierre Højbjerg","DEN","MF","24",1995,38,98,51,45,42,11,54,129,41.9,75,51,9,42,48,146,66,0,"https://fbref.com/en/players/8b04d6c1/Pierre-Hojbjerg"
2021,"Tottenham","Premier League","Harry Kane","ENG","FW","27",1993,34.2,22,12,1,17,4,8,26,30.8,18,28,11,17,11,33,40,0,"https://fbref.com/en/players/21a66f6a/Harry-Kane"
2021,"Tottenham","Premier League","Érik Lamela","ARG","FW,MF","28",1992,8,17,9,1,11,5,8,21,38.1,13,11,1,10,6,23,2,0,"https://fbref.com/en/players/abe66106/Erik-Lamela"
2021,"Tottenham","Premier League","Hugo Lloris","FRA","GK","33",1986,38,0,0,0,0,0,0,1,0,1,0,0,0,0,0,10,1,"https://fbref.com/en/players/8f62b6ee/Hugo-Lloris"
2021,"Tottenham","Premier League","Giovani Lo Celso","ARG","MF","24",1996,10.5,28,22,12,11,5,10,29,34.5,19,12,1,11,7,35,5,0,"https://fbref.com/en/players/d7553721/Giovani-Lo-Celso"
2021,"Tottenham","Premier League","Lucas Moura","BRA","FW,MF","27",1992,15.7,32,16,12,16,4,8,29,27.6,21,12,0,12,18,50,10,0,"https://fbref.com/en/players/2b622f01/Lucas-Moura"
2021,"Tottenham","Premier League","Tanguy Ndombele","FRA","MF","23",1996,23.2,41,20,11,21,9,18,44,40.9,26,28,4,24,19,60,15,0,"https://fbref.com/en/players/5cdddffa/Tanguy-Ndombele"
2021,"Tottenham","Premier League","Sergio Reguilón","ESP","DF","23",1996,24.9,47,25,30,13,4,23,48,47.9,25,39,7,32,32,79,50,1,"https://fbref.com/en/players/3353737a/Sergio-Reguilon"
2021,"Tottenham","Premier League","Joe Rodon","WAL","DF","22",1997,8.1,14,9,11,2,1,3,4,75,1,10,8,2,21,35,36,2,"https://fbref.com/en/players/8d62d31a/Joe-Rodon"
2021,"Tottenham","Premier League","Davinson Sánchez","COL","DF","24",1996,16.5,40,20,31,9,0,21,32,65.6,11,18,13,5,14,54,85,2,"https://fbref.com/en/players/da7b447d/Davinson-Sanchez"
2021,"Tottenham","Premier League","Dane Scarlett","ENG","FW","16",2004,0,0,0,0,0,0,0,0,NA,0,0,0,0,0,0,0,0,"https://fbref.com/en/players/21945a9e/Dane-Scarlett"
2021,"Tottenham","Premier League","Moussa Sissoko","FRA","MF","30",1989,17.6,22,16,19,3,0,8,20,40,12,11,4,7,23,45,25,0,"https://fbref.com/en/players/2acd49b9/Moussa-Sissoko"
2021,"Tottenham","Premier League","Japhet Tanganga","ENG","DF","21",1999,5.4,5,4,3,2,0,1,3,33.3,2,6,5,1,3,8,15,0,"https://fbref.com/en/players/e9971f2d/Japhet-Tanganga"
2021,"Tottenham","Premier League","Carlos Vinícius","BRA","FW","25",1995,3.4,3,1,2,1,0,1,1,100,0,0,0,0,2,5,5,0,"https://fbref.com/en/players/8b529245/Carlos-Vinicius"
2021,"Tottenham","Premier League","Harry Winks","ENG","MF","24",1996,9.6,16,9,11,5,0,5,20,25,15,16,4,12,11,27,12,1,"https://fbref.com/en/players/2f7acede/Harry-Winks"
2021,"Udinese","Serie A","Nícolas Andrade","BRA","GK","32",1988,2,0,0,0,0,0,0,0,NA,0,0,0,0,0,0,0,0,"https://fbref.com/en/players/326d09ef/Nicolas-Andrade"
2021,"Udinese","Serie A","Tolgay Arslan","GER","MF","29",1990,20.2,52,32,24,24,4,25,54,46.3,29,22,2,20,22,74,15,1,"https://fbref.com/en/players/963a328b/Tolgay-Arslan"
2021,"Udinese","Serie A","Rodrigo Becão","BRA","DF","24",1996,30.9,59,33,36,20,3,27,49,55.1,22,48,27,21,68,127,94,2,"https://fbref.com/en/players/19e4eab9/Rodrigo-Becao"
2021,"Udinese","Serie A","Kevin Bonifazi","ITA","DF","24",1996,27.4,32,21,24,6,2,8,23,34.8,15,33,20,13,50,82,85,1,"https://fbref.com/en/players/fb77bfef/Kevin-Bonifazi"
2021,"Udinese","Serie A","Jayden Braaf","NED","FW","17",2002,1.3,0,0,0,0,0,0,1,0,1,0,0,0,0,0,0,0,"https://fbref.com/en/players/c609e90e/Jayden-Braaf"
2021,"Udinese","Serie A","Mamadou Coulibaly","SEN","MF","21",1999,2,10,8,5,5,0,0,0,NA,0,2,0,2,1,11,0,0,"https://fbref.com/en/players/c976160c/Mamadou-Coulibaly"
2021,"Udinese","Serie A","Sebastien De Maio","FRA","DF","33",1987,9.5,15,10,6,9,0,4,5,80,1,16,9,7,18,33,41,0,"https://fbref.com/en/players/952a03fe/Sebastien-De-Maio"
2021,"Udinese","Serie A","Rodrigo De Paul","ARG","MF","26",1994,35.6,41,24,17,22,2,15,60,25,45,32,1,31,17,58,20,1,"https://fbref.com/en/players/162efffd/Rodrigo-De-Paul"
2021,"Udinese","Serie A","Gerard Deulofeu","ESP","FW,MF","26",1994,6.6,2,2,1,1,0,2,12,16.7,10,2,0,2,3,5,0,0,"https://fbref.com/en/players/39583cfd/Gerard-Deulofeu"
2021,"Udinese","Serie A","Fernando Forestieri","ITA","FW,MF","30",1990,6.1,9,7,4,4,1,3,7,42.9,4,7,0,7,2,11,0,0,"https://fbref.com/en/players/d60c26fc/Fernando-Forestieri"
2021,"Udinese","Serie A","Manuel Gasparini","ITA","GK","18",2002,0,0,0,0,0,0,0,0,NA,0,0,0,0,0,0,0,0,"https://fbref.com/en/players/7033ca08/Manuel-Gasparini"
2021,"Udinese","Serie A","Mato Jajalo","BIH","MF","32",1988,0.4,1,1,1,0,0,1,1,100,0,1,0,1,2,3,0,0,"https://fbref.com/en/players/8c65eb5f/Mato-Jajalo"
2021,"Udinese","Serie A","Kevin Lasagna","ITA","FW","27",1992,12.3,6,1,2,3,1,3,14,21.4,11,11,0,11,6,12,7,0,"https://fbref.com/en/players/09538fdb/Kevin-Lasagna"
2021,"Udinese","Serie A","Fernando Llorente","ESP","FW","35",1985,7.9,4,1,2,2,0,2,5,40,3,3,0,3,2,6,17,0,"https://fbref.com/en/players/82dbf623/Fernando-Llorente"
2021,"Udinese","Serie A","Jean-Victor Makengo","FRA","MF","22",1998,5.8,8,7,5,3,0,3,13,23.1,10,7,1,6,5,13,7,0,"https://fbref.com/en/players/22bfb57e/Jean-Victor-Makengo"
2021,"Udinese","Serie A","Rolando Mandragora","ITA","MF","23",1997,4.4,8,5,3,4,1,3,10,30,7,10,3,7,6,14,5,0,"https://fbref.com/en/players/c7259b83/Rolando-Mandragora"
2021,"Udinese","Serie A","Ryder Matos","BRA","MF","27",1993,0.1,0,0,0,0,0,0,0,NA,0,0,0,0,0,0,0,0,"https://fbref.com/en/players/7280b54f/Ryder-Matos"
2021,"Udinese","Serie A","Petar Mićin","SRB","MF","21",1998,0.2,0,0,0,0,0,0,0,NA,0,0,0,0,0,0,0,0,"https://fbref.com/en/players/259deea9/Petar-Micin"
2021,"Udinese","Serie A","Nahuel Molina","ARG","DF","22",1998,20.3,27,18,13,10,4,16,42,38.1,26,26,4,22,21,48,49,1,"https://fbref.com/en/players/23610943/Nahuel-Molina"
2021,"Udinese","Serie A","Juan Musso","ARG","GK","26",1994,35,1,1,1,0,0,1,1,100,0,0,0,0,1,2,8,1,"https://fbref.com/en/players/a111cf41/Juan-Musso"
2021,"Udinese","Serie A","Ilija Nestorovski","MKD","FW,MF","30",1990,7.8,6,4,2,3,1,2,13,15.4,11,5,0,5,1,7,7,0,"https://fbref.com/en/players/b1236c63/Ilija-Nestorovski"
2021,"Udinese","Serie A","Bram Nuytinck","NED","DF","30",1990,18.2,21,15,10,9,2,13,20,65,7,30,17,13,25,46,77,0,"https://fbref.com/en/players/e33f36d5/Bram-Nuytinck"
2021,"Udinese","Serie A","Stefano Okaka","ITA","FW","30",1989,16.5,10,7,2,5,3,2,10,20,8,7,1,6,2,12,19,0,"https://fbref.com/en/players/601ef102/Stefano-Okaka"
2021,"Udinese","Serie A","Thomas Ouwejan","NED","DF","23",1996,4.6,4,1,0,3,1,2,9,22.2,7,4,0,4,5,9,6,0,"https://fbref.com/en/players/36d9dabe/Thomas-Ouwejan"
2021,"Udinese","Serie A","Martin Palumbo","NOR","MF","18",2002,0.7,0,0,0,0,0,0,0,NA,0,5,0,5,1,1,0,0,"https://fbref.com/en/players/f8d41a8c/Martin-Palumbo"
2021,"Udinese","Serie A","Roberto Pereyra","ARG","MF,FW","29",1991,32.5,18,11,7,8,3,7,23,30.4,16,24,5,19,27,45,24,0,"https://fbref.com/en/players/75f2c59f/Roberto-Pereyra"
2021,"Udinese","Serie A","Ignacio Pussetto","ARG","FW","24",1995,8.4,16,8,5,6,5,6,17,35.3,11,14,0,14,13,29,6,0,"https://fbref.com/en/players/62437b4f/Ignacio-Pussetto"
2021,"Udinese","Serie A","Samir Santos","BRA","DF","25",1994,24.6,40,23,26,12,2,13,29,44.8,16,33,17,16,58,98,60,1,"https://fbref.com/en/players/92b4758e/Samir-Santos"
2021,"Udinese","Serie A","Simone Scuffet","ITA","GK","24",1996,1,0,0,0,0,0,0,0,NA,0,0,0,0,0,0,0,0,"https://fbref.com/en/players/41bd99ea/Simone-Scuffet"
2021,"Udinese","Serie A","Jens Stryger Larsen","DEN","DF","29",1991,29.3,17,11,14,3,0,8,25,32,17,26,11,15,24,41,65,0,"https://fbref.com/en/players/f91e81c9/Jens-Stryger-Larsen"
2021,"Udinese","Serie A","Hidde ter Avest","NED","DF","23",1997,3.9,5,2,3,2,0,2,5,40,3,3,1,2,2,7,5,0,"https://fbref.com/en/players/18f9dbd0/Hidde-ter-Avest"
2021,"Udinese","Serie A","Walace","BRA","MF","25",1995,22.8,50,23,28,19,3,21,60,35,39,36,3,33,34,84,23,0,"https://fbref.com/en/players/26db8853/Walace"
2021,"Udinese","Serie A","Marvin Zeegelaar","NED","DF","29",1990,19.3,40,18,23,16,1,20,39,51.3,19,21,9,12,24,64,43,0,"https://fbref.com/en/players/8abd0c03/Marvin-Zeegelaar"
2021,"Union Berlin","Bundesliga","Robert Andrich","GER","MF","25",1994,28.1,51,24,22,27,2,24,53,45.3,29,40,6,34,51,102,31,2,"https://fbref.com/en/players/e0b113a7/Robert-Andrich"
2021,"Union Berlin","Bundesliga","Taiwo Awoniyi","NGA","FW","22",1997,15.1,5,3,2,3,0,1,14,7.1,13,9,0,9,3,8,4,0,"https://fbref.com/en/players/e5478b87/Taiwo-Awoniyi"
2021,"Union Berlin","Bundesliga","Sheraldo Becker","SUR","FW,MF","25",1995,12.3,5,4,2,2,1,3,5,60,2,4,0,4,6,11,7,0,"https://fbref.com/en/players/8eb55dbb/Sheraldo-Becker"
2021,"Union Berlin","Bundesliga","Marius Bülter","GER","FW,MF","27",1993,10.9,15,8,6,6,3,5,17,29.4,12,17,2,15,12,27,11,0,"https://fbref.com/en/players/ab5b7dc1/Marius-Bulter"
2021,"Union Berlin","Bundesliga","Leon Dajaku","GER","FW","19",2001,0.4,0,0,0,0,0,0,0,NA,0,0,0,0,0,0,0,0,"https://fbref.com/en/players/aeaf1bc1/Leon-Dajaku"
2021,"Union Berlin","Bundesliga","Keita Endo","JPN","MF,FW","22",1997,5.1,8,3,1,5,2,3,9,33.3,6,5,2,3,6,14,4,0,"https://fbref.com/en/players/1a83027b/Keita-Endo"
2021,"Union Berlin","Bundesliga","Marvin Friedrich","GER","DF","24",1995,34,47,29,35,11,1,18,32,56.3,14,38,18,20,52,99,109,0,"https://fbref.com/en/players/b77f44a4/Marvin-Friedrich"
2021,"Union Berlin","Bundesliga","Christian Gentner","GER","MF","34",1985,11.5,17,8,9,5,3,5,18,27.8,13,13,1,12,17,34,16,0,"https://fbref.com/en/players/a4f94a0d/Christian-Gentner"
2021,"Union Berlin","Bundesliga","Niko Gießelmann","GER","DF","28",1991,4.8,12,9,7,4,1,5,8,62.5,3,9,3,6,8,20,13,1,"https://fbref.com/en/players/7242b495/Niko-Giesselmann"
2021,"Union Berlin","Bundesliga","Akaki Gogia","GER","FW,MF","28",1992,1.6,1,0,0,1,0,0,2,0,2,0,0,0,1,2,0,0,"https://fbref.com/en/players/deee6467/Akaki-Gogia"
2021,"Union Berlin","Bundesliga","Sebastian Griesbeck","GER","MF","29",1990,9.9,20,9,8,11,1,8,19,42.1,11,13,3,10,5,25,8,0,"https://fbref.com/en/players/a8db7ebb/Sebastian-Griesbeck"
2021,"Union Berlin","Bundesliga","Florian Hübner","GER","DF","29",1991,5.8,10,5,7,3,0,7,15,46.7,8,7,3,4,13,23,21,0,"https://fbref.com/en/players/e87ad81a/Florian-Hubner"
2021,"Union Berlin","Bundesliga","Marcus Ingvartsen","DEN","MF,FW","24",1996,21.8,17,11,5,6,6,8,26,30.8,18,22,0,22,18,35,10,0,"https://fbref.com/en/players/271b8617/Marcus-Ingvartsen"
2021,"Union Berlin","Bundesliga","Loris Karius","GER","GK","27",1993,3.2,0,0,0,0,0,0,0,NA,0,0,0,0,0,0,2,0,"https://fbref.com/en/players/32e7ce92/Loris-Karius"
2021,"Union Berlin","Bundesliga","Robin Knoche","GER","DF","28",1992,33.8,44,29,30,12,2,23,39,59,16,43,27,16,49,93,118,2,"https://fbref.com/en/players/6bd5cd5d/Robin-Knoche"
2021,"Union Berlin","Bundesliga","Max Kruse","GER","FW,MF","32",1988,18.1,7,3,1,5,1,2,9,22.2,7,11,0,11,3,10,3,0,"https://fbref.com/en/players/f9446dcd/Max-Kruse"
2021,"Union Berlin","Bundesliga","Christopher Lenz","GER","DF,FW","25",1994,25,74,41,39,30,5,35,71,49.3,36,34,5,29,35,109,50,0,"https://fbref.com/en/players/bbd86530/Christopher-Lenz"
2021,"Union Berlin","Bundesliga","Andreas Luthe","GER","GK","33",1987,30.8,1,1,1,0,0,1,3,33.3,2,1,0,1,0,1,8,3,"https://fbref.com/en/players/7fe12375/Andreas-Luthe"
2021,"Union Berlin","Bundesliga","Tim Maciejewski","GER","FW","19",2001,0.1,0,0,0,0,0,0,0,NA,0,0,0,0,0,0,0,0,"https://fbref.com/en/players/bfd522a6/Tim-Maciejewski"
2021,"Union Berlin","Bundesliga","Joshua Mees","GER","FW","24",1996,0.1,0,0,0,0,0,0,0,NA,0,0,0,0,0,0,0,0,"https://fbref.com/en/players/4b6dd263/Joshua-Mees"
2021,"Union Berlin","Bundesliga","Petar Musa","CRO","FW","22",1998,7.9,12,8,3,6,3,4,8,50,4,10,0,10,4,16,5,0,"https://fbref.com/en/players/4567a0b4/Petar-Musa"
2021,"Union Berlin","Bundesliga","Joel Pohjanpalo","FIN","FW","25",1994,9.5,5,1,0,3,2,1,6,16.7,5,1,0,1,1,6,12,0,"https://fbref.com/en/players/ea003d07/Joel-Pohjanpalo"
2021,"Union Berlin","Bundesliga","Grischa Prömel","GER","MF","25",1995,20.2,39,23,14,23,2,18,34,52.9,16,20,2,18,24,63,22,0,"https://fbref.com/en/players/924f9191/Grischa-Promel"
2021,"Union Berlin","Bundesliga","Julian Ryerson","NOR","DF,MF","22",1997,11.9,22,15,4,14,4,12,15,80,3,13,0,13,11,33,17,0,"https://fbref.com/en/players/009a4f60/Julian-Ryerson"
2021,"Union Berlin","Bundesliga","Nico Schlotterbeck","GER","DF","20",1999,14.3,34,19,14,19,1,18,28,64.3,10,13,6,7,31,65,29,1,"https://fbref.com/en/players/34e12499/Nico-Schlotterbeck"
2021,"Union Berlin","Bundesliga","Cedric Teuchert","GER","FW,MF","23",1997,8.4,7,5,2,4,1,3,16,18.8,13,12,0,12,5,12,6,0,"https://fbref.com/en/players/f956479d/Cedric-Teuchert"
2021,"Union Berlin","Bundesliga","Christopher Trimmel","AUT","DF,FW","33",1987,28.6,50,25,28,18,4,28,54,51.9,26,32,7,25,50,100,99,0,"https://fbref.com/en/players/056d2d95/Christopher-Trimmel"
2021,"Valencia","La Liga","Alejandro Blanco","ESP","MF","21",1998,6.4,8,4,4,4,0,3,18,16.7,15,5,0,5,8,16,9,0,"https://fbref.com/en/players/c4dce677/Alejandro-Blanco"
2021,"Valencia","La Liga","Denis Cheryshev","RUS","MF","29",1990,12.2,19,15,6,7,6,6,26,23.1,20,15,1,14,12,31,15,0,"https://fbref.com/en/players/0ac94a23/Denis-Cheryshev"
2021,"Valencia","La Liga","Jasper Cillessen","NED","GK","31",1989,10,0,0,0,0,0,0,0,NA,0,0,0,0,0,0,0,0,"https://fbref.com/en/players/04ac8285/Jasper-Cillessen"
2021,"Valencia","La Liga","Thierry Correia","POR","DF","21",1999,23.7,47,27,32,10,5,21,43,48.8,22,24,6,18,42,89,63,1,"https://fbref.com/en/players/c78b352d/Thierry-Correia"
2021,"Valencia","La Liga","Patrick Cutrone","ITA","FW","22",1998,1.2,0,0,0,0,0,0,1,0,1,0,0,0,1,1,0,0,"https://fbref.com/en/players/a4fe8cda/Patrick-Cutrone"
2021,"Valencia","La Liga","Mouctar Diakhaby","GUI","DF","23",1996,23.1,16,8,10,6,0,8,12,66.7,4,28,21,7,27,43,102,1,"https://fbref.com/en/players/d2110326/Mouctar-Diakhaby"
2021,"Valencia","La Liga","Jaume Doménech","ESP","GK","29",1990,28,1,1,1,0,0,1,2,50,1,1,0,1,0,1,16,2,"https://fbref.com/en/players/c9cb972b/Jaume-Domenech"
2021,"Valencia","La Liga","Vicente Esquerdo","ESP","MF","21",1999,2.6,7,4,5,2,0,4,6,66.7,2,4,2,2,8,15,1,0,"https://fbref.com/en/players/ced26057/Vicente-Esquerdo"
2021,"Valencia","La Liga","Kévin Gameiro","FRA","FW","33",1987,12,7,4,3,2,2,3,11,27.3,8,10,0,10,0,7,3,0,"https://fbref.com/en/players/42276181/Kevin-Gameiro"
2021,"Valencia","La Liga","Maxi Gómez","URU","FW","23",1996,29.9,11,9,3,7,1,3,14,21.4,11,13,3,10,2,13,34,0,"https://fbref.com/en/players/4c2e9442/Maxi-Gomez"
2021,"Valencia","La Liga","Gonçalo Guedes","POR","MF,FW","23",1996,25.4,18,12,8,7,3,10,45,22.2,35,24,1,23,8,26,7,0,"https://fbref.com/en/players/e6bc67d7/Goncalo-Guedes"
2021,"Valencia","La Liga","Hugo Guillamón","ESP","DF","20",2000,22.1,23,13,17,6,0,8,20,40,12,19,14,5,27,50,102,3,"https://fbref.com/en/players/f7c12fbf/Hugo-Guillamon"
2021,"Valencia","La Liga","Jason","ESP","MF,DF","26",1994,4.9,9,3,5,2,2,4,16,25,12,6,1,5,10,19,4,0,"https://fbref.com/en/players/9038c2a1/Jason"
2021,"Valencia","La Liga","Lee Kangin","KOR","FW,MF","19",2001,14,15,11,8,4,3,3,31,9.7,28,12,0,12,2,17,0,0,"https://fbref.com/en/players/8455ad90/Lee-Kangin"
2021,"Valencia","La Liga","Koba Koindredi","FRA","MF","18",2001,0.2,1,1,1,0,0,0,1,0,1,0,0,0,0,1,0,0,"https://fbref.com/en/players/3a58d075/Koba-Koindredi"
2021,"Valencia","La Liga","Geoffrey Kondogbia","CTA","MF","27",1993,4.9,16,9,9,4,3,7,19,36.8,12,6,1,5,8,24,8,0,"https://fbref.com/en/players/cce181df/Geoffrey-Kondogbia"
2021,"Valencia","La Liga","Toni Lato","ESP","DF","22",1997,8.1,13,6,7,3,3,6,13,46.2,7,12,1,11,10,23,21,0,"https://fbref.com/en/players/8e088e04/Toni-Lato"
2021,"Valencia","La Liga","José Luis Gayà","ESP","DF","25",1995,31.6,59,33,40,13,6,33,68,48.5,35,22,3,19,38,97,62,1,"https://fbref.com/en/players/b05e2dbd/Jose-Luis-Gaya"
2021,"Valencia","La Liga","Eliaquim Mangala","FRA","DF","29",1991,3.6,0,0,0,0,0,0,1,0,1,8,6,2,6,6,12,0,"https://fbref.com/en/players/f520049f/Eliaquim-Mangala"
2021,"Valencia","La Liga","Guillem Molina","ESP","DF","20",2000,1.7,1,0,1,0,0,0,5,0,5,1,1,0,4,5,5,0,"https://fbref.com/en/players/0bbab654/Guillem-Molina"
2021,"Valencia","La Liga","Yunus Musah","USA","MF","17",2002,17,21,18,12,3,6,8,24,33.3,16,20,0,20,15,36,12,1,"https://fbref.com/en/players/b51b1b9c/Yunus-Musah"
2021,"Valencia","La Liga","Christian Oliva","URU","MF","24",1996,2.2,2,0,1,1,0,1,6,16.7,5,1,0,1,6,8,0,0,"https://fbref.com/en/players/d3b888e3/Christian-Oliva"
2021,"Valencia","La Liga","Gabriel Paulista","BRA","DF","29",1990,30.2,17,11,9,5,3,6,17,35.3,11,32,27,5,59,76,132,3,"https://fbref.com/en/players/b7ca5c51/Gabriel-Paulista"
2021,"Valencia","La Liga","Cristiano Piccini","ITA","DF","27",1992,0.7,1,1,1,0,0,1,2,50,1,0,0,0,0,1,3,0,"https://fbref.com/en/players/32c0491f/Cristiano-Piccini"
2021,"Valencia","La Liga","Uroš Račić","SRB","MF","22",1998,24.3,38,22,16,16,6,16,54,29.6,38,33,11,22,26,64,54,0,"https://fbref.com/en/players/faed84db/Uros-Racic"
2021,"Valencia","La Liga","Francisco Reis Ferreira","POR","DF","23",1997,2,1,1,1,0,0,0,3,0,3,0,0,0,0,1,6,0,"https://fbref.com/en/players/4b3c863f/Francisco-Reis-Ferreira"
2021,"Valencia","La Liga","Rubén Sobrino","ESP","MF,FW","28",1992,0.5,1,1,1,0,0,0,1,0,1,0,0,0,0,1,1,0,"https://fbref.com/en/players/19b776e9/Ruben-Sobrino"
2021,"Valencia","La Liga","Carlos Soler","ESP","MF","23",1997,30.4,41,24,14,24,3,19,52,36.5,33,35,11,24,23,64,41,0,"https://fbref.com/en/players/fed17f5a/Carlos-Soler"
2021,"Valencia","La Liga","Manu Vallejo","ESP","FW,MF","23",1997,10.6,18,8,5,8,5,5,26,19.2,21,8,0,8,3,21,3,0,"https://fbref.com/en/players/0bc4e720/Manu-Vallejo"
2021,"Valencia","La Liga","Daniel Wass","DEN","MF,DF","31",1989,33.1,52,31,21,29,2,22,55,40,33,33,13,20,47,99,69,0,"https://fbref.com/en/players/d83bbc54/Daniel-Wass"
2021,"Valladolid","La Liga","Rubén Alcaraz","ESP","MF","29",1991,24.1,54,29,32,21,1,30,80,37.5,50,35,8,27,31,85,28,0,"https://fbref.com/en/players/036bba5f/Ruben-Alcaraz"
2021,"Valladolid","La Liga","Miguel Ángel Rubio","ESP","DF","22",1998,1.5,0,0,0,0,0,0,0,NA,0,2,2,0,3,3,11,0,"https://fbref.com/en/players/56cafd0a/Miguel-Angel-Rubio"
2021,"Valladolid","La Liga","Sergio Benito","ESP","FW","21",1999,0,0,0,0,0,0,0,0,NA,0,0,0,0,0,0,0,0,"https://fbref.com/en/players/608bcb88/Sergio-Benito"
2021,"Valladolid","La Liga","Joaquín Fernández","ESP","DF","24",1996,23,30,16,21,8,1,12,21,57.1,9,24,15,9,43,73,113,0,"https://fbref.com/en/players/b86a64b2/Joaquin-Fernandez"
2021,"Valladolid","La Liga","Raúl García","ESP","DF,MF","31",1989,5.6,10,8,5,5,0,6,20,30,14,5,1,4,9,19,10,0,"https://fbref.com/en/players/1a317a1b/Raul-Garcia"
2021,"Valladolid","La Liga","Bruno González","ESP","DF","30",1990,25.1,26,17,18,8,0,17,31,54.8,14,22,14,8,37,63,112,1,"https://fbref.com/en/players/f11fe861/Bruno-Gonzalez"
2021,"Valladolid","La Liga","Sergi Guardiola","ESP","FW","29",1991,19.9,11,5,1,5,5,2,27,7.4,25,12,1,11,7,18,16,3,"https://fbref.com/en/players/32974271/Sergi-Guardiola"
2021,"Valladolid","La Liga","Pablo Hervías","ESP","DF,MF","27",1993,13.4,19,12,7,9,3,9,26,34.6,17,6,0,6,11,30,8,0,"https://fbref.com/en/players/ba5a9545/Pablo-Hervias"
2021,"Valladolid","La Liga","Saidy Janko","GAM","DF","24",1995,13.6,19,10,12,5,2,8,14,57.1,6,9,1,8,18,37,47,0,"https://fbref.com/en/players/689c9cf4/Saidy-Janko"
2021,"Valladolid","La Liga","Jota","POR","MF,FW","21",1999,7.4,7,3,1,4,2,5,10,50,5,4,0,4,6,13,5,1,"https://fbref.com/en/players/2b65fe46/Jota"
2021,"Valladolid","La Liga","Kenan Kodro","BIH","FW,MF","26",1993,5.1,0,0,0,0,0,0,2,0,2,2,1,1,2,2,6,0,"https://fbref.com/en/players/e82d2807/Kenan-Kodro"
2021,"Valladolid","La Liga","Kuki","ESP","MF","22",1998,0.3,1,1,0,0,1,0,1,0,1,0,0,0,0,1,0,0,"https://fbref.com/en/players/2b6dc4d7/Kuki"
2021,"Valladolid","La Liga","Maranhão","BRA","FW","23",1996,13.1,8,2,2,2,4,0,8,0,8,15,2,13,2,10,9,0,"https://fbref.com/en/players/ae86d473/Maranhao"
2021,"Valladolid","La Liga","Jordi Masip","ESP","GK","31",1989,25,0,0,0,0,0,0,2,0,2,2,0,2,2,2,8,1,"https://fbref.com/en/players/8fae77ea/Jordi-Masip"
2021,"Valladolid","La Liga","Roque Mesa","ESP","MF","31",1989,19.6,46,29,18,24,4,20,47,42.6,27,11,2,9,14,60,23,1,"https://fbref.com/en/players/7c4243d4/Roque-Mesa"
2021,"Valladolid","La Liga","Míchel","ESP","MF","32",1988,10.5,18,11,10,3,5,5,22,22.7,17,10,1,9,9,27,12,1,"https://fbref.com/en/players/418f8f61/Michel"
2021,"Valladolid","La Liga","Javi Moyano","ESP","DF","34",1986,1.1,0,0,0,0,0,0,0,NA,0,2,0,2,0,0,2,0,"https://fbref.com/en/players/933e8c8a/Javi-Moyano"
2021,"Valladolid","La Liga","Nacho","ESP","DF","31",1989,20.1,43,21,29,10,4,24,52,46.2,28,21,1,20,29,72,47,0,"https://fbref.com/en/players/e29d1111/Nacho"
2021,"Valladolid","La Liga","Lucas Olaza","URU","DF","26",1994,14,20,9,11,7,2,9,17,52.9,8,15,7,8,15,35,38,0,"https://fbref.com/en/players/4cee5954/Lucas-Olaza"
2021,"Valladolid","La Liga","Kiko Olivas","ESP","DF","31",1988,2,3,2,2,1,0,3,5,60,2,2,2,0,7,10,3,0,"https://fbref.com/en/players/72b07a9c/Kiko-Olivas"
2021,"Valladolid","La Liga","Fabián Orellana","CHI","MF,FW","34",1986,23.8,33,19,12,14,7,12,55,21.8,43,18,0,18,15,48,9,0,"https://fbref.com/en/players/c90977db/Fabian-Orellana"
2021,"Valladolid","La Liga","Kike Pérez","ESP","MF","23",1997,12.9,26,19,8,14,4,7,33,21.2,26,10,1,9,17,43,18,0,"https://fbref.com/en/players/237a3851/Kike-Perez"
2021,"Valladolid","La Liga","Luis Pérez","ESP","DF","25",1995,14.4,33,17,16,17,0,18,30,60,12,26,8,18,14,47,54,1,"https://fbref.com/en/players/b7c04927/Luis-Perez"
2021,"Valladolid","La Liga","Óscar Plano","ESP","MF,FW","29",1991,28,42,24,24,12,6,14,46,30.4,32,35,6,29,34,76,43,0,"https://fbref.com/en/players/7c388b20/Oscar-Plano"
2021,"Valladolid","La Liga","Oriol Rey","ESP","MF","22",1998,0.2,0,0,0,0,0,0,0,NA,0,0,0,0,1,1,0,0,"https://fbref.com/en/players/e8a0d2f7/Oriol-Rey"
2021,"Valladolid","La Liga","Roberto","ESP","GK","34",1986,13,0,0,0,0,0,0,1,0,1,0,0,0,0,0,7,0,"https://fbref.com/en/players/ba3ca78f/Roberto"
2021,"Valladolid","La Liga","Waldo Rubio","ESP","FW,MF","24",1995,4.2,6,4,2,2,2,1,14,7.1,13,6,0,6,3,9,3,0,"https://fbref.com/en/players/ccaa5728/Waldo-Rubio"
2021,"Valladolid","La Liga","Fede San Emeterio","ESP","MF","23",1997,16.2,25,14,15,7,3,11,31,35.5,20,23,8,15,28,53,33,0,"https://fbref.com/en/players/efecd633/Fede-San-Emeterio"
2021,"Valladolid","La Liga","Javi Sánchez","ESP","DF","23",1997,10.2,15,10,10,4,1,9,10,90,1,15,7,8,15,30,37,0,"https://fbref.com/en/players/60359288/Javi-Sanchez"
2021,"Valladolid","La Liga","Toni Villa","ESP","MF,FW","25",1995,10.8,31,16,11,14,6,15,42,35.7,27,15,1,14,5,36,3,0,"https://fbref.com/en/players/636eae97/Toni-Villa"
2021,"Valladolid","La Liga","Shon Weissman","ISR","FW","24",1996,23.7,12,9,4,5,3,2,23,8.7,21,17,3,14,8,20,7,0,"https://fbref.com/en/players/379dc075/Shon-Weissman"
2021,"Valladolid","La Liga","Jawad El Yamiq","MAR","DF","28",1992,15.3,21,14,14,7,0,8,11,72.7,3,15,10,5,46,67,100,0,"https://fbref.com/en/players/f6f6b6e8/Jawad-El-Yamiq"
2021,"Villarreal","La Liga","Raúl Albiol","ESP","DF","34",1985,34.6,22,15,19,3,0,13,18,72.2,5,32,22,10,22,44,146,2,"https://fbref.com/en/players/4bd414c1/Raul-Albiol"
2021,"Villarreal","La Liga","Paco Alcácer","ESP","FW","26",1993,17.2,6,3,1,2,3,3,7,42.9,4,8,0,8,9,15,6,0,"https://fbref.com/en/players/a7a9d95a/Paco-Alcacer"
2021,"Villarreal","La Liga","Sergio Asenjo","ESP","GK","31",1989,36,0,0,0,0,0,0,1,0,1,0,0,0,0,0,13,2,"https://fbref.com/en/players/9f0ea33f/Sergio-Asenjo"
2021,"Villarreal","La Liga","Carlos Bacca","COL","FW","33",1986,8.7,9,5,5,3,1,3,5,60,2,5,0,5,3,12,2,0,"https://fbref.com/en/players/09a9e921/Carlos-Bacca"
2021,"Villarreal","La Liga","Alex Baena","ESP","MF","19",2001,1.5,4,3,1,2,1,1,3,33.3,2,1,1,0,1,5,1,0,"https://fbref.com/en/players/518f2234/Alex-Baena"
2021,"Villarreal","La Liga","Étienne Capoue","FRA","MF","32",1988,13.2,20,10,14,6,0,8,18,44.4,10,7,1,6,20,40,23,0,"https://fbref.com/en/players/5acc4a10/Etienne-Capoue"
2021,"Villarreal","La Liga","Sofian Chakla","MAR","DF","26",1993,0.1,0,0,0,0,0,0,0,NA,0,0,0,0,0,0,0,0,"https://fbref.com/en/players/37f04799/Sofian-Chakla"
2021,"Villarreal","La Liga","Samuel Chukwueze","NGA","MF,FW","21",1999,15.2,12,7,4,4,4,3,17,17.6,14,8,0,8,10,22,3,0,"https://fbref.com/en/players/b8a642fc/Samuel-Chukwueze"
2021,"Villarreal","La Liga","Francis Coquelin","FRA","MF","29",1991,8.2,19,14,4,12,3,8,19,42.1,11,8,2,6,21,40,11,1,"https://fbref.com/en/players/a6951bf8/Francis-Coquelin"
2021,"Villarreal","La Liga","Jaume Costa","ESP","DF,MF","32",1988,3.9,10,6,4,6,0,7,9,77.8,2,7,1,6,6,16,8,0,"https://fbref.com/en/players/808d48f3/Jaume-Costa"
2021,"Villarreal","La Liga","Pervis Estupiñán","ECU","DF","22",1998,13,37,17,23,12,2,14,23,60.9,9,10,2,8,35,72,14,2,"https://fbref.com/en/players/d38fdf53/Pervis-Estupinan"
2021,"Villarreal","La Liga","Juan Foyth","ARG","DF,MF","22",1998,13,40,22,22,14,4,12,29,41.4,17,21,6,15,19,59,24,1,"https://fbref.com/en/players/6c7762c3/Juan-Foyth"
2021,"Villarreal","La Liga","Ramiro Funes Mori","ARG","DF","29",1991,8.1,12,8,7,5,0,7,11,63.6,4,7,5,2,8,20,42,1,"https://fbref.com/en/players/89cbc961/Ramiro-Funes-Mori"
2021,"Villarreal","La Liga","Mario Gaspar","ESP","DF","29",1990,20.6,55,34,22,24,9,21,40,52.5,19,26,4,22,30,85,47,1,"https://fbref.com/en/players/fb5d47b3/Mario-Gaspar"
2021,"Villarreal","La Liga","Moi Gómez","ESP","MF,FW","26",1994,28.5,21,12,6,8,7,14,35,40,21,20,3,17,11,32,16,0,"https://fbref.com/en/players/5a626448/Moi-Gomez"
2021,"Villarreal","La Liga","Vicente Iborra","ESP","MF","32",1988,10.3,18,8,8,7,3,8,24,33.3,16,14,7,7,14,32,25,1,"https://fbref.com/en/players/ad1ffcfd/Vicente-Iborra"
2021,"Villarreal","La Liga","Takefusa Kubo","JPN","MF,FW","19",2001,3.3,1,1,0,0,1,1,5,20,4,2,0,2,1,2,2,0,"https://fbref.com/en/players/16aa3654/Takefusa-Kubo"
2021,"Villarreal","La Liga","Álex Millán","ESP","FW","20",1999,0,0,0,0,0,0,0,0,NA,0,0,0,0,0,0,0,0,"https://fbref.com/en/players/29ad0dd4/Alex-Millan"
2021,"Villarreal","La Liga","Alberto Moreno","ESP","DF","28",1992,2.1,7,4,7,0,0,2,5,40,3,2,1,1,3,10,2,0,"https://fbref.com/en/players/11b9265b/Alberto-Moreno"
2021,"Villarreal","La Liga","Gerard Moreno","ESP","FW","28",1992,29.7,24,15,8,10,6,7,34,20.6,27,17,4,13,15,39,26,0,"https://fbref.com/en/players/81f0781e/Gerard-Moreno"
2021,"Villarreal","La Liga","Fernando Niño","ESP","FW","19",2000,6.6,8,3,0,4,4,2,9,22.2,7,1,0,1,2,10,2,0,"https://fbref.com/en/players/81d5c497/Fernando-Nino"
2021,"Villarreal","La Liga","Daniel Parejo","ESP","MF","31",1989,34.6,65,40,32,23,10,33,81,40.7,48,35,8,27,45,110,21,3,"https://fbref.com/en/players/7460ca0d/Daniel-Parejo"
2021,"Villarreal","La Liga","Alfonso Pedraza","ESP","DF","24",1996,23.3,35,19,16,11,8,11,31,35.5,20,21,5,16,34,69,47,1,"https://fbref.com/en/players/63f04c6c/Alfonso-Pedraza"
2021,"Villarreal","La Liga","Rubén Peña","ESP","DF","29",1991,12.4,25,14,8,15,2,19,33,57.6,14,20,1,19,13,38,19,0,"https://fbref.com/en/players/1f079188/Ruben-Pena"
2021,"Villarreal","La Liga","Yeremi Pino","ESP","FW,MF","17",2002,8.9,19,11,10,7,2,8,28,28.6,20,20,1,19,9,28,8,0,"https://fbref.com/en/players/540ec57b/Yeremi-Pino"
2021,"Villarreal","La Liga","Dani Raba","ESP","MF,FW","24",1995,1.7,2,1,0,1,1,2,8,25,6,1,0,1,0,2,0,0,"https://fbref.com/en/players/ea6a7ab4/Dani-Raba"
2021,"Villarreal","La Liga","Gerónimo Rulli","ARG","GK","28",1992,2,0,0,0,0,0,0,0,NA,0,0,0,0,0,0,0,1,"https://fbref.com/en/players/625c144a/Geronimo-Rulli"
2021,"Villarreal","La Liga","Pau Torres","ESP","DF","23",1997,33,17,11,10,5,2,11,18,61.1,7,33,25,8,23,40,111,1,"https://fbref.com/en/players/532e1e4f/Pau-Torres"
2021,"Villarreal","La Liga","Manu Trigueros","ESP","MF","28",1991,28.1,51,30,25,21,5,21,77,27.3,56,32,2,30,17,68,19,0,"https://fbref.com/en/players/963829d0/Manu-Trigueros"
2021,"Werder Bremen","Bundesliga","Felix Agu","GER","DF","20",1999,7.8,20,9,10,9,1,10,18,55.6,8,14,3,11,12,32,18,0,"https://fbref.com/en/players/cb6d81b3/Felix-Agu"
2021,"Werder Bremen","Bundesliga","Ludwig Augustinsson","SWE","DF,FW","26",1994,21.7,37,20,19,14,4,17,29,58.6,12,21,7,14,20,57,62,0,"https://fbref.com/en/players/9fec8860/Ludwig-Augustinsson"
2021,"Werder Bremen","Bundesliga","Philipp Bargfrede","GER","MF","31",1989,0.3,0,0,0,0,0,0,0,NA,0,0,0,0,0,0,3,0,"https://fbref.com/en/players/3f7cd8f1/Philipp-Bargfrede"
2021,"Werder Bremen","Bundesliga","Leonardo Bittencourt","GER","MF,FW","26",1993,16.8,58,32,24,28,6,16,51,31.4,35,29,2,27,13,71,10,0,"https://fbref.com/en/players/dc62fbee/Leonardo-Bittencourt"
2021,"Werder Bremen","Bundesliga","Tahith Chong","NED","MF,FW","20",1999,4.3,11,6,1,9,1,4,8,50,4,4,0,4,5,16,1,0,"https://fbref.com/en/players/2696b6a9/Tahith-Chong"
2021,"Werder Bremen","Bundesliga","Eren Dinkçi","GER","MF,FW","18",2001,1.2,1,1,1,0,0,0,1,0,1,4,0,4,2,3,1,0,"https://fbref.com/en/players/4ccd8957/Eren-Dinkci"
2021,"Werder Bremen","Bundesliga","Johannes Eggestein","GER","FW,MF","22",1998,0.4,0,0,0,0,0,0,1,0,1,0,0,0,1,1,2,0,"https://fbref.com/en/players/d571df78/Johannes-Eggestein"
2021,"Werder Bremen","Bundesliga","Maximilian Eggestein","GER","MF","23",1996,32.7,57,42,22,29,6,21,46,45.7,25,30,5,25,43,100,36,0,"https://fbref.com/en/players/beb882a8/Maximilian-Eggestein"
2021,"Werder Bremen","Bundesliga","Patrick Erras","GER","FW,MF","25",1995,0.3,0,0,0,0,0,0,1,0,1,0,0,0,0,0,0,0,"https://fbref.com/en/players/e3f6253d/Patrick-Erras"
2021,"Werder Bremen","Bundesliga","Marco Friedl","AUT","DF","22",1998,30.9,50,34,31,17,2,30,62,48.4,32,38,17,21,55,105,118,1,"https://fbref.com/en/players/f86ad3f5/Marco-Friedl"
2021,"Werder Bremen","Bundesliga","Niclas Füllkrug","GER","FW","27",1993,9.7,7,3,2,4,1,1,13,7.7,12,10,4,6,3,10,13,0,"https://fbref.com/en/players/4f16405e/Niclas-Fullkrug"
2021,"Werder Bremen","Bundesliga","Theodor Gebre Selassie","CZE","DF","33",1986,33.7,61,35,39,17,5,28,64,43.8,36,33,11,22,58,119,98,1,"https://fbref.com/en/players/3f65898c/Theodor-Gebre-Selassie"
2021,"Werder Bremen","Bundesliga","Christian Groß","GER","MF,DF","31",1989,16.3,44,28,17,25,2,15,37,40.5,22,12,2,10,24,68,37,0,"https://fbref.com/en/players/14a7af33/Christian-Gross"
2021,"Werder Bremen","Bundesliga","Ilia Gruev","BUL","FW","20",2000,0,0,0,0,0,0,0,0,NA,0,0,0,0,0,0,0,0,"https://fbref.com/en/players/1fc4f3d1/Ilia-Gruev"
2021,"Werder Bremen","Bundesliga","Davy Klaassen","NED","MF","27",1993,2.5,3,1,0,1,2,0,5,0,5,5,1,4,3,6,4,0,"https://fbref.com/en/players/15fd5593/Davy-Klaassen"
2021,"Werder Bremen","Bundesliga","Jean-Manuel Mbom","GER","MF,DF","20",2000,12.9,19,13,14,3,2,8,27,29.6,19,17,6,11,13,32,27,0,"https://fbref.com/en/players/1a5d7cb9/Jean-Manuel-Mbom"
2021,"Werder Bremen","Bundesliga","Kevin Möhwald","GER","MF","27",1993,17.3,15,9,9,5,1,4,18,22.2,14,10,3,7,32,47,19,2,"https://fbref.com/en/players/a5ce09f2/Kevin-Mohwald"
2021,"Werder Bremen","Bundesliga","Niklas Moisander","FIN","DF","34",1985,13.6,14,11,11,3,0,8,14,57.1,6,15,8,7,22,36,61,0,"https://fbref.com/en/players/00844823/Niklas-Moisander"
2021,"Werder Bremen","Bundesliga","Yuya Osako","JPN","MF,FW","30",1990,8.5,12,8,2,5,5,2,9,22.2,7,6,1,5,5,17,7,0,"https://fbref.com/en/players/f69fba57/Yuya-Osako"
2021,"Werder Bremen","Bundesliga","Jiří Pavlenka","CZE","GK","28",1992,34,2,0,2,0,0,2,2,100,0,0,0,0,1,3,17,4,"https://fbref.com/en/players/0a1cb833/Jiri-Pavlenka"
2021,"Werder Bremen","Bundesliga","Milot Rashica","KVX","FW,MF","24",1996,16.2,24,12,11,11,2,12,23,52.2,11,7,0,7,4,28,6,0,"https://fbref.com/en/players/6c6a3300/Milot-Rashica"
2021,"Werder Bremen","Bundesliga","Josh Sargent","USA","FW,MF","20",2000,27.8,32,19,13,13,6,13,27,48.1,14,39,4,35,17,49,36,0,"https://fbref.com/en/players/a8d4428b/Josh-Sargent"
2021,"Werder Bremen","Bundesliga","Romano Schmid","AUT","MF,FW","20",2000,13.1,22,16,8,10,4,8,35,22.9,27,21,0,21,8,30,6,0,"https://fbref.com/en/players/220ace7e/Romano-Schmid"
2021,"Werder Bremen","Bundesliga","Davie Selke","GER","FW","25",1995,9,3,2,1,1,1,0,6,0,6,3,2,1,1,4,7,0,"https://fbref.com/en/players/1238a3f9/Davie-Selke"
2021,"Werder Bremen","Bundesliga","Ömer Toprak","TUR","DF","31",1989,21.6,23,16,15,6,2,12,24,50,12,27,16,11,36,59,115,1,"https://fbref.com/en/players/c5fd13e9/Omer-Toprak"
2021,"Werder Bremen","Bundesliga","Miloš Veljković","SRB","DF","24",1995,19.1,24,14,17,6,1,15,31,48.4,16,22,9,13,29,53,94,1,"https://fbref.com/en/players/a5ae8f8e/Milos-Veljkovic"
2021,"Werder Bremen","Bundesliga","Nick Woltemade","GER","MF,FW","18",2002,1.6,3,2,1,1,1,2,4,50,2,1,0,1,0,3,0,0,"https://fbref.com/en/players/7ca196eb/Nick-Woltemade"
2021,"West Brom","Premier League","Semi Ajayi","NGA","DF","26",1993,30.9,40,14,34,6,0,23,41,56.1,18,51,32,19,42,82,122,2,"https://fbref.com/en/players/d6192210/Semi-Ajayi"
2021,"West Brom","Premier League","Charlie Austin","ENG","FW,MF","31",1989,1.5,4,2,1,2,1,1,3,33.3,2,0,0,0,3,7,4,0,"https://fbref.com/en/players/8d228291/Charlie-Austin"
2021,"West Brom","Premier League","Kyle Bartley","ENG","DF","29",1991,28.7,27,16,14,10,3,11,23,47.8,12,50,35,15,38,65,159,1,"https://fbref.com/en/players/18e96f64/Kyle-Bartley"
2021,"West Brom","Premier League","David Button","ENG","GK","31",1989,1,0,0,0,0,0,0,0,NA,0,0,0,0,0,0,0,0,"https://fbref.com/en/players/e608ed4c/David-Button"
2021,"West Brom","Premier League","Mbaye Diagne","SEN","FW","28",1991,13.2,4,3,3,0,1,1,4,25,3,2,1,1,1,5,16,0,"https://fbref.com/en/players/dda3969e/Mbaye-Diagne"
2021,"West Brom","Premier League","Grady Diangana","ENG","MF,FW","22",1998,13.7,35,19,19,9,7,19,43,44.2,24,16,2,14,16,51,9,0,"https://fbref.com/en/players/f522d7ec/Grady-Diangana"
2021,"West Brom","Premier League","Kyle Edwards","ENG","MF,FW","22",1998,1.3,3,2,1,1,1,0,0,NA,0,2,0,2,1,4,0,0,"https://fbref.com/en/players/1566e437/Kyle-Edwards"
2021,"West Brom","Premier League","Sam Field","ENG","MF","22",1998,0.7,5,5,3,2,0,0,0,NA,0,4,1,3,2,7,4,0,"https://fbref.com/en/players/bd8a7d05/Sam-Field"
2021,"West Brom","Premier League","Darnell Furlong","ENG","DF","24",1995,32.6,45,27,27,12,6,21,44,47.7,23,39,16,23,49,94,90,0,"https://fbref.com/en/players/3ec9195b/Darnell-Furlong"
2021,"West Brom","Premier League","Conor Gallagher","ENG","MF","20",2000,28.1,81,41,30,39,12,29,97,29.9,68,47,8,39,27,108,31,0,"https://fbref.com/en/players/c2731c10/Conor-Gallagher"
2021,"West Brom","Premier League","Kieran Gibbs","ENG","DF","30",1989,9,15,11,11,3,1,8,10,80,2,8,6,2,16,31,30,1,"https://fbref.com/en/players/46ee5234/Kieran-Gibbs"
2021,"West Brom","Premier League","Karlan Grant","ENG","FW,MF","22",1997,12.5,5,3,3,2,0,2,4,50,2,7,0,7,5,10,17,0,"https://fbref.com/en/players/87f7500e/Karlan-Grant"
2021,"West Brom","Premier League","Kamil Grosicki","POL","MF,FW","32",1988,1.6,2,1,2,0,0,2,8,25,6,1,0,1,2,4,1,0,"https://fbref.com/en/players/81d8091f/Kamil-Grosicki"
2021,"West Brom","Premier League","Rekeem Harper","ENG","MF","20",2000,0.4,0,0,0,0,0,0,0,NA,0,2,0,2,1,1,0,0,"https://fbref.com/en/players/3c066877/Rekeem-Harper"
2021,"West Brom","Premier League","Ahmed Hegazi","EGY","DF","29",1991,1,0,0,0,0,0,0,0,NA,0,2,0,2,1,1,7,0,"https://fbref.com/en/players/5540c9dc/Ahmed-Hegazi"
2021,"West Brom","Premier League","Branislav Ivanović","SRB","DF","36",1984,8.5,14,5,11,3,0,7,13,53.8,6,11,5,6,8,22,25,0,"https://fbref.com/en/players/85f8571a/Branislav-Ivanovic"
2021,"West Brom","Premier League","Sam Johnstone","ENG","GK","27",1993,37,0,0,0,0,0,0,0,NA,0,0,0,0,2,2,15,2,"https://fbref.com/en/players/9e5708be/Sam-Johnstone"
2021,"West Brom","Premier League","Filip Krovinović","CRO","MF","24",1995,6.1,13,10,6,5,2,6,18,33.3,12,2,0,2,4,17,2,0,"https://fbref.com/en/players/c2dfedeb/Filip-Krovinovic"
2021,"West Brom","Premier League","Jake Livermore","ENG","MF","30",1989,13.8,33,18,14,16,3,14,31,45.2,17,21,6,15,16,49,26,0,"https://fbref.com/en/players/b98570d1/Jake-Livermore"
2021,"West Brom","Premier League","Ainsley Maitland-Niles","ENG","MF","22",1997,13.7,22,10,7,8,7,9,28,32.1,19,12,1,11,17,39,24,0,"https://fbref.com/en/players/e3a5814e/Ainsley-Maitland-Niles"
2021,"West Brom","Premier League","Dara O'Shea","IRL","DF","21",1999,23.4,45,25,30,13,2,21,45,46.7,24,32,17,15,45,90,108,0,"https://fbref.com/en/players/1d042188/Dara-OShea"
2021,"West Brom","Premier League","Lee Peltier","ENG","DF","33",1986,2.5,9,4,8,1,0,4,4,100,0,1,1,0,1,10,11,0,"https://fbref.com/en/players/af341b88/Lee-Peltier"
2021,"West Brom","Premier League","Matheus Pereira","POR","MF,FW","24",1996,28.6,26,15,14,10,2,12,54,22.2,42,18,0,18,29,55,16,0,"https://fbref.com/en/players/b04ee927/Matheus-Pereira"
2021,"West Brom","Premier League","Matt Phillips","SCO","MF","29",1991,20.3,15,8,4,11,0,7,23,30.4,16,32,4,28,10,25,32,1,"https://fbref.com/en/players/7bb5f40e/Matt-Phillips"
2021,"West Brom","Premier League","Callum Robinson","IRL","FW,MF","25",1995,17.3,7,5,5,1,1,3,19,15.8,16,9,0,9,7,14,8,0,"https://fbref.com/en/players/e75750a3/Callum-Robinson"
2021,"West Brom","Premier League","Hal Robson-Kanu","WAL","FW","31",1989,6.2,2,1,1,0,1,0,1,0,1,2,0,2,2,4,7,0,"https://fbref.com/en/players/fb2dec57/Hal-Robson-Kanu"
2021,"West Brom","Premier League","Romaine Sawyers","SKN","MF","28",1991,16.5,30,18,16,12,2,14,43,32.6,29,20,4,16,18,48,12,3,"https://fbref.com/en/players/77bb1522/Romaine-Sawyers"
2021,"West Brom","Premier League","Robert Snodgrass","SCO","MF,FW","32",1987,5.8,17,12,12,4,1,10,16,62.5,6,11,2,9,1,18,12,0,"https://fbref.com/en/players/9f4647e9/Robert-Snodgrass"
2021,"West Brom","Premier League","Conor Townsend","ENG","DF","27",1993,24.8,44,28,32,9,3,30,49,61.2,19,38,15,23,36,80,55,2,"https://fbref.com/en/players/4dc4f138/Conor-Townsend"
2021,"West Brom","Premier League","Okay Yokuşlu","TUR","MF","26",1994,14.6,38,25,21,13,4,17,35,48.6,18,15,3,12,35,73,33,1,"https://fbref.com/en/players/e49ce451/Okay-Yokuslu"
2021,"West Ham","Premier League","Felipe Anderson","BRA","FW,MF","27",1993,0,1,1,0,1,0,0,0,NA,0,0,0,0,0,1,0,0,"https://fbref.com/en/players/9f1893b9/Felipe-Anderson"
2021,"West Ham","Premier League","Michail Antonio","JAM","FW","30",1990,21.9,7,4,1,5,1,1,7,14.3,6,20,3,17,7,14,7,0,"https://fbref.com/en/players/ac05f970/Michail-Antonio"
2021,"West Ham","Premier League","Fabián Balbuena","PAR","DF","28",1991,13.3,24,12,23,1,0,14,23,60.9,9,23,6,17,25,49,63,0,"https://fbref.com/en/players/3626f7d9/Fabian-Balbuena"
2021,"West Ham","Premier League","Saïd Benrahma","ALG","FW,MF","24",1995,15.5,24,15,8,11,5,8,28,28.6,20,10,0,10,8,32,8,0,"https://fbref.com/en/players/5a04fd92/Said-Benrahma"
2021,"West Ham","Premier League","Jarrod Bowen","ENG","FW,MF","23",1996,28.5,26,15,12,7,7,10,29,34.5,19,19,1,18,22,48,10,0,"https://fbref.com/en/players/79c84d1c/Jarrod-Bowen"
2021,"West Ham","Premier League","Vladimír Coufal","CZE","DF","27",1992,33.9,73,36,50,15,8,52,89,58.4,37,41,7,34,41,114,102,1,"https://fbref.com/en/players/fdf3cb77/Vladimir-Coufal"
2021,"West Ham","Premier League","Aaron Cresswell","ENG","DF","30",1989,35.2,32,13,15,15,2,18,32,56.3,14,29,14,15,32,64,79,2,"https://fbref.com/en/players/4f974391/Aaron-Cresswell"
2021,"West Ham","Premier League","Craig Dawson","ENG","DF","30",1990,21.4,11,8,7,4,0,5,12,41.7,7,26,22,4,32,43,88,3,"https://fbref.com/en/players/3e9e06cb/Craig-Dawson"
2021,"West Ham","Premier League","Issa Diop","FRA","DF","23",1997,15.3,20,14,12,8,0,7,18,38.9,11,32,22,10,22,42,59,0,"https://fbref.com/en/players/a712ca2b/Issa-Diop"
2021,"West Ham","Premier League","Łukasz Fabiański","POL","GK","35",1985,35,1,0,1,0,0,1,1,100,0,1,0,1,1,2,12,3,"https://fbref.com/en/players/9328b835/Lukasz-Fabianski"
2021,"West Ham","Premier League","Pablo Fornals","ESP","FW,MF","24",1996,28.6,44,26,14,24,6,11,73,15.1,62,43,1,42,36,80,9,0,"https://fbref.com/en/players/82927de4/Pablo-Fornals"
2021,"West Ham","Premier League","Ryan Fredericks","ENG","DF,FW","27",1992,6.3,9,5,5,4,0,3,7,42.9,4,6,2,4,11,20,20,0,"https://fbref.com/en/players/c067631c/Ryan-Fredericks"
2021,"West Ham","Premier League","Sébastien Haller","CIV","FW","26",1994,10.4,14,9,1,6,7,4,20,20,16,7,1,6,5,19,7,0,"https://fbref.com/en/players/ba115a40/Sebastien-Haller"
2021,"West Ham","Premier League","Ben Johnson","ENG","DF,FW","20",2000,5.8,11,5,5,3,3,7,9,77.8,2,5,1,4,11,22,9,0,"https://fbref.com/en/players/9319781b/Ben-Johnson"
2021,"West Ham","Premier League","Manuel Lanzini","ARG","MF,FW","27",1993,6.3,9,2,3,4,2,3,10,30,7,9,0,9,7,16,5,0,"https://fbref.com/en/players/26f6dca8/Manuel-Lanzini"
2021,"West Ham","Premier League","Jesse Lingard","ENG","MF,FW","27",1992,15.8,12,6,4,8,0,5,14,35.7,9,7,1,6,4,16,0,0,"https://fbref.com/en/players/810e3c74/Jesse-Lingard"
2021,"West Ham","Premier League","Arthur Masuaku","COD","DF,MF","26",1993,11.2,20,12,14,6,0,11,34,32.4,23,12,0,12,8,28,28,2,"https://fbref.com/en/players/57df7a11/Arthur-Masuaku"
2021,"West Ham","Premier League","Mark Noble","ENG","MF","33",1987,7.9,8,4,2,5,1,4,14,28.6,10,7,3,4,13,21,3,0,"https://fbref.com/en/players/ff527768/Mark-Noble"
2021,"West Ham","Premier League","Angelo Ogbonna","ITA","DF","32",1988,27.7,26,13,20,5,1,9,17,52.9,8,25,11,14,30,56,119,0,"https://fbref.com/en/players/74b2cd7e/Angelo-Ogbonna"
2021,"West Ham","Premier League","Darren Randolph","IRL","GK","33",1987,3,0,0,0,0,0,0,0,NA,0,0,0,0,0,0,1,0,"https://fbref.com/en/players/6385ebfb/Darren-Randolph"
2021,"West Ham","Premier League","Declan Rice","ENG","MF","21",1999,32,59,35,33,25,1,21,51,41.2,30,39,11,28,59,118,41,0,"https://fbref.com/en/players/1c7012b8/Declan-Rice"
2021,"West Ham","Premier League","Robert Snodgrass","SCO","FW,MF","32",1987,0.1,0,0,0,0,0,0,0,NA,0,0,0,0,0,0,0,0,"https://fbref.com/en/players/9f4647e9/Robert-Snodgrass"
2021,"West Ham","Premier League","Tomáš Souček","CZE","MF","25",1995,38,78,41,37,36,5,28,77,36.4,49,43,18,25,62,140,107,0,"https://fbref.com/en/players/6613c819/Tomas-Soucek"
2021,"West Ham","Premier League","Andriy Yarmolenko","UKR","FW,MF","30",1989,4.2,5,4,2,2,1,2,8,25,6,1,0,1,1,6,2,0,"https://fbref.com/en/players/849c826a/Andriy-Yarmolenko"
2021,"Wolfsburg","Bundesliga","Maximilian Arnold","GER","MF","26",1994,28.7,47,32,20,26,1,18,49,36.7,31,24,3,21,49,96,57,0,"https://fbref.com/en/players/86e119e0/Maximilian-Arnold"
2021,"Wolfsburg","Bundesliga","Ridle Baku","GER","FW,DF","22",1998,29.8,50,31,20,20,10,22,53,41.5,31,54,4,50,40,90,33,1,"https://fbref.com/en/players/442b56fa/Ridle-Baku"
2021,"Wolfsburg","Bundesliga","Bartosz Bialek","POL","FW,MF","18",2001,3,6,5,1,4,1,4,4,100,0,5,1,4,3,9,4,0,"https://fbref.com/en/players/763b8b37/Bartosz-Bialek"
2021,"Wolfsburg","Bundesliga","Josip Brekalo","CRO","FW","22",1998,20.2,22,10,10,7,5,8,29,27.6,21,18,0,18,17,39,3,1,"https://fbref.com/en/players/d4a2533d/Josip-Brekalo"
2021,"Wolfsburg","Bundesliga","John Brooks","USA","DF","27",1993,30.8,47,29,33,14,0,30,54,55.6,24,35,10,25,55,102,134,0,"https://fbref.com/en/players/e27da244/John-Brooks"
2021,"Wolfsburg","Bundesliga","Koen Casteels","BEL","GK","28",1992,32,0,0,0,0,0,0,1,0,1,1,0,1,2,2,9,2,"https://fbref.com/en/players/db401046/Koen-Casteels"
2021,"Wolfsburg","Bundesliga","Yannick Gerhardt","GER","MF,FW","26",1994,21.5,52,32,14,32,6,21,52,40.4,31,34,4,30,21,73,30,0,"https://fbref.com/en/players/62ab9184/Yannick-Gerhardt"
2021,"Wolfsburg","Bundesliga","Daniel Ginczek","GER","FW,MF","29",1991,2.4,2,2,1,1,0,2,8,25,6,2,0,2,1,3,2,0,"https://fbref.com/en/players/e5f63987/Daniel-Ginczek"
2021,"Wolfsburg","Bundesliga","Josuha Guilavogui","FRA","MF,DF","29",1990,8.3,17,9,9,8,0,5,12,41.7,7,12,5,7,29,46,25,0,"https://fbref.com/en/players/e6c43eec/Josuha-Guilavogui"
2021,"Wolfsburg","Bundesliga","Felix Klaus","GER","DF,MF","27",1992,1.5,7,4,3,4,0,4,5,80,1,4,0,4,2,9,4,0,"https://fbref.com/en/players/aeda1f69/Felix-Klaus"
2021,"Wolfsburg","Bundesliga","Maxence Lacroix","FRA","DF","20",2000,28.8,49,29,37,12,0,24,45,53.3,21,51,21,30,65,114,140,1,"https://fbref.com/en/players/277c49ed/Maxence-Lacroix"
2021,"Wolfsburg","Bundesliga","Yunus Mallı","TUR","MF","28",1992,0.6,1,0,0,1,0,1,1,100,0,0,0,0,0,1,0,0,"https://fbref.com/en/players/f3722c97/Yunus-Malli"
2021,"Wolfsburg","Bundesliga","Omar Marmoush","EGY","FW","21",1999,0,0,0,0,0,0,0,0,NA,0,0,0,0,0,0,0,0,"https://fbref.com/en/players/0e0102eb/Omar-Marmoush"
2021,"Wolfsburg","Bundesliga","Kevin Mbabu","SUI","DF","25",1995,18.2,51,33,27,17,7,24,35,68.6,11,28,7,21,22,73,59,1,"https://fbref.com/en/players/493924a7/Kevin-Mbabu"
2021,"Wolfsburg","Bundesliga","Admir Mehmedi","SUI","MF,FW","29",1991,9.1,17,9,6,7,4,6,16,37.5,10,7,0,7,5,22,1,0,"https://fbref.com/en/players/b500b384/Admir-Mehmedi"
2021,"Wolfsburg","Bundesliga","Paulo Otávio","BRA","DF","25",1994,19.3,60,40,32,22,6,34,62,54.8,28,51,7,44,42,102,59,0,"https://fbref.com/en/players/1cbe4984/Paulo-Otavio"
2021,"Wolfsburg","Bundesliga","Pavao Pervan","AUT","GK","32",1987,2,0,0,0,0,0,0,0,NA,0,0,0,0,0,0,1,0,"https://fbref.com/en/players/c89e8aae/Pavao-Pervan"
2021,"Wolfsburg","Bundesliga","Maximilian Philipp","GER","MF","26",1994,12.3,15,6,3,6,6,5,21,23.8,16,17,0,17,6,21,3,0,"https://fbref.com/en/players/061e8e23/Maximilian-Philipp"
2021,"Wolfsburg","Bundesliga","Marin Pongračić","CRO","DF","22",1997,6.4,13,9,9,3,1,6,8,75,2,12,5,7,11,24,27,0,"https://fbref.com/en/players/2a6cd437/Marin-Pongracic"
2021,"Wolfsburg","Bundesliga","Jérôme Roussillon","FRA","DF","27",1993,13.7,24,12,14,8,2,11,20,55,9,10,1,9,19,43,28,0,"https://fbref.com/en/players/13203c45/Jerome-Roussillon"
2021,"Wolfsburg","Bundesliga","João Victor Santos Sá","BRA","FW","26",1994,5.2,9,6,2,6,1,6,11,54.5,5,11,0,11,8,17,2,0,"https://fbref.com/en/players/1a1033a1/Joao-Victor-Santos-Sa"
2021,"Wolfsburg","Bundesliga","Xaver Schlager","AUT","MF","22",1997,29.2,66,40,20,38,8,22,68,32.4,46,50,6,44,54,120,38,0,"https://fbref.com/en/players/8f056768/Xaver-Schlager"
2021,"Wolfsburg","Bundesliga","Tim Siersleben","GER","DF","20",2000,0.4,2,2,2,0,0,1,1,100,0,1,0,1,0,2,0,0,"https://fbref.com/en/players/f761c901/Tim-Siersleben"
2021,"Wolfsburg","Bundesliga","Renato Steffen","SUI","FW,MF","28",1991,17.4,24,15,6,12,6,13,24,54.2,11,21,2,19,22,46,15,0,"https://fbref.com/en/players/dd669209/Renato-Steffen"
2021,"Wolfsburg","Bundesliga","Wout Weghorst","NED","FW","27",1992,32.7,13,8,2,8,3,4,20,20,16,17,3,14,4,17,26,0,"https://fbref.com/en/players/c4e87b8b/Wout-Weghorst"
2021,"Wolfsburg","Bundesliga","William","BRA","MF,FW","25",1995,0,0,0,0,0,0,0,0,NA,0,0,0,0,0,0,0,0,"https://fbref.com/en/players/d4d0a9ad/William"
2021,"Wolves","Premier League","Rayan Aït Nouri","FRA","DF","19",2001,15.6,29,16,18,10,1,13,27,48.1,14,14,1,13,15,44,25,0,"https://fbref.com/en/players/9b398aea/Rayan-Ait-Nouri"
2021,"Wolves","Premier League","Willy Boly","CIV","DF","29",1991,20.9,33,20,26,7,0,13,24,54.2,11,18,12,6,32,65,84,1,"https://fbref.com/en/players/a4ac4b8f/Willy-Boly"
2021,"Wolves","Premier League","Oskar Buur","DEN","DF","22",1998,0.2,0,0,0,0,0,0,2,0,2,0,0,0,0,0,0,0,"https://fbref.com/en/players/aa6f2f2c/Oskar-Buur"
2021,"Wolves","Premier League","Jonny Castro","ESP","MF,DF","26",1994,5.5,11,5,6,4,1,6,13,46.2,7,9,3,6,9,20,7,0,"https://fbref.com/en/players/e28868f3/Jonny-Castro"
2021,"Wolves","Premier League","Conor Coady","ENG","DF","27",1993,36.7,35,23,25,10,0,19,35,54.3,16,40,32,8,27,62,134,2,"https://fbref.com/en/players/2928dca2/Conor-Coady"
2021,"Wolves","Premier League","Theo Corbeanu","CAN","FW","18",2002,0.1,2,1,0,2,0,1,1,100,0,0,0,0,1,3,0,0,"https://fbref.com/en/players/25b82f9a/Theo-Corbeanu"
2021,"Wolves","Premier League","Patrick Cutrone","ITA","FW","22",1998,0.3,0,0,0,0,0,0,0,NA,0,0,0,0,0,0,0,0,"https://fbref.com/en/players/a4fe8cda/Patrick-Cutrone"
2021,"Wolves","Premier League","Leander Dendoncker","BEL","MF,DF","25",1995,27.8,54,29,29,22,3,31,60,51.7,29,38,15,23,27,81,52,2,"https://fbref.com/en/players/5a7301ae/Leander-Dendoncker"
2021,"Wolves","Premier League","Morgan Gibbs-White","ENG","MF,FW","20",2000,4.6,9,7,3,4,2,5,12,41.7,7,6,0,6,3,12,1,0,"https://fbref.com/en/players/32f60ed8/Morgan-Gibbs-White"
2021,"Wolves","Premier League","Ki-Jana Hoever","NED","DF,MF","18",2002,6.4,14,6,11,2,1,10,22,45.5,12,2,0,2,9,23,23,0,"https://fbref.com/en/players/9a71e978/Ki-Jana-Hoever"
2021,"Wolves","Premier League","Raúl Jiménez","MEX","FW","29",1991,9.1,3,2,1,2,0,0,7,0,7,2,0,2,8,11,12,0,"https://fbref.com/en/players/b561db50/Raul-Jimenez"
2021,"Wolves","Premier League","Willian José","BRA","FW","28",1991,12.3,2,1,1,1,0,1,4,25,3,6,1,5,1,3,12,0,"https://fbref.com/en/players/d87e2cae/Willian-Jose"
2021,"Wolves","Premier League","Max Kilman","ENG","DF","23",1997,14.6,21,14,13,4,4,8,14,57.1,6,17,8,9,19,40,46,0,"https://fbref.com/en/players/d0f72bf1/Max-Kilman"
2021,"Wolves","Premier League","Fernando Marçal","BRA","DF,MF","31",1989,6.9,13,5,6,7,0,6,11,54.5,5,11,2,9,12,25,25,0,"https://fbref.com/en/players/9ae9eaea/Fernando-Marcal"
2021,"Wolves","Premier League","João Moutinho","POR","MF","33",1986,28.1,75,40,34,35,6,35,91,38.5,56,18,3,15,47,122,28,0,"https://fbref.com/en/players/f5a00fa4/Joao-Moutinho"
2021,"Wolves","Premier League","Pedro Neto","POR","FW,MF","20",2000,28.3,16,9,4,6,6,6,28,21.4,22,18,2,16,31,47,8,0,"https://fbref.com/en/players/7ba2eaa9/Pedro-Neto"
2021,"Wolves","Premier League","Rúben Neves","POR","MF","23",1997,29.7,86,46,42,38,6,36,88,40.9,52,55,11,44,65,151,46,2,"https://fbref.com/en/players/44bfb6c5/Ruben-Neves"
2021,"Wolves","Premier League","Owen Otasowie","USA","MF,FW","19",2001,2.1,5,5,3,2,0,1,2,50,1,1,1,0,3,8,4,0,"https://fbref.com/en/players/6956ff08/Owen-Otasowie"
2021,"Wolves","Premier League","Rui Patrício","POR","GK","32",1988,37,0,0,0,0,0,0,1,0,1,0,0,0,1,1,3,3,"https://fbref.com/en/players/79b0d6a0/Rui-Patricio"
2021,"Wolves","Premier League","Daniel Podence","POR","MF,FW","24",1995,18.5,12,6,5,5,2,2,19,10.5,17,5,1,4,13,25,2,0,"https://fbref.com/en/players/7fcc71d8/Daniel-Podence"
2021,"Wolves","Premier League","John Ruddy","ENG","GK","33",1986,1,0,0,0,0,0,0,0,NA,0,0,0,0,0,0,0,0,"https://fbref.com/en/players/da8b19e2/John-Ruddy"
2021,"Wolves","Premier League","Romain Saïss","MAR","DF","30",1990,26.7,35,24,23,12,0,19,33,57.6,14,28,13,15,52,87,115,1,"https://fbref.com/en/players/9fbbcf39/Romain-Saiss"
2021,"Wolves","Premier League","Nélson Semedo","POR","DF,MF","26",1993,33.1,85,48,53,23,9,42,72,58.3,30,30,10,20,41,126,78,2,"https://fbref.com/en/players/d04b94db/Nelson-Semedo"
2021,"Wolves","Premier League","Fábio Silva","POR","FW","18",2002,15.2,6,4,1,4,1,4,12,33.3,8,12,1,11,4,10,5,1,"https://fbref.com/en/players/e7aa9d7c/Fabio-Silva"
2021,"Wolves","Premier League","Adama Traoré","ESP","FW,MF","24",1996,29.4,28,16,11,13,4,13,21,61.9,8,23,1,22,7,35,12,1,"https://fbref.com/en/players/9a28eba4/Adama-Traore"
2021,"Wolves","Premier League","Rúben Vinagre","POR","MF,DF","21",1999,1.9,7,5,5,2,0,3,4,75,1,3,0,3,2,9,4,0,"https://fbref.com/en/players/b937e490/Ruben-Vinagre"
2021,"Wolves","Premier League","Vitinha","POR","MF","20",2000,5.8,7,3,2,5,0,3,8,37.5,5,3,0,3,3,10,1,0,"https://fbref.com/en/players/3b029691/Vitinha"
2022,"Alavés","La Liga","Martin Agirregabiria","ESP","DF","25",1996,18,34,22,17,11,6,18,37,48.6,19,20,3,17,25,59,38,0,"https://fbref.com/en/players/355c883a/Martin-Agirregabiria"
2022,"Alavés","La Liga","Mircea Alexandru Tirlea","ROU","DF","21",2000,0.2,0,0,0,0,0,0,0,NA,0,0,0,0,0,0,1,0,"https://fbref.com/en/players/683a1d81/Mircea-Alexandru-Tirlea"
2022,"Alavés","La Liga","Rubén Duarte","ESP","DF","25",1995,29.1,76,47,43,27,6,43,85,50.6,42,40,6,34,57,133,82,0,"https://fbref.com/en/players/1fe0492d/Ruben-Duarte"
2022,"Alavés","La Liga","Gonzalo Escalante","ARG","MF","28",1993,14.4,30,14,9,20,1,13,34,38.2,21,27,2,25,21,51,28,0,"https://fbref.com/en/players/3f79a1c8/Gonzalo-Escalante"
2022,"Alavés","La Liga","Manu García","ESP","MF","23",1998,12,18,9,6,9,3,9,27,33.3,18,8,2,6,13,31,4,0,"https://fbref.com/en/players/6ed1a2a2/Manu-Garcia"
2022,"Alavés","La Liga","Saúl García","ESP","MF","26",1994,0,1,1,1,0,0,0,0,NA,0,0,0,0,0,1,0,0,"https://fbref.com/en/players/dafa5038/Saul-Garcia"
2022,"Alavés","La Liga","John Guidetti","SWE","FW,MF","29",1992,3.1,2,1,0,0,2,0,1,0,1,1,0,1,0,2,0,0,"https://fbref.com/en/players/99bebd12/John-Guidetti"
2022,"Alavés","La Liga","Jason","ESP","MF,FW","27",1994,7.5,11,7,6,4,1,7,20,35,13,7,0,7,7,18,5,0,"https://fbref.com/en/players/9038c2a1/Jason"
2022,"Alavés","La Liga","Joselu","ESP","FW","31",1990,34.7,16,11,1,9,6,7,25,28,18,21,4,17,7,23,45,0,"https://fbref.com/en/players/6265208f/Joselu"
2022,"Alavés","La Liga","Víctor Laguardia","ESP","DF","31",1989,33.8,29,16,21,8,0,19,30,63.3,11,36,24,12,27,56,151,1,"https://fbref.com/en/players/b7c99b9b/Victor-Laguardia"
2022,"Alavés","La Liga","Florian Lejeune","FRA","DF","30",1991,30,33,24,22,10,1,12,20,60,8,30,19,11,31,64,158,0,"https://fbref.com/en/players/6eaed4eb/Florian-Lejeune"
2022,"Alavés","La Liga","Javi López","ESP","DF","19",2002,5.1,8,6,6,2,0,4,6,66.7,2,7,1,6,4,12,15,0,"https://fbref.com/en/players/e9ada8cf/Javi-Lopez"
2022,"Alavés","La Liga","Mamadou Loum","SEN","MF","24",1996,25.7,49,22,26,22,1,17,45,37.8,28,30,11,19,37,86,68,1,"https://fbref.com/en/players/bcfc4473/Mamadou-Loum"
2022,"Alavés","La Liga","Iván Martín","ESP","MF,FW","22",1999,1.8,1,1,1,0,0,0,1,0,1,2,0,2,1,2,1,0,"https://fbref.com/en/players/ae48c5cb/Ivan-Martin"
2022,"Alavés","La Liga","Tomás Mendes","ESP","MF","16",2004,0.1,0,0,0,0,0,0,0,NA,0,0,0,0,0,0,1,0,"https://fbref.com/en/players/45f771db/Tomas-Mendes"
2022,"Alavés","La Liga","Édgar Méndez","ESP","FW,MF","31",1990,17.9,25,14,11,10,4,11,34,32.4,23,16,0,16,4,29,17,0,"https://fbref.com/en/players/aed746df/Edgar-Mendez"
2022,"Alavés","La Liga","Matt Miazga","USA","DF","26",1995,9.3,7,7,3,4,0,2,7,28.6,5,14,12,2,11,18,55,1,"https://fbref.com/en/players/9fc0f253/Matt-Miazga"
2022,"Alavés","La Liga","Miguel","ESP","FW,MF","21",1999,9.2,7,3,1,5,1,2,15,13.3,13,6,0,6,1,8,7,0,"https://fbref.com/en/players/6763373d/Miguel"
2022,"Alavés","La Liga","Toni Moya","ESP","MF","23",1998,15.4,23,10,7,13,3,13,43,30.2,30,18,5,13,20,43,18,0,"https://fbref.com/en/players/9e098912/Toni-Moya"
2022,"Alavés","La Liga","Ximo Navarro","ESP","DF","31",1990,15,28,19,21,6,1,13,27,48.1,14,11,5,6,22,50,56,2,"https://fbref.com/en/players/8db394aa/Ximo-Navarro"
2022,"Alavés","La Liga","Jesús Owono","EQG","GK","20",2001,1,0,0,0,0,0,0,0,NA,0,0,0,0,0,0,1,0,"https://fbref.com/en/players/d6e3d7fb/Jesus-Owono"
2022,"Alavés","La Liga","Fernando Pacheco","ESP","GK","29",1992,33.9,2,1,2,0,0,2,2,100,0,0,0,0,0,2,18,1,"https://fbref.com/en/players/97852360/Fernando-Pacheco"
2022,"Alavés","La Liga","Facundo Pellistri","URU","MF,FW","19",2001,7.5,9,5,4,3,2,1,10,10,9,13,2,11,6,15,7,0,"https://fbref.com/en/players/ac7e7b1c/Facundo-Pellistri"
2022,"Alavés","La Liga","Tomás Pina Isla","ESP","MF","33",1987,16,28,16,13,11,4,14,29,48.3,15,12,3,9,22,50,23,0,"https://fbref.com/en/players/e54bd0a2/Tomas-Pina-Isla"
2022,"Alavés","La Liga","Pere Pons","ESP","MF","28",1993,15.2,26,18,4,20,2,7,21,33.3,14,10,1,9,6,32,11,0,"https://fbref.com/en/players/29b61deb/Pere-Pons"
2022,"Alavés","La Liga","Luis Rioja","ESP","MF,FW","27",1993,34.6,28,15,11,10,7,14,58,24.1,44,22,1,21,25,53,20,0,"https://fbref.com/en/players/eb3dd471/Luis-Rioja"
2022,"Alavés","La Liga","Unai Ropero","ESP","MF","19",2001,0.1,0,0,0,0,0,0,0,NA,0,0,0,0,1,1,0,0,"https://fbref.com/en/players/7868c973/Unai-Ropero"
2022,"Alavés","La Liga","Antonio Sivera","ESP","GK","24",1996,3.1,0,0,0,0,0,0,1,0,1,0,0,0,0,0,0,0,"https://fbref.com/en/players/9970da54/Antonio-Sivera"
2022,"Alavés","La Liga","Mamadou Sylla","SEN","FW,MF","27",1994,4.4,2,2,0,1,1,0,1,0,1,0,0,0,1,3,5,0,"https://fbref.com/en/players/e5ec95f8/Mamadou-Sylla"
2022,"Alavés","La Liga","Tachi","ESP","DF","23",1997,2.7,6,3,3,3,0,5,7,71.4,2,4,3,1,1,7,9,0,"https://fbref.com/en/players/8b625720/Tachi"
2022,"Alavés","La Liga","Nahuel Tenaglia","ARG","DF","25",1996,11.9,42,27,30,9,3,24,37,64.9,13,10,2,8,26,68,42,0,"https://fbref.com/en/players/66654daa/Nahuel-Tenaglia"
2022,"Alavés","La Liga","Marc Tenas","ESP","FW,MF","20",2001,0.6,1,1,1,0,0,1,1,100,0,1,0,1,0,1,0,1,"https://fbref.com/en/players/1c5d79e2/Marc-Tenas"
2022,"Alavés","La Liga","Manu Vallejo","ESP","MF,FW","24",1997,4.1,8,2,1,4,3,4,13,30.8,9,7,0,7,0,8,4,0,"https://fbref.com/en/players/0bc4e720/Manu-Vallejo"
2022,"Angers","Ligue 1","Mohamed Ali Cho","FRA","FW","17",2004,20.4,10,5,1,4,5,5,17,29.4,12,17,1,16,8,18,0,1,"https://fbref.com/en/players/f8405304/Mohamed-Ali-Cho"
2022,"Angers","Ligue 1","Stéphane Bahoken","CMR","FW","29",1992,12.2,13,8,2,7,4,1,9,11.1,8,15,0,15,3,16,3,0,"https://fbref.com/en/players/5046b7d4/Stephane-Bahoken"
2022,"Angers","Ligue 1","Abdoulaye Bamba","CIV","DF,FW","31",1990,5.1,6,5,6,0,0,4,11,36.4,7,5,1,4,9,15,13,0,"https://fbref.com/en/players/7fecbcdb/Abdoulaye-Bamba"
2022,"Angers","Ligue 1","Nabil Bentaleb","ALG","MF","26",1994,16.8,42,24,15,20,7,16,29,55.2,13,24,9,15,28,70,13,0,"https://fbref.com/en/players/3189f61a/Nabil-Bentaleb"
2022,"Angers","Ligue 1","Paul Bernardoni","FRA","GK","24",1997,13,3,2,3,0,0,3,4,75,1,0,0,0,0,3,8,1,"https://fbref.com/en/players/28dabd43/Paul-Bernardoni"
2022,"Angers","Ligue 1","Antonin Bobichon","FRA","MF,FW","25",1995,0.4,1,0,0,1,0,0,0,NA,0,0,0,0,1,2,0,0,"https://fbref.com/en/players/7d937aa1/Antonin-Bobichon"
2022,"Angers","Ligue 1","Sofiane Boufal","MAR","FW,MF","27",1993,25.9,44,29,19,16,9,18,38,47.4,20,19,2,17,7,51,1,0,"https://fbref.com/en/players/b0c71810/Sofiane-Boufal"
2022,"Angers","Ligue 1","Bilal Brahimi","ALG","FW","21",2000,3.8,1,1,0,1,0,0,3,0,3,0,0,0,1,2,1,0,"https://fbref.com/en/players/02bcaf8e/Bilal-Brahimi"
2022,"Angers","Ligue 1","Jimmy Cabot","FRA","DF","27",1994,22.3,81,44,59,15,7,47,83,56.6,36,29,0,29,32,113,30,0,"https://fbref.com/en/players/46359159/Jimmy-Cabot"
2022,"Angers","Ligue 1","Pierrick Capelle","FRA","MF,DF","34",1987,13.3,36,24,16,17,3,18,52,34.6,34,12,1,11,16,52,20,0,"https://fbref.com/en/players/79b2399c/Pierrick-Capelle"
2022,"Angers","Ligue 1","Souleyman Doumbia","CIV","DF,FW","24",1996,24.7,30,20,16,9,5,13,27,48.1,14,25,4,21,39,69,51,0,"https://fbref.com/en/players/9daeac61/Souleyman-Doumbia"
2022,"Angers","Ligue 1","Enzo Ebosse","CMR","DF","22",1999,21,25,14,19,6,0,11,19,57.9,8,19,9,10,15,40,42,0,"https://fbref.com/en/players/9ba7b4fa/Enzo-Ebosse"
2022,"Angers","Ligue 1","Noah Fatar","FRA","DF,MF","19",2002,0.1,1,0,0,0,1,0,1,0,1,0,0,0,1,2,0,0,"https://fbref.com/en/players/2693f6bc/Noah-Fatar"
2022,"Angers","Ligue 1","Angelo Fulgini","FRA","MF,FW","24",1996,32.5,35,25,8,18,9,14,44,31.8,30,21,5,16,22,57,5,1,"https://fbref.com/en/players/4b96c347/Angelo-Fulgini"
2022,"Angers","Ligue 1","Noah Guede-Nadje","FRA","MF","17",2003,0,0,0,0,0,0,0,0,NA,0,0,0,0,0,0,0,0,"https://fbref.com/en/players/94b442c0/Noah-Guede-Nadje"
2022,"Angers","Ligue 1","Marin Jakoliš","CRO","FW","24",1996,2.5,2,1,0,1,1,0,6,0,6,0,0,0,1,3,0,0,"https://fbref.com/en/players/96f4ebc0/Marin-Jakolis"
2022,"Angers","Ligue 1","Vincent Manceau","FRA","DF","32",1989,26.2,32,19,18,13,1,14,37,37.8,23,23,6,17,32,64,72,0,"https://fbref.com/en/players/c26a3918/Vincent-Manceau"
2022,"Angers","Ligue 1","Anthony Mandrea","ALG","GK","24",1996,10,0,0,0,0,0,0,0,NA,0,0,0,0,0,0,9,0,"https://fbref.com/en/players/f7d3a773/Anthony-Mandrea"
2022,"Angers","Ligue 1","Thomas Mangani","FRA","MF","34",1987,24.4,58,30,23,34,1,31,68,45.6,37,38,11,27,36,94,29,0,"https://fbref.com/en/players/c801616a/Thomas-Mangani"
2022,"Angers","Ligue 1","Jason Mbock","FRA","FW","21",1999,0.2,0,0,0,0,0,0,0,NA,0,0,0,0,0,0,0,0,"https://fbref.com/en/players/890bc029/Jason-Mbock"
2022,"Angers","Ligue 1","Farid El Melali","ALG","FW","24",1997,0.2,0,0,0,0,0,0,1,0,1,1,0,1,0,0,1,0,"https://fbref.com/en/players/d21e361a/Farid-El-Melali"
2022,"Angers","Ligue 1","Batista Mendy","FRA","MF,DF","21",2000,26.8,49,28,21,22,6,23,45,51.1,22,37,6,31,34,83,40,0,"https://fbref.com/en/players/e472a6f6/Batista-Mendy"
2022,"Angers","Ligue 1","Casimir Ninga","CHA","FW","28",1993,4.5,5,1,1,4,0,2,5,40,3,2,0,2,1,6,0,0,"https://fbref.com/en/players/91f2da4c/Casimir-Ninga"
2022,"Angers","Ligue 1","Azzedine Ounahi","MAR","MF","21",2000,18.1,39,22,16,22,1,11,40,27.5,29,19,1,18,26,65,13,0,"https://fbref.com/en/players/83299cc0/Azzedine-Ounahi"
2022,"Angers","Ligue 1","Mathias Pereira Lage","POR","DF","24",1996,11.6,21,7,10,7,4,8,30,26.7,22,18,7,11,21,42,22,0,"https://fbref.com/en/players/8846a40f/Mathias-Pereira-Lage"
2022,"Angers","Ligue 1","Danijel Petković","MNE","GK","28",1993,15,0,0,0,0,0,0,1,0,1,0,0,0,1,1,9,5,"https://fbref.com/en/players/b98cea65/Danijel-Petkovic"
2022,"Angers","Ligue 1","Waniss Taibi","FRA","MF,FW","19",2002,1.5,8,7,4,4,0,2,4,50,2,0,0,0,1,9,1,0,"https://fbref.com/en/players/95192fe4/Waniss-Taibi"
2022,"Angers","Ligue 1","Sada Thioub","SEN","FW","26",1995,0,0,0,0,0,0,0,0,NA,0,0,0,0,0,0,0,0,"https://fbref.com/en/players/f4bc42b1/Sada-Thioub"
2022,"Angers","Ligue 1","Romain Thomas","FRA","DF","33",1988,28.5,49,37,28,21,0,30,57,52.6,27,35,19,16,44,93,126,0,"https://fbref.com/en/players/275e2c51/Romain-Thomas"
2022,"Angers","Ligue 1","Ismaël Traoré","CIV","DF","34",1986,35.7,28,17,16,11,1,13,28,46.4,15,25,17,8,44,72,122,1,"https://fbref.com/en/players/b666421b/Ismael-Traore"
2022,"Arminia","Bundesliga","Andrés Andrade Cedeño","PAN","DF","22",1998,11.6,27,16,18,8,1,17,35,48.6,18,16,7,9,19,46,44,0,"https://fbref.com/en/players/6ea23758/Andres-Andrade-Cedeno"
2022,"Arminia","Bundesliga","Jacob Barrett Laursen","DEN","DF","26",1994,18.1,16,12,10,6,0,8,21,38.1,13,19,7,12,28,44,43,0,"https://fbref.com/en/players/c0d3bd23/Jacob-Barrett-Laursen"
2022,"Arminia","Bundesliga","George Bello","USA","DF","19",2002,4.8,7,7,7,0,0,4,4,100,0,5,4,1,6,13,11,0,"https://fbref.com/en/players/aca0a525/George-Bello"
2022,"Arminia","Bundesliga","Cédric Brunner","SUI","DF","27",1994,24.3,51,35,29,20,2,25,49,51,24,27,10,17,43,94,84,0,"https://fbref.com/en/players/f0a37d36/Cedric-Brunner"
2022,"Arminia","Bundesliga","Gonzalo Castro","GER","MF,FW","34",1987,4.8,8,3,4,4,0,1,5,20,4,3,0,3,3,11,3,0,"https://fbref.com/en/players/68829001/Gonzalo-Castro"
2022,"Arminia","Bundesliga","Lennart-Marten Czyborra","GER","DF","22",1999,1.5,0,0,0,0,0,0,2,0,2,0,0,0,3,3,3,1,"https://fbref.com/en/players/7ba1f1ef/Lennart-Marten-Czyborra"
2022,"Arminia","Bundesliga","Mike van der Hoorn","NED","DF","28",1992,0.2,1,0,1,0,0,0,0,NA,0,0,0,0,1,2,2,0,"https://fbref.com/en/players/25f50295/Mike-van-der-Hoorn"
2022,"Arminia","Bundesliga","Edimilson Fernandes","SUI","MF,FW","25",1996,3.1,2,0,1,1,0,1,4,25,3,2,2,0,2,4,6,0,"https://fbref.com/en/players/3bb625ac/Edimilson-Fernandes"
2022,"Arminia","Bundesliga","Robin Hack","GER","FW,MF","22",1998,15.2,14,8,6,5,3,3,21,14.3,18,18,1,17,5,19,4,0,"https://fbref.com/en/players/0174ba21/Robin-Hack"
2022,"Arminia","Bundesliga","Burak İnce","TUR","FW","17",2004,1.5,1,1,1,0,0,1,2,50,1,1,0,1,0,1,0,0,"https://fbref.com/en/players/683dec01/Burak-Ince"
2022,"Arminia","Bundesliga","Stefanos Kapino","GRE","GK","27",1994,1,0,0,0,0,0,0,0,NA,0,0,0,0,0,0,0,0,"https://fbref.com/en/players/62ba5881/Stefanos-Kapino"
2022,"Arminia","Bundesliga","Fabian Klos","GER","FW","33",1987,15.8,7,5,0,5,2,2,10,20,8,17,4,13,0,7,31,0,"https://fbref.com/en/players/e21042ae/Fabian-Klos"
2022,"Arminia","Bundesliga","Florian Krüger","GER","FW,MF","22",1999,12.5,3,1,0,3,0,2,10,20,8,12,1,11,2,5,13,0,"https://fbref.com/en/players/f9f92b5f/Florian-Kruger"
2022,"Arminia","Bundesliga","Fabian Kunze","GER","MF","23",1998,14,35,21,14,20,1,15,32,46.9,17,17,2,15,19,54,27,1,"https://fbref.com/en/players/d25fee56/Fabian-Kunze"
2022,"Arminia","Bundesliga","Bryan Lasme","FRA","FW","22",1998,9.7,6,6,1,2,3,0,3,0,3,7,0,7,1,7,9,0,"https://fbref.com/en/players/ebac0ace/Bryan-Lasme"
2022,"Arminia","Bundesliga","Nathan de Medina","BEL","DF","23",1997,8.6,17,10,11,6,0,6,10,60,4,14,3,11,10,27,28,0,"https://fbref.com/en/players/d686dbc0/Nathan-de-Medina"
2022,"Arminia","Bundesliga","Joakim Nilsson","SWE","DF","27",1994,30.4,37,19,24,13,0,20,26,76.9,6,36,23,13,56,93,143,1,"https://fbref.com/en/players/c562c5b4/Joakim-Nilsson"
2022,"Arminia","Bundesliga","Masaya Okugawa","JPN","MF,FW","25",1996,28.1,46,25,18,22,6,12,37,32.4,25,29,1,28,20,66,13,0,"https://fbref.com/en/players/63b9cc6d/Masaya-Okugawa"
2022,"Arminia","Bundesliga","Stefan Ortega","GER","GK","28",1992,33,1,0,1,0,0,1,2,50,1,2,0,2,0,1,5,1,"https://fbref.com/en/players/c1242d4e/Stefan-Ortega"
2022,"Arminia","Bundesliga","Amos Pieper","GER","DF","23",1998,26.4,58,29,38,19,1,32,51,62.7,19,37,23,14,50,108,132,1,"https://fbref.com/en/players/526ea7cc/Amos-Pieper"
2022,"Arminia","Bundesliga","Manuel Prietl","AUT","MF","29",1991,23.6,59,26,23,31,5,23,60,38.3,37,28,3,25,39,98,33,0,"https://fbref.com/en/players/901c0f97/Manuel-Prietl"
2022,"Arminia","Bundesliga","Guilherme Ramos","POR","DF","23",1997,10.1,25,15,17,8,0,12,19,63.2,7,21,8,13,27,52,52,0,"https://fbref.com/en/players/df9c3473/Guilherme-Ramos"
2022,"Arminia","Bundesliga","Alessandro Schöpf","AUT","MF","27",1994,26.6,40,22,19,16,5,14,30,46.7,16,31,5,26,30,70,21,1,"https://fbref.com/en/players/106bca06/Alessandro-Schopf"
2022,"Arminia","Bundesliga","Janni Serra","GER","FW","23",1998,12.4,4,2,2,0,2,2,7,28.6,5,8,3,5,5,9,19,0,"https://fbref.com/en/players/40b58bfc/Janni-Serra"
2022,"Arminia","Bundesliga","Sebastian Vasiliadis","GRE","MF","23",1997,13.3,31,17,12,15,4,15,42,35.7,27,15,2,13,25,56,31,1,"https://fbref.com/en/players/d3112d86/Sebastian-Vasiliadis"
2022,"Arminia","Bundesliga","Patrick Wimmer","AUT","FW,MF","20",2001,22.8,53,31,13,31,9,22,61,36.1,39,30,1,29,27,80,13,0,"https://fbref.com/en/players/cb11b429/Patrick-Wimmer"
2022,"Arsenal","Premier League","Pierre-Emerick Aubameyang","GAB","FW","32",1989,11.5,11,5,6,4,1,3,10,30,7,12,1,11,0,11,4,0,"https://fbref.com/en/players/d5dd5f1f/Pierre-Emerick-Aubameyang"
2022,"Arsenal","Premier League","Folarin Balogun","ENG","FW","20",2001,0.8,1,1,0,0,1,0,0,NA,0,1,0,1,0,1,1,0,"https://fbref.com/en/players/31822f8c/Folarin-Balogun"
2022,"Arsenal","Premier League","Calum Chambers","ENG","DF","26",1995,1.9,5,3,3,1,1,3,4,75,1,6,3,3,0,5,10,0,"https://fbref.com/en/players/dc6f5bdd/Calum-Chambers"
2022,"Arsenal","Premier League","Gabriel Dos Santos","BRA","DF","23",1997,34,50,30,36,12,2,30,41,73.2,11,34,26,8,13,63,112,4,"https://fbref.com/en/players/67ac5bb8/Gabriel-Dos-Santos"
2022,"Arsenal","Premier League","Mohamed Elneny","EGY","MF","29",1992,9,16,8,10,5,1,7,12,58.3,5,7,1,6,14,30,13,0,"https://fbref.com/en/players/47a34c4f/Mohamed-Elneny"
2022,"Arsenal","Premier League","Rob Holding","ENG","DF","25",1995,9.4,13,9,11,1,1,5,6,83.3,1,23,18,5,10,23,42,1,"https://fbref.com/en/players/d79a8c87/Rob-Holding"
2022,"Arsenal","Premier League","Sead Kolašinac","BIH","DF","28",1993,1,0,0,0,0,0,0,0,NA,0,0,0,0,4,4,1,0,"https://fbref.com/en/players/3935e52e/Sead-Kolasinac"
2022,"Arsenal","Premier League","Alexandre Lacazette","FRA","FW","30",1991,19.8,27,10,8,13,6,7,21,33.3,14,12,1,11,5,32,6,0,"https://fbref.com/en/players/9dbb75ca/Alexandre-Lacazette"
2022,"Arsenal","Premier League","Bernd Leno","GER","GK","29",1992,4,1,1,1,0,0,1,1,100,0,0,0,0,0,1,1,0,"https://fbref.com/en/players/2628fd2b/Bernd-Leno"
2022,"Arsenal","Premier League","Ainsley Maitland-Niles","ENG","MF","23",1997,3,8,4,5,3,0,2,4,50,2,2,0,2,4,12,4,0,"https://fbref.com/en/players/e3a5814e/Ainsley-Maitland-Niles"
2022,"Arsenal","Premier League","Pablo Marí","ESP","DF","27",1993,2,5,3,1,3,1,3,6,50,3,5,4,1,3,8,10,0,"https://fbref.com/en/players/aa54ec6f/Pablo-Mari"
2022,"Arsenal","Premier League","Martinelli","BRA","FW,MF","20",2001,20.7,27,19,7,14,6,10,29,34.5,19,26,1,25,20,47,15,0,"https://fbref.com/en/players/48a5a5d6/Martinelli"
2022,"Arsenal","Premier League","Reiss Nelson","ENG","FW","21",1999,0.2,1,0,0,0,1,0,1,0,1,1,0,1,0,1,0,0,"https://fbref.com/en/players/c5bdb6e3/Reiss-Nelson"
2022,"Arsenal","Premier League","Eddie Nketiah","ENG","FW","22",1999,9.3,9,4,1,4,4,1,4,25,3,9,2,7,4,13,5,0,"https://fbref.com/en/players/a53649b7/Eddie-Nketiah"
2022,"Arsenal","Premier League","Thomas Partey","GHA","MF","28",1993,22.5,43,29,22,17,4,18,44,40.9,26,22,4,18,23,66,35,2,"https://fbref.com/en/players/529f49ab/Thomas-Partey"
2022,"Arsenal","Premier League","Nicolas Pépé","CIV","FW,MF","26",1995,7.7,8,5,3,5,0,3,9,33.3,6,9,1,8,8,16,2,0,"https://fbref.com/en/players/57e3f0c7/Nicolas-Pepe"
2022,"Arsenal","Premier League","Aaron Ramsdale","ENG","GK","23",1998,34,2,1,2,0,0,1,2,50,1,0,0,0,0,2,26,3,"https://fbref.com/en/players/466fb2c5/Aaron-Ramsdale"
2022,"Arsenal","Premier League","Bukayo Saka","ENG","FW,MF","19",2001,33.1,40,21,12,17,11,13,39,33.3,26,28,2,26,22,62,23,0,"https://fbref.com/en/players/bc7dc64d/Bukayo-Saka"
2022,"Arsenal","Premier League","Albert Sambi Lokonga","BEL","MF","21",1999,12.6,22,18,11,9,2,12,14,85.7,2,12,7,5,13,35,12,4,"https://fbref.com/en/players/1b4f1169/Albert-Sambi-Lokonga"
2022,"Arsenal","Premier League","Emile Smith Rowe","ENG","MF,FW","21",2000,21.3,14,7,7,7,0,4,20,20,16,18,1,17,15,29,10,1,"https://fbref.com/en/players/17695062/Emile-Smith-Rowe"
2022,"Arsenal","Premier League","Cédric Soares","POR","DF","29",1991,16.5,38,26,23,9,6,16,25,64,9,18,7,11,16,54,31,1,"https://fbref.com/en/players/839c14e1/Cedric-Soares"
2022,"Arsenal","Premier League","Nuno Tavares","POR","DF","21",2000,13.1,21,14,10,7,4,8,18,44.4,10,15,5,10,9,30,33,1,"https://fbref.com/en/players/a65c844b/Nuno-Tavares"
2022,"Arsenal","Premier League","Kieran Tierney","SCO","DF","24",1997,21.3,18,14,11,7,0,10,11,90.9,1,23,5,18,15,33,54,0,"https://fbref.com/en/players/fce2302c/Kieran-Tierney"
2022,"Arsenal","Premier League","Takehiro Tomiyasu","JPN","DF","22",1998,18.7,35,17,19,13,3,21,32,65.6,11,22,3,19,24,59,64,2,"https://fbref.com/en/players/b3af9be1/Takehiro-Tomiyasu"
2022,"Arsenal","Premier League","Ben White","ENG","DF","23",1997,32,44,23,30,8,6,28,45,62.2,17,42,24,18,42,86,102,0,"https://fbref.com/en/players/35e413f1/Ben-White"
2022,"Arsenal","Premier League","Granit Xhaka","SUI","MF,DF","28",1992,25.9,32,18,16,12,4,16,41,39,25,21,6,15,21,53,31,0,"https://fbref.com/en/players/e61b8aee/Granit-Xhaka"
2022,"Arsenal","Premier League","Martin Ødegaard","NOR","MF,FW","22",1998,30.9,49,21,6,24,19,22,61,36.1,39,18,1,17,11,60,11,1,"https://fbref.com/en/players/79300479/Martin-Odegaard"
2022,"Aston Villa","Premier League","Cameron Archer","ENG","FW,MF","20",2001,0.3,0,0,0,0,0,0,0,NA,0,0,0,0,0,0,0,0,"https://fbref.com/en/players/05e8ca6d/Cameron-Archer"
2022,"Aston Villa","Premier League","Leon Bailey","JAM","FW,MF","23",1997,8.5,17,11,6,8,3,6,13,46.2,7,10,1,9,1,18,2,0,"https://fbref.com/en/players/3a233281/Leon-Bailey"
2022,"Aston Villa","Premier League","Emi Buendía","ARG","MF,FW","24",1996,21.1,38,18,16,13,9,21,51,41.2,30,21,3,18,9,47,11,0,"https://fbref.com/en/players/66b76d44/Emi-Buendia"
2022,"Aston Villa","Premier League","Matty Cash","POL","DF","23",1997,37.5,89,50,52,34,3,47,78,60.3,31,54,16,38,49,138,100,2,"https://fbref.com/en/players/2389cdc2/Matty-Cash"
2022,"Aston Villa","Premier League","Calum Chambers","ENG","DF","26",1995,9.2,16,8,10,6,0,4,6,66.7,2,14,8,6,5,21,42,0,"https://fbref.com/en/players/dc6f5bdd/Calum-Chambers"
2022,"Aston Villa","Premier League","Carney Chukwuemeka","ENG","MF,FW","17",2003,3.3,7,1,2,5,0,3,5,60,2,3,0,3,1,8,2,1,"https://fbref.com/en/players/b2f9c73e/Carney-Chukwuemeka"
2022,"Aston Villa","Premier League","Philippe Coutinho","BRA","MF,FW","29",1992,14.8,17,12,4,11,2,6,21,28.6,15,11,1,10,7,24,4,0,"https://fbref.com/en/players/0ef89a37/Philippe-Coutinho"
2022,"Aston Villa","Premier League","Keinan Davis","ENG","FW","23",1998,0.1,0,0,0,0,0,0,0,NA,0,0,0,0,0,0,0,0,"https://fbref.com/en/players/9deaf2c8/Keinan-Davis"
2022,"Aston Villa","Premier League","Lucas Digne","FRA","DF","28",1993,14.1,13,10,8,3,2,9,19,47.4,10,15,8,7,23,36,40,0,"https://fbref.com/en/players/1b84dbe1/Lucas-Digne"
2022,"Aston Villa","Premier League","Anwar El Ghazi","NED","FW,MF","26",1995,4.3,4,4,2,2,0,2,7,28.6,5,6,0,6,1,5,2,0,"https://fbref.com/en/players/ffa90327/Anwar-El-Ghazi"
2022,"Aston Villa","Premier League","Kortney Hause","ENG","DF","26",1995,4.4,3,3,2,0,1,3,4,75,1,8,5,3,6,9,13,0,"https://fbref.com/en/players/bf8fad51/Kortney-Hause"
2022,"Aston Villa","Premier League","Danny Ings","ENG","FW","29",1992,21.1,23,16,2,16,5,13,37,35.1,24,31,2,29,6,29,22,0,"https://fbref.com/en/players/07802f7f/Danny-Ings"
2022,"Aston Villa","Premier League","Tim Iroegbunam","ENG","MF","18",2003,1,5,4,2,3,0,1,1,100,0,0,0,0,2,7,1,0,"https://fbref.com/en/players/84c5ceea/Tim-Iroegbunam"
2022,"Aston Villa","Premier League","Ezri Konsa","ENG","DF","23",1997,27.5,25,15,13,11,1,10,13,76.9,3,31,22,9,15,40,86,2,"https://fbref.com/en/players/0313a347/Ezri-Konsa"
2022,"Aston Villa","Premier League","Douglas Luiz","BRA","MF","23",1998,30.2,59,39,30,24,5,21,72,29.2,51,30,7,23,34,93,28,1,"https://fbref.com/en/players/6f7d826d/Douglas-Luiz"
2022,"Aston Villa","Premier League","Emiliano Martínez","ARG","GK","28",1992,36,1,1,1,0,0,1,3,33.3,2,0,0,0,0,1,6,1,"https://fbref.com/en/players/7956236f/Emiliano-Martinez"
2022,"Aston Villa","Premier League","John McGinn","SCO","MF","26",1994,34.3,106,64,35,55,16,54,104,51.9,50,53,6,47,35,141,34,0,"https://fbref.com/en/players/90f91999/John-McGinn"
2022,"Aston Villa","Premier League","Tyrone Mings","ENG","DF","28",1993,35.4,23,12,17,3,3,14,22,63.6,8,47,30,17,46,69,153,2,"https://fbref.com/en/players/8397a50c/Tyrone-Mings"
2022,"Aston Villa","Premier League","Wesley Moraes","BRA","FW","24",1996,0,0,0,0,0,0,0,0,NA,0,0,0,0,0,0,0,0,"https://fbref.com/en/players/bfae110f/Wesley-Moraes"
2022,"Aston Villa","Premier League","Marvelous Nakamba","ZIM","MF","27",1994,10,32,19,18,14,0,12,34,35.3,22,14,4,10,12,44,17,1,"https://fbref.com/en/players/de5b5570/Marvelous-Nakamba"
2022,"Aston Villa","Premier League","Robin Olsen","SWE","GK","31",1990,1,0,0,0,0,0,0,0,NA,0,0,0,0,0,0,0,0,"https://fbref.com/en/players/e7ee38c3/Robin-Olsen"
2022,"Aston Villa","Premier League","Jaden Philogene Bidace","ENG","FW","19",2002,0.1,0,0,0,0,0,0,0,NA,0,0,0,0,0,0,0,0,"https://fbref.com/en/players/19f4d211/Jaden-Philogene-Bidace"
2022,"Aston Villa","Premier League","Jacob Ramsey","ENG","MF","20",2001,27.4,67,44,31,28,8,30,69,43.5,39,36,7,29,24,91,28,0,"https://fbref.com/en/players/1544f145/Jacob-Ramsey"
2022,"Aston Villa","Premier League","Morgan Sanson","FRA","MF","26",1994,4,12,8,7,2,3,3,7,42.9,4,13,0,13,10,22,2,1,"https://fbref.com/en/players/6e7f1353/Morgan-Sanson"
2022,"Aston Villa","Premier League","Jed Steer","ENG","GK","28",1992,1,0,0,0,0,0,0,0,NA,0,0,0,0,0,0,0,0,"https://fbref.com/en/players/a8a3d139/Jed-Steer"
2022,"Aston Villa","Premier League","Matt Targett","ENG","DF","25",1995,15.9,34,18,28,5,1,24,45,53.3,21,16,9,7,23,57,35,0,"https://fbref.com/en/players/e514ab62/Matt-Targett"
2022,"Aston Villa","Premier League","Bertrand Traoré","BFA","MF,FW","25",1995,2.4,3,3,0,1,2,1,2,50,1,0,0,0,0,3,1,0,"https://fbref.com/en/players/c47541e0/Bertrand-Traore"
2022,"Aston Villa","Premier League","Trézéguet","EGY","FW","26",1994,0.1,0,0,0,0,0,0,0,NA,0,0,0,0,0,0,0,0,"https://fbref.com/en/players/3ae14ed1/Trezeguet"
2022,"Aston Villa","Premier League","Axel Tuanzebe","ENG","DF","23",1997,5.6,5,3,3,2,0,2,5,40,3,5,4,1,5,10,12,1,"https://fbref.com/en/players/2baec6ce/Axel-Tuanzebe"
2022,"Aston Villa","Premier League","Ollie Watkins","ENG","FW","25",1995,32.8,17,13,2,7,8,2,15,13.3,13,25,3,22,12,29,27,0,"https://fbref.com/en/players/aed3a70f/Ollie-Watkins"
2022,"Aston Villa","Premier League","Ashley Young","ENG","DF,FW","36",1985,13.9,18,6,9,6,3,11,16,68.8,5,10,4,6,13,31,25,1,"https://fbref.com/en/players/be927d03/Ashley-Young"
2022,"Atalanta","Serie A","Jeremie Boga","CIV","FW,MF","24",1997,8.5,7,3,0,4,3,4,6,66.7,2,6,0,6,1,8,3,1,"https://fbref.com/en/players/fe012aca/Jeremie-Boga"
2022,"Atalanta","Serie A","Moustapha Cissé","GUI","FW","17",2003,0.4,1,0,0,1,0,0,3,0,3,0,0,0,0,1,0,0,"https://fbref.com/en/players/ee3c4b3f/Moustapha-Cisse"
2022,"Atalanta","Serie A","Giorgio Cittadini","ITA","DF","19",2002,0,0,0,0,0,0,0,0,NA,0,0,0,0,1,1,0,0,"https://fbref.com/en/players/e4ba67f2/Giorgio-Cittadini"
2022,"Atalanta","Serie A","Tommaso De Nipoti","ITA","FW","18",2003,0.1,0,0,0,0,0,0,0,NA,0,0,0,0,0,0,0,0,"https://fbref.com/en/players/7f9d956a/Tommaso-De-Nipoti"
2022,"Atalanta","Serie A","Merih Demiral","TUR","DF","23",1998,21.3,31,17,18,12,1,15,28,53.6,13,26,14,12,58,89,68,1,"https://fbref.com/en/players/e3cceee6/Merih-Demiral"
2022,"Atalanta","Serie A","Berat Djimsiti","ALB","DF","28",1993,25.1,43,24,21,20,2,29,46,63,17,21,11,10,31,74,56,0,"https://fbref.com/en/players/6eee05f1/Berat-Djimsiti"
2022,"Atalanta","Serie A","Remo Freuler","SUI","MF","29",1992,26.3,69,39,22,33,14,30,70,42.9,40,48,8,40,35,104,26,1,"https://fbref.com/en/players/98d2c2c4/Remo-Freuler"
2022,"Atalanta","Serie A","Robin Gosens","GER","DF","27",1994,5.1,7,3,3,4,0,4,8,50,4,4,0,4,9,16,1,0,"https://fbref.com/en/players/2d970560/Robin-Gosens"
2022,"Atalanta","Serie A","Hans Hateboer","NED","DF,MF","27",1994,15.4,22,14,10,8,4,11,26,42.3,15,11,1,10,7,29,20,0,"https://fbref.com/en/players/3b333ac3/Hans-Hateboer"
2022,"Atalanta","Serie A","Josip Iličić","SVN","MF,FW","33",1988,9.3,7,7,3,2,2,4,17,23.5,13,6,1,5,3,10,1,0,"https://fbref.com/en/players/68252d6d/Josip-Ilicic"
2022,"Atalanta","Serie A","Teun Koopmeiners","NED","MF","23",1998,23.6,40,24,10,19,11,22,54,40.7,32,31,2,29,15,55,19,0,"https://fbref.com/en/players/a26fb8aa/Teun-Koopmeiners"
2022,"Atalanta","Serie A","Sam Lammers","NED","FW,MF","24",1997,0.4,1,0,0,0,1,0,0,NA,0,0,0,0,0,1,0,0,"https://fbref.com/en/players/c283ddef/Sam-Lammers"
2022,"Atalanta","Serie A","Matteo Lovato","ITA","DF","21",2000,3.4,5,4,4,1,0,0,1,0,1,4,2,2,7,12,8,0,"https://fbref.com/en/players/5fa57166/Matteo-Lovato"
2022,"Atalanta","Serie A","José Luis Palomino","ARG","DF","31",1990,29.7,78,40,42,33,3,32,50,64,18,43,21,22,100,178,80,2,"https://fbref.com/en/players/921f6058/Jose-Luis-Palomino"
2022,"Atalanta","Serie A","Ruslan Malinovskyi","UKR","MF,FW","28",1993,17.7,18,10,3,10,5,5,19,26.3,14,27,3,24,5,23,1,0,"https://fbref.com/en/players/48d5bd33/Ruslan-Malinovskyi"
2022,"Atalanta","Serie A","Valentin Mihaila","ROU","MF,FW","21",2000,0.8,1,1,0,1,0,0,1,0,1,2,0,2,0,1,0,0,"https://fbref.com/en/players/81a4c239/Valentin-Mihaila"
2022,"Atalanta","Serie A","Aleksei Miranchuk","RUS","MF,FW","25",1995,8.6,11,7,3,7,1,4,12,33.3,8,3,0,3,1,12,7,0,"https://fbref.com/en/players/a9aa0d1d/Aleksei-Miranchuk"
2022,"Atalanta","Serie A","Luis Muriel","COL","FW,MF","30",1991,17.1,15,4,2,7,6,3,19,15.8,16,12,0,12,4,19,5,0,"https://fbref.com/en/players/eb2fe5b6/Luis-Muriel"
2022,"Atalanta","Serie A","Juan Musso","ARG","GK","27",1994,32.6,1,1,1,0,0,0,0,NA,0,0,0,0,0,1,17,1,"https://fbref.com/en/players/a111cf41/Juan-Musso"
2022,"Atalanta","Serie A","Joakim Mæhle","DEN","DF,MF","24",1997,16.3,21,11,6,9,6,12,27,44.4,15,18,2,16,14,35,13,0,"https://fbref.com/en/players/c459a650/Joakim-Maehle"
2022,"Atalanta","Serie A","Mario Pašalić","CRO","MF,FW","26",1995,22.2,27,12,8,13,6,12,30,40,18,27,6,21,20,47,14,0,"https://fbref.com/en/players/e599253a/Mario-Pasalic"
2022,"Atalanta","Serie A","Matteo Pessina","ITA","MF,FW","24",1997,16,27,14,10,11,6,14,33,42.4,19,22,3,19,13,40,7,0,"https://fbref.com/en/players/780e3631/Matteo-Pessina"
2022,"Atalanta","Serie A","Giuseppe Pezzella","ITA","DF,MF","23",1997,11.9,28,13,15,7,6,8,18,44.4,10,13,5,8,9,37,16,0,"https://fbref.com/en/players/149c5f5d/Giuseppe-Pezzella"
2022,"Atalanta","Serie A","Roberto Piccoli","ITA","FW","20",2001,2.2,2,0,0,0,2,0,2,0,2,1,0,1,0,2,0,0,"https://fbref.com/en/players/1cadaf34/Roberto-Piccoli"
2022,"Atalanta","Serie A","Marten de Roon","NED","MF,DF","30",1991,28.3,69,42,33,29,7,34,62,54.8,28,36,2,34,45,114,41,0,"https://fbref.com/en/players/2a1beb34/Marten-de-Roon"
2022,"Atalanta","Serie A","Francesco Rossi","ITA","GK","30",1991,0.4,0,0,0,0,0,0,0,NA,0,0,0,0,0,0,0,0,"https://fbref.com/en/players/7b5f516f/Francesco-Rossi"
2022,"Atalanta","Serie A","Giorgio Scalvini","ITA","DF,MF","17",2003,8.5,22,11,13,8,1,9,19,47.4,10,12,1,11,22,44,16,0,"https://fbref.com/en/players/1e9aa637/Giorgio-Scalvini"
2022,"Atalanta","Serie A","Alassane Sidibe","CIV","MF","19",2002,0.1,1,1,1,0,0,0,0,NA,0,0,0,0,0,1,0,0,"https://fbref.com/en/players/f944979d/Alassane-Sidibe"
2022,"Atalanta","Serie A","Marco Sportiello","ITA","GK","29",1992,5,0,0,0,0,0,0,0,NA,0,0,0,0,0,0,2,0,"https://fbref.com/en/players/ac4003af/Marco-Sportiello"
2022,"Atalanta","Serie A","Rafael Tolói","ITA","DF","30",1990,16,38,15,12,15,11,24,39,61.5,15,23,11,12,26,64,35,0,"https://fbref.com/en/players/c56dc39e/Rafael-Toloi"
2022,"Atalanta","Serie A","Duván Zapata","COL","FW","30",1991,19.1,6,2,0,4,2,4,8,50,4,8,1,7,3,9,5,0,"https://fbref.com/en/players/d3de9af0/Duvan-Zapata"
2022,"Atalanta","Serie A","Davide Zappacosta","ITA","DF","29",1992,26.1,32,22,12,13,7,19,37,51.4,18,32,2,30,12,44,22,0,"https://fbref.com/en/players/7fe90ccd/Davide-Zappacosta"
2022,"Athletic Club","La Liga","Julen Agirrezabala","ESP","GK","20",2000,4,0,0,0,0,0,0,0,NA,0,0,0,0,0,0,2,0,"https://fbref.com/en/players/a2c1a8d3/Julen-Agirrezabala"
2022,"Athletic Club","La Liga","Yeray Álvarez","ESP","DF","26",1995,20.7,24,14,15,8,1,10,18,55.6,8,21,16,5,45,69,97,0,"https://fbref.com/en/players/3ecc11d8/Yeray-Alvarez"
2022,"Athletic Club","La Liga","Mikel Balenziaga","ESP","DF","33",1988,22.5,33,24,15,15,3,25,43,58.1,18,27,4,23,21,54,79,0,"https://fbref.com/en/players/1fe67e86/Mikel-Balenziaga"
2022,"Athletic Club","La Liga","Yuri Berchiche","ESP","DF","31",1990,11.3,25,11,10,11,4,7,14,50,7,19,6,13,13,38,25,0,"https://fbref.com/en/players/b6e50615/Yuri-Berchiche"
2022,"Athletic Club","La Liga","Álex Berenguer","ESP","MF","26",1995,24.1,45,26,23,14,8,11,51,21.6,40,40,2,38,16,61,20,0,"https://fbref.com/en/players/dc1c2fce/Alex-Berenguer"
2022,"Athletic Club","La Liga","Ander Capa","ESP","DF","29",1992,0,0,0,0,0,0,0,0,NA,0,0,0,0,0,0,0,0,"https://fbref.com/en/players/37f1cf47/Ander-Capa"
2022,"Athletic Club","La Liga","Dani García","ESP","MF","31",1990,24.2,36,22,15,17,4,14,47,29.8,33,27,10,17,24,60,41,1,"https://fbref.com/en/players/240d3a0b/Dani-Garcia"
2022,"Athletic Club","La Liga","Raúl García","ESP","FW","35",1986,20,27,17,6,11,10,8,36,22.2,28,30,4,26,9,36,21,0,"https://fbref.com/en/players/b418dbd4/Raul-Garcia"
2022,"Athletic Club","La Liga","Iñigo Lekue","ESP","DF","28",1993,21.4,32,23,16,12,4,22,44,50,22,37,12,25,23,55,63,0,"https://fbref.com/en/players/59b7d823/Inigo-Lekue"
2022,"Athletic Club","La Liga","Óscar de Marcos","ESP","DF","32",1989,18.7,50,37,24,19,7,28,43,65.1,15,20,3,17,19,69,27,0,"https://fbref.com/en/players/9f323c71/Oscar-de-Marcos"
2022,"Athletic Club","La Liga","Iñigo Martínez","ESP","DF","30",1991,26,28,13,18,7,3,14,23,60.9,9,22,10,12,39,67,143,0,"https://fbref.com/en/players/3fc45c73/Inigo-Martinez"
2022,"Athletic Club","La Liga","Jon Morcillo","ESP","MF,FW","22",1998,0.6,3,0,1,2,0,3,4,75,1,1,0,1,0,3,0,0,"https://fbref.com/en/players/b7d7f3bf/Jon-Morcillo"
2022,"Athletic Club","La Liga","Iker Muniain","ESP","MF","28",1992,30.9,32,10,8,19,5,12,40,30,28,20,1,19,17,49,8,1,"https://fbref.com/en/players/c05dfb74/Iker-Muniain"
2022,"Athletic Club","La Liga","Peru Nolaskoain","ESP","DF","22",1998,0,0,0,0,0,0,0,0,NA,0,0,0,0,0,0,0,0,"https://fbref.com/en/players/857cb4f3/Peru-Nolaskoain"
2022,"Athletic Club","La Liga","Unai Núñez","ESP","DF","24",1997,6.9,4,4,2,2,0,3,6,50,3,9,8,1,8,12,26,2,"https://fbref.com/en/players/be170419/Unai-Nunez"
2022,"Athletic Club","La Liga","Alex Petxa","ESP","DF,MF","24",1997,4.6,12,9,4,7,1,4,8,50,4,8,2,6,4,16,6,0,"https://fbref.com/en/players/97d08e60/Alex-Petxa"
2022,"Athletic Club","La Liga","Oihan Sancet","ESP","FW","21",2000,15.8,12,7,2,8,2,5,20,25,15,2,0,2,5,17,13,0,"https://fbref.com/en/players/bdb624a3/Oihan-Sancet"
2022,"Athletic Club","La Liga","Nicolás Serrano","ESP","MF,FW","18",2003,3.5,9,6,3,5,1,3,10,30,7,5,1,4,2,11,3,0,"https://fbref.com/en/players/2ad0e5e5/Nicolas-Serrano"
2022,"Athletic Club","La Liga","Unai Simón","ESP","GK","24",1997,34,0,0,0,0,0,0,0,NA,0,0,0,0,1,1,5,1,"https://fbref.com/en/players/5dcf3e90/Unai-Simon"
2022,"Athletic Club","La Liga","Unai Vencedor Paris","ESP","MF","20",2000,26.5,26,11,11,9,6,8,42,19,34,31,13,18,19,45,22,0,"https://fbref.com/en/players/4112ace5/Unai-Vencedor-Paris"
2022,"Athletic Club","La Liga","Mikel Vesga","ESP","MF","28",1993,15.1,27,14,7,18,2,11,31,35.5,20,16,5,11,20,47,34,2,"https://fbref.com/en/players/b0fce72c/Mikel-Vesga"
2022,"Athletic Club","La Liga","Asier Villalibre","ESP","FW","23",1997,6.1,4,3,2,1,1,1,2,50,1,3,1,2,1,5,7,0,"https://fbref.com/en/players/57be54ec/Asier-Villalibre"
2022,"Athletic Club","La Liga","Daniel Vivian","ESP","DF","22",1999,22.1,32,21,24,7,1,17,24,70.8,7,20,15,5,26,58,107,1,"https://fbref.com/en/players/ab7bf91d/Daniel-Vivian"
2022,"Athletic Club","La Liga","Iñaki Williams","GHA","FW","27",1994,30.9,14,5,1,6,7,5,17,29.4,12,18,3,15,3,17,20,0,"https://fbref.com/en/players/6a99e0b1/Inaki-Williams"
2022,"Athletic Club","La Liga","Nico Williams","ESP","MF","19",2002,14.9,20,10,6,11,3,10,31,32.3,21,18,2,16,5,25,9,0,"https://fbref.com/en/players/afdc14d7/Nico-Williams"
2022,"Athletic Club","La Liga","Oier Zarraga","ESP","MF","22",1999,13,13,5,4,7,2,3,28,10.7,25,17,10,7,19,32,10,0,"https://fbref.com/en/players/968a1c2f/Oier-Zarraga"
2022,"Atlético Madrid","La Liga","Yannick Carrasco","BEL","FW,MF","27",1993,28.7,34,19,16,12,6,19,44,43.2,25,26,5,21,19,53,12,2,"https://fbref.com/en/players/de39485a/Yannick-Carrasco"
2022,"Atlético Madrid","La Liga","Ángel Correa","ARG","FW,MF","26",1995,20.6,16,8,5,10,1,7,29,24.1,22,25,2,23,10,26,4,0,"https://fbref.com/en/players/01eb744d/Angel-Correa"
2022,"Atlético Madrid","La Liga","Matheus Cunha","BRA","FW","22",1999,11.8,19,12,3,11,5,5,20,25,15,18,2,16,6,25,9,0,"https://fbref.com/en/players/dc62b55d/Matheus-Cunha"
2022,"Atlético Madrid","La Liga","Rodrigo De Paul","ARG","MF","27",1994,23.9,55,30,22,25,8,30,60,50,30,24,3,21,21,76,17,2,"https://fbref.com/en/players/162efffd/Rodrigo-De-Paul"
2022,"Atlético Madrid","La Liga","Felipe","BRA","DF","32",1989,16.7,20,15,11,8,1,8,18,44.4,10,17,11,6,28,48,77,0,"https://fbref.com/en/players/51a3c4c8/Felipe"
2022,"Atlético Madrid","La Liga","João Félix","POR","FW,MF","21",1999,14,5,2,1,4,0,1,5,20,4,4,1,3,7,12,8,0,"https://fbref.com/en/players/8aafd64f/Joao-Felix"
2022,"Atlético Madrid","La Liga","Antoine Griezmann","FRA","FW,MF","30",1991,18.8,30,14,11,15,4,12,32,37.5,20,18,1,17,7,37,18,0,"https://fbref.com/en/players/df69b544/Antoine-Griezmann"
2022,"Atlético Madrid","La Liga","Mario Hermoso","ESP","DF","26",1995,20.7,30,15,23,4,3,20,38,52.6,18,18,3,15,29,59,49,2,"https://fbref.com/en/players/555f3a0b/Mario-Hermoso"
2022,"Atlético Madrid","La Liga","Héctor Herrera","MEX","MF","31",1990,9.5,16,8,11,4,1,7,20,35,13,13,2,11,12,28,16,0,"https://fbref.com/en/players/a8542814/Hector-Herrera"
2022,"Atlético Madrid","La Liga","Koke","ESP","MF","29",1992,27.9,55,30,19,29,7,26,63,41.3,37,21,5,16,24,79,31,1,"https://fbref.com/en/players/55126f3b/Koke"
2022,"Atlético Madrid","La Liga","Geoffrey Kondogbia","CTA","MF,DF","28",1993,20.9,74,44,25,40,9,21,49,42.9,28,16,5,11,44,118,24,0,"https://fbref.com/en/players/cce181df/Geoffrey-Kondogbia"
2022,"Atlético Madrid","La Liga","Thomas Lemar","FRA","MF","25",1995,16,24,14,9,12,3,8,23,34.8,15,18,0,18,8,32,11,0,"https://fbref.com/en/players/4dbd0916/Thomas-Lemar"
2022,"Atlético Madrid","La Liga","Marcos Llorente","ESP","MF,DF","26",1995,27.2,51,23,25,22,4,28,43,65.1,15,33,10,23,27,78,44,0,"https://fbref.com/en/players/02c15616/Marcos-Llorente"
2022,"Atlético Madrid","La Liga","Renan Lodi","BRA","DF","23",1998,13.1,31,18,14,13,4,11,27,40.7,16,22,4,18,13,44,19,1,"https://fbref.com/en/players/ed9f7cfe/Renan-Lodi"
2022,"Atlético Madrid","La Liga","Reinildo Mandava","MOZ","DF","27",1994,14.4,45,25,30,14,1,22,30,73.3,8,18,9,9,21,66,38,0,"https://fbref.com/en/players/c20bdcd7/Reinildo-Mandava"
2022,"Atlético Madrid","La Liga","José María Giménez","URU","DF","26",1995,22.7,18,12,12,6,0,8,16,50,8,25,19,6,25,43,96,1,"https://fbref.com/en/players/f0da930c/Jose-Maria-Gimenez"
2022,"Atlético Madrid","La Liga","Carlos Martín","ESP","DF","19",2002,0.1,0,0,0,0,0,0,0,NA,0,0,0,0,0,0,1,0,"https://fbref.com/en/players/64035864/Carlos-Martin"
2022,"Atlético Madrid","La Liga","Saúl Ñíguez","ESP","FW,MF","26",1994,2.2,7,2,0,6,1,3,4,75,1,7,1,6,0,7,3,0,"https://fbref.com/en/players/c14bc029/Saul-Niguez"
2022,"Atlético Madrid","La Liga","Jan Oblak","SVN","GK","28",1993,38,0,0,0,0,0,0,0,NA,0,0,0,0,1,1,10,4,"https://fbref.com/en/players/ee8508c0/Jan-Oblak"
2022,"Atlético Madrid","La Liga","Stefan Savić","MNE","DF","30",1991,27.1,46,20,25,20,1,29,43,67.4,14,19,12,7,37,83,102,1,"https://fbref.com/en/players/f6ac68c1/Stefan-Savic"
2022,"Atlético Madrid","La Liga","Javier Serrano","ESP","MF","18",2003,0.8,3,1,0,3,0,2,4,50,2,0,0,0,3,6,2,0,"https://fbref.com/en/players/0a8fd9cb/Javier-Serrano"
2022,"Atlético Madrid","La Liga","Giuliano Simeone","ARG","MF","18",2002,0,0,0,0,0,0,0,0,NA,0,0,0,0,0,0,0,0,"https://fbref.com/en/players/a6536561/Giuliano-Simeone"
2022,"Atlético Madrid","La Liga","Luis Suárez","URU","FW","34",1987,20.4,8,5,2,4,2,2,10,20,8,8,1,7,1,9,14,0,"https://fbref.com/en/players/a6154613/Luis-Suarez"
2022,"Atlético Madrid","La Liga","Kieran Trippier","ENG","DF,FW","30",1990,10.8,22,12,12,5,5,12,21,57.1,9,12,1,11,10,32,11,0,"https://fbref.com/en/players/21512407/Kieran-Trippier"
2022,"Atlético Madrid","La Liga","Šime Vrsaljko","CRO","DF","29",1992,10.2,27,17,14,12,1,12,20,60,8,10,1,9,12,39,30,0,"https://fbref.com/en/players/46a8347f/Sime-Vrsaljko"
2022,"Atlético Madrid","La Liga","Daniel Wass","DEN","DF,FW","32",1989,0.5,0,0,0,0,0,0,0,NA,0,0,0,0,0,0,3,0,"https://fbref.com/en/players/d83bbc54/Daniel-Wass"
2022,"Augsburg","Bundesliga","Noah Joel Sarenren Bazee","NGA","MF,FW","24",1996,2.7,5,2,2,2,1,3,4,75,1,8,2,6,1,6,4,0,"https://fbref.com/en/players/fbbc8e15/Noah-Joel-Sarenren-Bazee"
2022,"Augsburg","Bundesliga","Daniel Caligiuri","ITA","DF,MF","33",1988,22.3,46,30,17,26,3,27,72,37.5,45,36,5,31,18,64,33,0,"https://fbref.com/en/players/d1273f09/Daniel-Caligiuri"
2022,"Augsburg","Bundesliga","Sergio Córdova","VEN","FW,MF","23",1997,3.6,4,3,2,2,0,1,2,50,1,4,0,4,0,4,4,0,"https://fbref.com/en/players/229cd98a/Sergio-Cordova"
2022,"Augsburg","Bundesliga","Niklas Dorsch","GER","MF","23",1998,25.8,76,47,47,23,6,30,60,50,30,34,12,22,35,111,36,3,"https://fbref.com/en/players/7f73bdf4/Niklas-Dorsch"
2022,"Augsburg","Bundesliga","Ohis Felix Uduokhai","GER","DF","23",1997,8.7,9,6,6,3,0,6,11,54.5,5,13,8,5,9,18,33,0,"https://fbref.com/en/players/677da306/Ohis-Felix-Uduokhai"
2022,"Augsburg","Bundesliga","Alfreð Finnbogason","ISL","FW","32",1989,3.2,3,1,0,2,1,2,4,50,2,5,1,4,2,5,8,0,"https://fbref.com/en/players/f9e7c4ac/Alfred-Finnbogason"
2022,"Augsburg","Bundesliga","Raphael Framberger","GER","DF","25",1995,9.4,26,19,12,10,4,13,27,48.1,14,8,2,6,9,35,25,0,"https://fbref.com/en/players/626fab5f/Raphael-Framberger"
2022,"Augsburg","Bundesliga","Rafał Gikiewicz","POL","GK","33",1987,34,2,0,2,0,0,2,7,28.6,5,0,0,0,3,5,11,5,"https://fbref.com/en/players/17376543/Rafal-Gikiewicz"
2022,"Augsburg","Bundesliga","Jeffrey Gouweleeuw","NED","DF","30",1991,28.6,50,27,33,17,0,22,36,61.1,14,35,18,17,49,99,116,0,"https://fbref.com/en/players/1025db8e/Jeffrey-Gouweleeuw"
2022,"Augsburg","Bundesliga","Michael Gregoritsch","AUT","FW,MF","27",1994,15.5,19,8,4,10,5,2,15,13.3,13,18,2,16,6,25,29,0,"https://fbref.com/en/players/8e235926/Michael-Gregoritsch"
2022,"Augsburg","Bundesliga","Carlos Gruezo","ECU","MF","26",1995,10.8,22,11,10,10,2,8,21,38.1,13,11,2,9,9,31,15,0,"https://fbref.com/en/players/f2dd9a21/Carlos-Gruezo"
2022,"Augsburg","Bundesliga","Robert Gumny","POL","DF","23",1998,25.2,48,29,25,20,3,25,43,58.1,18,24,7,17,28,76,57,3,"https://fbref.com/en/players/1df0c0b9/Robert-Gumny"
2022,"Augsburg","Bundesliga","Lasse Günther","GER","DF","18",2003,1.8,8,5,4,3,1,5,9,55.6,4,0,0,0,2,10,2,0,"https://fbref.com/en/players/00672803/Lasse-Gunther"
2022,"Augsburg","Bundesliga","André Hahn","GER","MF,FW","30",1990,23.3,36,20,9,15,12,17,50,34,33,38,5,33,15,51,43,0,"https://fbref.com/en/players/cd82452e/Andre-Hahn"
2022,"Augsburg","Bundesliga","Iago","BRA","DF","24",1997,24.2,49,29,25,19,5,15,34,44.1,19,28,6,22,27,76,62,0,"https://fbref.com/en/players/054849d2/Iago"
2022,"Augsburg","Bundesliga","Fredrik Jensen","FIN","MF,FW","23",1997,4.6,5,4,1,3,1,4,7,57.1,3,5,1,4,2,7,4,0,"https://fbref.com/en/players/3eeb80e0/Fredrik-Jensen"
2022,"Augsburg","Bundesliga","Arne Maier","GER","MF","22",1999,20.7,20,13,6,10,4,8,26,30.8,18,18,1,17,15,35,13,0,"https://fbref.com/en/players/ab700320/Arne-Maier"
2022,"Augsburg","Bundesliga","Jan Morávek","CZE","MF","31",1989,5.2,11,6,3,7,1,6,18,33.3,12,11,2,9,6,17,8,0,"https://fbref.com/en/players/e7d22eae/Jan-Moravek"
2022,"Augsburg","Bundesliga","Florian Niederlechner","GER","FW","30",1990,12.9,6,5,1,3,2,4,13,30.8,9,9,0,9,4,10,7,0,"https://fbref.com/en/players/d6862409/Florian-Niederlechner"
2022,"Augsburg","Bundesliga","Reece Oxford","ENG","DF","22",1998,29.9,27,14,16,9,2,15,31,48.4,16,42,33,9,72,99,172,1,"https://fbref.com/en/players/8b6e0db2/Reece-Oxford"
2022,"Augsburg","Bundesliga","Mads Pedersen","DEN","MF,DF","24",1996,15.5,28,21,8,15,5,12,27,44.4,15,13,4,9,15,43,30,0,"https://fbref.com/en/players/582a5247/Mads-Pedersen"
2022,"Augsburg","Bundesliga","Ricardo Pepi","USA","FW,MF","18",2003,5.3,4,2,1,3,0,1,8,12.5,7,7,0,7,3,7,8,0,"https://fbref.com/en/players/a2b1ed42/Ricardo-Pepi"
2022,"Augsburg","Bundesliga","Tobias Strobl","GER","MF,DF","31",1990,3.6,8,3,3,5,0,3,11,27.3,8,7,2,5,7,15,3,0,"https://fbref.com/en/players/17780d2b/Tobias-Strobl"
2022,"Augsburg","Bundesliga","Ruben Vargas","SUI","MF,FW","22",1998,22,28,21,7,14,7,11,30,36.7,19,9,1,8,16,44,13,0,"https://fbref.com/en/players/6ecbddf6/Ruben-Vargas"
2022,"Augsburg","Bundesliga","Frederik Winther","DEN","DF","20",2001,3.6,7,2,7,0,0,5,6,83.3,1,4,1,3,8,15,21,0,"https://fbref.com/en/players/a1257b5e/Frederik-Winther"
2022,"Augsburg","Bundesliga","Andi Zeqiri","SUI","FW,MF","22",1999,11.3,14,7,3,5,6,3,12,25,9,10,1,9,2,16,12,0,"https://fbref.com/en/players/d01231f0/Andi-Zeqiri"
2022,"Barcelona","La Liga","Sergio Agüero","ARG","FW","33",1988,1.7,1,1,0,0,1,0,2,0,2,0,0,0,0,1,0,0,"https://fbref.com/en/players/4d034881/Sergio-Aguero"
2022,"Barcelona","La Liga","Ilias Akhomach","ESP","FW","17",2004,1.4,2,0,0,1,1,0,0,NA,0,0,0,0,0,2,0,0,"https://fbref.com/en/players/b8bd60fe/Ilias-Akhomach"
2022,"Barcelona","La Liga","Jordi Alba","ESP","DF","32",1989,29.4,47,34,12,26,9,27,47,57.4,20,26,6,20,33,80,41,1,"https://fbref.com/en/players/4601e194/Jordi-Alba"
2022,"Barcelona","La Liga","Dani Alves","BRA","DF","38",1983,12.2,30,19,13,13,4,14,26,53.8,12,10,3,7,11,41,10,2,"https://fbref.com/en/players/c9e99e49/Dani-Alves"
2022,"Barcelona","La Liga","Ronald Araújo","URU","DF","22",1999,25.2,41,23,29,12,0,21,25,84,4,37,20,17,23,64,66,1,"https://fbref.com/en/players/2bef2bca/Ronald-Araujo"
2022,"Barcelona","La Liga","Pierre-Emerick Aubameyang","GAB","FW","32",1989,12,2,2,0,1,1,0,5,0,5,9,1,8,2,4,4,0,"https://fbref.com/en/players/d5dd5f1f/Pierre-Emerick-Aubameyang"
2022,"Barcelona","La Liga","Alejandro Balde","ESP","DF,FW","17",2003,2.1,2,1,1,0,1,0,0,NA,0,2,2,0,1,3,1,0,"https://fbref.com/en/players/5ccc9672/Alejandro-Balde"
2022,"Barcelona","La Liga","Martin Braithwaite","DEN","FW","30",1991,2.6,1,1,0,0,1,0,0,NA,0,2,0,2,1,2,1,0,"https://fbref.com/en/players/fd771f95/Martin-Braithwaite"
2022,"Barcelona","La Liga","Sergio Busquets","ESP","MF","33",1988,35.5,93,49,31,48,14,46,83,55.4,37,44,8,36,45,138,31,0,"https://fbref.com/en/players/5ab0ea87/Sergio-Busquets"
2022,"Barcelona","La Liga","Philippe Coutinho","BRA","MF,FW","29",1992,5.6,6,3,3,3,0,3,11,27.3,8,3,0,3,4,10,3,0,"https://fbref.com/en/players/0ef89a37/Philippe-Coutinho"
2022,"Barcelona","La Liga","Ousmane Dembélé","FRA","FW","24",1997,15.7,24,16,6,10,8,7,23,30.4,16,8,0,8,8,32,3,0,"https://fbref.com/en/players/b19db005/Ousmane-Dembele"
2022,"Barcelona","La Liga","Yusuf Demir","AUT","FW","18",2003,2.1,3,1,1,1,1,2,5,40,3,1,0,1,2,5,1,0,"https://fbref.com/en/players/fa265f6d/Yusuf-Demir"
2022,"Barcelona","La Liga","Sergiño Dest","USA","DF,FW","20",2000,16.8,32,15,21,10,1,13,18,72.2,5,22,4,18,2,34,18,0,"https://fbref.com/en/players/5976f83e/Sergino-Dest"
2022,"Barcelona","La Liga","Emerson","BRA","DF","22",1999,1,3,3,2,1,0,1,2,50,1,1,0,1,2,5,1,0,"https://fbref.com/en/players/df8b52a5/Emerson"
2022,"Barcelona","La Liga","Estanis","ESP","FW","17",2003,0.1,1,1,0,1,0,1,1,100,0,0,0,0,0,1,0,0,"https://fbref.com/en/players/ace50e9f/Estanis"
2022,"Barcelona","La Liga","Abdessamad Ezzalzouli","MAR","FW","19",2001,6.4,17,9,9,5,3,5,8,62.5,3,3,0,3,9,26,0,0,"https://fbref.com/en/players/bed68338/Abdessamad-Ezzalzouli"
2022,"Barcelona","La Liga","Ansu Fati","ESP","FW","18",2002,3.7,3,2,0,2,1,1,1,100,0,4,0,4,1,4,0,0,"https://fbref.com/en/players/0ba976e4/Ansu-Fati"
2022,"Barcelona","La Liga","Eric García","ESP","DF","20",2001,22.7,27,18,13,13,1,11,26,42.3,15,22,12,10,44,71,53,3,"https://fbref.com/en/players/2bed3eab/Eric-Garcia"
2022,"Barcelona","La Liga","Gavi","ESP","MF,FW","16",2004,25.7,38,18,13,18,7,9,33,27.3,24,36,0,36,25,63,13,0,"https://fbref.com/en/players/19cae58d/Gavi"
2022,"Barcelona","La Liga","Nicolás González","ESP","MF","19",2002,12.4,31,20,5,23,3,11,27,40.7,16,12,0,12,6,37,12,0,"https://fbref.com/en/players/2c56a792/Nicolas-Gonzalez"
2022,"Barcelona","La Liga","Antoine Griezmann","FRA","FW","30",1991,2.9,13,5,3,10,0,2,6,33.3,4,4,0,4,3,16,5,0,"https://fbref.com/en/players/df69b544/Antoine-Griezmann"
2022,"Barcelona","La Liga","Frenkie de Jong","NED","MF","24",1997,27.5,35,19,12,18,5,12,23,52.2,11,19,5,14,20,55,16,0,"https://fbref.com/en/players/1bacc518/Frenkie-de-Jong"
2022,"Barcelona","La Liga","Luuk de Jong","NED","FW","30",1990,7.3,9,7,1,5,3,1,2,50,1,4,0,4,0,9,12,0,"https://fbref.com/en/players/abb3bb95/Luuk-de-Jong"
2022,"Barcelona","La Liga","Jutglà","ESP","FW","22",1999,3.3,2,1,0,1,1,0,1,0,1,2,0,2,1,3,1,0,"https://fbref.com/en/players/2a9f6b4d/Jutgla"
2022,"Barcelona","La Liga","Clément Lenglet","FRA","DF","26",1995,9.2,20,11,11,7,2,8,13,61.5,5,7,3,4,13,33,21,0,"https://fbref.com/en/players/4f28a6ff/Clement-Lenglet"
2022,"Barcelona","La Liga","Mika Màrmol","ESP","DF","19",2002,0,0,0,0,0,0,0,0,NA,0,0,0,0,0,0,0,0,"https://fbref.com/en/players/e7630876/Mika-Marmol"
2022,"Barcelona","La Liga","Memphis","NED","FW","27",1994,20.6,10,4,2,4,4,3,13,23.1,10,9,1,8,3,13,4,0,"https://fbref.com/en/players/8f696594/Memphis"
2022,"Barcelona","La Liga","Óscar Mingueza","ESP","DF","22",1999,9.9,25,11,12,11,2,16,23,69.6,7,5,0,5,9,34,22,1,"https://fbref.com/en/players/056269d7/Oscar-Mingueza"
2022,"Barcelona","La Liga","Neto","BRA","GK","32",1989,3,0,0,0,0,0,0,0,NA,0,0,0,0,0,0,2,1,"https://fbref.com/en/players/a9dc785c/Neto"
2022,"Barcelona","La Liga","Pedri","ESP","MF","18",2002,9.8,20,12,9,8,3,7,20,35,13,13,0,13,5,25,7,1,"https://fbref.com/en/players/0d9b2d31/Pedri"
2022,"Barcelona","La Liga","Gerard Piqué","ESP","DF","34",1987,23.2,22,12,18,4,0,11,14,78.6,3,19,16,3,34,56,86,1,"https://fbref.com/en/players/adfc9123/Gerard-Pique"
2022,"Barcelona","La Liga","Riqui Puig","ESP","MF","21",1999,5.4,6,3,2,4,0,2,14,14.3,12,5,0,5,3,9,0,0,"https://fbref.com/en/players/f090a37a/Riqui-Puig"
2022,"Barcelona","La Liga","Sergi Roberto","ESP","MF,DF","29",1992,4.4,5,1,2,3,0,3,5,60,2,2,0,2,4,9,6,0,"https://fbref.com/en/players/335fa267/Sergi-Roberto"
2022,"Barcelona","La Liga","Alvaro Sanz","ESP","MF","20",2001,0.3,0,0,0,0,0,0,1,0,1,0,0,0,0,0,0,0,"https://fbref.com/en/players/eaefa2d0/Alvaro-Sanz"
2022,"Barcelona","La Liga","Marc-André ter Stegen","GER","GK","29",1992,35,0,0,0,0,0,0,1,0,1,0,0,0,1,1,13,5,"https://fbref.com/en/players/6f51e382/Marc-Andre-ter-Stegen"
2022,"Barcelona","La Liga","Ferrán Torres","ESP","FW","21",2000,15.7,10,5,3,4,3,3,7,42.9,4,12,3,9,6,16,7,0,"https://fbref.com/en/players/9e1035f8/Ferran-Torres"
2022,"Barcelona","La Liga","Adama Traoré","ESP","FW","25",1996,4.2,4,2,0,3,1,3,5,60,2,2,0,2,4,8,3,1,"https://fbref.com/en/players/9a28eba4/Adama-Traore"
2022,"Barcelona","La Liga","Samuel Umtiti","FRA","DF","27",1993,1,2,2,2,0,0,1,2,50,1,1,1,0,0,2,4,0,"https://fbref.com/en/players/3eed9821/Samuel-Umtiti"
2022,"Bayern Munich","Bundesliga","Kingsley Coman","FRA","FW,DF","25",1996,15.1,14,8,1,9,4,5,16,31.3,11,14,0,14,8,22,5,0,"https://fbref.com/en/players/042e8a49/Kingsley-Coman"
2022,"Bayern Munich","Bundesliga","Lucas Copado","GER","FW","17",2004,0.2,1,0,1,0,0,1,1,100,0,0,0,0,0,1,0,0,"https://fbref.com/en/players/8356931a/Lucas-Copado"
2022,"Bayern Munich","Bundesliga","Mickaël Cuisance","FRA","MF","21",1999,0.1,1,1,0,1,0,0,0,NA,0,0,0,0,0,1,0,0,"https://fbref.com/en/players/5722eced/Mickael-Cuisance"
2022,"Bayern Munich","Bundesliga","Alphonso Davies","CAN","DF","20",2000,19.3,34,17,17,8,9,13,31,41.9,18,27,1,26,23,57,26,1,"https://fbref.com/en/players/d781d855/Alphonso-Davies"
2022,"Bayern Munich","Bundesliga","Christian Früchtl","GER","GK","21",2000,0.1,0,0,0,0,0,0,0,NA,0,0,0,0,0,0,0,0,"https://fbref.com/en/players/1940be91/Christian-Fruchtl"
2022,"Bayern Munich","Bundesliga","Serge Gnabry","GER","FW,DF","26",1995,24.3,47,31,16,20,11,22,57,38.6,35,26,0,26,14,61,3,0,"https://fbref.com/en/players/88e357ef/Serge-Gnabry"
2022,"Bayern Munich","Bundesliga","Leon Goretzka","GER","MF","26",1995,15.5,25,15,12,9,4,11,26,42.3,15,11,1,10,17,42,23,2,"https://fbref.com/en/players/cc86b9a3/Leon-Goretzka"
2022,"Bayern Munich","Bundesliga","Lucas Hernández","FRA","DF","25",1996,22.6,50,31,20,24,6,26,42,61.9,16,22,11,11,28,78,54,1,"https://fbref.com/en/players/c3ee18ef/Lucas-Hernandez"
2022,"Bayern Munich","Bundesliga","Joshua Kimmich","GER","MF","26",1995,27.5,39,20,14,17,8,18,58,31,40,34,8,26,52,91,29,1,"https://fbref.com/en/players/49296448/Joshua-Kimmich"
2022,"Bayern Munich","Bundesliga","Robert Lewandowski","POL","FW","32",1988,32.7,10,3,0,6,4,5,17,29.4,12,17,2,15,6,16,8,0,"https://fbref.com/en/players/8d78e732/Robert-Lewandowski"
2022,"Bayern Munich","Bundesliga","Eric Maxim Choupo-Moting","CMR","FW,MF","32",1989,4.2,10,9,3,6,1,3,10,30,7,1,0,1,5,15,2,0,"https://fbref.com/en/players/0e6bc38c/Eric-Maxim-Choupo-Moting"
2022,"Bayern Munich","Bundesliga","Thomas Müller","GER","MF","31",1989,28.4,35,20,7,16,12,16,54,29.6,38,32,1,31,15,50,12,0,"https://fbref.com/en/players/3c6089ab/Thomas-Muller"
2022,"Bayern Munich","Bundesliga","Jamal Musiala","GER","MF,FW","18",2003,16.3,40,26,11,16,13,15,36,41.7,21,25,0,25,19,59,2,1,"https://fbref.com/en/players/2c0558b8/Jamal-Musiala"
2022,"Bayern Munich","Bundesliga","Manuel Neuer","GER","GK","35",1986,27.9,2,1,2,0,0,1,2,50,1,0,0,0,0,2,7,1,"https://fbref.com/en/players/8778c910/Manuel-Neuer"
2022,"Bayern Munich","Bundesliga","Tanguy Nianzou","FRA","DF","19",2002,6.5,11,7,7,3,1,7,11,63.6,4,7,2,5,7,18,17,0,"https://fbref.com/en/players/5853ac44/Tanguy-Nianzou"
2022,"Bayern Munich","Bundesliga","Benjamin Pavard","FRA","DF","25",1996,23.1,35,20,21,13,1,19,29,65.5,10,28,16,12,36,71,50,1,"https://fbref.com/en/players/45a03961/Benjamin-Pavard"
2022,"Bayern Munich","Bundesliga","Chris Richards","USA","DF","21",2000,0,0,0,0,0,0,0,0,NA,0,1,0,1,0,0,0,0,"https://fbref.com/en/players/0a3d6d2b/Chris-Richards"
2022,"Bayern Munich","Bundesliga","Omar Richards","ENG","DF","23",1998,4.9,19,12,11,5,3,11,16,68.8,5,7,1,6,4,23,7,0,"https://fbref.com/en/players/f9b1b7bf/Omar-Richards"
2022,"Bayern Munich","Bundesliga","Marc Roca","ESP","MF","24",1996,4.2,9,7,2,4,3,2,8,25,6,6,0,6,6,15,4,0,"https://fbref.com/en/players/da27e268/Marc-Roca"
2022,"Bayern Munich","Bundesliga","Marcel Sabitzer","AUT","MF,DF","27",1994,10.1,18,7,8,8,2,9,19,47.4,10,7,0,7,9,27,10,1,"https://fbref.com/en/players/e280527c/Marcel-Sabitzer"
2022,"Bayern Munich","Bundesliga","Leroy Sané","GER","FW,MF","25",1996,22,28,16,5,19,4,9,24,37.5,15,18,0,18,12,40,2,1,"https://fbref.com/en/players/2b114be3/Leroy-Sane"
2022,"Bayern Munich","Bundesliga","Bouna Sarr","SEN","DF","29",1992,0.7,4,4,2,1,1,4,5,80,1,2,1,1,6,10,1,0,"https://fbref.com/en/players/1a4b9094/Bouna-Sarr"
2022,"Bayern Munich","Bundesliga","Josip Stanišić","CRO","DF","21",2000,7.2,21,10,7,12,2,12,18,66.7,6,7,0,7,11,32,10,2,"https://fbref.com/en/players/7ed08d5c/Josip-Stanisic"
2022,"Bayern Munich","Bundesliga","Niklas Süle","GER","DF","25",1995,20.4,29,23,21,7,1,18,24,75,6,16,12,4,28,57,49,0,"https://fbref.com/en/players/e33c06cf/Niklas-Sule"
2022,"Bayern Munich","Bundesliga","Malik Tillman","USA","FW,MF","19",2002,1.2,2,1,0,1,1,0,1,0,1,5,1,4,2,4,1,0,"https://fbref.com/en/players/a5420709/Malik-Tillman"
2022,"Bayern Munich","Bundesliga","Corentin Tolisso","FRA","MF","26",1994,7.8,11,5,1,9,1,7,17,41.2,10,5,1,4,9,20,10,0,"https://fbref.com/en/players/652d4c37/Corentin-Tolisso"
2022,"Bayern Munich","Bundesliga","Sven Ulreich","GER","GK","32",1988,6,0,0,0,0,0,0,0,NA,0,0,0,0,0,0,1,0,"https://fbref.com/en/players/7d3e7da6/Sven-Ulreich"
2022,"Bayern Munich","Bundesliga","Dayot Upamecano","FRA","DF","22",1998,24.6,66,42,42,21,3,24,36,66.7,12,20,10,10,32,98,71,6,"https://fbref.com/en/players/d248cd8f/Dayot-Upamecano"
2022,"Bayern Munich","Bundesliga","Gabriel Vidovic","CRO","FW,MF","17",2003,0.4,0,0,0,0,0,0,0,NA,0,0,0,0,0,0,0,0,"https://fbref.com/en/players/5360a956/Gabriel-Vidovic"
2022,"Bayern Munich","Bundesliga","Paul Wanner","GER","FW,MF","15",2005,0.4,2,2,0,2,0,1,1,100,0,0,0,0,0,2,0,0,"https://fbref.com/en/players/cb64672e/Paul-Wanner"
2022,"Betis","La Liga","Paul Akouokou","CIV","MF","23",1997,5.7,14,9,5,7,2,8,12,66.7,4,6,0,6,11,25,6,0,"https://fbref.com/en/players/31f5b89b/Paul-Akouokou"
2022,"Betis","La Liga","Marc Bartra","ESP","DF","30",1991,22.1,39,14,18,17,4,19,35,54.3,16,39,22,17,33,72,105,1,"https://fbref.com/en/players/b742cc0d/Marc-Bartra"
2022,"Betis","La Liga","Héctor Bellerín","ESP","DF","26",1995,22,52,32,29,20,3,31,44,70.5,13,11,2,9,23,75,57,1,"https://fbref.com/en/players/f874dd44/Hector-Bellerin"
2022,"Betis","La Liga","Claudio Bravo","CHI","GK","38",1983,16.2,0,0,0,0,0,0,0,NA,0,0,0,0,0,0,6,2,"https://fbref.com/en/players/10072610/Claudio-Bravo"
2022,"Betis","La Liga","Calderón","ESP","DF","21",2000,0.7,2,0,1,0,1,1,3,33.3,2,0,0,0,0,2,2,0,"https://fbref.com/en/players/da4e70e5/Calderon"
2022,"Betis","La Liga","Víctor Camarasa","ESP","MF,FW","27",1994,1.2,2,1,1,1,0,0,1,0,1,2,1,1,2,4,2,0,"https://fbref.com/en/players/b2d03887/Victor-Camarasa"
2022,"Betis","La Liga","Sergio Canales","ESP","FW,MF","30",1991,31,24,14,8,12,4,10,35,28.6,25,16,1,15,10,34,12,0,"https://fbref.com/en/players/a6de370d/Sergio-Canales"
2022,"Betis","La Liga","William Carvalho","POR","MF","29",1992,20.1,49,33,20,25,4,15,40,37.5,25,18,7,11,16,65,20,0,"https://fbref.com/en/players/dee86451/William-Carvalho"
2022,"Betis","La Liga","Nabil Fekir","FRA","MF","28",1993,31,43,29,5,25,13,7,36,19.4,29,14,0,14,7,50,7,0,"https://fbref.com/en/players/bece776f/Nabil-Fekir"
2022,"Betis","La Liga","Édgar González","ESP","DF","24",1997,16.3,25,19,15,8,2,17,24,70.8,7,17,11,6,23,48,82,0,"https://fbref.com/en/players/49d028db/Edgar-Gonzalez"
2022,"Betis","La Liga","Roberto González","ESP","FW,MF","20",2001,1.5,5,4,3,2,0,4,6,66.7,2,5,0,5,1,6,1,0,"https://fbref.com/en/players/56545648/Roberto-Gonzalez"
2022,"Betis","La Liga","Andrés Guardado","MEX","MF","34",1986,15.5,30,13,12,17,1,13,34,38.2,21,18,4,14,21,51,29,1,"https://fbref.com/en/players/ef322658/Andres-Guardado"
2022,"Betis","La Liga","Kike Hermoso","ESP","DF","21",1999,1,2,1,2,0,0,2,2,100,0,2,1,1,0,2,5,1,"https://fbref.com/en/players/dea912dc/Kike-Hermoso"
2022,"Betis","La Liga","Borja Iglesias","ESP","FW","28",1993,17.5,6,4,1,2,3,0,8,0,8,11,1,10,4,10,7,0,"https://fbref.com/en/players/75645f0e/Borja-Iglesias"
2022,"Betis","La Liga","Joaquín","ESP","FW,MF","40",1981,5.2,6,2,4,2,0,3,8,37.5,5,5,2,3,3,9,10,0,"https://fbref.com/en/players/4c5b14d2/Joaquin"
2022,"Betis","La Liga","Willian José","BRA","FW","29",1991,17.8,15,13,2,10,3,2,8,25,6,10,2,8,3,18,16,0,"https://fbref.com/en/players/d87e2cae/Willian-Jose"
2022,"Betis","La Liga","Juanmi","ESP","FW","28",1993,23.7,39,25,11,19,9,19,49,38.8,30,24,1,23,9,48,10,1,"https://fbref.com/en/players/84399660/Juanmi"
2022,"Betis","La Liga","Diego Lainez","MEX","FW","21",2000,1.6,1,1,0,1,0,0,3,0,3,3,0,3,1,2,0,0,"https://fbref.com/en/players/bf12926c/Diego-Lainez"
2022,"Betis","La Liga","Juan Miranda","ESP","DF","21",2000,8.7,21,11,16,4,1,12,22,54.5,10,10,4,6,15,36,22,0,"https://fbref.com/en/players/ead61f73/Juan-Miranda"
2022,"Betis","La Liga","Martín Montoya","ESP","DF","30",1991,5.8,20,12,11,7,2,15,26,57.7,11,6,0,6,11,31,20,0,"https://fbref.com/en/players/5cec2487/Martin-Montoya"
2022,"Betis","La Liga","Álex Moreno","ESP","DF","28",1993,26.7,76,40,53,15,8,33,60,55,27,28,6,22,34,110,82,1,"https://fbref.com/en/players/16e9d0ea/Alex-Moreno"
2022,"Betis","La Liga","Loren Morón","ESP","FW","27",1993,0,1,1,1,0,0,1,1,100,0,0,0,0,0,1,0,0,"https://fbref.com/en/players/3aa4a3be/Loren-Moron"
2022,"Betis","La Liga","Germán Pezzella","ARG","DF","30",1991,22.1,21,9,16,5,0,16,29,55.2,13,29,18,11,39,60,106,0,"https://fbref.com/en/players/8c725b43/German-Pezzella"
2022,"Betis","La Liga","Raúl","ESP","FW,DF","20",2000,0,0,0,0,0,0,0,0,NA,0,0,0,0,0,0,0,0,"https://fbref.com/en/players/18f0a9f0/Raul"
2022,"Betis","La Liga","Rodrigo","ESP","FW","21",2000,9.8,10,7,4,5,1,5,22,22.7,17,11,0,11,3,13,4,0,"https://fbref.com/en/players/85bed4ee/Rodrigo"
2022,"Betis","La Liga","Guido Rodríguez","ARG","MF","27",1994,28.1,97,53,46,45,6,54,98,55.1,44,55,12,43,31,128,56,0,"https://fbref.com/en/players/34e393f2/Guido-Rodriguez"
2022,"Betis","La Liga","Aitor Ruibal","ESP","FW,DF","25",1996,9.5,21,15,13,3,5,10,34,29.4,24,8,0,8,8,29,6,0,"https://fbref.com/en/players/a55d8df5/Aitor-Ruibal"
2022,"Betis","La Liga","Víctor Ruiz","ESP","DF","32",1989,15.8,11,9,7,2,2,6,9,66.7,3,18,13,5,29,40,71,1,"https://fbref.com/en/players/b3dc6eca/Victor-Ruiz"
2022,"Betis","La Liga","Youssouf Sabaly","SEN","DF","28",1993,8.8,12,10,11,0,1,7,13,53.8,6,11,4,7,13,25,16,1,"https://fbref.com/en/players/fbbb9269/Youssouf-Sabaly"
2022,"Betis","La Liga","Rui Silva","POR","GK","27",1994,21.8,1,0,1,0,0,1,2,50,1,0,0,0,1,2,11,1,"https://fbref.com/en/players/ea83bfa6/Rui-Silva"
2022,"Betis","La Liga","Cristian Tello","ESP","FW","29",1991,9.1,17,11,6,7,4,13,31,41.9,18,9,0,9,10,27,6,0,"https://fbref.com/en/players/72a99e38/Cristian-Tello"
2022,"Bochum","Bundesliga","Christopher Antwi-Adjei","GHA","FW,MF","27",1994,12.6,21,18,7,8,6,6,26,23.1,20,12,0,12,1,22,8,0,"https://fbref.com/en/players/0a3f6cde/Christopher-Antwi-Adjei"
2022,"Bochum","Bundesliga","Takuma Asano","JPN","FW,MF","26",1994,17.9,11,6,3,6,2,5,19,26.3,14,14,1,13,7,18,7,0,"https://fbref.com/en/players/13ddc856/Takuma-Asano"
2022,"Bochum","Bundesliga","Armel Bella Kotchap","GER","DF","19",2001,19.6,34,20,25,9,0,18,28,64.3,10,21,16,5,42,76,84,2,"https://fbref.com/en/players/a39d11bc/Armel-Bella-Kotchap"
2022,"Bochum","Bundesliga","Danny Blum","GER","FW","30",1991,3.8,2,1,0,0,2,0,2,0,2,4,0,4,2,4,1,0,"https://fbref.com/en/players/eb61713c/Danny-Blum"
2022,"Bochum","Bundesliga","Herbert Bockhorn","GER","DF","26",1995,9.4,20,14,13,4,3,12,20,60,8,10,1,9,14,34,18,0,"https://fbref.com/en/players/5ad8c360/Herbert-Bockhorn"
2022,"Bochum","Bundesliga","Tarsis Bonga","GER","MF,FW","24",1997,0.2,0,0,0,0,0,0,0,NA,0,0,0,0,0,0,0,0,"https://fbref.com/en/players/6ebbc28a/Tarsis-Bonga"
2022,"Bochum","Bundesliga","Saulo Decarli","SUI","DF","29",1992,0.1,0,0,0,0,0,0,0,NA,0,0,0,0,0,0,0,0,"https://fbref.com/en/players/41df88b8/Saulo-Decarli"
2022,"Bochum","Bundesliga","Michael Esser","GER","GK","33",1987,3,0,0,0,0,0,0,1,0,1,0,0,0,0,0,2,0,"https://fbref.com/en/players/83e0eeb4/Michael-Esser"
2022,"Bochum","Bundesliga","Cristian Gamboa","CRC","DF","31",1989,19.1,59,36,40,16,3,30,61,49.2,31,22,7,15,32,91,35,1,"https://fbref.com/en/players/f27680d9/Cristian-Gamboa"
2022,"Bochum","Bundesliga","Silvère Ganvoula M'Boussy","CGO","FW","25",1996,1.7,0,0,0,0,0,0,1,0,1,0,0,0,0,0,1,0,"https://fbref.com/en/players/6c731625/Silvere-Ganvoula-MBoussy"
2022,"Bochum","Bundesliga","Luis Hartwig","GER","FW","18",2002,0,0,0,0,0,0,0,0,NA,0,0,0,0,0,0,0,0,"https://fbref.com/en/players/a3f30508/Luis-Hartwig"
2022,"Bochum","Bundesliga","Gerrit Holtmann","PHI","FW,MF","26",1995,20.4,15,9,5,3,7,6,22,27.3,16,26,2,24,8,23,6,0,"https://fbref.com/en/players/2979c05a/Gerrit-Holtmann"
2022,"Bochum","Bundesliga","Vassilis Lambropoulos","GRE","DF","31",1990,13,18,12,13,3,2,11,25,44,14,21,10,11,17,35,56,0,"https://fbref.com/en/players/591477c9/Vassilis-Lambropoulos"
2022,"Bochum","Bundesliga","Maxim Leitsch","GER","DF","23",1998,17.1,18,10,9,7,2,10,15,66.7,5,31,19,12,31,49,74,1,"https://fbref.com/en/players/7e12a98d/Maxim-Leitsch"
2022,"Bochum","Bundesliga","Jürgen Locadia","NED","FW,MF","27",1993,4.9,4,2,1,0,3,1,1,100,0,1,0,1,1,5,2,0,"https://fbref.com/en/players/6cc47ae1/Jurgen-Locadia"
2022,"Bochum","Bundesliga","Anthony Losilla","FRA","MF","35",1986,32.6,65,39,29,30,6,34,69,49.3,35,32,9,23,70,135,53,1,"https://fbref.com/en/players/07c7eb0c/Anthony-Losilla"
2022,"Bochum","Bundesliga","Eduard Löwen","GER","MF","24",1997,15.7,28,22,12,11,5,10,43,23.3,33,17,2,15,9,37,15,1,"https://fbref.com/en/players/70678132/Eduard-Lowen"
2022,"Bochum","Bundesliga","Erhan Mašović","SRB","DF","22",1998,17.2,35,20,21,13,1,21,33,63.6,12,28,19,9,34,69,64,1,"https://fbref.com/en/players/a396fb61/Erhan-Masovic"
2022,"Bochum","Bundesliga","Soma Novothny","HUN","FW,MF","27",1994,0.9,1,1,1,0,0,0,1,0,1,1,0,1,0,1,2,0,"https://fbref.com/en/players/6fb91ea9/Soma-Novothny"
2022,"Bochum","Bundesliga","Patrick Osterhage","GER","MF","21",2000,6.7,9,6,3,5,1,3,7,42.9,4,7,1,6,11,20,8,0,"https://fbref.com/en/players/9662c9ec/Patrick-Osterhage"
2022,"Bochum","Bundesliga","Miloš Pantović","SRB","MF,FW","25",1996,17,19,10,8,7,4,6,25,24,19,26,4,22,18,37,14,0,"https://fbref.com/en/players/5dc15574/Milos-Pantovic"
2022,"Bochum","Bundesliga","Sebastian Polter","GER","FW","30",1991,26,9,3,1,4,4,2,11,18.2,9,15,5,10,2,11,24,0,"https://fbref.com/en/players/3745e8bd/Sebastian-Polter"
2022,"Bochum","Bundesliga","Elvis Rexhbeçaj","GER","MF","23",1997,28.2,41,20,17,19,5,19,40,47.5,21,41,6,35,27,68,15,0,"https://fbref.com/en/players/1ae836b1/Elvis-Rexhbecaj"
2022,"Bochum","Bundesliga","Manuel Riemann","GER","GK","32",1988,31,1,0,1,0,0,1,4,25,3,0,0,0,1,2,12,3,"https://fbref.com/en/players/9f941969/Manuel-Riemann"
2022,"Bochum","Bundesliga","Danilo Soares","BRA","DF","29",1991,28.5,109,71,61,39,9,56,84,66.7,28,63,9,54,62,171,65,2,"https://fbref.com/en/players/c05f2f8c/Danilo-Soares"
2022,"Bochum","Bundesliga","Kostas Stafylidis","GRE","DF,MF","27",1993,15.4,37,27,22,13,2,20,26,76.9,6,19,6,13,31,68,43,0,"https://fbref.com/en/players/861e0116/Kostas-Stafylidis"
2022,"Bochum","Bundesliga","Robert Tesche","GER","MF","34",1987,3.9,6,4,4,1,1,5,7,71.4,2,6,2,4,5,11,5,1,"https://fbref.com/en/players/037130ca/Robert-Tesche"
2022,"Bochum","Bundesliga","Simon Zoller","GER","FW","30",1991,6.6,4,2,2,1,1,1,3,33.3,2,3,0,3,4,8,2,0,"https://fbref.com/en/players/29f7cfd9/Simon-Zoller"
2022,"Bologna","Serie A","Michel Aebischer","SUI","MF","24",1997,4.9,14,5,5,8,1,6,11,54.5,5,4,1,3,6,20,3,0,"https://fbref.com/en/players/f9c927de/Michel-Aebischer"
2022,"Bologna","Serie A","Wisdom Amey","ITA","DF","15",2005,0.8,3,2,1,1,1,2,3,66.7,1,2,0,2,3,6,1,0,"https://fbref.com/en/players/35b4bc62/Wisdom-Amey"
2022,"Bologna","Serie A","Ebenezer Annan","GHA","DF","18",2002,0.3,1,1,1,0,0,0,0,NA,0,0,0,0,1,2,1,0,"https://fbref.com/en/players/39aa05a7/Ebenezer-Annan"
2022,"Bologna","Serie A","Marko Arnautović","AUT","FW","32",1989,29.9,17,9,1,11,5,7,30,23.3,23,13,2,11,7,24,17,0,"https://fbref.com/en/players/00459419/Marko-Arnautovic"
2022,"Bologna","Serie A","Nicola Bagnolini","ITA","GK","17",2004,0,0,0,0,0,0,0,0,NA,0,0,0,0,0,0,0,0,"https://fbref.com/en/players/ad263695/Nicola-Bagnolini"
2022,"Bologna","Serie A","Francesco Bardi","ITA","GK","29",1992,2,0,0,0,0,0,0,0,NA,0,0,0,0,0,0,0,0,"https://fbref.com/en/players/0acda699/Francesco-Bardi"
2022,"Bologna","Serie A","Musa Barrow","GAM","FW,MF","22",1998,23.7,12,4,4,4,4,6,20,30,14,20,1,19,6,18,8,0,"https://fbref.com/en/players/e5bf73f3/Musa-Barrow"
2022,"Bologna","Serie A","Luis Binks","ENG","DF","19",2001,7.2,8,4,7,1,0,4,6,66.7,2,6,5,1,17,25,33,1,"https://fbref.com/en/players/36e88fbc/Luis-Binks"
2022,"Bologna","Serie A","Kevin Bonifazi","ITA","DF","25",1996,13.4,25,16,16,7,2,13,14,92.9,1,22,7,15,16,41,35,0,"https://fbref.com/en/players/fb77bfef/Kevin-Bonifazi"
2022,"Bologna","Serie A","Lorenzo De Silvestri","ITA","DF","33",1988,25.5,23,14,13,8,2,9,31,29,22,25,7,18,26,49,52,0,"https://fbref.com/en/players/e74f0e59/Lorenzo-De-Silvestri"
2022,"Bologna","Serie A","Mitchell Dijks","NED","DF,FW","28",1993,7.7,15,6,6,6,3,5,12,41.7,7,11,2,9,3,18,10,1,"https://fbref.com/en/players/0a3065c8/Mitchell-Dijks"
2022,"Bologna","Serie A","Nicolás Domínguez","ARG","MF","23",1998,22.4,76,45,36,32,8,32,76,42.1,44,38,9,29,32,108,34,1,"https://fbref.com/en/players/20b3a502/Nicolas-Dominguez"
2022,"Bologna","Serie A","Diego Falcinelli","ITA","FW","30",1991,0.7,2,2,2,0,0,0,0,NA,0,0,0,0,1,3,1,0,"https://fbref.com/en/players/a39b9ef6/Diego-Falcinelli"
2022,"Bologna","Serie A","Aaron Hickey","SCO","DF","19",2002,31.3,46,29,24,15,7,20,30,66.7,10,36,13,23,29,75,44,0,"https://fbref.com/en/players/1780bb4a/Aaron-Hickey"
2022,"Bologna","Serie A","Sydney van Hooijdonk","NED","FW,MF","21",2000,0.4,0,0,0,0,0,0,1,0,1,1,0,1,0,0,0,0,"https://fbref.com/en/players/5b418e15/Sydney-van-Hooijdonk"
2022,"Bologna","Serie A","Denso Kasius","NED","DF,FW","18",2002,2,9,7,5,3,1,2,5,40,3,4,0,4,3,12,4,0,"https://fbref.com/en/players/7ae36711/Denso-Kasius"
2022,"Bologna","Serie A","Ibrahima Mbaye","SEN","DF","26",1994,1.2,1,1,1,0,0,1,2,50,1,1,1,0,1,2,6,0,"https://fbref.com/en/players/cfbf9881/Ibrahima-Mbaye"
2022,"Bologna","Serie A","Gary Medel","CHI","DF","33",1987,31.4,39,23,27,11,1,16,36,44.4,20,30,21,9,44,83,112,0,"https://fbref.com/en/players/563a68ad/Gary-Medel"
2022,"Bologna","Serie A","Kingsley Michael","NGA","MF","21",1999,0.8,4,1,2,2,0,1,2,50,1,2,1,1,1,5,1,1,"https://fbref.com/en/players/e63e122d/Kingsley-Michael"
2022,"Bologna","Serie A","Riccardo Orsolini","ITA","FW,MF","24",1997,19.8,21,13,9,11,1,13,29,44.8,16,9,4,5,5,26,14,0,"https://fbref.com/en/players/e14ec482/Riccardo-Orsolini"
2022,"Bologna","Serie A","Niklas Pyyhtiä","FIN","MF","17",2003,0.2,0,0,0,0,0,0,1,0,1,0,0,0,0,0,0,0,"https://fbref.com/en/players/88f53b75/Niklas-Pyyhtia"
2022,"Bologna","Serie A","Antonio Raimondo","ITA","FW","17",2004,0.8,0,0,0,0,0,0,1,0,1,1,0,1,0,0,1,0,"https://fbref.com/en/players/ce1a6c7e/Antonio-Raimondo"
2022,"Bologna","Serie A","Nicola Sansone","ITA","FW,MF","29",1991,10,13,7,5,6,2,3,15,20,12,1,0,1,4,17,2,0,"https://fbref.com/en/players/7eb97a8e/Nicola-Sansone"
2022,"Bologna","Serie A","Federico Santander","PAR","FW,DF","30",1991,0.7,2,1,1,1,0,1,1,100,0,0,0,0,0,2,0,0,"https://fbref.com/en/players/df85d472/Federico-Santander"
2022,"Bologna","Serie A","Jerdy Schouten","NED","MF","24",1997,15.5,25,17,10,12,3,9,22,40.9,13,22,5,17,33,58,29,1,"https://fbref.com/en/players/2cfae697/Jerdy-Schouten"
2022,"Bologna","Serie A","Łukasz Skorupski","POL","GK","30",1991,36,0,0,0,0,0,0,1,0,1,0,0,0,0,0,17,0,"https://fbref.com/en/players/ab4449d6/Lukasz-Skorupski"
2022,"Bologna","Serie A","Andreas Skov Olsen","DEN","FW,DF","21",1999,8.3,12,10,4,4,4,5,11,45.5,6,9,1,8,3,15,11,0,"https://fbref.com/en/players/c50cee19/Andreas-Skov-Olsen"
2022,"Bologna","Serie A","Roberto Soriano","ITA","MF","30",1991,29.1,57,30,27,22,8,17,56,30.4,39,37,3,34,22,79,32,0,"https://fbref.com/en/players/9d4c45d6/Roberto-Soriano"
2022,"Bologna","Serie A","Adama Soumaoro","FRA","DF","29",1992,25.2,15,5,5,8,2,4,9,44.4,5,22,16,6,34,49,95,0,"https://fbref.com/en/players/7b075c75/Adama-Soumaoro"
2022,"Bologna","Serie A","Riccardo Stivanello","ITA","DF","17",2004,0.5,1,1,1,0,0,1,1,100,0,2,2,0,0,1,6,0,"https://fbref.com/en/players/90e1d9dc/Riccardo-Stivanello"
2022,"Bologna","Serie A","Mattias Svanberg","SWE","MF","22",1999,28.5,39,15,15,16,8,16,54,29.6,38,31,9,22,28,67,34,0,"https://fbref.com/en/players/92d83c27/Mattias-Svanberg"
2022,"Bologna","Serie A","Arthur Theate","BEL","DF","21",2000,26.9,33,19,26,3,4,14,31,45.2,17,29,16,13,42,75,69,0,"https://fbref.com/en/players/df8d6029/Arthur-Theate"
2022,"Bologna","Serie A","Takehiro Tomiyasu","JPN","DF","22",1998,0.1,0,0,0,0,0,0,0,NA,0,1,0,1,1,1,0,0,"https://fbref.com/en/players/b3af9be1/Takehiro-Tomiyasu"
2022,"Bologna","Serie A","Kacper Urbanski","POL","MF","16",2004,0.5,3,2,1,2,0,2,2,100,0,2,0,2,0,3,0,0,"https://fbref.com/en/players/2d9d9e42/Kacper-Urbanski"
2022,"Bologna","Serie A","Emanuel Vignato","ITA","MF,DF","20",2000,6.6,12,7,5,7,0,6,13,46.2,7,2,0,2,2,14,5,0,"https://fbref.com/en/players/ec5dae45/Emanuel-Vignato"
2022,"Bologna","Serie A","Nicolas Viola","ITA","MF","31",1989,1.1,2,2,1,1,0,1,2,50,1,1,1,0,0,2,1,0,"https://fbref.com/en/players/45392b06/Nicolas-Viola"
2022,"Bordeaux","Ligue 1","Yacine Adli","FRA","MF,FW","21",2000,25.1,43,27,22,14,7,19,68,27.9,49,33,3,30,37,80,11,2,"https://fbref.com/en/players/26777636/Yacine-Adli"
2022,"Bordeaux","Ligue 1","Anel Ahmedhodzic","BIH","DF","22",1999,15,38,26,27,9,2,20,31,64.5,11,16,8,8,22,60,44,0,"https://fbref.com/en/players/eab957a3/Anel-Ahmedhodzic"
2022,"Bordeaux","Ligue 1","Dilane Bakwa","FRA","FW,MF","18",2002,0.5,1,1,0,1,0,1,2,50,1,0,0,0,0,1,1,0,"https://fbref.com/en/players/2b5a35e5/Dilane-Bakwa"
2022,"Bordeaux","Ligue 1","Toma Bašić","CRO","MF","24",1996,2.3,2,2,1,0,1,0,4,0,4,4,1,3,2,4,0,0,"https://fbref.com/en/players/80556f08/Toma-Basic"
2022,"Bordeaux","Ligue 1","Paul Baysse","FRA","MF,DF","33",1988,0.1,1,1,0,1,0,0,0,NA,0,0,0,0,0,1,1,0,"https://fbref.com/en/players/2515040a/Paul-Baysse"
2022,"Bordeaux","Ligue 1","Loris Benito","SUI","DF","29",1992,0.7,0,0,0,0,0,0,0,NA,0,0,0,0,1,1,3,1,"https://fbref.com/en/players/f5b6fb78/Loris-Benito"
2022,"Bordeaux","Ligue 1","Jimmy Briand","FRA","FW,MF","35",1985,2.5,2,0,2,0,0,0,2,0,2,0,0,0,1,3,2,0,"https://fbref.com/en/players/f83c8d6c/Jimmy-Briand"
2022,"Bordeaux","Ligue 1","Benoît Costil","FRA","GK","34",1987,25,1,0,1,0,0,1,2,50,1,0,0,0,0,1,6,3,"https://fbref.com/en/players/2434f24a/Benoit-Costil"
2022,"Bordeaux","Ligue 1","Javairô Dilrosun","NED","MF,FW","23",1998,19.2,13,4,2,8,3,7,24,29.2,17,14,1,13,11,24,5,0,"https://fbref.com/en/players/34a0f5ff/Javairo-Dilrosun"
2022,"Bordeaux","Ligue 1","Alberth Elis","HON","FW,MF","25",1996,15.7,19,10,5,5,9,11,25,44,14,9,0,9,7,26,10,0,"https://fbref.com/en/players/104b4ad3/Alberth-Elis"
2022,"Bordeaux","Ligue 1","Fransérgio","BRA","MF","30",1990,14,24,10,8,12,4,12,43,27.9,31,18,6,12,23,47,23,0,"https://fbref.com/en/players/deba6b05/Fransergio"
2022,"Bordeaux","Ligue 1","Josuha Guilavogui","FRA","MF,DF","30",1990,14.8,39,16,18,17,4,14,29,48.3,15,16,8,8,36,75,23,0,"https://fbref.com/en/players/e6c43eec/Josuha-Guilavogui"
2022,"Bordeaux","Ligue 1","Danylo Ihnatenko","UKR","MF","24",1997,7.7,17,9,8,7,2,10,24,41.7,14,9,2,7,6,23,17,1,"https://fbref.com/en/players/65bbfba3/Danylo-Ihnatenko"
2022,"Bordeaux","Ligue 1","Abdel Jalil Medioub","ALG","DF","23",1997,6.9,9,5,5,3,1,3,4,75,1,8,4,4,12,21,34,0,"https://fbref.com/en/players/4937a9f7/Abdel-Jalil-Medioub"
2022,"Bordeaux","Ligue 1","Samuel Kalu","NGA","FW,MF","23",1997,3.6,8,5,3,4,1,2,5,40,3,2,0,2,3,11,1,0,"https://fbref.com/en/players/b8d22478/Samuel-Kalu"
2022,"Bordeaux","Ligue 1","Thibault Klidje","TOG","MF,FW","20",2001,1,0,0,0,0,0,0,1,0,1,1,1,0,2,2,0,0,"https://fbref.com/en/players/db013c7d/Thibault-Klidje"
2022,"Bordeaux","Ligue 1","Laurent Koscielny","FRA","DF","35",1985,10.4,14,9,10,3,1,8,13,61.5,5,17,12,5,12,26,39,0,"https://fbref.com/en/players/f5efb153/Laurent-Koscielny"
2022,"Bordeaux","Ligue 1","Enock Kwateng","FRA","DF","24",1997,22.2,54,35,31,19,4,33,72,45.8,39,17,4,13,43,97,48,1,"https://fbref.com/en/players/4bf69118/Enock-Kwateng"
2022,"Bordeaux","Ligue 1","Tom Lacoux","FRA","DF,MF","19",2002,10.1,18,13,11,5,2,9,24,37.5,15,14,4,10,9,27,20,1,"https://fbref.com/en/players/295ba708/Tom-Lacoux"
2022,"Bordeaux","Ligue 1","Johaneko Louisjean","FRA","DF","17",2004,0.1,0,0,0,0,0,0,0,NA,0,0,0,0,0,0,0,0,"https://fbref.com/en/players/9af3613f/Johaneko-Louisjean"
2022,"Bordeaux","Ligue 1","Josh Maja","NGA","FW","22",1998,0.1,0,0,0,0,0,0,0,NA,0,1,0,1,0,0,0,0,"https://fbref.com/en/players/bc0bfc64/Josh-Maja"
2022,"Bordeaux","Ligue 1","Ricardo Mangas","POR","DF","23",1998,26.1,35,22,22,8,5,26,41,63.4,15,18,4,14,25,60,47,3,"https://fbref.com/en/players/eef2d8ce/Ricardo-Mangas"
2022,"Bordeaux","Ligue 1","Sekou Mara","FRA","FW,MF","19",2002,10.1,8,4,1,1,6,1,8,12.5,7,7,0,7,2,10,6,0,"https://fbref.com/en/players/3544641e/Sekou-Mara"
2022,"Bordeaux","Ligue 1","Marcelo","BRA","DF","34",1987,10,9,5,7,2,0,4,6,66.7,2,4,3,1,13,22,46,1,"https://fbref.com/en/players/e3d0b0c4/Marcelo"
2022,"Bordeaux","Ligue 1","Gideon Mensah","GHA","DF","23",1998,13.4,37,24,19,12,6,18,38,47.4,20,11,2,9,16,53,21,0,"https://fbref.com/en/players/9bdd8118/Gideon-Mensah"
2022,"Bordeaux","Ligue 1","Mexer","MOZ","DF","32",1988,13.6,14,10,11,3,0,11,17,64.7,6,12,7,5,21,35,60,2,"https://fbref.com/en/players/ce492295/Mexer"
2022,"Bordeaux","Ligue 1","Junior Mwanga","FRA","DF","18",2003,1,5,2,4,1,0,3,3,100,0,1,0,1,0,5,1,0,"https://fbref.com/en/players/ee158be5/Junior-Mwanga"
2022,"Bordeaux","Ligue 1","M'Baye Niang","SEN","FW","26",1994,8.6,4,0,0,2,2,0,4,0,4,9,1,8,1,5,4,0,"https://fbref.com/en/players/2054d037/MBaye-Niang"
2022,"Bordeaux","Ligue 1","Jean Onana","CMR","MF","21",2000,20.4,70,49,33,33,4,35,86,40.7,51,37,5,32,36,106,23,1,"https://fbref.com/en/players/b5bb8188/Jean-Onana"
2022,"Bordeaux","Ligue 1","Otávio","BRA","MF","27",1994,12.7,36,23,13,21,2,16,39,41,23,9,3,6,18,54,11,0,"https://fbref.com/en/players/243f4a0b/Otavio"
2022,"Bordeaux","Ligue 1","Remi Oudin","FRA","MF,FW","24",1996,19.3,34,18,19,13,2,18,32,56.3,14,14,3,11,27,61,21,0,"https://fbref.com/en/players/ea02beaf/Remi-Oudin"
2022,"Bordeaux","Ligue 1","Rubén Pardo","ESP","MF","28",1992,0.1,0,0,0,0,0,0,0,NA,0,0,0,0,0,0,0,0,"https://fbref.com/en/players/2306bfde/Ruben-Pardo"
2022,"Bordeaux","Ligue 1","Timothee Pembele","FRA","DF","18",2002,15.7,20,8,8,10,2,10,29,34.5,19,12,3,9,16,36,24,0,"https://fbref.com/en/players/f8ce97ca/Timothee-Pembele"
2022,"Bordeaux","Ligue 1","Gaëtan Poussin","FRA","GK","22",1999,13,1,1,1,0,0,1,1,100,0,0,0,0,0,1,15,1,"https://fbref.com/en/players/c252c705/Gaetan-Poussin"
2022,"Bordeaux","Ligue 1","Stian Rode Gregersen","NOR","DF","26",1995,21.7,39,26,23,12,4,18,33,54.5,15,26,16,10,38,77,103,2,"https://fbref.com/en/players/5f011e05/Stian-Rode-Gregersen"
2022,"Bordeaux","Ligue 1","Issouf Sissokho","MLI","MF","19",2002,4.8,17,8,2,13,2,8,17,47.1,9,8,1,7,7,24,0,0,"https://fbref.com/en/players/792a9d41/Issouf-Sissokho"
2022,"Bordeaux","Ligue 1","Amadou Traore","FRA","FW","19",2002,0.2,0,0,0,0,0,0,0,NA,0,0,0,0,0,0,0,0,"https://fbref.com/en/players/4eb0686f/Amadou-Traore"
2022,"Bordeaux","Ligue 1","Hwang Ui-jo","KOR","FW","28",1992,27.9,10,4,4,4,2,4,13,30.8,9,9,1,8,5,15,18,0,"https://fbref.com/en/players/a2d873dd/Hwang-Ui-jo"
2022,"Bordeaux","Ligue 1","Mehdi Zerkane","ALG","MF,DF","22",1999,0.9,0,0,0,0,0,0,1,0,1,1,1,0,2,2,0,0,"https://fbref.com/en/players/53f6306f/Mehdi-Zerkane"
2022,"Brentford","Premier League","Kristoffer Ajer","NOR","DF","23",1998,22.2,29,18,21,6,2,13,21,61.9,8,19,11,8,26,55,74,0,"https://fbref.com/en/players/a8c0acb7/Kristoffer-Ajer"
2022,"Brentford","Premier League","Shandon Baptiste","GRN","MF","23",1998,10.1,14,4,9,4,1,6,15,40,9,10,0,10,11,25,12,0,"https://fbref.com/en/players/2886c9b5/Shandon-Baptiste"
2022,"Brentford","Premier League","Mads Bech Sørensen","DEN","DF","22",1999,9.3,8,7,6,2,0,6,7,85.7,1,9,6,3,6,14,25,0,"https://fbref.com/en/players/30db8574/Mads-Bech-Sorensen"
2022,"Brentford","Premier League","Mads Bidstrup","DEN","MF","20",2001,0.5,1,0,0,1,0,0,3,0,3,0,0,0,1,2,2,0,"https://fbref.com/en/players/407db0d5/Mads-Bidstrup"
2022,"Brentford","Premier League","Sergi Canós","ESP","DF,FW","24",1997,23.1,56,25,32,15,9,33,60,55,27,32,3,29,22,78,38,0,"https://fbref.com/en/players/1137759d/Sergi-Canos"
2022,"Brentford","Premier League","Josh Dasilva","ENG","MF,FW","22",1998,2.9,2,1,0,1,1,1,2,50,1,3,0,3,1,3,7,0,"https://fbref.com/en/players/60344e4f/Josh-Dasilva"
2022,"Brentford","Premier League","Christian Eriksen","DEN","MF","29",1992,10.4,13,6,4,5,4,8,17,47.1,9,9,1,8,9,22,14,0,"https://fbref.com/en/players/980522ec/Christian-Eriksen"
2022,"Brentford","Premier League","Álvaro Fernández","ESP","GK","23",1998,12,0,0,0,0,0,0,0,NA,0,0,0,0,0,0,5,2,"https://fbref.com/en/players/f127d782/Alvaro-Fernandez"
2022,"Brentford","Premier League","Marcus Forss","FIN","FW,MF","22",1999,2.3,3,3,0,2,1,2,4,50,2,5,0,5,1,4,0,0,"https://fbref.com/en/players/82c215a0/Marcus-Forss"
2022,"Brentford","Premier League","Tariqe Fosu","GHA","DF","25",1995,0.2,0,0,0,0,0,0,0,NA,0,1,0,1,0,0,0,0,"https://fbref.com/en/players/3dcef539/Tariqe-Fosu"
2022,"Brentford","Premier League","Saman Ghoddos","IRN","MF,DF","27",1993,6,17,10,8,6,3,9,15,60,6,2,0,2,3,20,16,0,"https://fbref.com/en/players/f7b1d4e0/Saman-Ghoddos"
2022,"Brentford","Premier League","Charlie Goode","ENG","DF","25",1995,5,7,5,5,2,0,4,4,100,0,4,2,2,2,9,8,0,"https://fbref.com/en/players/7aee4dd3/Charlie-Goode"
2022,"Brentford","Premier League","Rico Henry","ENG","DF","24",1997,30.8,28,20,18,8,2,12,34,35.3,22,31,10,21,26,54,76,1,"https://fbref.com/en/players/8a3c1dc7/Rico-Henry"
2022,"Brentford","Premier League","Vitaly Janelt","GER","MF","23",1998,25.5,61,32,26,27,8,27,53,50.9,26,23,7,16,28,89,35,0,"https://fbref.com/en/players/8449d35e/Vitaly-Janelt"
2022,"Brentford","Premier League","Pontus Jansson","SWE","DF","30",1991,36.9,40,21,32,8,0,22,34,64.7,12,37,27,10,52,92,187,0,"https://fbref.com/en/players/172e52d8/Pontus-Jansson"
2022,"Brentford","Premier League","Mathias Jensen","DEN","MF","25",1996,17.8,33,18,12,16,5,22,63,34.9,41,32,3,29,22,55,13,0,"https://fbref.com/en/players/0f134faf/Mathias-Jensen"
2022,"Brentford","Premier League","Mathias Jørgensen","DEN","DF","31",1990,5.8,10,4,3,5,2,7,10,70,3,6,1,5,10,20,13,0,"https://fbref.com/en/players/0db5d2c8/Mathias-Jorgensen"
2022,"Brentford","Premier League","Jonas Lössl","DEN","GK","32",1989,2,0,0,0,0,0,0,0,NA,0,0,0,0,0,0,1,0,"https://fbref.com/en/players/939bc634/Jonas-Lossl"
2022,"Brentford","Premier League","Bryan Mbeumo","CMR","FW","21",1999,32.3,28,16,1,12,15,6,20,30,14,21,6,15,11,39,20,0,"https://fbref.com/en/players/6afaebf2/Bryan-Mbeumo"
2022,"Brentford","Premier League","Christian Nørgaard","DEN","MF","27",1994,33.9,109,60,42,58,9,52,101,51.5,49,48,9,39,64,173,58,1,"https://fbref.com/en/players/df0a4c90/Christian-Norgaard"
2022,"Brentford","Premier League","Frank Onyeka","NGA","MF","23",1998,11.6,25,17,13,9,3,8,27,29.6,19,16,2,14,14,39,13,0,"https://fbref.com/en/players/2944f86f/Frank-Onyeka"
2022,"Brentford","Premier League","Ethan Pinnock","JAM","DF","28",1993,29.9,51,35,37,12,2,25,38,65.8,13,30,11,19,44,95,154,1,"https://fbref.com/en/players/e541326e/Ethan-Pinnock"
2022,"Brentford","Premier League","David Raya","ESP","GK","25",1995,24,0,0,0,0,0,0,0,NA,0,1,0,1,0,0,10,1,"https://fbref.com/en/players/98ea5115/David-Raya"
2022,"Brentford","Premier League","Mads Roerslev","DEN","DF","22",1999,13.8,23,12,19,2,2,14,32,43.8,18,14,5,9,16,39,29,0,"https://fbref.com/en/players/57c94db2/Mads-Roerslev"
2022,"Brentford","Premier League","Finley Stevens","WAL","DF","18",2003,0.2,3,1,0,3,0,1,1,100,0,0,0,0,0,3,0,0,"https://fbref.com/en/players/7e003182/Finley-Stevens"
2022,"Brentford","Premier League","Dominic Thompson","ENG","DF","21",2000,1.6,1,0,1,0,0,0,1,0,1,2,2,0,2,3,3,0,"https://fbref.com/en/players/235a62f8/Dominic-Thompson"
2022,"Brentford","Premier League","Ivan Toney","ENG","FW","25",1996,32.3,33,21,5,20,8,12,38,31.6,26,16,2,14,14,47,44,1,"https://fbref.com/en/players/e09f279b/Ivan-Toney"
2022,"Brentford","Premier League","Yoane Wissa","COD","FW","24",1996,14.3,12,6,5,4,3,1,16,6.3,15,12,5,7,8,20,6,0,"https://fbref.com/en/players/2500cef9/Yoane-Wissa"
2022,"Brentford","Premier League","Nathan Young-Coombes","ENG","MF","18",2003,0,0,0,0,0,0,0,0,NA,0,0,0,0,0,0,0,0,"https://fbref.com/en/players/f9682888/Nathan-Young-Coombes"
2022,"Brest","Ligue 1","Lucien Agoume","FRA","MF","19",2002,20.8,51,31,24,20,7,23,45,51.1,22,30,9,21,52,103,27,1,"https://fbref.com/en/players/8bc8829a/Lucien-Agoume"
2022,"Brest","Ligue 1","Youssouph Badji","SEN","FW,MF","19",2001,1.5,1,0,0,1,0,0,1,0,1,0,0,0,0,1,0,0,"https://fbref.com/en/players/6a2b9aee/Youssouph-Badji"
2022,"Brest","Ligue 1","Dénys Bain","FRA","DF","28",1993,2,3,3,1,2,0,1,1,100,0,3,1,2,3,6,5,0,"https://fbref.com/en/players/5065d67d/Denys-Bain"
2022,"Brest","Ligue 1","Youcef Belaïli","ALG","MF,FW","29",1992,9.2,2,1,0,0,2,2,9,22.2,7,5,1,4,7,9,4,0,"https://fbref.com/en/players/1a248246/Youcef-Belaili"
2022,"Brest","Ligue 1","Haris Belkebla","ALG","MF","27",1994,25.7,46,23,21,21,4,18,39,46.2,21,26,6,20,48,94,30,1,"https://fbref.com/en/players/2b1bed19/Haris-Belkebla"
2022,"Brest","Ligue 1","Marco Bizot","NED","GK","30",1991,38,3,1,3,0,0,3,5,60,2,1,0,1,0,3,24,1,"https://fbref.com/en/players/3d214e5f/Marco-Bizot"
2022,"Brest","Ligue 1","Lilian Brassier","FRA","DF","21",1999,25.1,40,24,23,13,4,10,21,47.6,11,31,21,10,32,72,86,0,"https://fbref.com/en/players/5b146df3/Lilian-Brassier"
2022,"Brest","Ligue 1","Irvin Cardona","FRA","FW,MF","23",1997,14.8,13,7,5,4,4,3,16,18.8,13,10,0,10,5,18,17,0,"https://fbref.com/en/players/5e080f73/Irvin-Cardona"
2022,"Brest","Ligue 1","Brendan Chardonnet","FRA","DF","26",1994,29.8,44,25,32,11,1,29,40,72.5,11,42,29,13,55,99,141,0,"https://fbref.com/en/players/16aa7d4c/Brendan-Chardonnet"
2022,"Brest","Ligue 1","Romain Del Castillo","FRA","MF,FW","25",1996,10.8,27,16,3,17,7,12,31,38.7,19,12,0,12,7,34,3,0,"https://fbref.com/en/players/0be95d34/Romain-Del-Castillo"
2022,"Brest","Ligue 1","Jean-Kevin Duverne","FRA","DF","24",1997,33.4,71,44,43,21,7,42,90,46.7,48,40,5,35,53,124,92,0,"https://fbref.com/en/players/0cbc8baa/Jean-Kevin-Duverne"
2022,"Brest","Ligue 1","Romain Faivre","FRA","MF","23",1998,19.9,30,18,12,13,5,12,30,40,18,11,0,11,13,43,10,0,"https://fbref.com/en/players/745ca0a3/Romain-Faivre"
2022,"Brest","Ligue 1","Julien Faussurier","FRA","MF,DF","34",1987,5.4,10,6,3,3,4,6,13,46.2,7,12,1,11,5,15,6,0,"https://fbref.com/en/players/767212e6/Julien-Faussurier"
2022,"Brest","Ligue 1","Christophe Hérelle","MTQ","DF","28",1992,21.5,48,28,30,16,2,17,26,65.4,9,20,15,5,44,92,84,1,"https://fbref.com/en/players/3681cfff/Christophe-Herelle"
2022,"Brest","Ligue 1","Franck Honorat","FRA","FW,MF","24",1996,32.2,54,38,25,13,16,27,47,57.4,20,24,2,22,15,69,25,0,"https://fbref.com/en/players/db7849ca/Franck-Honorat"
2022,"Brest","Ligue 1","Paul Lasne","FRA","MF","32",1989,9.4,26,12,6,16,4,8,18,44.4,10,11,2,9,24,50,10,0,"https://fbref.com/en/players/542cc80f/Paul-Lasne"
2022,"Brest","Ligue 1","Jérémy Le Douaron","FRA","FW,MF","23",1998,16.1,11,5,4,4,3,1,17,5.9,16,15,0,15,4,15,14,0,"https://fbref.com/en/players/88c4d190/Jeremy-Le-Douaron"
2022,"Brest","Ligue 1","Hugo Magnetti","FRA","MF","23",1998,16.3,50,34,27,20,3,22,50,44,28,14,3,11,25,75,13,0,"https://fbref.com/en/players/d4d35152/Hugo-Magnetti"
2022,"Brest","Ligue 1","Hianga Mananga Mbock","FRA","MF","21",1999,8.9,18,12,8,7,3,9,21,42.9,12,5,2,3,5,23,6,0,"https://fbref.com/en/players/0f86995c/Hianga-Mananga-Mbock"
2022,"Brest","Ligue 1","Steve Mounié","BEN","FW","26",1994,25.7,17,6,3,12,2,4,27,14.8,23,13,1,12,6,23,12,0,"https://fbref.com/en/players/19ba6c6d/Steve-Mounie"
2022,"Brest","Ligue 1","Romain Philippoteaux","FRA","MF","33",1988,0.3,1,1,0,1,0,0,0,NA,0,0,0,0,0,1,0,0,"https://fbref.com/en/players/f98b15f0/Romain-Philippoteaux"
2022,"Brest","Ligue 1","Ronaël Pierre-Gabriel","FRA","DF","23",1998,28.3,79,45,52,21,6,42,73,57.5,31,22,7,15,48,127,74,0,"https://fbref.com/en/players/64ba07c0/Ronael-Pierre-Gabriel"
2022,"Brest","Ligue 1","Rafiki Said Ahamada","FRA","MF,FW","21",2000,1.4,4,3,1,2,1,3,4,75,1,2,0,2,0,4,0,0,"https://fbref.com/en/players/c2e5f306/Rafiki-Said-Ahamada"
2022,"Brest","Ligue 1","Martin Satriano","URU","FW","20",2001,10.4,5,2,1,1,3,2,7,28.6,5,8,0,8,2,7,3,0,"https://fbref.com/en/players/86383d0e/Martin-Satriano"
2022,"Brest","Ligue 1","Jere Uronen","FIN","DF","27",1994,9.8,28,15,15,10,3,14,24,58.3,10,12,3,9,16,44,21,0,"https://fbref.com/en/players/d75f3980/Jere-Uronen"
2022,"Brighton","Premier League","Steven Alzate","COL","MF","22",1998,4.5,10,4,4,5,1,4,7,57.1,3,2,1,1,10,20,10,0,"https://fbref.com/en/players/ad1f61f3/Steven-Alzate"
2022,"Brighton","Premier League","Yves Bissouma","MLI","MF","24",1996,23.5,76,49,35,37,4,21,37,56.8,16,33,3,30,50,126,49,0,"https://fbref.com/en/players/6c203af0/Yves-Bissouma"
2022,"Brighton","Premier League","Dan Burn","ENG","DF","29",1992,11.4,22,12,13,8,1,6,15,40,9,14,10,4,24,46,51,0,"https://fbref.com/en/players/b2d31e83/Dan-Burn"
2022,"Brighton","Premier League","Moisés Caicedo","ECU","MF","19",2001,7.3,16,10,7,7,2,5,12,41.7,7,18,4,14,10,26,7,0,"https://fbref.com/en/players/16264a81/Moises-Caicedo"
2022,"Brighton","Premier League","Aaron Connolly","IRL","FW,MF","21",2000,1.7,0,0,0,0,0,0,1,0,1,2,0,2,0,0,0,0,"https://fbref.com/en/players/27c01749/Aaron-Connolly"
2022,"Brighton","Premier League","Marc Cucurella","ESP","DF","23",1998,34.3,93,62,43,32,18,44,71,62,27,42,14,28,30,123,74,0,"https://fbref.com/en/players/1daec722/Marc-Cucurella"
2022,"Brighton","Premier League","Shane Duffy","IRL","DF","29",1992,16,15,12,12,3,0,8,14,57.1,6,24,18,6,16,31,76,1,"https://fbref.com/en/players/7314bba4/Shane-Duffy"
2022,"Brighton","Premier League","Lewis Dunk","ENG","DF","29",1991,28.6,10,8,5,5,0,5,11,45.5,6,32,28,4,27,37,113,3,"https://fbref.com/en/players/282f75f3/Lewis-Dunk"
2022,"Brighton","Premier League","Evan Ferguson","IRL","MF","16",2004,0.3,0,0,0,0,0,0,0,NA,0,0,0,0,0,0,0,0,"https://fbref.com/en/players/4596da74/Evan-Ferguson"
2022,"Brighton","Premier League","Pascal Groß","GER","MF,DF","30",1991,22.6,28,15,15,11,2,12,33,36.4,21,34,8,26,18,46,23,0,"https://fbref.com/en/players/8aec0537/Pascal-Gross"
2022,"Brighton","Premier League","Adam Lallana","ENG","MF","33",1988,17.3,34,17,14,14,6,12,41,29.3,29,16,6,10,16,50,13,1,"https://fbref.com/en/players/99813635/Adam-Lallana"
2022,"Brighton","Premier League","Tariq Lamptey","GHA","DF,FW","20",2000,17.3,36,25,14,17,5,15,25,60,10,13,3,10,21,57,23,0,"https://fbref.com/en/players/f4e433d4/Tariq-Lamptey"
2022,"Brighton","Premier League","Jürgen Locadia","NED","MF,FW","27",1993,0.3,0,0,0,0,0,0,0,NA,0,0,0,0,0,0,0,0,"https://fbref.com/en/players/6cc47ae1/Jurgen-Locadia"
2022,"Brighton","Premier League","Alexis Mac Allister","ARG","MF,FW","22",1998,23.6,65,40,23,30,12,29,68,42.6,39,37,7,30,13,78,22,0,"https://fbref.com/en/players/83d074ff/Alexis-Mac-Allister"
2022,"Brighton","Premier League","Solly March","ENG","DF,FW","27",1994,19.4,30,17,11,9,10,7,22,31.8,15,22,3,19,17,47,25,0,"https://fbref.com/en/players/bb5fbd2b/Solly-March"
2022,"Brighton","Premier League","Neal Maupay","FRA","FW","24",1996,25.3,17,10,2,6,9,4,18,22.2,14,21,2,19,2,19,2,0,"https://fbref.com/en/players/4bcf39f6/Neal-Maupay"
2022,"Brighton","Premier League","Jakub Moder","POL","MF","22",1999,18.9,42,25,18,17,7,23,42,54.8,19,25,2,23,10,52,22,1,"https://fbref.com/en/players/f230bc30/Jakub-Moder"
2022,"Brighton","Premier League","Enock Mwepu","ZAM","MF","23",1998,11.1,22,12,10,10,2,5,27,18.5,22,20,2,18,12,34,19,0,"https://fbref.com/en/players/1d5cab82/Enock-Mwepu"
2022,"Brighton","Premier League","Taylor Richards","ENG","MF","20",2000,0.3,1,0,0,1,0,1,2,50,1,0,0,0,0,1,0,0,"https://fbref.com/en/players/e0243d23/Taylor-Richards"
2022,"Brighton","Premier League","Robert Sánchez","ESP","GK","23",1997,37,2,1,2,0,0,1,1,100,0,1,0,1,0,2,11,4,"https://fbref.com/en/players/6a713852/Robert-Sanchez"
2022,"Brighton","Premier League","Jeremy Sarmiento","ECU","FW,MF","19",2002,0.5,1,1,0,0,1,0,2,0,2,2,0,2,0,1,0,0,"https://fbref.com/en/players/ac0d576d/Jeremy-Sarmiento"
2022,"Brighton","Premier League","Jason Steele","ENG","GK","30",1990,1,0,0,0,0,0,0,0,NA,0,0,0,0,0,0,0,0,"https://fbref.com/en/players/28300a16/Jason-Steele"
2022,"Brighton","Premier League","Leandro Trossard","BEL","FW,MF","26",1994,31.2,34,20,12,9,13,4,31,12.9,27,33,4,29,15,49,10,0,"https://fbref.com/en/players/38ceb24a/Leandro-Trossard"
2022,"Brighton","Premier League","Joël Veltman","NED","DF","29",1992,31.9,74,48,47,21,6,21,53,39.6,32,46,16,30,45,119,89,0,"https://fbref.com/en/players/dad4b285/Joel-Veltman"
2022,"Brighton","Premier League","Adam Webster","ENG","DF","26",1995,15.9,26,8,17,7,2,13,20,65,7,25,17,8,17,43,66,2,"https://fbref.com/en/players/c40b6180/Adam-Webster"
2022,"Brighton","Premier League","Danny Welbeck","ENG","FW,MF","30",1990,16.4,14,7,2,8,4,3,10,30,7,18,2,16,5,19,18,0,"https://fbref.com/en/players/ce5143da/Danny-Welbeck"
2022,"Burnley","Premier League","Ashley Barnes","ENG","FW","31",1989,9,11,2,2,7,2,2,9,22.2,7,8,1,7,2,13,5,0,"https://fbref.com/en/players/2691c772/Ashley-Barnes"
2022,"Burnley","Premier League","Jóhann Berg Guðmundsson","ISL","MF","30",1990,12.2,16,6,7,7,2,5,20,25,15,11,2,9,12,28,22,0,"https://fbref.com/en/players/f72293fc/Johann-Berg-Gudmundsson"
2022,"Burnley","Premier League","Josh Brownhill","ENG","MF","25",1995,32.8,73,37,25,42,6,21,53,39.6,32,37,12,25,68,141,42,1,"https://fbref.com/en/players/47369df8/Josh-Brownhill"
2022,"Burnley","Premier League","Nathan Collins","IRL","DF","20",2001,18.6,37,15,27,8,2,17,27,63,10,38,25,13,24,61,83,2,"https://fbref.com/en/players/a8c19eb8/Nathan-Collins"
2022,"Burnley","Premier League","Jack Cork","ENG","MF","32",1989,18.6,20,6,6,11,3,7,20,35,13,17,4,13,17,37,29,1,"https://fbref.com/en/players/74e12f1e/Jack-Cork"
2022,"Burnley","Premier League","Maxwel Cornet","CIV","FW,MF","24",1996,19.6,16,9,7,5,4,7,15,46.7,8,13,4,9,10,26,14,0,"https://fbref.com/en/players/beb391dd/Maxwel-Cornet"
2022,"Burnley","Premier League","Wayne Hennessey","WAL","GK","34",1987,2,0,0,0,0,0,0,0,NA,0,0,0,0,1,1,0,1,"https://fbref.com/en/players/76eca7e2/Wayne-Hennessey"
2022,"Burnley","Premier League","Aaron Lennon","ENG","MF,FW","34",1987,17.2,33,17,10,13,10,10,34,29.4,24,26,4,22,9,42,14,0,"https://fbref.com/en/players/2ff964a0/Aaron-Lennon"
2022,"Burnley","Premier League","Kevin Long","IRL","DF","30",1990,4.6,3,2,1,2,0,1,2,50,1,4,1,3,1,4,20,0,"https://fbref.com/en/players/5a4280b1/Kevin-Long"
2022,"Burnley","Premier League","Matthew Lowton","ENG","DF","32",1989,19.7,38,24,20,10,8,20,37,54.1,17,25,11,14,26,64,68,0,"https://fbref.com/en/players/9a9c05db/Matthew-Lowton"
2022,"Burnley","Premier League","Dwight McNeil","ENG","MF","21",1999,34.5,78,49,27,38,13,33,73,45.2,40,64,11,53,35,113,31,1,"https://fbref.com/en/players/fc15fb84/Dwight-McNeil"
2022,"Burnley","Premier League","Ben Mee","ENG","DF","31",1989,20.4,26,12,16,7,3,12,19,63.2,7,28,22,6,24,50,94,1,"https://fbref.com/en/players/8df7a2fb/Ben-Mee"
2022,"Burnley","Premier League","Erik Pieters","NED","DF","32",1988,8.1,28,15,15,11,2,17,28,60.7,11,18,7,11,10,38,38,0,"https://fbref.com/en/players/1ef37668/Erik-Pieters"
2022,"Burnley","Premier League","Nick Pope","ENG","GK","29",1992,36,0,0,0,0,0,0,2,0,2,0,0,0,2,2,30,3,"https://fbref.com/en/players/4b40d9ca/Nick-Pope"
2022,"Burnley","Premier League","Connor Roberts","WAL","DF","25",1995,18.8,20,13,10,7,3,10,15,66.7,5,25,5,20,22,42,62,1,"https://fbref.com/en/players/24fae784/Connor-Roberts"
2022,"Burnley","Premier League","Jay Rodriguez","ENG","FW","32",1989,15.4,20,12,8,8,4,4,14,28.6,10,19,1,18,4,24,12,0,"https://fbref.com/en/players/4ab53cdb/Jay-Rodriguez"
2022,"Burnley","Premier League","Dale Stephens","ENG","MF","32",1989,1.4,4,1,0,3,1,3,8,37.5,5,4,1,3,1,5,1,0,"https://fbref.com/en/players/653ee42d/Dale-Stephens"
2022,"Burnley","Premier League","James Tarkowski","ENG","DF","28",1992,34.5,65,45,47,17,1,33,47,70.2,14,75,61,14,48,113,186,4,"https://fbref.com/en/players/15ea812b/James-Tarkowski"
2022,"Burnley","Premier League","Charlie Taylor","ENG","DF","27",1993,30.3,45,26,31,11,3,26,44,59.1,18,42,20,22,58,103,95,2,"https://fbref.com/en/players/cc2d7ad5/Charlie-Taylor"
2022,"Burnley","Premier League","Matěj Vydra","CZE","FW","29",1992,7.5,12,7,3,4,5,3,7,42.9,4,5,1,4,0,12,9,0,"https://fbref.com/en/players/0d4ceb32/Matej-Vydra"
2022,"Burnley","Premier League","Wout Weghorst","NED","FW","28",1992,16.1,17,9,3,9,5,6,19,31.6,13,16,5,11,6,23,13,0,"https://fbref.com/en/players/c4e87b8b/Wout-Weghorst"
2022,"Burnley","Premier League","Ashley Westwood","ENG","MF","31",1990,25.4,21,12,8,12,1,10,31,32.3,21,21,9,12,30,51,16,1,"https://fbref.com/en/players/495945ef/Ashley-Westwood"
2022,"Burnley","Premier League","Chris Wood","NZL","FW","29",1991,15.2,7,5,0,3,4,3,10,30,7,13,4,9,0,7,3,0,"https://fbref.com/en/players/4e9a0555/Chris-Wood"
2022,"Cagliari","Serie A","Giorgio Altare","ITA","DF","22",1998,16.3,39,28,18,18,3,21,26,80.8,5,17,5,12,30,69,70,0,"https://fbref.com/en/players/aa5322d5/Giorgio-Altare"
2022,"Cagliari","Serie A","Keita Baldé","SEN","FW","26",1995,13.7,8,4,1,5,2,1,10,10,9,6,0,6,4,12,6,0,"https://fbref.com/en/players/509a4ccb/Keita-Balde"
2022,"Cagliari","Serie A","Daniele Baselli","ITA","MF","29",1992,3.2,6,5,3,1,2,1,5,20,4,2,0,2,2,8,5,0,"https://fbref.com/en/players/ea06dd97/Daniele-Baselli"
2022,"Cagliari","Serie A","Raoul Bellanova","ITA","DF,FW","21",2000,27.7,29,15,14,12,3,6,27,22.2,21,39,8,31,21,50,51,0,"https://fbref.com/en/players/e3756e72/Raoul-Bellanova"
2022,"Cagliari","Serie A","Martín Cáceres","URU","DF","34",1987,9.2,13,7,5,5,3,4,12,33.3,8,12,3,9,14,27,21,0,"https://fbref.com/en/players/e94d79e3/Martin-Caceres"
2022,"Cagliari","Serie A","Andrea Carboni","ITA","DF","20",2001,24.6,53,24,33,16,4,19,42,45.2,23,42,15,27,27,80,87,0,"https://fbref.com/en/players/f7e2af2c/Andrea-Carboni"
2022,"Cagliari","Serie A","Luca Ceppitelli","ITA","DF","31",1989,16.1,23,12,13,10,0,16,27,59.3,11,21,14,7,25,48,54,0,"https://fbref.com/en/players/7d50454d/Luca-Ceppitelli"
2022,"Cagliari","Serie A","Damir Ceter","COL","FW","23",1997,0.1,0,0,0,0,0,0,0,NA,0,0,0,0,0,0,0,0,"https://fbref.com/en/players/eade5337/Damir-Ceter"
2022,"Cagliari","Serie A","Alessio Cragno","ITA","GK","27",1994,35,3,3,2,1,0,3,3,100,0,0,0,0,1,4,14,1,"https://fbref.com/en/players/f554e29b/Alessio-Cragno"
2022,"Cagliari","Serie A","Alessandro Deiola","ITA","MF","25",1995,23.7,47,22,15,25,7,23,58,39.7,35,28,10,18,26,73,45,0,"https://fbref.com/en/players/7f267d66/Alessandro-Deiola"
2022,"Cagliari","Serie A","Paolo Faragò","ITA","MF","28",1993,0.2,1,1,1,0,0,0,0,NA,0,2,0,2,0,1,0,0,"https://fbref.com/en/players/9085dd7c/Paolo-Farago"
2022,"Cagliari","Serie A","Diego Farias","BRA","MF,FW","31",1990,0.7,1,1,0,1,0,1,3,33.3,2,0,0,0,0,1,0,0,"https://fbref.com/en/players/157d29b6/Diego-Farias"
2022,"Cagliari","Serie A","Luca Gagliano","ITA","FW,DF","21",2000,0.1,0,0,0,0,0,0,0,NA,0,1,0,1,0,0,1,0,"https://fbref.com/en/players/1d00a56c/Luca-Gagliano"
2022,"Cagliari","Serie A","Diego Godín","URU","DF","35",1986,9.1,18,7,13,3,2,10,15,66.7,5,7,5,2,13,31,46,0,"https://fbref.com/en/players/fc4f85b1/Diego-Godin"
2022,"Cagliari","Serie A","Edoardo Goldaniga","ITA","DF","27",1993,10.4,12,5,7,5,0,4,11,36.4,7,8,5,3,22,34,23,0,"https://fbref.com/en/players/4b029b31/Edoardo-Goldaniga"
2022,"Cagliari","Serie A","Alberto Grassi","ITA","MF","26",1995,24.2,47,26,13,30,4,16,38,42.1,22,27,9,18,63,110,33,1,"https://fbref.com/en/players/6cc97b6a/Alberto-Grassi"
2022,"Cagliari","Serie A","Dalbert Henrique","BRA","DF,MF","27",1993,23.1,43,23,23,16,4,11,35,31.4,24,28,5,23,24,67,34,0,"https://fbref.com/en/players/f45f9427/Dalbert-Henrique"
2022,"Cagliari","Serie A","Christos Kourfalidis","GRE","MF,FW","18",2002,0.2,0,0,0,0,0,0,1,0,1,1,0,1,0,0,0,0,"https://fbref.com/en/players/5c522c88/Christos-Kourfalidis"
2022,"Cagliari","Serie A","Matteo Lovato","ITA","DF","21",2000,13.8,23,15,13,10,0,8,20,40,12,21,10,11,28,51,43,0,"https://fbref.com/en/players/5fa57166/Matteo-Lovato"
2022,"Cagliari","Serie A","Charalambos Lykogiannis","GRE","DF,FW","27",1993,20.2,19,12,16,1,2,11,20,55,9,18,8,10,31,50,73,0,"https://fbref.com/en/players/5efc5389/Charalambos-Lykogiannis"
2022,"Cagliari","Serie A","Răzvan Marin","ROU","MF","25",1996,31.3,42,21,16,22,4,24,54,44.4,30,23,5,18,10,52,17,1,"https://fbref.com/en/players/7fac99d4/Razvan-Marin"
2022,"Cagliari","Serie A","Nahitan Nández","URU","MF,DF","25",1995,16.9,39,21,16,15,8,18,33,54.5,15,16,1,15,9,48,15,1,"https://fbref.com/en/players/95facda1/Nahitan-Nandez"
2022,"Cagliari","Serie A","Adam Obert","SVK","DF,MF","18",2002,3,8,5,6,2,0,5,6,83.3,1,6,4,2,4,12,11,0,"https://fbref.com/en/players/aa25ce92/Adam-Obert"
2022,"Cagliari","Serie A","Christian Oliva","URU","MF","25",1996,0.5,2,2,2,0,0,1,4,25,3,0,0,0,0,2,0,0,"https://fbref.com/en/players/d3b888e3/Christian-Oliva"
2022,"Cagliari","Serie A","Leonardo Pavoletti","ITA","FW","32",1988,16.9,10,6,2,5,3,3,9,33.3,6,9,5,4,2,12,12,0,"https://fbref.com/en/players/d37b0350/Leonardo-Pavoletti"
2022,"Cagliari","Serie A","João Pedro","ITA","FW","29",1992,36.9,15,12,2,8,5,4,18,22.2,14,23,5,18,8,23,18,1,"https://fbref.com/en/players/81255c03/Joao-Pedro"
2022,"Cagliari","Serie A","Gastón Pereiro","URU","FW,MF","26",1995,10.8,13,5,7,4,2,5,18,27.8,13,12,1,11,1,14,8,0,"https://fbref.com/en/players/7ec7738e/Gaston-Pereiro"
2022,"Cagliari","Serie A","Boris Radunović","SRB","GK","25",1996,3,0,0,0,0,0,0,0,NA,0,0,0,0,0,0,0,0,"https://fbref.com/en/players/0dfce079/Boris-Radunovic"
2022,"Cagliari","Serie A","Marko Rog","CRO","MF","26",1995,3.5,5,3,1,2,2,1,8,12.5,7,6,1,5,1,6,3,0,"https://fbref.com/en/players/b6b2b820/Marko-Rog"
2022,"Cagliari","Serie A","Giovanni Simeone","ARG","FW","26",1995,0.1,0,0,0,0,0,0,0,NA,0,0,0,0,0,0,0,0,"https://fbref.com/en/players/343c0d52/Giovanni-Simeone"
2022,"Cagliari","Serie A","Kevin Strootman","NED","MF","31",1990,7.1,8,4,2,4,2,5,12,41.7,7,11,2,9,10,18,15,0,"https://fbref.com/en/players/ef2e5e1a/Kevin-Strootman"
2022,"Cagliari","Serie A","Sebastian Walukiewicz","POL","DF","21",2000,3.4,9,5,7,2,0,3,5,60,2,5,2,3,7,16,14,0,"https://fbref.com/en/players/217875a4/Sebastian-Walukiewicz"
2022,"Cagliari","Serie A","Gabriele Zappa","ITA","DF","21",1999,12.7,21,9,12,6,3,6,24,25,18,15,5,10,14,35,28,0,"https://fbref.com/en/players/ca3db240/Gabriele-Zappa"
2022,"Celta Vigo","La Liga","Joseph Aidoo","GHA","DF","25",1995,29.3,39,26,28,10,1,17,31,54.8,14,23,13,10,38,77,96,3,"https://fbref.com/en/players/18abe173/Joseph-Aidoo"
2022,"Celta Vigo","La Liga","Hugo Álvarez","ESP","FW","18",2003,0.1,1,0,1,0,0,0,0,NA,0,0,0,0,0,1,1,0,"https://fbref.com/en/players/6f392eb8/Hugo-Alvarez"
2022,"Celta Vigo","La Liga","Néstor Araujo","MEX","DF","29",1991,29.1,22,14,17,5,0,9,21,42.9,12,17,10,7,27,49,105,2,"https://fbref.com/en/players/27a013f7/Nestor-Araujo"
2022,"Celta Vigo","La Liga","Iago Aspas","ESP","FW","33",1987,34.3,14,7,1,5,8,4,24,16.7,20,23,2,21,11,25,19,0,"https://fbref.com/en/players/7dcf86f6/Iago-Aspas"
2022,"Celta Vigo","La Liga","Miguel Baeza","ESP","DF","21",2000,0,0,0,0,0,0,0,0,NA,0,0,0,0,0,0,0,0,"https://fbref.com/en/players/a98f3cbf/Miguel-Baeza"
2022,"Celta Vigo","La Liga","Fran Beltrán","ESP","MF","22",1999,28.9,56,41,27,23,6,28,68,41.2,40,29,5,24,32,88,39,0,"https://fbref.com/en/players/ed5c5fa3/Fran-Beltran"
2022,"Celta Vigo","La Liga","Franco Cervi","ARG","MF","27",1994,20,73,41,35,22,16,33,77,42.9,44,38,2,36,21,94,19,0,"https://fbref.com/en/players/5e1028e5/Franco-Cervi"
2022,"Celta Vigo","La Liga","Matías Dituro","ARG","GK","34",1987,38,0,0,0,0,0,0,0,NA,0,0,0,0,0,0,10,5,"https://fbref.com/en/players/b6160ad0/Matias-Dituro"
2022,"Celta Vigo","La Liga","Carlos Dominguez","ESP","DF","20",2001,3.8,4,1,4,0,0,4,6,66.7,2,2,1,1,4,8,21,0,"https://fbref.com/en/players/3521abfe/Carlos-Dominguez"
2022,"Celta Vigo","La Liga","José Fontán","ESP","DF","21",2000,3.1,5,3,3,2,0,1,5,20,4,3,1,2,10,15,10,0,"https://fbref.com/en/players/1827a42d/Jose-Fontan"
2022,"Celta Vigo","La Liga","Javi Galán","ESP","DF","26",1994,36.6,108,66,60,37,11,42,99,42.4,57,48,8,40,45,153,52,0,"https://fbref.com/en/players/a4b00319/Javi-Galan"
2022,"Celta Vigo","La Liga","Thiago Galhardo","BRA","FW,MF","32",1989,12.8,12,6,3,3,6,2,12,16.7,10,15,2,13,6,18,9,0,"https://fbref.com/en/players/766f48dd/Thiago-Galhardo"
2022,"Celta Vigo","La Liga","Hugo Mallo","ESP","DF","30",1991,20.3,45,25,24,19,2,16,31,51.6,15,23,9,14,20,65,53,0,"https://fbref.com/en/players/cb574619/Hugo-Mallo"
2022,"Celta Vigo","La Liga","Brais Méndez","ESP","MF","24",1997,33.6,68,35,24,35,9,26,87,29.9,61,52,6,46,37,105,30,0,"https://fbref.com/en/players/c9e39d91/Brais-Mendez"
2022,"Celta Vigo","La Liga","Santi Mina","ESP","FW","25",1995,26.3,27,17,8,15,4,5,32,15.6,27,28,2,26,6,33,22,0,"https://fbref.com/en/players/0b90bb97/Santi-Mina"
2022,"Celta Vigo","La Liga","Jeison Murillo","COL","DF","29",1992,12.4,15,10,13,2,0,9,13,69.2,4,11,8,3,17,32,37,0,"https://fbref.com/en/players/b233e8e4/Jeison-Murillo"
2022,"Celta Vigo","La Liga","Nolito","ESP","MF","34",1986,15.4,25,15,14,7,4,13,47,27.7,34,20,1,19,9,34,5,0,"https://fbref.com/en/players/b2d0ec1b/Nolito"
2022,"Celta Vigo","La Liga","Orbelín Pineda","MEX","MF,FW","25",1996,1.1,4,1,4,0,0,1,2,50,1,0,0,0,0,4,1,0,"https://fbref.com/en/players/411fabd7/Orbelin-Pineda"
2022,"Celta Vigo","La Liga","Augusto Solari","ARG","MF,DF","29",1992,7.9,24,12,9,12,3,12,32,37.5,20,14,4,10,7,31,10,1,"https://fbref.com/en/players/3ca6106c/Augusto-Solari"
2022,"Celta Vigo","La Liga","Hugo Sotelo","ESP","FW","17",2003,0,0,0,0,0,0,0,0,NA,0,0,0,0,0,0,0,0,"https://fbref.com/en/players/3aa74860/Hugo-Sotelo"
2022,"Celta Vigo","La Liga","Denis Suárez","ESP","MF","27",1994,31.3,61,29,20,33,8,25,82,30.5,57,32,4,28,16,77,11,0,"https://fbref.com/en/players/12c50af5/Denis-Suarez"
2022,"Celta Vigo","La Liga","Renato Tapia","PER","MF","26",1995,15.7,50,31,15,31,4,20,50,40,30,21,5,16,28,78,43,0,"https://fbref.com/en/players/34269bdf/Renato-Tapia"
2022,"Celta Vigo","La Liga","Kevin Vázquez","ESP","DF","28",1993,14.8,34,24,12,13,9,14,28,50,14,20,7,13,36,70,34,0,"https://fbref.com/en/players/ee923664/Kevin-Vazquez"
2022,"Celta Vigo","La Liga","Gabriel Veiga","ESP","MF","19",2002,1.2,5,4,0,4,1,3,12,25,9,2,0,2,4,9,1,0,"https://fbref.com/en/players/35a6e5c7/Gabriel-Veiga"
2022,"Celta Vigo","La Liga","Okay Yokuşlu","TUR","DF,MF","27",1994,1.6,4,1,2,1,1,2,3,66.7,1,2,1,1,2,6,6,0,"https://fbref.com/en/players/e49ce451/Okay-Yokuslu"
2022,"Chelsea","Premier League","Marcos Alonso","ESP","DF","30",1990,24.1,41,29,20,12,9,17,36,47.2,19,29,5,24,43,84,53,0,"https://fbref.com/en/players/f4290206/Marcos-Alonso"
2022,"Chelsea","Premier League","Kepa Arrizabalaga","ESP","GK","26",1994,4,0,0,0,0,0,0,0,NA,0,0,0,0,0,0,4,0,"https://fbref.com/en/players/28d596a0/Kepa-Arrizabalaga"
2022,"Chelsea","Premier League","César Azpilicueta","ESP","DF","31",1989,23,51,28,18,27,6,16,35,45.7,19,32,9,23,23,74,65,1,"https://fbref.com/en/players/53cad200/Cesar-Azpilicueta"
2022,"Chelsea","Premier League","Ross Barkley","ENG","MF,FW","27",1993,2,0,0,0,0,0,0,1,0,1,1,0,1,1,1,0,0,"https://fbref.com/en/players/3a24769f/Ross-Barkley"
2022,"Chelsea","Premier League","Trevoh Chalobah","ENG","DF","22",1999,16.1,40,27,22,18,0,24,31,77.4,7,16,6,10,19,59,43,2,"https://fbref.com/en/players/5515376c/Trevoh-Chalobah"
2022,"Chelsea","Premier League","Ben Chilwell","ENG","DF","24",1996,6,8,3,2,6,0,2,5,40,3,7,0,7,4,12,14,1,"https://fbref.com/en/players/d2424d1b/Ben-Chilwell"
2022,"Chelsea","Premier League","Andreas Christensen","DEN","DF","25",1996,16.6,14,8,9,4,1,4,7,57.1,3,14,6,8,29,43,57,1,"https://fbref.com/en/players/1cb49278/Andreas-Christensen"
2022,"Chelsea","Premier League","Kai Havertz","GER","FW,MF","22",1999,20.1,17,8,5,7,5,4,14,28.6,10,28,1,27,4,21,32,1,"https://fbref.com/en/players/fed7cb61/Kai-Havertz"
2022,"Chelsea","Premier League","Callum Hudson-Odoi","ENG","MF,FW","20",2000,10.7,14,10,5,6,3,8,23,34.8,15,8,0,8,2,16,6,1,"https://fbref.com/en/players/15f3ec41/Callum-Hudson-Odoi"
2022,"Chelsea","Premier League","Reece James","ENG","DF","21",1999,20.7,33,25,14,18,1,9,22,40.9,13,20,2,18,17,50,22,0,"https://fbref.com/en/players/1265a93a/Reece-James"
2022,"Chelsea","Premier League","Jorginho","ITA","MF","29",1991,25.3,64,33,27,31,6,29,83,34.9,54,27,4,23,36,100,21,1,"https://fbref.com/en/players/45db685d/Jorginho"
2022,"Chelsea","Premier League","N'Golo Kanté","FRA","MF","30",1991,19.7,59,31,20,27,12,25,40,62.5,15,37,2,35,31,90,8,0,"https://fbref.com/en/players/b9fbae28/NGolo-Kante"
2022,"Chelsea","Premier League","Kenedy","BRA","DF","25",1996,0.6,5,2,1,2,2,2,3,66.7,1,0,0,0,0,5,0,0,"https://fbref.com/en/players/5eebbfdf/Kenedy"
2022,"Chelsea","Premier League","Mateo Kovačić","CRO","MF","27",1994,17.3,51,31,14,26,11,17,35,48.6,18,19,4,15,7,58,9,1,"https://fbref.com/en/players/79c0821a/Mateo-Kovacic"
2022,"Chelsea","Premier League","Ruben Loftus-Cheek","ENG","MF,DF","25",1996,15.5,29,10,16,11,2,10,19,52.6,9,15,6,9,11,40,17,0,"https://fbref.com/en/players/e97fd090/Ruben-Loftus-Cheek"
2022,"Chelsea","Premier League","Romelu Lukaku","BEL","FW","28",1993,17.7,2,1,0,1,1,1,5,20,4,11,1,10,0,2,20,0,"https://fbref.com/en/players/5eae500a/Romelu-Lukaku"
2022,"Chelsea","Premier League","Edouard Mendy","SEN","GK","29",1992,34,1,0,1,0,0,1,3,33.3,2,0,0,0,0,1,13,4,"https://fbref.com/en/players/33887998/Edouard-Mendy"
2022,"Chelsea","Premier League","Mason Mount","ENG","MF","22",1999,26.3,41,16,10,17,14,10,34,29.4,24,18,1,17,13,54,12,0,"https://fbref.com/en/players/9674002f/Mason-Mount"
2022,"Chelsea","Premier League","Saúl Ñíguez","ESP","DF,MF","26",1994,5.3,20,9,11,9,0,9,16,56.3,7,14,3,11,7,27,10,1,"https://fbref.com/en/players/c14bc029/Saul-Niguez"
2022,"Chelsea","Premier League","Emerson Palmieri","ITA","DF","26",1994,0.1,0,0,0,0,0,0,0,NA,0,0,0,0,0,0,0,0,"https://fbref.com/en/players/e0bc6fdc/Emerson-Palmieri"
2022,"Chelsea","Premier League","Christian Pulisic","USA","MF,FW","22",1998,14.3,10,7,6,3,1,3,17,17.6,14,12,0,12,5,15,10,0,"https://fbref.com/en/players/1bf33a9a/Christian-Pulisic"
2022,"Chelsea","Premier League","Antonio Rüdiger","GER","DF","28",1993,33.7,48,28,29,15,4,36,48,75,12,20,11,9,28,76,91,1,"https://fbref.com/en/players/18b896d6/Antonio-Rudiger"
2022,"Chelsea","Premier League","Malang Sarr","FRA","DF","22",1999,6.1,14,7,10,2,2,7,12,58.3,5,6,3,3,11,25,20,0,"https://fbref.com/en/players/4315f30d/Malang-Sarr"
2022,"Chelsea","Premier League","Thiago Silva","BRA","DF","36",1984,29.4,32,21,19,12,1,11,22,50,11,54,31,23,44,76,100,0,"https://fbref.com/en/players/86e7deaf/Thiago-Silva"
2022,"Chelsea","Premier League","Timo Werner","GER","FW,MF","25",1996,14.3,8,4,3,3,2,2,20,10,18,9,0,9,2,10,4,0,"https://fbref.com/en/players/49fe9070/Timo-Werner"
2022,"Chelsea","Premier League","Hakim Ziyech","MAR","MF,FW","28",1993,14.7,19,10,5,12,2,10,36,27.8,26,11,1,10,10,29,10,0,"https://fbref.com/en/players/6622454d/Hakim-Ziyech"
2022,"Clermont Foot","Ligue 1","Salis Abdul Samed","GHA","MF","21",2000,27.4,43,23,25,16,2,20,57,35.1,37,18,1,17,42,85,15,0,"https://fbref.com/en/players/82464ce3/Salis-Abdul-Samed"
2022,"Clermont Foot","Ligue 1","Josué Albert","GUF","DF","29",1992,0.2,0,0,0,0,0,0,0,NA,0,0,0,0,1,1,2,0,"https://fbref.com/en/players/3d738df0/Josue-Albert"
2022,"Clermont Foot","Ligue 1","Jim Allevinah","GAB","FW","26",1995,16.5,18,13,8,8,2,5,18,27.8,13,11,0,11,6,24,4,0,"https://fbref.com/en/players/1956b948/Jim-Allevinah"
2022,"Clermont Foot","Ligue 1","Jason Berthomier","FRA","MF","31",1990,19.2,29,14,5,17,7,12,34,35.3,22,14,2,12,8,37,4,1,"https://fbref.com/en/players/03e91055/Jason-Berthomier"
2022,"Clermont Foot","Ligue 1","Jean-Claude Billong","CMR","DF","27",1993,10.9,17,8,14,1,2,8,11,72.7,3,9,1,8,10,27,35,0,"https://fbref.com/en/players/a3e1d20d/Jean-Claude-Billong"
2022,"Clermont Foot","Ligue 1","Oriol Busquets","ESP","MF","22",1999,2.2,3,3,0,3,0,2,6,33.3,4,7,4,3,1,4,2,0,"https://fbref.com/en/players/49712367/Oriol-Busquets"
2022,"Clermont Foot","Ligue 1","Lucas Da Cunha","FRA","FW,MF","20",2001,9.3,17,11,5,8,4,9,18,50,9,13,0,13,1,18,3,0,"https://fbref.com/en/players/007faf7a/Lucas-Da-Cunha"
2022,"Clermont Foot","Ligue 1","Arthur Desmas","FRA","GK","27",1994,14.5,0,0,0,0,0,0,3,0,3,0,0,0,0,0,1,3,"https://fbref.com/en/players/e8c5dd4d/Arthur-Desmas"
2022,"Clermont Foot","Ligue 1","Yadaly Diaby","FRA","FW,MF","20",2000,0.7,0,0,0,0,0,0,1,0,1,0,0,0,2,2,2,0,"https://fbref.com/en/players/5630a6e0/Yadaly-Diaby"
2022,"Clermont Foot","Ligue 1","Ouparine Djoco","SEN","GK","23",1998,23.5,0,0,0,0,0,0,0,NA,0,0,0,0,1,1,14,2,"https://fbref.com/en/players/62124972/Ouparine-Djoco"
2022,"Clermont Foot","Ligue 1","Jodel Dossou","BEN","FW","29",1992,22.3,36,17,15,14,7,15,43,34.9,28,14,0,14,5,41,7,0,"https://fbref.com/en/players/a1dbfcb1/Jodel-Dossou"
2022,"Clermont Foot","Ligue 1","Johan Gastien","FRA","MF","33",1988,30.5,56,34,26,25,5,27,74,36.5,47,45,11,34,53,109,49,1,"https://fbref.com/en/players/868eaba0/Johan-Gastien"
2022,"Clermont Foot","Ligue 1","Pierre-Yves Hamel","FRA","FW","27",1994,5.8,11,6,0,5,6,5,6,83.3,1,2,1,1,0,11,0,0,"https://fbref.com/en/players/a99da9ec/Pierre-Yves-Hamel"
2022,"Clermont Foot","Ligue 1","Cédric Hountondji","BEN","DF","27",1994,22.6,33,17,20,12,1,16,24,66.7,8,23,12,11,34,67,76,0,"https://fbref.com/en/players/00891164/Cedric-Hountondji"
2022,"Clermont Foot","Ligue 1","Jonathan Iglesias","URU","MF","32",1988,6.4,18,11,6,10,2,10,18,55.6,8,8,2,6,5,23,2,1,"https://fbref.com/en/players/639ca1cf/Jonathan-Iglesias"
2022,"Clermont Foot","Ligue 1","Saîf-Eddine Khaoui","TUN","MF,FW","26",1995,10.3,19,10,5,10,4,9,18,50,9,9,0,9,14,33,5,0,"https://fbref.com/en/players/796b1c41/Saif-Eddine-Khaoui"
2022,"Clermont Foot","Ligue 1","Grejohn Kyei","FRA","FW","25",1995,4.4,3,2,1,1,1,0,6,0,6,6,0,6,0,3,1,0,"https://fbref.com/en/players/397ba086/Grejohn-Kyei"
2022,"Clermont Foot","Ligue 1","Mohamed Lamine Bayo","GUI","FW","23",1998,26.8,12,5,4,3,5,3,24,12.5,21,7,1,6,7,19,14,0,"https://fbref.com/en/players/01870104/Mohamed-Lamine-Bayo"
2022,"Clermont Foot","Ligue 1","Yohann Magnin","FRA","MF,DF","24",1997,19.1,53,31,22,26,5,24,42,57.1,18,17,7,10,20,73,36,0,"https://fbref.com/en/players/caa7aaea/Yohann-Magnin"
2022,"Clermont Foot","Ligue 1","Arial Mendy","SEN","DF,FW","26",1994,8.8,6,4,4,2,0,2,11,18.2,9,6,1,5,7,13,17,0,"https://fbref.com/en/players/9f0f4b49/Arial-Mendy"
2022,"Clermont Foot","Ligue 1","Vital N'Simba","COD","DF","28",1993,31,66,45,38,23,5,36,63,57.1,27,28,7,21,29,95,30,0,"https://fbref.com/en/players/249ac66d/Vital-NSimba"
2022,"Clermont Foot","Ligue 1","Florent Ogier","FRA","DF","32",1989,27,31,17,18,12,1,17,31,54.8,14,41,27,14,37,68,89,0,"https://fbref.com/en/players/6993927b/Florent-Ogier"
2022,"Clermont Foot","Ligue 1","Jérôme Phojo","FRA","DF","28",1993,0.1,0,0,0,0,0,0,0,NA,0,0,0,0,0,0,1,0,"https://fbref.com/en/players/ff44d058/Jerome-Phojo"
2022,"Clermont Foot","Ligue 1","Elba Rashani","KVX","FW,MF","28",1993,19.5,40,21,15,21,4,17,55,30.9,38,34,3,31,11,51,20,0,"https://fbref.com/en/players/25749008/Elba-Rashani"
2022,"Clermont Foot","Ligue 1","Alidu Seidu","GHA","DF","21",2000,15.7,34,20,20,13,1,16,27,59.3,11,25,11,14,34,68,49,1,"https://fbref.com/en/players/cea59f02/Alidu-Seidu"
2022,"Clermont Foot","Ligue 1","Aboubakar Sidibé","FRA","DF","25",1996,0.1,0,0,0,0,0,0,0,NA,0,0,0,0,0,0,0,0,"https://fbref.com/en/players/ae5b93a0/Aboubakar-Sidibe"
2022,"Clermont Foot","Ligue 1","Jordan Tell","FRA","FW","24",1997,3.2,5,5,0,3,2,1,4,25,3,3,0,3,0,5,1,0,"https://fbref.com/en/players/4f093689/Jordan-Tell"
2022,"Clermont Foot","Ligue 1","Akim Zedadka","ALG","DF","26",1995,37.1,72,44,34,29,9,37,71,52.1,34,32,8,24,58,130,48,0,"https://fbref.com/en/players/0ff630d0/Akim-Zedadka"
2022,"Crystal Palace","Premier League","Joachim Andersen","DEN","DF","25",1996,32.4,30,23,21,9,0,16,27,59.3,11,29,19,10,37,67,125,3,"https://fbref.com/en/players/e34fc66d/Joachim-Andersen"
2022,"Crystal Palace","Premier League","Jordan Ayew","GHA","FW","29",1991,22.4,47,30,20,20,7,17,31,54.8,14,33,3,30,15,62,15,0,"https://fbref.com/en/players/da052c14/Jordan-Ayew"
2022,"Crystal Palace","Premier League","Christian Benteke","BEL","FW","30",1990,12.7,3,2,1,2,0,2,6,33.3,4,7,3,4,2,5,33,0,"https://fbref.com/en/players/ab070c55/Christian-Benteke"
2022,"Crystal Palace","Premier League","Jack Butland","ENG","GK","28",1993,8.5,0,0,0,0,0,0,0,NA,0,0,0,0,0,0,1,0,"https://fbref.com/en/players/cc70a1d5/Jack-Butland"
2022,"Crystal Palace","Premier League","Nathaniel Clyne","ENG","DF","30",1991,15,21,10,11,9,1,10,20,50,10,7,2,5,15,36,32,0,"https://fbref.com/en/players/0442183b/Nathaniel-Clyne"
2022,"Crystal Palace","Premier League","Odsonne Édouard","FRA","FW","23",1998,17.4,16,10,2,7,7,7,21,33.3,14,20,5,15,0,16,18,0,"https://fbref.com/en/players/0562b7f1/Odsonne-Edouard"
2022,"Crystal Palace","Premier League","Eberechi Eze","ENG","MF,FW","23",1998,6.7,10,6,5,2,3,6,11,54.5,5,4,1,3,5,15,1,0,"https://fbref.com/en/players/ae4fc6a4/Eberechi-Eze"
2022,"Crystal Palace","Premier League","Nathan Ferguson","ENG","DF","20",2000,0.1,0,0,0,0,0,0,0,NA,0,0,0,0,0,0,0,0,"https://fbref.com/en/players/2f8d27bc/Nathan-Ferguson"
2022,"Crystal Palace","Premier League","Conor Gallagher","ENG","MF","21",2000,31.6,69,38,35,20,14,21,69,30.4,48,58,9,49,29,98,26,0,"https://fbref.com/en/players/c2731c10/Conor-Gallagher"
2022,"Crystal Palace","Premier League","Vicente Guaita","ESP","GK","34",1987,29.5,1,0,1,0,0,1,1,100,0,0,0,0,1,2,8,1,"https://fbref.com/en/players/ab13a5aa/Vicente-Guaita"
2022,"Crystal Palace","Premier League","Marc Guéhi","ENG","DF","21",2000,35.8,35,17,24,10,1,15,16,93.8,1,34,26,8,30,65,127,0,"https://fbref.com/en/players/d0706b27/Marc-Guehi"
2022,"Crystal Palace","Premier League","Will Hughes","ENG","MF","26",1995,11.7,29,14,10,16,3,7,16,43.8,9,13,7,6,8,37,10,0,"https://fbref.com/en/players/a0666d3e/Will-Hughes"
2022,"Crystal Palace","Premier League","Cheikhou Kouyaté","SEN","MF","31",1989,21.9,52,38,28,22,2,18,39,46.2,21,40,14,26,38,90,39,0,"https://fbref.com/en/players/8d3c902d/Cheikhou-Kouyate"
2022,"Crystal Palace","Premier League","Jean-Philippe Mateta","FRA","FW","24",1997,12.7,8,4,2,5,1,3,18,16.7,15,11,3,8,4,12,13,0,"https://fbref.com/en/players/50e6dc35/Jean-Philippe-Mateta"
2022,"Crystal Palace","Premier League","James McArthur","SCO","MF","33",1987,16,33,23,13,19,1,16,44,36.4,28,23,9,14,30,63,27,0,"https://fbref.com/en/players/cee31595/James-McArthur"
2022,"Crystal Palace","Premier League","Luka Milivojević","SRB","MF","30",1991,8.6,18,9,9,6,3,10,16,62.5,6,6,1,5,11,29,15,0,"https://fbref.com/en/players/2ce2508a/Luka-Milivojevic"
2022,"Crystal Palace","Premier League","Tyrick Mitchell","ENG","DF","21",1999,34.5,104,57,67,26,11,46,67,68.7,21,47,5,42,41,145,101,0,"https://fbref.com/en/players/5cbd1eb0/Tyrick-Mitchell"
2022,"Crystal Palace","Premier League","Michael Olise","FRA","FW,MF","19",2001,12.7,22,18,8,11,3,7,24,29.2,17,17,0,17,6,28,6,0,"https://fbref.com/en/players/c4486bac/Michael-Olise"
2022,"Crystal Palace","Premier League","Jesuran Rak Sakyi","ENG","FW,MF","18",2002,0.9,0,0,0,0,0,0,1,0,1,3,0,3,1,1,0,0,"https://fbref.com/en/players/45685411/Jesuran-Rak-Sakyi"
2022,"Crystal Palace","Premier League","Jaïro Riedewald","NED","MF","24",1996,1.3,1,1,0,1,0,1,2,50,1,1,0,1,1,2,2,0,"https://fbref.com/en/players/7a1f2c08/Jairo-Riedewald"
2022,"Crystal Palace","Premier League","Jeffrey Schlupp","GHA","MF,FW","28",1992,20.6,46,25,16,23,7,24,50,48,26,39,9,30,18,64,32,0,"https://fbref.com/en/players/3312f911/Jeffrey-Schlupp"
2022,"Crystal Palace","Premier League","James Tomkins","ENG","DF","32",1989,6.1,8,3,6,2,0,6,8,75,2,8,8,0,4,12,18,0,"https://fbref.com/en/players/e7ca0439/James-Tomkins"
2022,"Crystal Palace","Premier League","Joel Ward","ENG","DF","31",1989,27.6,44,26,30,11,3,30,57,52.6,27,24,11,13,32,76,107,1,"https://fbref.com/en/players/8a7ff278/Joel-Ward"
2022,"Crystal Palace","Premier League","Wilfried Zaha","CIV","FW","28",1992,30.7,40,20,14,15,11,10,31,32.3,21,28,0,28,5,45,5,0,"https://fbref.com/en/players/b2bc3b1f/Wilfried-Zaha"
2022,"Cádiz","La Liga","Carlos Akapo","EQG","DF","28",1993,20.5,43,31,26,15,2,21,37,56.8,16,26,7,19,51,94,61,0,"https://fbref.com/en/players/f2a68b97/Carlos-Akapo"
2022,"Cádiz","La Liga","Tomás Alarcón","CHI","MF","22",1999,15.8,31,20,17,10,4,10,31,32.3,21,19,7,12,30,61,31,0,"https://fbref.com/en/players/99ea2ddd/Tomas-Alarcon"
2022,"Cádiz","La Liga","Rubén Alcaraz","ESP","MF","30",1991,12.3,41,20,14,24,3,22,45,48.9,23,10,2,8,13,54,14,0,"https://fbref.com/en/players/036bba5f/Ruben-Alcaraz"
2022,"Cádiz","La Liga","Iván Alejo","ESP","MF,FW","26",1995,11.8,33,15,21,10,2,15,44,34.1,29,12,0,12,8,41,17,0,"https://fbref.com/en/players/3d7e48ce/Ivan-Alejo"
2022,"Cádiz","La Liga","Florin Andone","ROU","FW","28",1993,2,1,1,1,0,0,0,1,0,1,2,0,2,0,1,1,0,"https://fbref.com/en/players/dc008610/Florin-Andone"
2022,"Cádiz","La Liga","Santiago Arzamendia","PAR","MF","23",1998,5.2,14,6,6,5,3,6,13,46.2,7,6,0,6,4,18,7,0,"https://fbref.com/en/players/759d8dd7/Santiago-Arzamendia"
2022,"Cádiz","La Liga","Álvaro Bastida","ESP","MF","17",2004,2.2,7,4,2,4,1,4,5,80,1,1,0,1,3,10,1,0,"https://fbref.com/en/players/42a028c5/Alvaro-Bastida"
2022,"Cádiz","La Liga","Pedro Benito","ESP","FW","21",2000,0.3,0,0,0,0,0,0,1,0,1,0,0,0,0,0,0,0,"https://fbref.com/en/players/a7416105/Pedro-Benito"
2022,"Cádiz","La Liga","Cala","ESP","DF","31",1989,10.5,9,4,9,0,0,8,17,47.1,9,12,6,6,12,21,56,0,"https://fbref.com/en/players/fe05804b/Cala"
2022,"Cádiz","La Liga","Isaac Carcelen","ESP","DF,MF","28",1993,17.2,43,29,29,12,2,28,56,50,28,25,6,19,34,77,42,0,"https://fbref.com/en/players/c4b888df/Isaac-Carcelen"
2022,"Cádiz","La Liga","Chapela","ESP","MF,FW","22",1999,4.4,4,2,1,0,3,2,4,50,2,6,1,5,4,8,5,0,"https://fbref.com/en/players/9ed40a69/Chapela"
2022,"Cádiz","La Liga","Víctor Chust","ESP","DF","21",2000,20.3,19,10,14,4,1,11,17,64.7,6,20,8,12,16,35,87,0,"https://fbref.com/en/players/ec1a731e/Victor-Chust"
2022,"Cádiz","La Liga","Alfonso Espino","URU","DF","29",1992,37,107,63,58,39,10,44,112,39.3,68,45,10,35,54,161,87,1,"https://fbref.com/en/players/db001fa9/Alfonso-Espino"
2022,"Cádiz","La Liga","Fali","ESP","DF,MF","27",1993,20,32,19,24,8,0,17,32,53.1,15,26,16,10,24,56,82,0,"https://fbref.com/en/players/72a84002/Fali"
2022,"Cádiz","La Liga","Álex Fernández","ESP","MF","28",1992,22.8,47,31,22,17,8,21,61,34.4,40,30,7,23,30,77,31,0,"https://fbref.com/en/players/aa677a35/Alex-Fernandez"
2022,"Cádiz","La Liga","Marcos Mauro López Gutiérrez","ARG","DF","30",1991,1.5,1,0,0,1,0,0,2,0,2,2,1,1,1,2,9,0,"https://fbref.com/en/players/b3b62f94/Marcos-Mauro-Lopez-Gutierrez"
2022,"Cádiz","La Liga","Varazdat Haroyan","ARM","DF","28",1992,16,31,21,20,10,1,19,29,65.5,10,22,12,10,15,46,62,0,"https://fbref.com/en/players/be32269e/Varazdat-Haroyan"
2022,"Cádiz","La Liga","Luis Hernández","ESP","DF","32",1989,15.2,9,5,9,0,0,5,8,62.5,3,5,3,2,16,25,34,0,"https://fbref.com/en/players/02d2c436/Luis-Hernandez"
2022,"Cádiz","La Liga","Oussama Idrissi","MAR","MF","25",1996,10,8,4,3,4,1,4,15,26.7,11,8,0,8,3,11,5,0,"https://fbref.com/en/players/34caa4b3/Oussama-Idrissi"
2022,"Cádiz","La Liga","Álvaro Jiménez","ESP","MF,FW","26",1995,2.6,6,3,3,2,1,4,7,57.1,3,3,0,3,3,9,0,0,"https://fbref.com/en/players/5f5501ed/Alvaro-Jimenez"
2022,"Cádiz","La Liga","Jens Jønsson","DEN","MF","28",1993,14.5,40,29,22,17,1,17,35,48.6,18,17,7,10,34,74,32,0,"https://fbref.com/en/players/53520a67/Jens-Jonsson"
2022,"Cádiz","La Liga","Jeremías Ledesma","ARG","GK","28",1993,38,3,1,3,0,0,3,4,75,1,0,0,0,1,4,21,4,"https://fbref.com/en/players/6c4776b1/Jeremias-Ledesma"
2022,"Cádiz","La Liga","Anthony Lozano","HON","FW,MF","28",1993,18.6,8,4,2,3,3,5,18,27.8,13,16,2,14,2,10,7,0,"https://fbref.com/en/players/38699c72/Anthony-Lozano"
2022,"Cádiz","La Liga","José Mari","ESP","MF","33",1987,4.3,14,7,3,10,1,7,8,87.5,1,4,1,3,7,21,2,0,"https://fbref.com/en/players/6f4c734d/Jose-Mari"
2022,"Cádiz","La Liga","Martín","ESP","MF","22",1999,1.3,2,2,0,2,0,0,0,NA,0,1,0,1,1,3,3,0,"https://fbref.com/en/players/cbec0059/Martin"
2022,"Cádiz","La Liga","Álvaro Negredo","ESP","FW","35",1985,24,5,3,1,4,0,3,6,50,3,11,5,6,2,7,23,0,"https://fbref.com/en/players/63b0ca6b/Alvaro-Negredo"
2022,"Cádiz","La Liga","Milutin Osmajić","MNE","FW,MF","22",1999,2.9,1,1,0,1,0,0,0,NA,0,0,0,0,1,2,3,0,"https://fbref.com/en/players/375ed9d7/Milutin-Osmajic"
2022,"Cádiz","La Liga","Raúl Parra","ESP","DF","21",1999,1,2,1,2,0,0,1,3,33.3,2,0,0,0,0,2,5,0,"https://fbref.com/en/players/647d39d2/Raul-Parra"
2022,"Cádiz","La Liga","Alberto Perea","ESP","MF","30",1990,8.6,19,9,7,9,3,6,20,30,14,15,1,14,9,28,4,0,"https://fbref.com/en/players/5496cc91/Alberto-Perea"
2022,"Cádiz","La Liga","Lucas Pérez","ESP","FW,MF","32",1988,11.8,3,3,2,1,0,0,10,0,10,3,1,2,0,3,1,0,"https://fbref.com/en/players/a300ac7e/Lucas-Perez"
2022,"Cádiz","La Liga","Salvi","ESP","MF,FW","30",1991,15.5,20,10,9,8,3,8,20,40,12,17,2,15,6,26,11,0,"https://fbref.com/en/players/405f267a/Salvi"
2022,"Cádiz","La Liga","Fede San Emeterio","ESP","MF","24",1997,9.2,16,5,5,8,3,5,15,33.3,10,5,0,5,8,24,6,0,"https://fbref.com/en/players/efecd633/Fede-San-Emeterio"
2022,"Cádiz","La Liga","Rubén Sobrino","ESP","FW,MF","29",1992,20.7,28,17,11,10,7,5,35,14.3,30,21,1,20,21,49,18,0,"https://fbref.com/en/players/19b776e9/Ruben-Sobrino"
2022,"Dortmund","Bundesliga","Manuel Akanji","SUI","DF","26",1995,25.1,33,23,20,11,2,22,32,68.8,10,26,15,11,35,68,58,0,"https://fbref.com/en/players/89ac64a6/Manuel-Akanji"
2022,"Dortmund","Bundesliga","Jude Bellingham","ENG","MF","18",2003,31,52,34,15,31,6,21,53,39.6,32,50,4,46,42,94,32,0,"https://fbref.com/en/players/57d88cf9/Jude-Bellingham"
2022,"Dortmund","Bundesliga","Julian Brandt","GER","MF,FW","25",1996,23.1,37,19,13,20,4,17,54,31.5,37,19,2,17,24,61,14,1,"https://fbref.com/en/players/a167537f/Julian-Brandt"
2022,"Dortmund","Bundesliga","Roman Bürki","SUI","GK","30",1990,1,0,0,0,0,0,0,0,NA,0,0,0,0,0,0,0,0,"https://fbref.com/en/players/9d12e142/Roman-Burki"
2022,"Dortmund","Bundesliga","Jamie Bynoe-Gittens","ENG","FW","16",2004,1.5,3,2,0,2,1,2,5,40,3,4,1,3,1,4,1,0,"https://fbref.com/en/players/10745192/Jamie-Bynoe-Gittens"
2022,"Dortmund","Bundesliga","Emre Can","GER","DF,MF","27",1994,18.8,36,22,20,16,0,15,30,50,15,26,10,16,36,72,40,2,"https://fbref.com/en/players/a65ce836/Emre-Can"
2022,"Dortmund","Bundesliga","Mahmoud Dahoud","GER","MF","25",1996,18.4,42,19,10,24,8,20,46,43.5,26,18,3,15,17,59,16,0,"https://fbref.com/en/players/db4ed67b/Mahmoud-Dahoud"
2022,"Dortmund","Bundesliga","Thomas Delaney","DEN","MF","29",1991,0.2,0,0,0,0,0,0,0,NA,0,0,0,0,0,0,0,0,"https://fbref.com/en/players/fe641c1a/Thomas-Delaney"
2022,"Dortmund","Bundesliga","Raphaël Guerreiro","POR","DF","27",1993,19.9,35,19,19,12,4,16,31,51.6,15,18,2,16,25,60,14,1,"https://fbref.com/en/players/048a1cbc/Raphael-Guerreiro"
2022,"Dortmund","Bundesliga","Erling Haaland","NOR","FW","21",2000,21.2,2,1,0,1,1,0,1,0,1,8,1,7,1,3,31,0,"https://fbref.com/en/players/1f44ac21/Erling-Haaland"
2022,"Dortmund","Bundesliga","Thorgan Hazard","BEL","FW,DF","28",1993,14.9,23,13,8,10,5,15,40,37.5,25,23,1,22,6,29,4,0,"https://fbref.com/en/players/50871bcc/Thorgan-Hazard"
2022,"Dortmund","Bundesliga","Marwin Hitz","SUI","GK","33",1987,4.5,0,0,0,0,0,0,0,NA,0,0,0,0,0,0,2,0,"https://fbref.com/en/players/2e7ff968/Marwin-Hitz"
2022,"Dortmund","Bundesliga","Mats Hummels","GER","DF","32",1988,19.6,34,22,20,13,1,20,36,55.6,16,18,13,5,32,66,66,1,"https://fbref.com/en/players/05d548d8/Mats-Hummels"
2022,"Dortmund","Bundesliga","Ansgar Knauff","GER","FW,MF","19",2002,1.3,3,1,1,1,1,0,4,0,4,2,0,2,0,3,4,0,"https://fbref.com/en/players/19a967ab/Ansgar-Knauff"
2022,"Dortmund","Bundesliga","Gregor Kobel","SUI","GK","23",1997,28.5,0,0,0,0,0,0,2,0,2,0,0,0,1,1,20,0,"https://fbref.com/en/players/cd59b9df/Gregor-Kobel"
2022,"Dortmund","Bundesliga","Donyell Malen","NED","FW","22",1999,18.7,13,10,4,5,4,7,13,53.8,6,10,0,10,10,23,11,0,"https://fbref.com/en/players/864163f3/Donyell-Malen"
2022,"Dortmund","Bundesliga","Lennard Maloney","USA","DF","21",1999,0.1,1,0,1,0,0,1,1,100,0,0,0,0,0,1,0,0,"https://fbref.com/en/players/75402e99/Lennard-Maloney"
2022,"Dortmund","Bundesliga","Thomas Meunier","BEL","DF","29",1991,15.6,29,19,13,12,4,16,33,48.5,17,10,2,8,12,41,25,1,"https://fbref.com/en/players/e162b013/Thomas-Meunier"
2022,"Dortmund","Bundesliga","Youssoufa Moukoko","GER","FW,MF","16",2004,2.5,1,0,0,1,0,0,1,0,1,5,0,5,3,4,0,0,"https://fbref.com/en/players/6ce43701/Youssoufa-Moukoko"
2022,"Dortmund","Bundesliga","Antonios Papadopoulos","GER","DF,MF","21",1999,0.2,0,0,0,0,0,0,0,NA,0,1,0,1,0,0,0,0,"https://fbref.com/en/players/13d23b29/Antonios-Papadopoulos"
2022,"Dortmund","Bundesliga","Felix Passlack","GER","DF","23",1998,5.2,13,9,8,4,1,6,12,50,6,5,1,4,4,17,7,0,"https://fbref.com/en/players/5c899683/Felix-Passlack"
2022,"Dortmund","Bundesliga","Immanuel Pherai","NED","MF","20",2001,0,0,0,0,0,0,0,0,NA,0,0,0,0,0,0,0,0,"https://fbref.com/en/players/f168d9b9/Immanuel-Pherai"
2022,"Dortmund","Bundesliga","Marin Pongračić","CRO","DF","23",1997,9.2,17,10,13,4,0,6,10,60,4,11,5,6,17,34,32,2,"https://fbref.com/en/players/2a6cd437/Marin-Pongracic"
2022,"Dortmund","Bundesliga","Reinier","BRA","FW,MF","19",2002,1.8,5,3,4,0,1,1,1,100,0,3,0,3,0,5,0,0,"https://fbref.com/en/players/6b21b7b5/Reinier"
2022,"Dortmund","Bundesliga","Marco Reus","GER","MF,FW","32",1989,27.8,45,30,13,21,11,16,42,38.1,26,23,6,17,12,57,41,1,"https://fbref.com/en/players/36a3ff67/Marco-Reus"
2022,"Dortmund","Bundesliga","Gio Reyna","USA","MF","18",2002,4.9,7,4,2,4,1,3,9,33.3,6,6,0,6,1,8,3,0,"https://fbref.com/en/players/7fa4e703/Gio-Reyna"
2022,"Dortmund","Bundesliga","Tom Rothe","GER","DF","16",2004,1,4,3,2,2,0,3,6,50,3,2,0,2,2,6,3,0,"https://fbref.com/en/players/90c1f9a4/Tom-Rothe"
2022,"Dortmund","Bundesliga","Nico Schulz","GER","DF","28",1993,9.3,21,12,9,7,5,9,21,42.9,12,8,1,7,11,32,8,0,"https://fbref.com/en/players/fa274d97/Nico-Schulz"
2022,"Dortmund","Bundesliga","Lion Semić","GER","DF","17",2003,0,0,0,0,0,0,0,0,NA,0,0,0,0,0,0,0,0,"https://fbref.com/en/players/87ebd8c9/Lion-Semic"
2022,"Dortmund","Bundesliga","Steffen Tigges","GER","FW,MF","23",1998,1.2,4,3,1,2,1,2,3,66.7,1,3,1,2,0,4,3,0,"https://fbref.com/en/players/6b8887c2/Steffen-Tigges"
2022,"Dortmund","Bundesliga","Axel Witsel","BEL","MF,DF","32",1989,21.6,42,27,12,23,7,18,30,60,12,24,9,15,27,69,38,0,"https://fbref.com/en/players/5dfc6ad5/Axel-Witsel"
2022,"Dortmund","Bundesliga","Marius Wolf","GER","DF,FW","26",1995,14.7,26,10,13,9,4,12,24,50,12,14,1,13,13,39,8,0,"https://fbref.com/en/players/fa661778/Marius-Wolf"
2022,"Dortmund","Bundesliga","Dan-Axel Zagadou","FRA","DF","22",1999,10.6,13,7,11,1,1,7,10,70,3,14,4,10,15,28,38,2,"https://fbref.com/en/players/a4effc55/Dan-Axel-Zagadou"
2022,"Eint Frankfurt","Bundesliga","Ragnar Ache","GER","MF,FW","23",1998,2.9,2,0,0,1,1,1,4,25,3,3,0,3,0,2,1,0,"https://fbref.com/en/players/dc38e3bc/Ragnar-Ache"
2022,"Eint Frankfurt","Bundesliga","Aymen Barkok","MAR","MF,DF","23",1998,1.8,6,2,2,3,1,2,7,28.6,5,4,1,3,5,11,6,0,"https://fbref.com/en/players/a2a85828/Aymen-Barkok"
2022,"Eint Frankfurt","Bundesliga","Rafael Borré","COL","FW","25",1995,26.4,31,22,4,13,14,7,33,21.2,26,24,4,20,5,36,9,0,"https://fbref.com/en/players/c68da769/Rafael-Borre"
2022,"Eint Frankfurt","Bundesliga","Timothy Chandler","USA","DF","31",1990,13.5,18,12,10,8,0,11,24,45.8,13,10,3,7,19,37,28,1,"https://fbref.com/en/players/b3b7f5a6/Timothy-Chandler"
2022,"Eint Frankfurt","Bundesliga","Danny da Costa","GER","DF,MF","28",1993,8.1,15,4,6,7,2,6,18,33.3,12,14,1,13,11,26,18,1,"https://fbref.com/en/players/5ddb8f9f/Danny-da-Costa"
2022,"Eint Frankfurt","Bundesliga","Erik Durm","GER","DF","29",1992,5.3,13,7,6,5,2,10,13,76.9,3,8,1,7,10,23,7,0,"https://fbref.com/en/players/cf623c78/Erik-Durm"
2022,"Eint Frankfurt","Bundesliga","Jens Grahl","GER","GK","32",1988,1,0,0,0,0,0,0,0,NA,0,0,0,0,0,0,1,0,"https://fbref.com/en/players/f26dee6b/Jens-Grahl"
2022,"Eint Frankfurt","Bundesliga","Makoto Hasebe","JPN","DF","37",1984,13.2,27,12,15,11,1,13,29,44.8,16,24,8,16,22,49,36,0,"https://fbref.com/en/players/9ab16552/Makoto-Hasebe"
2022,"Eint Frankfurt","Bundesliga","Martin Hinteregger","AUT","DF","28",1992,24.7,45,28,28,16,1,28,43,65.1,15,36,16,20,42,87,78,3,"https://fbref.com/en/players/080440a4/Martin-Hinteregger"
2022,"Eint Frankfurt","Bundesliga","Ajdin Hrustic","AUS","MF","25",1996,10.7,16,11,5,7,4,11,32,34.4,21,18,1,17,10,26,7,0,"https://fbref.com/en/players/1f2d714c/Ajdin-Hrustic"
2022,"Eint Frankfurt","Bundesliga","Stefan Ilsanker","AUT","DF,MF","32",1989,3,14,8,7,6,1,5,10,50,5,6,2,4,6,20,15,1,"https://fbref.com/en/players/8494acc4/Stefan-Ilsanker"
2022,"Eint Frankfurt","Bundesliga","Kristijan Jakić","CRO","MF","24",1997,20.9,37,22,10,21,6,15,62,24.2,47,33,3,30,21,58,25,1,"https://fbref.com/en/players/a8ee54ad/Kristijan-Jakic"
2022,"Eint Frankfurt","Bundesliga","Daichi Kamada","JPN","MF","24",1996,23.8,40,21,7,26,7,11,40,27.5,29,18,0,18,8,48,10,0,"https://fbref.com/en/players/15b287da/Daichi-Kamada"
2022,"Eint Frankfurt","Bundesliga","Ansgar Knauff","GER","DF,MF","19",2002,8.4,18,14,8,5,5,8,15,53.3,7,11,1,10,8,26,6,0,"https://fbref.com/en/players/19a967ab/Ansgar-Knauff"
2022,"Eint Frankfurt","Bundesliga","Filip Kostić","SRB","DF,FW","28",1992,28,44,17,26,9,9,20,53,37.7,33,24,1,23,15,59,24,0,"https://fbref.com/en/players/b1cd37e6/Filip-Kostic"
2022,"Eint Frankfurt","Bundesliga","Sam Lammers","NED","FW,MF","24",1997,5.7,4,4,0,2,2,2,6,33.3,4,9,2,7,2,6,4,0,"https://fbref.com/en/players/c283ddef/Sam-Lammers"
2022,"Eint Frankfurt","Bundesliga","Christopher Lenz","GER","DF","26",1994,7.4,29,15,22,6,1,12,21,57.1,9,9,4,5,7,36,21,0,"https://fbref.com/en/players/bbd86530/Christopher-Lenz"
2022,"Eint Frankfurt","Bundesliga","Jesper Lindstrøm","DEN","MF,FW","21",2000,22,28,13,6,13,9,12,36,33.3,24,30,0,30,24,52,11,1,"https://fbref.com/en/players/37dc1a48/Jesper-Lindstrom"
2022,"Eint Frankfurt","Bundesliga","Obite N'Dicka","FRA","DF","21",1999,31.7,60,34,29,27,4,44,59,74.6,15,46,20,26,48,108,137,0,"https://fbref.com/en/players/441197b8/Obite-NDicka"
2022,"Eint Frankfurt","Bundesliga","Gonçalo Paciência","POR","FW","26",1994,5.7,4,2,2,1,1,1,3,33.3,2,2,0,2,1,5,4,0,"https://fbref.com/en/players/962e54cb/Goncalo-Paciencia"
2022,"Eint Frankfurt","Bundesliga","Jens Petter Hauge","NOR","MF,FW","21",1999,11.6,14,5,6,7,1,7,23,30.4,16,7,0,7,3,17,5,0,"https://fbref.com/en/players/12c35abe/Jens-Petter-Hauge"
2022,"Eint Frankfurt","Bundesliga","Diant Ramaj","GER","GK","19",2001,1,0,0,0,0,0,0,0,NA,0,0,0,0,0,0,3,0,"https://fbref.com/en/players/b90c4a43/Diant-Ramaj"
2022,"Eint Frankfurt","Bundesliga","Sebastian Rode","GER","MF","30",1990,8.4,15,7,5,8,2,5,17,29.4,12,11,1,10,13,28,8,0,"https://fbref.com/en/players/e12b0b5b/Sebastian-Rode"
2022,"Eint Frankfurt","Bundesliga","Djibril Sow","SUI","MF","24",1997,26.8,57,33,28,25,4,22,60,36.7,38,35,8,27,50,107,20,1,"https://fbref.com/en/players/4c6facae/Djibril-Sow"
2022,"Eint Frankfurt","Bundesliga","Almamy Touré","MLI","DF,MF","25",1996,5.6,12,9,8,3,1,4,17,23.5,13,10,3,7,5,17,19,0,"https://fbref.com/en/players/c8c60119/Almamy-Toure"
2022,"Eint Frankfurt","Bundesliga","Kevin Trapp","GER","GK","31",1990,32,0,0,0,0,0,0,1,0,1,0,0,0,1,1,13,2,"https://fbref.com/en/players/ce17b5eb/Kevin-Trapp"
2022,"Eint Frankfurt","Bundesliga","Tuta","BRA","DF","22",1999,24.3,46,28,20,22,4,26,47,55.3,21,43,15,28,41,87,76,1,"https://fbref.com/en/players/35d64857/Tuta"
2022,"Elche","La Liga","Édgar Badía","ESP","GK","29",1992,24,0,0,0,0,0,0,0,NA,0,0,0,0,0,0,16,2,"https://fbref.com/en/players/e4346678/Edgar-Badia"
2022,"Elche","La Liga","Antonio Barragán","ESP","DF","34",1987,11.3,21,14,13,7,1,11,17,64.7,6,5,3,2,17,38,34,0,"https://fbref.com/en/players/487d9b09/Antonio-Barragan"
2022,"Elche","La Liga","Darío Benedetto","ARG","FW,MF","31",1990,6.6,5,1,2,2,1,3,6,50,3,4,0,4,1,6,1,0,"https://fbref.com/en/players/bef0a7ac/Dario-Benedetto"
2022,"Elche","La Liga","Pedro Bigas","ESP","DF","30",1990,17.2,24,10,16,8,0,9,20,45,11,21,16,5,18,42,77,1,"https://fbref.com/en/players/697295b1/Pedro-Bigas"
2022,"Elche","La Liga","Lucas Boyé","ARG","FW","25",1996,19,27,13,5,15,7,9,24,37.5,15,24,1,23,2,29,23,0,"https://fbref.com/en/players/d49f3e6b/Lucas-Boye"
2022,"Elche","La Liga","Guido Carrillo","ARG","FW","30",1991,13,7,4,2,4,1,3,13,23.1,10,9,2,7,1,8,27,0,"https://fbref.com/en/players/8f898ba8/Guido-Carrillo"
2022,"Elche","La Liga","Kiko Casilla","ESP","GK","34",1986,14,0,0,0,0,0,0,1,0,1,0,0,0,1,1,2,2,"https://fbref.com/en/players/58bc7d18/Kiko-Casilla"
2022,"Elche","La Liga","John Donald","ESP","DF","20",2000,2,7,4,4,2,1,5,8,62.5,3,5,3,2,3,10,3,0,"https://fbref.com/en/players/5e95c000/John-Donald"
2022,"Elche","La Liga","Fidel","ESP","MF","31",1989,25.1,44,23,18,17,9,14,57,24.6,43,9,1,8,7,51,20,0,"https://fbref.com/en/players/eb82b6f1/Fidel"
2022,"Elche","La Liga","Diego González","ESP","DF","26",1995,19.9,25,16,18,7,0,9,16,56.3,7,21,13,8,19,44,87,0,"https://fbref.com/en/players/4ac7608e/Diego-Gonzalez"
2022,"Elche","La Liga","Gerard Gumbau","ESP","MF","26",1994,21,46,19,22,19,5,22,51,43.1,29,18,4,14,23,69,25,0,"https://fbref.com/en/players/ac454a4f/Gerard-Gumbau"
2022,"Elche","La Liga","Raúl Guti","ESP","MF","24",1996,18.1,25,15,7,14,4,10,30,33.3,20,9,3,6,25,50,7,0,"https://fbref.com/en/players/0b2c8585/Raul-Guti"
2022,"Elche","La Liga","Josan","ESP","DF,MF","31",1989,13.5,36,22,23,9,4,26,44,59.1,18,11,4,7,10,46,21,0,"https://fbref.com/en/players/5b28b2f6/Josan"
2022,"Elche","La Liga","Josema","ESP","DF","25",1996,2,3,2,1,1,1,0,2,0,2,1,1,0,0,3,11,0,"https://fbref.com/en/players/ed3f5f4c/Josema"
2022,"Elche","La Liga","Iván Marcone","ARG","MF","31",1990,9,24,14,17,6,1,12,24,50,12,8,3,5,12,36,13,0,"https://fbref.com/en/players/b14f755d/Ivan-Marcone"
2022,"Elche","La Liga","Omar Mascarell","ESP","MF","28",1993,27.7,46,26,16,23,7,24,60,40,36,42,14,28,48,94,52,2,"https://fbref.com/en/players/11fd2b75/Omar-Mascarell"
2022,"Elche","La Liga","Pere Milla","ESP","MF,FW","28",1992,18.3,20,15,14,5,1,8,44,18.2,36,21,1,20,5,25,21,0,"https://fbref.com/en/players/335039a2/Pere-Milla"
2022,"Elche","La Liga","Johan Mojica","COL","DF","28",1992,31.7,46,25,34,7,5,23,31,74.2,8,22,3,19,25,71,61,3,"https://fbref.com/en/players/608f2092/Johan-Mojica"
2022,"Elche","La Liga","Tete Morente","ESP","MF","24",1996,18.1,21,14,13,7,1,7,28,25,21,30,1,29,12,33,12,0,"https://fbref.com/en/players/004d185e/Tete-Morente"
2022,"Elche","La Liga","Lucas Olaza","URU","DF","27",1994,3.3,5,3,3,1,1,1,1,100,0,5,1,4,4,9,6,0,"https://fbref.com/en/players/4cee5954/Lucas-Olaza"
2022,"Elche","La Liga","Helibelton Palacios","COL","DF","28",1993,21.5,69,38,56,10,3,37,55,67.3,18,21,8,13,18,87,61,0,"https://fbref.com/en/players/ac8b2421/Helibelton-Palacios"
2022,"Elche","La Liga","Javier Pastore","ARG","MF,FW","32",1989,5.8,7,3,3,2,2,3,12,25,9,5,1,4,4,11,2,0,"https://fbref.com/en/players/881ef58c/Javier-Pastore"
2022,"Elche","La Liga","Kike Pérez","ESP","MF,FW","24",1997,5.8,8,6,1,3,4,0,10,0,10,6,1,5,3,11,4,0,"https://fbref.com/en/players/237a3851/Kike-Perez"
2022,"Elche","La Liga","Lucas Pérez","ESP","FW","32",1988,14.1,4,1,2,1,1,3,10,30,7,2,0,2,3,7,4,0,"https://fbref.com/en/players/a300ac7e/Lucas-Perez"
2022,"Elche","La Liga","Pablo Piatti","ARG","MF,FW","32",1989,3.5,9,4,5,3,1,3,8,37.5,5,5,1,4,2,11,3,0,"https://fbref.com/en/players/48e89655/Pablo-Piatti"
2022,"Elche","La Liga","Ezequiel Ponce","ARG","FW","24",1997,7.4,5,4,1,3,1,3,10,30,7,5,0,5,1,6,7,0,"https://fbref.com/en/players/ccbbe661/Ezequiel-Ponce"
2022,"Elche","La Liga","Enzo Roco","CHI","DF","28",1992,28.4,36,20,24,11,1,15,24,62.5,9,38,27,11,28,64,110,3,"https://fbref.com/en/players/37f827ec/Enzo-Roco"
2022,"Elche","La Liga","Gonzalo Verdú","ESP","DF","32",1988,15.5,19,9,15,4,0,8,16,50,8,20,14,6,13,32,59,1,"https://fbref.com/en/players/1c2c55fc/Gonzalo-Verdu"
2022,"Empoli","Serie A","Kristjan Asllani","ALB","MF","19",2002,15,18,9,9,8,1,11,29,37.9,18,16,7,9,19,37,15,1,"https://fbref.com/en/players/0fdcef0e/Kristjan-Asllani"
2022,"Empoli","Serie A","Nedim Bajrami","ALB","MF,FW","22",1999,22.8,21,14,5,13,3,4,14,28.6,10,11,0,11,3,24,8,0,"https://fbref.com/en/players/f42d6c13/Nedim-Bajrami"
2022,"Empoli","Serie A","Tommaso Baldanzi","ITA","FW","18",2003,0.2,0,0,0,0,0,0,0,NA,0,1,0,1,0,0,0,0,"https://fbref.com/en/players/102e2599/Tommaso-Baldanzi"
2022,"Empoli","Serie A","Filippo Bandinelli","ITA","MF","26",1995,21.7,33,20,10,17,6,15,31,48.4,16,22,5,17,10,43,37,2,"https://fbref.com/en/players/d44360be/Filippo-Bandinelli"
2022,"Empoli","Serie A","Marco Benassi","ITA","MF","26",1994,4.2,6,3,3,2,1,1,10,10,9,4,0,4,3,9,6,0,"https://fbref.com/en/players/0000acda/Marco-Benassi"
2022,"Empoli","Serie A","Liberato Cacace","NZL","DF","20",2000,5.2,15,6,8,4,3,8,8,100,0,7,2,5,8,23,9,0,"https://fbref.com/en/players/dd86e8e4/Liberato-Cacace"
2022,"Empoli","Serie A","Giovanni Crociata","ITA","FW","23",1997,0.2,0,0,0,0,0,0,1,0,1,0,0,0,0,0,0,0,"https://fbref.com/en/players/8c964914/Giovanni-Crociata"
2022,"Empoli","Serie A","Patrick Cutrone","ITA","FW","23",1998,15.6,5,2,0,3,2,1,9,11.1,8,11,1,10,5,10,1,0,"https://fbref.com/en/players/a4fe8cda/Patrick-Cutrone"
2022,"Empoli","Serie A","Federico Di Francesco","ITA","FW,MF","27",1994,15.2,16,5,2,8,6,9,23,39.1,14,17,1,16,9,25,11,0,"https://fbref.com/en/players/1fca9171/Federico-Di-Francesco"
2022,"Empoli","Serie A","Riccardo Fiamozzi","ITA","DF","28",1993,6.9,7,5,2,2,3,2,4,50,2,6,5,1,7,14,12,0,"https://fbref.com/en/players/9f9b9269/Riccardo-Fiamozzi"
2022,"Empoli","Serie A","Nicolas Haas","SUI","MF","25",1996,11.1,35,22,15,10,10,17,39,43.6,22,24,4,20,9,44,17,1,"https://fbref.com/en/players/fa449bba/Nicolas-Haas"
2022,"Empoli","Serie A","Liam Henderson","SCO","MF","25",1996,22.4,22,13,7,8,7,9,31,29,22,14,4,10,9,31,13,0,"https://fbref.com/en/players/d7918b13/Liam-Henderson"
2022,"Empoli","Serie A","Ardian Ismajli","ALB","DF","24",1996,14.1,13,9,8,4,1,5,14,35.7,9,21,11,10,24,37,80,0,"https://fbref.com/en/players/6b635f5c/Ardian-Ismajli"
2022,"Empoli","Serie A","Andrea La Mantia","ITA","FW,MF","30",1991,5.4,2,0,0,0,2,1,2,50,1,3,1,2,1,3,6,0,"https://fbref.com/en/players/c375dfa5/Andrea-La-Mantia"
2022,"Empoli","Serie A","Sebastiano Luperto","ITA","DF","24",1996,21.8,29,17,17,10,2,10,20,50,10,32,26,6,45,74,132,0,"https://fbref.com/en/players/997fff07/Sebastiano-Luperto"
2022,"Empoli","Serie A","Leonardo Mancuso","ITA","FW","29",1992,4.7,1,1,0,1,0,0,6,0,6,2,0,2,1,2,2,0,"https://fbref.com/en/players/311027cb/Leonardo-Mancuso"
2022,"Empoli","Serie A","Riccardo Marchizza","ITA","DF","23",1998,15,21,15,11,8,2,11,16,68.8,5,15,6,9,10,31,24,0,"https://fbref.com/en/players/91d0fabf/Riccardo-Marchizza"
2022,"Empoli","Serie A","Fabiano Parisi","ITA","DF","20",2000,16.4,35,19,25,5,5,13,31,41.9,18,30,10,20,22,57,42,0,"https://fbref.com/en/players/0967845b/Fabiano-Parisi"
2022,"Empoli","Serie A","Andrea Pinamonti","ITA","FW","22",1999,31.9,11,6,0,7,4,2,18,11.1,16,24,3,21,7,18,23,0,"https://fbref.com/en/players/08aa9cd1/Andrea-Pinamonti"
2022,"Empoli","Serie A","Samuele Ricci","ITA","MF","19",2001,17,33,19,17,13,3,20,34,58.8,14,24,5,19,31,64,18,0,"https://fbref.com/en/players/9823be92/Samuele-Ricci"
2022,"Empoli","Serie A","Simone Romagnoli","ITA","DF","31",1990,16.6,28,12,14,12,2,15,20,75,5,34,28,6,9,37,86,0,"https://fbref.com/en/players/09899de8/Simone-Romagnoli"
2022,"Empoli","Serie A","Petar Stojanović","SVN","DF","25",1995,30.4,96,63,55,32,9,59,114,51.8,55,39,13,26,27,123,65,1,"https://fbref.com/en/players/13b44b02/Petar-Stojanovic"
2022,"Empoli","Serie A","Leo Štulac","SVN","MF","26",1994,9.3,13,6,5,6,2,7,19,36.8,12,6,2,4,8,21,15,0,"https://fbref.com/en/players/92948398/Leo-Stulac"
2022,"Empoli","Serie A","Lorenzo Tonelli","ITA","DF","31",1990,9.7,17,9,11,4,2,6,13,46.2,7,14,8,6,19,36,28,2,"https://fbref.com/en/players/8cc29864/Lorenzo-Tonelli"
2022,"Empoli","Serie A","Valerio Verre","ITA","MF","27",1994,3.4,4,2,3,1,0,2,7,28.6,5,2,0,2,1,5,0,0,"https://fbref.com/en/players/33ecf462/Valerio-Verre"
2022,"Empoli","Serie A","Guglielmo Vicario","ITA","GK","24",1996,38,1,1,1,0,0,1,1,100,0,1,0,1,1,2,21,1,"https://fbref.com/en/players/77d6fd4d/Guglielmo-Vicario"
2022,"Empoli","Serie A","Mattia Viti","ITA","DF","19",2002,16.6,28,16,16,9,3,15,24,62.5,9,28,25,3,29,57,69,1,"https://fbref.com/en/players/75438a9a/Mattia-Viti"
2022,"Empoli","Serie A","Szymon Żurkowski","POL","MF","23",1997,25.6,58,33,24,21,13,29,68,42.6,39,43,10,33,35,93,32,1,"https://fbref.com/en/players/4e1d5e59/Szymon-Zurkowski"
2022,"Espanyol","La Liga","Keidi Bare","ALB","MF","23",1997,16.5,27,17,14,12,1,11,31,35.5,20,20,10,10,15,42,26,1,"https://fbref.com/en/players/03049c8c/Keidi-Bare"
2022,"Espanyol","La Liga","Leandro Cabrera","URU","DF","30",1991,37,37,24,27,10,0,21,34,61.8,13,32,23,9,44,81,222,2,"https://fbref.com/en/players/69cbc8b6/Leandro-Cabrera"
2022,"Espanyol","La Liga","Fernando Calero","ESP","DF","25",1995,12.1,17,10,12,5,0,8,13,61.5,5,7,2,5,16,33,63,1,"https://fbref.com/en/players/41b3069f/Fernando-Calero"
2022,"Espanyol","La Liga","Sergi Darder","ESP","MF","27",1993,34.7,45,22,16,19,10,18,54,33.3,36,16,1,15,26,71,32,1,"https://fbref.com/en/players/070a3904/Sergi-Darder"
2022,"Espanyol","La Liga","Landry Dimata","BEL","FW,MF","23",1997,6,2,2,1,1,0,1,4,25,3,0,0,0,1,3,7,0,"https://fbref.com/en/players/b5f63410/Landry-Dimata"
2022,"Espanyol","La Liga","Adri Embarba","ESP","FW,MF","29",1992,22.1,44,29,22,15,7,26,69,37.7,43,35,3,32,19,63,30,0,"https://fbref.com/en/players/db8f0eba/Adri-Embarba"
2022,"Espanyol","La Liga","Joan García","ESP","GK","20",2001,1.2,0,0,0,0,0,0,0,NA,0,0,0,0,1,1,1,2,"https://fbref.com/en/players/87b498b0/Joan-Garcia"
2022,"Espanyol","La Liga","Óscar Gil","ESP","DF","24",1997,18.8,52,35,27,20,5,25,46,54.3,21,33,9,24,19,71,33,2,"https://fbref.com/en/players/6652cf96/Oscar-Gil"
2022,"Espanyol","La Liga","Sergi Gómez","ESP","DF","29",1992,30.2,33,24,29,3,1,18,27,66.7,9,33,23,10,40,73,125,2,"https://fbref.com/en/players/bc6f5f06/Sergi-Gomez"
2022,"Espanyol","La Liga","Gori","ESP","MF","19",2002,0.1,0,0,0,0,0,0,0,NA,0,2,0,2,0,0,0,0,"https://fbref.com/en/players/f3451c66/Gori"
2022,"Espanyol","La Liga","Yangel Herrera","VEN","MF","23",1998,18.3,41,31,19,19,3,18,39,46.2,21,27,5,22,19,60,33,1,"https://fbref.com/en/players/e778654a/Yangel-Herrera"
2022,"Espanyol","La Liga","Jofre","ESP","MF,DF","20",2001,0.2,1,1,0,0,1,1,1,100,0,0,0,0,0,1,0,0,"https://fbref.com/en/players/030ef8d6/Jofre"
2022,"Espanyol","La Liga","Miguel Juan Llambrich","ESP","DF","25",1996,0.8,2,2,1,1,0,0,0,NA,0,1,0,1,0,2,5,0,"https://fbref.com/en/players/d83f09ff/Miguel-Juan-Llambrich"
2022,"Espanyol","La Liga","Luca Koleosho","CAN","FW","16",2004,0,0,0,0,0,0,0,0,NA,0,0,0,0,0,0,0,0,"https://fbref.com/en/players/fc076f78/Luca-Koleosho"
2022,"Espanyol","La Liga","Wu Lei","CHN","FW,MF","29",1991,5.3,3,2,1,2,0,3,8,37.5,5,4,0,4,4,7,3,0,"https://fbref.com/en/players/e3fabb0a/Wu-Lei"
2022,"Espanyol","La Liga","David López","ESP","MF,DF","31",1989,8.3,18,13,9,8,1,9,16,56.3,7,10,8,2,10,28,25,2,"https://fbref.com/en/players/f03f284b/David-Lopez"
2022,"Espanyol","La Liga","Diego López","ESP","GK","39",1981,35.3,0,0,0,0,0,0,2,0,2,0,0,0,1,1,21,1,"https://fbref.com/en/players/73683fa9/Diego-Lopez"
2022,"Espanyol","La Liga","Óscar Melendo","ESP","MF,FW","23",1997,11,11,5,4,4,3,3,13,23.1,10,4,1,3,1,12,10,0,"https://fbref.com/en/players/379652be/Oscar-Melendo"
2022,"Espanyol","La Liga","Fran Mérida","ESP","MF","31",1990,3,7,3,5,2,0,4,10,40,6,1,0,1,6,13,1,0,"https://fbref.com/en/players/0e50f929/Fran-Merida"
2022,"Espanyol","La Liga","Manu Morlanes","ESP","MF","22",1999,12.7,36,15,16,17,3,18,43,41.9,25,24,5,19,13,49,17,0,"https://fbref.com/en/players/a0255c67/Manu-Morlanes"
2022,"Espanyol","La Liga","Loren Morón","ESP","FW,MF","27",1993,6.3,6,4,1,3,2,0,12,0,12,11,1,10,2,8,9,0,"https://fbref.com/en/players/3aa4a3be/Loren-Moron"
2022,"Espanyol","La Liga","Oier Olazábal","ESP","GK","31",1989,1.5,0,0,0,0,0,0,0,NA,0,0,0,0,0,0,0,0,"https://fbref.com/en/players/b5bdf144/Oier-Olazabal"
2022,"Espanyol","La Liga","Pedrosa","ESP","DF","23",1998,30.2,58,30,38,14,6,26,57,45.6,31,25,7,18,25,83,92,2,"https://fbref.com/en/players/112521d1/Pedrosa"
2022,"Espanyol","La Liga","Victor Perea","ESP","DF","21",2000,0,0,0,0,0,0,0,0,NA,0,0,0,0,0,0,0,0,"https://fbref.com/en/players/b7de5bad/Victor-Perea"
2022,"Espanyol","La Liga","Javi Puado","ESP","MF,FW","23",1998,24.9,24,14,18,5,1,12,37,32.4,25,18,2,16,11,35,24,0,"https://fbref.com/en/players/2683eda7/Javi-Puado"
2022,"Espanyol","La Liga","Lluís Recasens","ESP","DF","19",2002,0.5,2,0,2,0,0,1,1,100,0,0,0,0,2,4,2,0,"https://fbref.com/en/players/c31ea173/Lluis-Recasens"
2022,"Espanyol","La Liga","Nico Ribaudo","ESP","MF,FW","20",2001,12.4,15,6,9,5,1,11,34,32.4,23,14,2,12,7,22,3,0,"https://fbref.com/en/players/ce8039aa/Nico-Ribaudo"
2022,"Espanyol","La Liga","Rubén","ESP","DF","20",2001,1.7,6,1,4,2,0,4,7,57.1,3,0,0,0,2,8,4,0,"https://fbref.com/en/players/35d4f151/Ruben"
2022,"Espanyol","La Liga","Raúl de Tomás","ESP","FW","26",1994,32.4,15,11,6,7,2,6,17,35.3,11,12,3,9,6,21,42,1,"https://fbref.com/en/players/02ef8778/Raul-de-Tomas"
2022,"Espanyol","La Liga","Álvaro Vadillo","ESP","DF,MF","26",1994,0.1,1,1,1,0,0,1,2,50,1,0,0,0,0,1,1,0,"https://fbref.com/en/players/61b62b33/Alvaro-Vadillo"
2022,"Espanyol","La Liga","Aleix Vidal","ESP","DF,MF","31",1989,21.1,31,25,17,9,5,19,39,48.7,20,19,6,13,25,56,35,2,"https://fbref.com/en/players/04965583/Aleix-Vidal"
2022,"Espanyol","La Liga","Dídac Vilà","ESP","DF,MF","32",1989,2.3,7,5,2,5,0,4,9,44.4,5,2,1,1,3,10,8,0,"https://fbref.com/en/players/bad38a94/Didac-Vila"
2022,"Espanyol","La Liga","Tonny Vilhena","NED","MF,FW","26",1995,10.3,16,6,7,8,1,7,21,33.3,14,10,2,8,8,24,17,0,"https://fbref.com/en/players/c7069d87/Tonny-Vilhena"
2022,"Espanyol","La Liga","Daniel Villahermosa","ESP","MF","20",2001,0.3,0,0,0,0,0,0,0,NA,0,0,0,0,0,0,1,0,"https://fbref.com/en/players/de903ae2/Daniel-Villahermosa"
2022,"Everton","Premier League","Allan","BRA","MF","30",1991,24.3,74,44,28,39,7,34,105,32.4,71,40,9,31,23,97,39,1,"https://fbref.com/en/players/cc700722/Allan"
2022,"Everton","Premier League","Dele Alli","ENG","MF,FW","25",1996,3.8,7,2,3,4,0,0,4,0,4,7,2,5,6,13,10,0,"https://fbref.com/en/players/cea4ee8f/Dele-Alli"
2022,"Everton","Premier League","Donny van de Beek","NED","MF","24",1997,5.4,15,7,8,6,1,6,13,46.2,7,6,2,4,6,21,4,0,"https://fbref.com/en/players/50dc94ce/Donny-van-de-Beek"
2022,"Everton","Premier League","Asmir Begović","BIH","GK","34",1987,3,0,0,0,0,0,0,0,NA,0,0,0,0,0,0,3,0,"https://fbref.com/en/players/7b4de647/Asmir-Begovic"
2022,"Everton","Premier League","Jarrad Branthwaite","ENG","DF","19",2002,4.3,4,1,3,1,0,3,8,37.5,5,3,2,1,1,5,20,0,"https://fbref.com/en/players/c1949191/Jarrad-Branthwaite"
2022,"Everton","Premier League","Dominic Calvert-Lewin","ENG","FW","24",1997,14.3,11,8,1,6,4,3,8,37.5,5,5,2,3,3,14,12,0,"https://fbref.com/en/players/59e6e5bf/Dominic-Calvert-Lewin"
2022,"Everton","Premier League","Séamus Coleman","IRL","DF","32",1988,29.5,61,36,35,16,10,33,51,64.7,18,30,11,19,32,93,80,2,"https://fbref.com/en/players/0420d84f/Seamus-Coleman"
2022,"Everton","Premier League","Tom Davies","ENG","MF","23",1998,2.6,3,1,1,1,1,2,5,40,3,2,1,1,2,5,9,0,"https://fbref.com/en/players/9228b07c/Tom-Davies"
2022,"Everton","Premier League","Fabian Delph","ENG","MF","31",1989,7.4,18,15,10,7,1,8,21,38.1,13,12,5,7,14,32,10,0,"https://fbref.com/en/players/111c3236/Fabian-Delph"
2022,"Everton","Premier League","Lucas Digne","FRA","DF","28",1993,13,33,19,26,4,3,21,28,75,7,16,5,11,14,47,30,0,"https://fbref.com/en/players/1b84dbe1/Lucas-Digne"
2022,"Everton","Premier League","Lewis Dobbin","ENG","FW,MF","18",2003,0.4,2,1,0,1,1,1,2,50,1,0,0,0,0,2,0,0,"https://fbref.com/en/players/e814e1cf/Lewis-Dobbin"
2022,"Everton","Premier League","Abdoulaye Doucouré","MLI","MF","28",1993,28.2,75,43,30,37,8,32,71,45.1,39,33,8,25,28,103,32,0,"https://fbref.com/en/players/02b29014/Abdoulaye-Doucoure"
2022,"Everton","Premier League","Jean-Philippe Gbamin","CIV","MF","25",1995,0.7,1,1,1,0,0,0,2,0,2,0,0,0,1,2,1,0,"https://fbref.com/en/players/6bd603db/Jean-Philippe-Gbamin"
2022,"Everton","Premier League","Anwar El Ghazi","NED","FW,MF","26",1995,0.1,1,1,1,0,0,1,1,100,0,3,0,3,0,1,0,0,"https://fbref.com/en/players/ffa90327/Anwar-El-Ghazi"
2022,"Everton","Premier League","Ben Godfrey","ENG","DF","23",1998,22.5,47,32,29,14,4,24,39,61.5,15,41,19,22,15,62,100,2,"https://fbref.com/en/players/9f7c837d/Ben-Godfrey"
2022,"Everton","Premier League","André Gomes","POR","MF","28",1993,6.9,16,4,6,6,4,8,32,25,24,8,2,6,1,17,7,1,"https://fbref.com/en/players/1961b2aa/Andre-Gomes"
2022,"Everton","Premier League","Anthony Gordon","ENG","MF,FW","20",2001,25.4,54,32,20,30,4,21,59,35.6,38,49,3,46,22,76,17,0,"https://fbref.com/en/players/2bd83368/Anthony-Gordon"
2022,"Everton","Premier League","Demarai Gray","ENG","MF,FW","25",1996,26,30,19,13,10,7,10,22,45.5,12,30,2,28,15,45,21,1,"https://fbref.com/en/players/4468ec10/Demarai-Gray"
2022,"Everton","Premier League","Mason Holgate","ENG","DF","24",1996,23.7,35,18,26,9,0,11,26,42.3,15,25,17,8,26,61,95,1,"https://fbref.com/en/players/d0042ab9/Mason-Holgate"
2022,"Everton","Premier League","Alex Iwobi","NGA","MF,DF","25",1996,22.6,40,19,23,12,5,21,52,40.4,31,39,3,36,20,60,25,2,"https://fbref.com/en/players/6ca5ec4b/Alex-Iwobi"
2022,"Everton","Premier League","Moise Kean","ITA","FW","21",2000,0,0,0,0,0,0,0,0,NA,0,0,0,0,0,0,0,0,"https://fbref.com/en/players/3d50bcdb/Moise-Kean"
2022,"Everton","Premier League","Michael Keane","ENG","DF","28",1993,31,46,25,32,13,1,28,45,62.2,17,33,28,5,62,108,128,2,"https://fbref.com/en/players/c5b7c315/Michael-Keane"
2022,"Everton","Premier League","Jonjoe Kenny","ENG","DF","24",1997,11.3,17,7,11,6,0,13,21,61.9,8,8,1,7,20,37,31,0,"https://fbref.com/en/players/099e666f/Jonjoe-Kenny"
2022,"Everton","Premier League","Yerry Mina","COL","DF","26",1994,9.4,12,10,12,0,0,10,13,76.9,3,13,9,4,11,23,38,1,"https://fbref.com/en/players/6d5701f2/Yerry-Mina"
2022,"Everton","Premier League","Vitaliy Mykolenko","UKR","DF","22",1999,11.7,25,15,15,7,3,12,21,57.1,9,15,2,13,16,41,37,0,"https://fbref.com/en/players/30d4a2e5/Vitaliy-Mykolenko"
2022,"Everton","Premier League","Tyler Onyango","ENG","MF","18",2003,0.3,0,0,0,0,0,0,0,NA,0,0,0,0,0,0,1,0,"https://fbref.com/en/players/d86a1f3e/Tyler-Onyango"
2022,"Everton","Premier League","Jordan Pickford","ENG","GK","27",1994,35,1,1,1,0,0,0,1,0,1,1,0,1,1,2,14,1,"https://fbref.com/en/players/4806ec67/Jordan-Pickford"
2022,"Everton","Premier League","Isaac Price","NIR","MF","17",2003,0.2,0,0,0,0,0,0,0,NA,0,1,0,1,0,0,0,0,"https://fbref.com/en/players/b9403c99/Isaac-Price"
2022,"Everton","Premier League","Richarlison","BRA","FW","24",1997,28,40,23,18,15,7,15,31,48.4,16,42,4,38,12,52,34,0,"https://fbref.com/en/players/fa031b34/Richarlison"
2022,"Everton","Premier League","Salomón Rondón","VEN","FW","31",1989,8.8,6,1,1,2,3,4,14,28.6,10,5,0,5,0,6,10,0,"https://fbref.com/en/players/b318a643/Salomon-Rondon"
2022,"Everton","Premier League","Ellis Simms","ENG","FW","20",2001,0.7,0,0,0,0,0,0,0,NA,0,1,1,0,0,0,1,0,"https://fbref.com/en/players/26d3b5be/Ellis-Simms"
2022,"Everton","Premier League","Cenk Tosun","TUR","MF","30",1991,0.1,0,0,0,0,0,0,0,NA,0,0,0,0,0,0,0,0,"https://fbref.com/en/players/9a104dee/Cenk-Tosun"
2022,"Everton","Premier League","Andros Townsend","ENG","MF,FW","30",1991,16.2,31,17,15,6,10,15,40,37.5,25,28,2,26,14,45,6,1,"https://fbref.com/en/players/b28bbd58/Andros-Townsend"
2022,"Fiorentina","Serie A","Sofyan Amrabat","MAR","MF","24",1996,10.5,24,13,9,13,2,11,19,57.9,8,25,8,17,5,29,6,1,"https://fbref.com/en/players/5a2cb25d/Sofyan-Amrabat"
2022,"Fiorentina","Serie A","Arthur","BRA","FW","23",1998,8.3,9,5,2,5,2,4,7,57.1,3,4,1,3,1,10,8,0,"https://fbref.com/en/players/a820e429/Arthur"
2022,"Fiorentina","Serie A","Marco Benassi","ITA","DF,MF","26",1994,1.8,1,0,1,0,0,1,2,50,1,3,0,3,3,4,3,0,"https://fbref.com/en/players/0000acda/Marco-Benassi"
2022,"Fiorentina","Serie A","Cristiano Biraghi","ITA","DF","28",1992,35,37,24,17,15,5,22,53,41.5,31,28,10,18,19,56,31,1,"https://fbref.com/en/players/9e1577aa/Cristiano-Biraghi"
2022,"Fiorentina","Serie A","Giacomo Bonaventura","ITA","MF","31",1989,25.2,33,17,12,16,5,21,46,45.7,25,20,2,18,14,47,9,1,"https://fbref.com/en/players/d995ed27/Giacomo-Bonaventura"
2022,"Fiorentina","Serie A","José Callejón","ESP","FW","34",1987,14.4,15,6,6,6,3,13,31,41.9,18,6,0,6,3,18,1,1,"https://fbref.com/en/players/78841da9/Jose-Callejon"
2022,"Fiorentina","Serie A","Gaetano Castrovilli","ITA","MF","24",1997,15.5,25,17,15,6,4,12,23,52.2,11,18,4,14,11,36,6,0,"https://fbref.com/en/players/0728bebe/Gaetano-Castrovilli"
2022,"Fiorentina","Serie A","Filippo Distefano","ITA","FW","17",2003,0,0,0,0,0,0,0,0,NA,0,0,0,0,0,0,0,0,"https://fbref.com/en/players/2110f96c/Filippo-Distefano"
2022,"Fiorentina","Serie A","Bartłomiej Drągowski","POL","GK","23",1997,6.2,0,0,0,0,0,0,0,NA,0,0,0,0,1,1,5,2,"https://fbref.com/en/players/085e71a7/Bartlomiej-Dragowski"
2022,"Fiorentina","Serie A","Alfred Duncan","GHA","MF","28",1993,21.5,34,19,13,16,5,11,32,34.4,21,32,3,29,10,44,7,0,"https://fbref.com/en/players/528492ea/Alfred-Duncan"
2022,"Fiorentina","Serie A","Nicolás González","ARG","FW","23",1998,26.2,21,16,6,8,7,9,28,32.1,19,26,2,24,21,42,4,1,"https://fbref.com/en/players/2374aaca/Nicolas-Gonzalez"
2022,"Fiorentina","Serie A","Igor","BRA","DF","23",1998,24.9,53,31,34,16,3,30,40,75,10,37,19,18,31,84,46,4,"https://fbref.com/en/players/a4e85758/Igor"
2022,"Fiorentina","Serie A","Jonathan Ikone","FRA","FW","23",1998,7.2,7,3,2,3,2,3,10,30,7,10,2,8,1,8,2,0,"https://fbref.com/en/players/42eaa028/Jonathan-Ikone"
2022,"Fiorentina","Serie A","Aleksandr Kokorin","RUS","FW,MF","30",1991,0.6,1,1,1,0,0,0,0,NA,0,1,0,1,0,1,0,0,"https://fbref.com/en/players/fec5accc/Aleksandr-Kokorin"
2022,"Fiorentina","Serie A","Youssef Maleh","ITA","MF","22",1998,11.3,27,16,8,13,6,12,25,48,13,14,1,13,6,33,2,0,"https://fbref.com/en/players/4c8845f7/Youssef-Maleh"
2022,"Fiorentina","Serie A","Lucas Martínez Quarta","ARG","DF","25",1996,15.9,36,25,23,11,2,21,34,61.8,13,22,9,13,19,55,46,0,"https://fbref.com/en/players/3ec3c1c9/Lucas-Martinez-Quarta"
2022,"Fiorentina","Serie A","Nikola Milenković","SRB","DF","23",1997,32.5,54,32,31,20,3,29,34,85.3,5,30,15,15,39,93,94,0,"https://fbref.com/en/players/bee704fc/Nikola-Milenkovic"
2022,"Fiorentina","Serie A","Matija Nastasić","SRB","DF","28",1993,2.4,1,1,1,0,0,1,1,100,0,1,1,0,5,6,11,0,"https://fbref.com/en/players/f35430a4/Matija-Nastasic"
2022,"Fiorentina","Serie A","Álvaro Odriozola","ESP","DF","25",1995,19.3,25,15,12,6,7,15,32,46.9,17,17,6,11,8,33,25,2,"https://fbref.com/en/players/1d1691ad/Alvaro-Odriozola"
2022,"Fiorentina","Serie A","Krzysztof Piątek","POL","FW","26",1995,8.1,5,4,1,1,3,2,3,66.7,1,6,0,6,2,7,8,0,"https://fbref.com/en/players/17f3620a/Krzysztof-Piatek"
2022,"Fiorentina","Serie A","Erick Pulgar","CHI","MF","27",1994,3.8,6,6,4,2,0,4,9,44.4,5,5,1,4,5,11,2,1,"https://fbref.com/en/players/4611e028/Erick-Pulgar"
2022,"Fiorentina","Serie A","Riccardo Saponara","ITA","FW","29",1991,14.3,10,2,1,6,3,6,16,37.5,10,5,0,5,1,11,3,0,"https://fbref.com/en/players/3bb7af3b/Riccardo-Saponara"
2022,"Fiorentina","Serie A","Riccardo Sottil","ITA","FW","22",1999,13.8,9,4,4,4,1,3,9,33.3,6,3,0,3,1,10,2,0,"https://fbref.com/en/players/94816803/Riccardo-Sottil"
2022,"Fiorentina","Serie A","Pietro Terracciano","ITA","GK","31",1990,31.8,0,0,0,0,0,0,4,0,4,0,0,0,2,2,20,1,"https://fbref.com/en/players/e1b0a70d/Pietro-Terracciano"
2022,"Fiorentina","Serie A","Aleksa Terzić","SRB","DF","21",1999,3,8,5,3,3,2,4,7,57.1,3,7,0,7,4,12,5,0,"https://fbref.com/en/players/3ef0a2d7/Aleksa-Terzic"
2022,"Fiorentina","Serie A","Lucas Torreira","URU","MF","25",1996,24.4,37,29,13,21,3,18,40,45,22,18,1,17,26,63,18,0,"https://fbref.com/en/players/52611641/Lucas-Torreira"
2022,"Fiorentina","Serie A","Lorenzo Venuti","ITA","DF","26",1995,17.5,25,10,13,10,2,14,24,58.3,10,13,4,9,5,30,27,0,"https://fbref.com/en/players/983ff2c7/Lorenzo-Venuti"
2022,"Fiorentina","Serie A","Dušan Vlahović","SRB","FW","21",2000,20.6,5,0,0,2,3,2,11,18.2,9,6,2,4,1,6,16,0,"https://fbref.com/en/players/79443529/Dusan-Vlahovic"
2022,"Freiburg","Bundesliga","Ermedin Demirović","BIH","FW","23",1998,9.7,12,6,4,4,4,1,10,10,9,14,1,13,1,13,7,0,"https://fbref.com/en/players/ed79b7d3/Ermedin-Demirovic"
2022,"Freiburg","Bundesliga","Maximilian Eggestein","GER","MF","24",1996,24.4,48,28,17,25,6,22,50,44,28,35,11,24,30,78,32,1,"https://fbref.com/en/players/beb882a8/Maximilian-Eggestein"
2022,"Freiburg","Bundesliga","Mark Flekken","NED","GK","28",1993,32,0,0,0,0,0,0,2,0,2,1,0,1,2,2,10,1,"https://fbref.com/en/players/a92ab7be/Mark-Flekken"
2022,"Freiburg","Bundesliga","Vincenzo Grifo","ITA","MF,FW","28",1993,30.8,27,15,9,13,5,9,26,34.6,17,12,2,10,13,40,28,0,"https://fbref.com/en/players/54e4866f/Vincenzo-Grifo"
2022,"Freiburg","Bundesliga","Manuel Gulde","GER","DF","30",1991,13.6,18,10,14,3,1,8,11,72.7,3,16,8,8,17,35,37,0,"https://fbref.com/en/players/25ab9c9c/Manuel-Gulde"
2022,"Freiburg","Bundesliga","Christian Günter","GER","DF,MF","28",1993,34,34,20,16,15,3,18,50,36,32,23,6,17,17,51,49,2,"https://fbref.com/en/players/8593f88c/Christian-Gunter"
2022,"Freiburg","Bundesliga","Janik Haberer","GER","MF","27",1994,9.1,14,8,5,6,3,7,19,36.8,12,11,4,7,16,30,11,0,"https://fbref.com/en/players/70dcf94d/Janik-Haberer"
2022,"Freiburg","Bundesliga","Dominique Heintz","GER","DF","27",1993,0.3,0,0,0,0,0,0,0,NA,0,0,0,0,1,1,0,0,"https://fbref.com/en/players/699fb8db/Dominique-Heintz"
2022,"Freiburg","Bundesliga","Nicolas Höfler","GER","MF","31",1990,28.9,73,42,37,29,7,28,62,45.2,34,50,21,29,46,119,42,0,"https://fbref.com/en/players/5d8e331f/Nicolas-Hofler"
2022,"Freiburg","Bundesliga","Lucas Höler","GER","FW","27",1994,28.7,41,25,10,17,14,13,28,46.4,15,25,4,21,17,58,39,2,"https://fbref.com/en/players/ca618d23/Lucas-Holer"
2022,"Freiburg","Bundesliga","Yannik Keitel","GER","MF","21",2000,5.6,11,4,5,4,2,5,15,33.3,10,7,1,6,1,12,8,0,"https://fbref.com/en/players/d2c580ce/Yannik-Keitel"
2022,"Freiburg","Bundesliga","Lukas Kübler","GER","DF,MF","28",1992,25.9,62,35,38,16,8,28,49,57.1,21,24,8,16,44,106,70,0,"https://fbref.com/en/players/2a29eb9b/Lukas-Kubler"
2022,"Freiburg","Bundesliga","Philipp Lienhart","AUT","DF","25",1996,31.9,24,13,17,6,1,13,24,54.2,11,33,23,10,50,74,158,1,"https://fbref.com/en/players/302527b2/Philipp-Lienhart"
2022,"Freiburg","Bundesliga","Nils Petersen","GER","FW","32",1988,6.4,5,3,2,3,0,1,13,7.7,12,7,0,7,2,7,17,0,"https://fbref.com/en/players/f93e6e94/Nils-Petersen"
2022,"Freiburg","Bundesliga","Roland Sallai","HUN","MF,FW","24",1997,17.2,22,16,8,11,3,7,23,30.4,16,12,0,12,11,33,12,0,"https://fbref.com/en/players/bf075f6b/Roland-Sallai"
2022,"Freiburg","Bundesliga","Baptiste Santamaria","FRA","MF","26",1995,0.2,0,0,0,0,0,0,1,0,1,0,0,0,1,1,1,0,"https://fbref.com/en/players/5e22e2a4/Baptiste-Santamaria"
2022,"Freiburg","Bundesliga","Kevin Schade","GER","MF,FW","19",2001,9.2,9,7,6,2,1,3,10,30,7,15,3,12,3,12,16,0,"https://fbref.com/en/players/52afb588/Kevin-Schade"
2022,"Freiburg","Bundesliga","Keven Schlotterbeck","GER","DF,FW","24",1997,3.5,11,5,6,5,0,5,6,83.3,1,7,4,3,11,22,24,1,"https://fbref.com/en/players/f6bdc830/Keven-Schlotterbeck"
2022,"Freiburg","Bundesliga","Nico Schlotterbeck","GER","DF","21",1999,30.9,72,43,36,34,2,33,48,68.8,15,41,32,9,56,128,154,1,"https://fbref.com/en/players/34e12499/Nico-Schlotterbeck"
2022,"Freiburg","Bundesliga","Jonathan Schmid","FRA","DF","31",1990,6.5,12,6,6,3,3,5,7,71.4,2,7,1,6,6,18,15,0,"https://fbref.com/en/players/088ca1bd/Jonathan-Schmid"
2022,"Freiburg","Bundesliga","Kiliann Sildillia","FRA","DF,MF","19",2002,1.9,7,3,3,4,0,3,6,50,3,1,0,1,2,9,7,1,"https://fbref.com/en/players/313254a3/Kiliann-Sildillia"
2022,"Freiburg","Bundesliga","Hugo Siquet","BEL","DF","19",2002,0.2,0,0,0,0,0,0,0,NA,0,0,0,0,0,0,0,0,"https://fbref.com/en/players/c6cf860f/Hugo-Siquet"
2022,"Freiburg","Bundesliga","Benjamin Uphoff","GER","GK","27",1993,2,0,0,0,0,0,0,0,NA,0,0,0,0,0,0,2,2,"https://fbref.com/en/players/a9a6fc08/Benjamin-Uphoff"
2022,"Freiburg","Bundesliga","Vincent Vermeij","NED","MF","26",1994,0,0,0,0,0,0,0,0,NA,0,1,0,1,0,0,0,0,"https://fbref.com/en/players/7e629adc/Vincent-Vermeij"
2022,"Freiburg","Bundesliga","Noah Weißhaupt","GER","MF,FW","19",2001,1.1,1,1,1,0,0,1,2,50,1,2,0,2,1,2,1,1,"https://fbref.com/en/players/dd676a97/Noah-Weisshaupt"
2022,"Freiburg","Bundesliga","Jeong Woo-yeong","KOR","FW,MF","21",1999,19.8,15,9,6,7,2,5,15,33.3,10,8,1,7,7,22,11,0,"https://fbref.com/en/players/6190474d/Jeong-Woo-yeong"
2022,"Genoa","Serie A","Nadiem Amiri","GER","MF,FW","24",1996,7.6,6,4,2,2,2,2,9,22.2,7,7,0,7,0,6,0,0,"https://fbref.com/en/players/555d5edd/Nadiem-Amiri"
2022,"Genoa","Serie A","Milan Badelj","CRO","MF","32",1989,31.6,64,37,25,30,9,34,80,42.5,46,39,7,32,85,149,43,0,"https://fbref.com/en/players/e8c930bb/Milan-Badelj"
2022,"Genoa","Serie A","Mattia Bani","ITA","DF","27",1993,13.5,23,13,17,6,0,14,18,77.8,4,19,11,8,20,43,76,0,"https://fbref.com/en/players/0821331c/Mattia-Bani"
2022,"Genoa","Serie A","Valon Behrami","SUI","MF,FW","36",1985,3.5,3,1,0,2,1,0,7,0,7,4,1,3,1,4,4,0,"https://fbref.com/en/players/d3d758d8/Valon-Behrami"
2022,"Genoa","Serie A","Davide Biraschi","ITA","DF","27",1994,10.3,31,16,19,9,3,17,24,70.8,7,16,9,7,16,47,26,0,"https://fbref.com/en/players/64cd167d/Davide-Biraschi"
2022,"Genoa","Serie A","Aleksander Buksa","POL","FW","18",2003,0.7,0,0,0,0,0,0,1,0,1,0,0,0,0,0,1,0,"https://fbref.com/en/players/59f2d958/Aleksander-Buksa"
2022,"Genoa","Serie A","Felipe Caicedo","ECU","FW","32",1988,3.2,3,3,0,2,1,0,1,0,1,1,0,1,0,3,4,0,"https://fbref.com/en/players/93b891d1/Felipe-Caicedo"
2022,"Genoa","Serie A","Riccardo Calafiori","ITA","DF","19",2002,0.9,1,0,0,0,1,1,2,50,1,2,1,1,2,3,4,0,"https://fbref.com/en/players/aded8e6f/Riccardo-Calafiori"
2022,"Genoa","Serie A","Andrea Cambiaso","ITA","DF","21",2000,19.9,46,20,28,14,4,18,32,56.3,14,33,8,25,23,69,37,1,"https://fbref.com/en/players/247ed022/Andrea-Cambiaso"
2022,"Genoa","Serie A","Francesco Cassata","ITA","MF","24",1997,0.1,0,0,0,0,0,0,0,NA,0,0,0,0,0,0,0,0,"https://fbref.com/en/players/96960855/Francesco-Cassata"
2022,"Genoa","Serie A","Domenico Criscito","ITA","DF","34",1986,18,37,21,19,14,4,16,25,64,9,22,12,10,39,76,57,0,"https://fbref.com/en/players/35dd6d80/Domenico-Criscito"
2022,"Genoa","Serie A","Mattia Destro","ITA","FW","30",1991,19.4,9,4,1,4,4,1,6,16.7,5,14,1,13,2,11,16,0,"https://fbref.com/en/players/d7d32194/Mattia-Destro"
2022,"Genoa","Serie A","Caleb Ekuban","GHA","FW,MF","27",1994,19.1,19,12,2,12,5,7,23,30.4,16,19,5,14,9,28,6,0,"https://fbref.com/en/players/7afbd2c3/Caleb-Ekuban"
2022,"Genoa","Serie A","Mohamed Fares","ALG","DF,FW","25",1996,6.5,4,2,1,3,0,0,4,0,4,8,3,5,8,12,11,0,"https://fbref.com/en/players/b7a5bc86/Mohamed-Fares"
2022,"Genoa","Serie A","Andrea Favilli","ITA","FW","24",1997,0.4,1,1,0,0,1,0,0,NA,0,0,0,0,0,1,2,0,"https://fbref.com/en/players/44510fde/Andrea-Favilli"
2022,"Genoa","Serie A","Morten Frendrup","DEN","DF,MF","20",2001,7.7,40,24,19,13,8,13,29,44.8,16,19,2,17,17,57,7,1,"https://fbref.com/en/players/f4d60499/Morten-Frendrup"
2022,"Genoa","Serie A","Pablo Galdames Millán","CHI","MF","24",1996,11.4,28,12,6,16,6,12,35,34.3,23,16,2,14,8,36,9,1,"https://fbref.com/en/players/dd403465/Pablo-Galdames-Millan"
2022,"Genoa","Serie A","Paolo Ghiglione","ITA","DF","24",1997,6.7,17,12,8,6,3,9,14,64.3,5,11,5,6,10,27,12,1,"https://fbref.com/en/players/71dc23da/Paolo-Ghiglione"
2022,"Genoa","Serie A","Albert Guðmundsson","ISL","FW,MF","24",1997,6.7,5,3,2,1,2,3,8,37.5,5,2,0,2,5,10,4,0,"https://fbref.com/en/players/b79858d5/Albert-Gudmundsson"
2022,"Genoa","Serie A","Silvan Hefti","SUI","DF","23",1997,14.3,50,30,23,22,5,32,58,55.2,26,20,4,16,20,70,34,1,"https://fbref.com/en/players/f8342731/Silvan-Hefti"
2022,"Genoa","Serie A","Hernani","BRA","MF,FW","27",1994,7.6,20,10,8,9,3,13,32,40.6,19,17,4,13,13,33,5,1,"https://fbref.com/en/players/6f5ead86/Hernani"
2022,"Genoa","Serie A","Flavio Junior Bianchi","ITA","FW,MF","21",2000,3.5,2,2,1,0,1,0,2,0,2,0,0,0,0,2,0,0,"https://fbref.com/en/players/3ef965c1/Flavio-Junior-Bianchi"
2022,"Genoa","Serie A","Yayah Kallon","SLE","FW,MF","20",2001,7.1,15,11,5,6,4,3,11,27.3,8,7,1,6,1,16,5,0,"https://fbref.com/en/players/f95f49d2/Yayah-Kallon"
2022,"Genoa","Serie A","Nikola Maksimović","SRB","DF","29",1991,12.4,14,6,10,4,0,7,9,77.8,2,17,11,6,12,26,61,1,"https://fbref.com/en/players/16b9d5cf/Nikola-Maksimovic"
2022,"Genoa","Serie A","Andrea Masiello","ITA","DF","35",1986,5.7,5,3,4,1,0,4,7,57.1,3,8,4,4,11,16,20,1,"https://fbref.com/en/players/e0314d87/Andrea-Masiello"
2022,"Genoa","Serie A","Filippo Melegoni","ITA","MF,FW","22",1999,10.9,20,12,5,8,7,8,16,50,8,10,1,9,11,31,8,1,"https://fbref.com/en/players/6604165d/Filippo-Melegoni"
2022,"Genoa","Serie A","Goran Pandev","MKD","FW,MF","38",1983,9.4,2,0,1,0,1,0,9,0,9,3,1,2,2,4,0,0,"https://fbref.com/en/players/d711d04f/Goran-Pandev"
2022,"Genoa","Serie A","Roberto Piccoli","ITA","FW","20",2001,2.4,1,1,0,1,0,0,0,NA,0,0,0,0,1,2,1,1,"https://fbref.com/en/players/1cadaf34/Roberto-Piccoli"
2022,"Genoa","Serie A","Manolo Portanova","ITA","FW,MF","21",2000,14.7,46,28,9,26,11,14,34,41.2,20,26,2,24,17,63,22,0,"https://fbref.com/en/players/c8c0dccd/Manolo-Portanova"
2022,"Genoa","Serie A","Nicolò Rovella","ITA","MF","19",2001,16.3,37,26,16,14,7,15,40,37.5,25,21,1,20,20,57,20,0,"https://fbref.com/en/players/e58cbfd5/Nicolo-Rovella"
2022,"Genoa","Serie A","Stefano Sabelli","ITA","DF","28",1993,3.9,6,3,3,2,1,3,9,33.3,6,5,1,4,3,9,12,0,"https://fbref.com/en/players/0ccac09c/Stefano-Sabelli"
2022,"Genoa","Serie A","Adrian Šemper","CRO","GK","23",1998,1,0,0,0,0,0,0,0,NA,0,0,0,0,0,0,0,0,"https://fbref.com/en/players/f02dde20/Adrian-Semper"
2022,"Genoa","Serie A","Laurens Serpe","ITA","DF","20",2001,0.5,1,0,1,0,0,1,2,50,1,0,0,0,0,1,1,0,"https://fbref.com/en/players/79d60e74/Laurens-Serpe"
2022,"Genoa","Serie A","Salvatore Sirigu","ITA","GK","34",1987,37,1,1,1,0,0,1,2,50,1,0,0,0,0,1,19,2,"https://fbref.com/en/players/10dc46f0/Salvatore-Sirigu"
2022,"Genoa","Serie A","Leo Skiri Østigård","NOR","DF","21",1999,13,16,9,8,7,1,9,11,81.8,2,17,10,7,8,24,55,1,"https://fbref.com/en/players/b35a7399/Leo-Skiri-Ostigard"
2022,"Genoa","Serie A","Stefano Sturaro","ITA","MF","28",1993,19.6,43,26,16,16,11,22,48,45.8,26,25,1,24,15,58,29,2,"https://fbref.com/en/players/2334478a/Stefano-Sturaro"
2022,"Genoa","Serie A","Abdoulaye Touré","FRA","MF","27",1994,4.8,12,4,3,8,1,5,11,45.5,6,6,1,5,4,16,6,0,"https://fbref.com/en/players/ef7cd87a/Abdoulaye-Toure"
2022,"Genoa","Serie A","Zinho Vanheusden","BEL","DF","22",1999,11,18,6,12,5,1,8,14,57.1,6,19,14,5,23,41,42,0,"https://fbref.com/en/players/afbf187b/Zinho-Vanheusden"
2022,"Genoa","Serie A","Johan Vásquez","MEX","DF","22",1998,25.3,79,46,44,32,3,48,75,64,27,32,10,22,42,121,85,0,"https://fbref.com/en/players/5eaed77a/Johan-Vasquez"
2022,"Genoa","Serie A","Kelvin Yeboah","ITA","FW,MF","21",2000,9.4,14,7,5,7,2,9,19,47.4,10,22,1,21,1,15,7,0,"https://fbref.com/en/players/ea0893d6/Kelvin-Yeboah"
2022,"Getafe","La Liga","Carles Aleñá","ESP","MF","23",1998,25.8,27,19,11,13,3,9,48,18.8,39,21,2,19,15,42,16,0,"https://fbref.com/en/players/6c811eb7/Carles-Alena"
2022,"Getafe","La Liga","Emmanuel Amankwaa Akurugu","GHA","DF","19",2001,0.9,0,0,0,0,0,0,2,0,2,1,0,1,0,0,0,0,"https://fbref.com/en/players/69c5633e/Emmanuel-Amankwaa-Akurugu"
2022,"Getafe","La Liga","Mauro Arambarri","URU","MF","25",1995,29.6,62,37,19,32,11,20,68,29.4,48,35,5,30,32,94,18,0,"https://fbref.com/en/players/58afe001/Mauro-Arambarri"
2022,"Getafe","La Liga","Erick Cabaco","URU","DF","26",1995,4.5,2,1,1,1,0,2,5,40,3,5,2,3,4,6,10,0,"https://fbref.com/en/players/e7ab4179/Erick-Cabaco"
2022,"Getafe","La Liga","Chema","ESP","MF","29",1992,0.5,0,0,0,0,0,0,1,0,1,0,0,0,0,0,0,0,"https://fbref.com/en/players/7f203b54/Chema"
2022,"Getafe","La Liga","Diego Conde","ESP","GK","22",1998,0.1,0,0,0,0,0,0,0,NA,0,0,0,0,0,0,0,0,"https://fbref.com/en/players/4eae5bc4/Diego-Conde"
2022,"Getafe","La Liga","Marc Cucurella","ESP","MF,DF","23",1998,0.3,0,0,0,0,0,0,0,NA,0,0,0,0,0,0,0,0,"https://fbref.com/en/players/1daec722/Marc-Cucurella"
2022,"Getafe","La Liga","Jorge Cuenca","ESP","DF","21",1999,29.8,46,32,30,15,1,21,28,75,7,29,14,15,39,85,155,0,"https://fbref.com/en/players/0abc51f2/Jorge-Cuenca"
2022,"Getafe","La Liga","Djené","TOG","DF","29",1991,34.6,44,26,24,16,4,23,34,67.6,11,24,5,19,59,103,109,2,"https://fbref.com/en/players/a4971d84/Djene"
2022,"Getafe","La Liga","Hugo Duro","ESP","DF,MF","21",1999,0.1,0,0,0,0,0,0,0,NA,0,0,0,0,0,0,0,0,"https://fbref.com/en/players/37e103f8/Hugo-Duro"
2022,"Getafe","La Liga","Iglesias","ESP","DF","23",1998,8,19,10,11,8,0,7,17,41.2,10,8,2,6,10,29,28,0,"https://fbref.com/en/players/974322dc/Iglesias"
2022,"Getafe","La Liga","Jakub Jankto","CZE","DF,MF","25",1996,6.5,11,7,5,5,1,10,17,58.8,7,4,0,4,4,15,7,0,"https://fbref.com/en/players/1ea5f91c/Jakub-Jankto"
2022,"Getafe","La Liga","José Juan Macías","MEX","FW,MF","21",1999,2.2,1,0,0,0,1,0,1,0,1,1,0,1,1,2,0,0,"https://fbref.com/en/players/1f1c8a15/Jose-Juan-Macias"
2022,"Getafe","La Liga","Florentino Luís","POR","MF","21",1999,11,42,25,22,17,3,17,35,48.6,18,21,2,19,21,63,11,1,"https://fbref.com/en/players/881cd6be/Florentino-Luis"
2022,"Getafe","La Liga","Nemanja Maksimović","SRB","MF","26",1995,32.6,56,32,24,26,6,18,49,36.7,31,42,13,29,71,127,41,0,"https://fbref.com/en/players/00b28772/Nemanja-Maksimovic"
2022,"Getafe","La Liga","Jaime Mata","ESP","FW","32",1988,7.5,7,5,3,1,3,1,9,11.1,8,4,1,3,1,8,5,0,"https://fbref.com/en/players/02319ad7/Jaime-Mata"
2022,"Getafe","La Liga","Borja Mayoral","ESP","FW","24",1997,11.6,7,5,2,3,2,1,2,50,1,10,4,6,4,11,3,0,"https://fbref.com/en/players/64e8ed6d/Borja-Mayoral"
2022,"Getafe","La Liga","Stefan Mitrović","SRB","DF","31",1990,29.6,16,8,12,4,0,8,13,61.5,5,28,18,10,22,38,114,1,"https://fbref.com/en/players/e6777e6b/Stefan-Mitrovic"
2022,"Getafe","La Liga","Allan Nyom","CMR","DF","33",1988,2.7,3,1,2,1,0,2,2,100,0,2,1,1,2,5,7,0,"https://fbref.com/en/players/97572117/Allan-Nyom"
2022,"Getafe","La Liga","Mathías Olivera","URU","DF","23",1997,31.1,79,47,39,34,6,40,69,58,29,45,4,41,55,134,67,1,"https://fbref.com/en/players/41c12f75/Mathias-Olivera"
2022,"Getafe","La Liga","Darío Poveda","ESP","FW,MF","24",1997,4.2,2,0,1,0,1,0,5,0,5,7,1,6,1,3,1,0,"https://fbref.com/en/players/cbdf7d5c/Dario-Poveda"
2022,"Getafe","La Liga","Sandro Ramírez","ESP","FW","26",1995,16.2,7,3,1,3,3,1,12,8.3,11,14,3,11,2,9,3,0,"https://fbref.com/en/players/833fb62e/Sandro-Ramirez"
2022,"Getafe","La Liga","Óscar Rodríguez Arnaiz","ESP","MF,FW","23",1998,10.5,16,11,6,8,2,4,12,33.3,8,7,1,6,11,27,6,0,"https://fbref.com/en/players/19709006/Oscar-Rodriguez-Arnaiz"
2022,"Getafe","La Liga","Jonathan Silva","ARG","DF,FW","27",1994,2.5,10,8,4,4,2,7,12,58.3,5,4,0,4,3,13,7,0,"https://fbref.com/en/players/f2308b33/Jonathan-Silva"
2022,"Getafe","La Liga","David Soria","ESP","GK","28",1993,37.9,1,0,1,0,0,1,2,50,1,0,0,0,0,1,22,2,"https://fbref.com/en/players/8f8c6934/David-Soria"
2022,"Getafe","La Liga","Damián Suárez","URU","DF","33",1988,30.1,74,47,34,30,10,42,91,46.2,49,46,5,41,31,105,30,0,"https://fbref.com/en/players/ba5004e1/Damian-Suarez"
2022,"Getafe","La Liga","David Timor","ESP","MF","31",1989,3.8,1,1,1,0,0,0,3,0,3,3,2,1,1,2,4,1,"https://fbref.com/en/players/174651c8/David-Timor"
2022,"Getafe","La Liga","Enes Ünal","TUR","FW","24",1997,31.1,37,22,2,18,17,5,42,11.9,37,25,5,20,5,42,36,0,"https://fbref.com/en/players/f8eca1b6/Enes-Unal"
2022,"Getafe","La Liga","Gonzalo Villar","ESP","MF","23",1998,3.3,5,3,4,1,0,2,5,40,3,4,1,3,1,6,1,0,"https://fbref.com/en/players/bdc74a8f/Gonzalo-Villar"
2022,"Getafe","La Liga","Vitolo","ESP","MF","31",1989,2.5,3,2,1,1,1,2,5,40,3,3,0,3,1,4,1,0,"https://fbref.com/en/players/db750822/Vitolo"
2022,"Getafe","La Liga","Okay Yokuşlu","TUR","DF,MF","27",1994,5.2,9,8,6,2,1,5,5,100,0,7,5,2,5,14,17,0,"https://fbref.com/en/players/e49ce451/Okay-Yokuslu"
2022,"Granada","La Liga","Luis Abram","PER","DF","25",1996,6.2,6,3,3,3,0,2,4,50,2,6,5,1,5,11,37,1,"https://fbref.com/en/players/1f462f95/Luis-Abram"
2022,"Granada","La Liga","Matias Arezo","URU","FW,MF","18",2002,1.8,5,3,2,1,2,4,9,44.4,5,1,0,1,1,6,1,0,"https://fbref.com/en/players/484ebdb0/Matias-Arezo"
2022,"Granada","La Liga","Santiago Arias","COL","DF","29",1992,4.9,12,5,8,3,1,4,9,44.4,5,8,4,4,5,17,10,0,"https://fbref.com/en/players/fdd60087/Santiago-Arias"
2022,"Granada","La Liga","Carlos Bacca","COL","FW","34",1986,5.7,4,4,2,0,2,0,3,0,3,5,0,5,1,5,5,0,"https://fbref.com/en/players/09a9e921/Carlos-Bacca"
2022,"Granada","La Liga","Barcia","ESP","DF","20",2000,0.8,0,0,0,0,0,0,0,NA,0,1,1,0,1,1,0,1,"https://fbref.com/en/players/0c717ae6/Barcia"
2022,"Granada","La Liga","Yan Brice Eteki","CMR","MF","23",1997,3.8,6,3,3,2,1,3,7,42.9,4,7,3,4,4,10,6,1,"https://fbref.com/en/players/3d688b46/Yan-Brice-Eteki"
2022,"Granada","La Liga","Adrián Butzke","ESP","FW","22",1999,0,0,0,0,0,0,0,0,NA,0,0,0,0,0,0,0,0,"https://fbref.com/en/players/505dce2b/Adrian-Butzke"
2022,"Granada","La Liga","Álex Collado","ESP","MF,FW","22",1999,11.3,27,12,6,16,5,12,31,38.7,19,28,2,26,6,33,11,0,"https://fbref.com/en/players/85dace26/Alex-Collado"
2022,"Granada","La Liga","Víctor Díaz","ESP","DF","33",1988,16.7,23,15,14,9,0,12,25,48,13,19,11,8,17,40,71,1,"https://fbref.com/en/players/3624ce4c/Victor-Diaz"
2022,"Granada","La Liga","Domingos Duarte","POR","DF","26",1995,18.7,18,14,9,9,0,6,11,54.5,5,27,20,7,22,40,82,0,"https://fbref.com/en/players/93090f69/Domingos-Duarte"
2022,"Granada","La Liga","Aarón Escandell","ESP","GK","25",1995,3.2,0,0,0,0,0,0,1,0,1,0,0,0,0,0,4,0,"https://fbref.com/en/players/67669ce7/Aaron-Escandell"
2022,"Granada","La Liga","Sergio Escudero","ESP","DF,MF","31",1989,15.9,46,24,25,17,4,26,54,48.1,28,18,3,15,26,72,35,0,"https://fbref.com/en/players/b0616e3d/Sergio-Escudero"
2022,"Granada","La Liga","Dimitri Foulquier","FRA","DF","28",1993,2,0,0,0,0,0,0,1,0,1,2,1,1,1,1,2,0,"https://fbref.com/en/players/45e17712/Dimitri-Foulquier"
2022,"Granada","La Liga","Maxime Gonalons","FRA","MF","32",1989,17.2,43,28,17,22,4,14,39,35.9,25,33,10,23,18,61,29,0,"https://fbref.com/en/players/b8c1de25/Maxime-Gonalons"
2022,"Granada","La Liga","Luis Javier Suárez","COL","FW","23",1997,31.6,26,14,9,9,8,8,27,29.6,19,25,3,22,6,32,23,0,"https://fbref.com/en/players/eeba07f8/Luis-Javier-Suarez"
2022,"Granada","La Liga","Darwin Machís","VEN","MF,FW","28",1993,15.3,23,13,11,8,4,9,23,39.1,14,10,0,10,15,38,17,0,"https://fbref.com/en/players/ed6ea4d9/Darwin-Machis"
2022,"Granada","La Liga","Luís Maximiano","POR","GK","22",1999,34.8,3,1,3,0,0,3,6,50,3,0,0,0,1,4,16,2,"https://fbref.com/en/players/3318286e/Luis-Maximiano"
2022,"Granada","La Liga","Luis Milla","ESP","MF","26",1994,30.8,59,29,25,30,4,25,64,39.1,39,28,4,24,25,84,34,0,"https://fbref.com/en/players/19c36442/Luis-Milla"
2022,"Granada","La Liga","Jorge Molina","ESP","FW","39",1982,21.8,4,2,2,1,1,2,18,11.1,16,13,2,11,6,10,11,0,"https://fbref.com/en/players/43f71e77/Jorge-Molina"
2022,"Granada","La Liga","Monchu","ESP","MF","21",1999,7.4,15,6,5,9,1,5,10,50,5,8,3,5,4,19,4,0,"https://fbref.com/en/players/8ac501f5/Monchu"
2022,"Granada","La Liga","Ángel Montoro","ESP","MF","33",1988,14.8,26,13,16,7,3,17,27,63,10,11,1,10,11,37,29,1,"https://fbref.com/en/players/719384c1/Angel-Montoro"
2022,"Granada","La Liga","Carlos Neva","ESP","DF","25",1996,23.4,31,19,24,7,0,16,28,57.1,12,27,9,18,32,63,81,0,"https://fbref.com/en/players/8d47bb39/Carlos-Neva"
2022,"Granada","La Liga","Njegoš Petrović","SRB","MF","22",1999,10.2,24,11,4,19,1,8,14,57.1,6,16,4,12,9,33,11,0,"https://fbref.com/en/players/0cb29e91/Njegos-Petrovic"
2022,"Granada","La Liga","Antonio Puertas","ESP","MF,FW","29",1992,25.1,34,20,18,12,4,17,44,38.6,27,33,3,30,11,45,36,0,"https://fbref.com/en/players/c77a8043/Antonio-Puertas"
2022,"Granada","La Liga","Quini","ESP","DF","31",1989,25.6,73,34,48,21,4,42,79,53.2,37,28,10,18,36,109,62,0,"https://fbref.com/en/players/7a538238/Quini"
2022,"Granada","La Liga","Dani Raba","ESP","MF,FW","25",1995,0.3,2,2,1,0,1,2,3,66.7,1,0,0,0,1,3,0,0,"https://fbref.com/en/players/ea6a7ab4/Dani-Raba"
2022,"Granada","La Liga","Rubén Rochina","ESP","MF,FW","30",1991,8.3,21,13,7,8,6,8,28,28.6,20,11,1,10,6,27,5,1,"https://fbref.com/en/players/ecd8c01e/Ruben-Rochina"
2022,"Granada","La Liga","Isma Ruiz","ESP","MF","20",2001,3.1,3,1,3,0,0,1,9,11.1,8,5,2,3,3,6,2,0,"https://fbref.com/en/players/6e36226f/Isma-Ruiz"
2022,"Granada","La Liga","Germán Sánchez","ESP","DF","34",1986,25.5,27,19,18,9,0,11,20,55,9,19,16,3,28,55,137,0,"https://fbref.com/en/players/ea9b2ef9/German-Sanchez"
2022,"Granada","La Liga","Alberto Soro","ESP","MF,FW","22",1999,6.4,12,10,3,6,3,1,7,14.3,6,21,2,19,3,15,4,0,"https://fbref.com/en/players/452c3055/Alberto-Soro"
2022,"Granada","La Liga","Raúl Torrente","ESP","DF","19",2001,14.2,31,21,18,11,2,16,29,55.2,13,14,9,5,12,43,69,0,"https://fbref.com/en/players/4d753a3f/Raul-Torrente"
2022,"Granada","La Liga","Myrto Uzuni","ALB","FW,MF","26",1995,9.5,7,4,6,1,0,0,2,0,2,13,1,12,10,17,7,0,"https://fbref.com/en/players/01da7812/Myrto-Uzuni"
2022,"Greuther Fürth","Bundesliga","Dickson Abiama","NGA","FW","22",1998,8.1,11,7,4,5,2,2,10,20,8,12,1,11,4,15,8,0,"https://fbref.com/en/players/cadd666a/Dickson-Abiama"
2022,"Greuther Fürth","Bundesliga","Simon Asta","GER","DF","20",2001,8.7,13,6,4,5,4,4,8,50,4,14,2,12,8,21,16,0,"https://fbref.com/en/players/dfc85b89/Simon-Asta"
2022,"Greuther Fürth","Bundesliga","Abdourahmane Barry","FRA","DF","21",2000,2.3,6,4,3,3,0,5,7,71.4,2,5,2,3,4,10,1,0,"https://fbref.com/en/players/8df328f4/Abdourahmane-Barry"
2022,"Greuther Fürth","Bundesliga","Maximilian Bauer","GER","DF","21",2000,18.8,28,15,17,10,1,11,28,39.3,17,24,14,10,29,57,99,0,"https://fbref.com/en/players/44a20f0c/Maximilian-Bauer"
2022,"Greuther Fürth","Bundesliga","Sascha Burchert","GER","GK","31",1989,14,1,1,1,0,0,1,2,50,1,0,0,0,0,1,11,1,"https://fbref.com/en/players/25bdea4b/Sascha-Burchert"
2022,"Greuther Fürth","Bundesliga","Max Christiansen","GER","MF","24",1996,22.8,46,25,19,22,5,18,43,41.9,25,52,16,36,68,114,56,0,"https://fbref.com/en/players/e7b899b8/Max-Christiansen"
2022,"Greuther Fürth","Bundesliga","Jeremy Dudziak","TUN","MF,FW","25",1995,12.6,17,6,5,8,4,3,14,21.4,11,8,0,8,10,27,4,0,"https://fbref.com/en/players/5a8d6540/Jeremy-Dudziak"
2022,"Greuther Fürth","Bundesliga","Adrian Fein","GER","MF","22",1999,0.4,0,0,0,0,0,0,1,0,1,0,0,0,2,2,0,0,"https://fbref.com/en/players/60097ff6/Adrian-Fein"
2022,"Greuther Fürth","Bundesliga","Marius Funk","GER","GK","25",1996,8,0,0,0,0,0,0,0,NA,0,0,0,0,0,0,8,1,"https://fbref.com/en/players/86314793/Marius-Funk"
2022,"Greuther Fürth","Bundesliga","Julian Green","USA","MF","26",1995,11.7,9,5,0,8,1,2,8,25,6,10,2,8,7,16,10,0,"https://fbref.com/en/players/ad1d6fa4/Julian-Green"
2022,"Greuther Fürth","Bundesliga","Sebastian Griesbeck","GER","DF,MF","30",1990,27.1,60,31,38,19,3,39,62,62.9,23,38,13,25,43,103,100,1,"https://fbref.com/en/players/a8db7ebb/Sebastian-Griesbeck"
2022,"Greuther Fürth","Bundesliga","Justin Hoogma","NED","DF","23",1998,3,6,5,4,2,0,4,6,66.7,2,5,5,0,4,10,4,0,"https://fbref.com/en/players/816192f0/Justin-Hoogma"
2022,"Greuther Fürth","Bundesliga","Branimir Hrgota","SWE","FW","28",1993,30.9,46,29,10,31,5,21,72,29.2,51,27,1,26,11,57,3,1,"https://fbref.com/en/players/710fbdd1/Branimir-Hrgota"
2022,"Greuther Fürth","Bundesliga","Cedric Itten","SUI","FW","24",1996,7.1,5,2,1,2,2,1,6,16.7,5,3,0,3,2,7,4,0,"https://fbref.com/en/players/ef233486/Cedric-Itten"
2022,"Greuther Fürth","Bundesliga","Gian-Luca Itter","GER","DF","22",1999,16.2,44,26,30,11,3,21,38,55.3,17,24,9,15,13,57,51,0,"https://fbref.com/en/players/e6c15f6e/Gian-Luca-Itter"
2022,"Greuther Fürth","Bundesliga","Gideon Jung","GER","DF","26",1994,1.6,3,1,1,2,0,2,4,50,2,1,1,0,2,5,5,0,"https://fbref.com/en/players/a2e7de6f/Gideon-Jung"
2022,"Greuther Fürth","Bundesliga","Jamie Leweling","GER","FW,MF","20",2001,21.8,13,8,3,7,3,3,16,18.8,13,9,0,9,13,26,5,0,"https://fbref.com/en/players/13fe7b69/Jamie-Leweling"
2022,"Greuther Fürth","Bundesliga","Andreas Linde","SWE","GK","28",1993,12,0,0,0,0,0,0,0,NA,0,0,0,0,1,1,1,1,"https://fbref.com/en/players/4d6a842d/Andreas-Linde"
2022,"Greuther Fürth","Bundesliga","Marco Meyerhöfer","GER","DF","25",1995,25.3,53,35,22,22,9,24,37,64.9,13,38,19,19,47,100,64,1,"https://fbref.com/en/players/0b104510/Marco-Meyerhofer"
2022,"Greuther Fürth","Bundesliga","Jessic Ngankam","GER","FW","21",2000,3.8,3,1,1,1,1,1,2,50,1,3,0,3,0,3,1,0,"https://fbref.com/en/players/bc249af8/Jessic-Ngankam"
2022,"Greuther Fürth","Bundesliga","Håvard Nielsen","NOR","MF,FW","28",1993,15.2,17,12,5,11,1,8,21,38.1,13,18,1,17,7,24,22,0,"https://fbref.com/en/players/b18ef366/Havard-Nielsen"
2022,"Greuther Fürth","Bundesliga","Hans Nunoo Sarpei","GHA","DF,MF","22",1998,7.1,16,11,9,7,0,10,14,71.4,4,8,5,3,14,30,21,0,"https://fbref.com/en/players/9593331d/Hans-Nunoo-Sarpei"
2022,"Greuther Fürth","Bundesliga","Afimico Pululu","FRA","FW,MF","22",1999,0.8,1,0,1,0,0,1,2,50,1,1,0,1,0,1,0,0,"https://fbref.com/en/players/32c016f8/Afimico-Pululu"
2022,"Greuther Fürth","Bundesliga","Tobias Raschl","GER","MF","21",2000,6.6,12,9,4,8,0,5,7,71.4,2,10,1,9,3,15,1,0,"https://fbref.com/en/players/bd992863/Tobias-Raschl"
2022,"Greuther Fürth","Bundesliga","Paul Seguin","GER","MF","26",1995,23.4,50,31,15,32,3,26,56,46.4,30,27,3,24,19,69,30,1,"https://fbref.com/en/players/8872ed17/Paul-Seguin"
2022,"Greuther Fürth","Bundesliga","Nils Seufert","GER","MF","24",1997,1.1,3,2,1,1,1,0,1,0,1,0,0,0,0,3,0,0,"https://fbref.com/en/players/0da32a38/Nils-Seufert"
2022,"Greuther Fürth","Bundesliga","Timothy Tillman","GER","MF","22",1999,22.3,43,26,17,18,8,19,42,45.2,23,33,4,29,12,55,26,0,"https://fbref.com/en/players/a5bea1fb/Timothy-Tillman"
2022,"Greuther Fürth","Bundesliga","Nick Viergever","NED","DF","31",1989,23.7,32,23,25,7,0,24,34,70.6,10,31,22,9,37,69,119,1,"https://fbref.com/en/players/e38f1636/Nick-Viergever"
2022,"Greuther Fürth","Bundesliga","Jetro Willems","NED","DF","27",1994,17.8,30,15,18,10,2,15,26,57.7,11,15,3,12,14,44,42,0,"https://fbref.com/en/players/9050ddc4/Jetro-Willems"
2022,"Hellas Verona","Serie A","Antonín Barák","CZE","MF,FW","26",1994,26,18,8,9,8,1,5,17,29.4,12,32,5,27,6,24,26,0,"https://fbref.com/en/players/01efac19/Antonin-Barak"
2022,"Hellas Verona","Serie A","Alessandro Berardi","ITA","GK","30",1991,1,0,0,0,0,0,0,0,NA,0,0,0,0,0,0,0,0,"https://fbref.com/en/players/ec1f737d/Alessandro-Berardi"
2022,"Hellas Verona","Serie A","Daniel Bessa","ITA","MF","28",1993,8.5,7,2,3,3,1,4,15,26.7,11,13,3,10,5,12,11,0,"https://fbref.com/en/players/88895312/Daniel-Bessa"
2022,"Hellas Verona","Serie A","Matteo Cancellieri","ITA","MF,DF","19",2002,2.5,4,4,2,2,0,0,5,0,5,2,0,2,1,5,0,0,"https://fbref.com/en/players/b6a1cdf9/Matteo-Cancellieri"
2022,"Hellas Verona","Serie A","Gianluca Caprari","ITA","MF,FW","28",1993,30.4,43,25,10,22,11,17,51,33.3,34,32,0,32,4,47,7,0,"https://fbref.com/en/players/54e53b7e/Gianluca-Caprari"
2022,"Hellas Verona","Serie A","Nicolò Casale","ITA","DF","23",1998,28.7,46,30,25,19,2,21,37,56.8,16,31,12,19,49,95,95,0,"https://fbref.com/en/players/3f5f38fb/Nicolo-Casale"
2022,"Hellas Verona","Serie A","Federico Ceccherini","ITA","DF","29",1992,26.2,32,16,19,10,3,19,33,57.6,14,13,8,5,50,82,76,1,"https://fbref.com/en/players/d9624b51/Federico-Ceccherini"
2022,"Hellas Verona","Serie A","Diego Coppola","ITA","DF","17",2003,2.8,8,4,4,4,0,3,3,100,0,5,1,4,4,12,5,0,"https://fbref.com/en/players/22ae86f9/Diego-Coppola"
2022,"Hellas Verona","Serie A","Paweł Dawidowicz","POL","DF","26",1995,13.3,30,18,16,10,4,16,25,64,9,14,11,3,21,51,53,0,"https://fbref.com/en/players/16bb656a/Pawel-Dawidowicz"
2022,"Hellas Verona","Serie A","Fabio Depaoli","ITA","DF","24",1997,7.8,12,7,6,4,2,1,7,14.3,6,9,2,7,8,20,14,0,"https://fbref.com/en/players/d97f2e8d/Fabio-Depaoli"
2022,"Hellas Verona","Serie A","Samuel Di Carmine","ITA","FW","32",1988,0.4,0,0,0,0,0,0,0,NA,0,0,0,0,0,0,0,0,"https://fbref.com/en/players/ef94dc2f/Samuel-Di-Carmine"
2022,"Hellas Verona","Serie A","Davide Faraoni","ITA","DF","29",1991,28.6,62,40,38,21,3,29,62,46.8,33,38,5,33,23,85,62,1,"https://fbref.com/en/players/aae9d04a/Davide-Faraoni"
2022,"Hellas Verona","Serie A","Gianluca Frabotta","ITA","DF,MF","22",1999,0.2,0,0,0,0,0,0,1,0,1,1,0,1,1,1,0,0,"https://fbref.com/en/players/d80b1835/Gianluca-Frabotta"
2022,"Hellas Verona","Serie A","Koray Günter","GER","DF","26",1994,26.8,32,18,19,11,2,16,32,50,16,27,21,6,69,101,110,1,"https://fbref.com/en/players/f1f1f238/Koray-Gunter"
2022,"Hellas Verona","Serie A","Martin Hongla","CMR","MF","23",1998,7.2,14,8,5,6,3,4,8,50,4,6,2,4,4,18,16,1,"https://fbref.com/en/players/b85bf253/Martin-Hongla"
2022,"Hellas Verona","Serie A","Ivan Ilić","SRB","MF","20",2001,28.1,39,18,16,19,4,20,54,37,34,34,12,22,22,61,55,0,"https://fbref.com/en/players/bb376bed/Ivan-Ilic"
2022,"Hellas Verona","Serie A","Nikola Kalinić","CRO","FW","33",1988,4.5,2,0,0,1,1,1,2,50,1,2,0,2,0,2,2,0,"https://fbref.com/en/players/d4931a5a/Nikola-Kalinic"
2022,"Hellas Verona","Serie A","Kevin Lasagna","ITA","MF,FW","28",1992,13.2,13,7,4,5,4,4,15,26.7,11,16,0,16,3,16,7,0,"https://fbref.com/en/players/09538fdb/Kevin-Lasagna"
2022,"Hellas Verona","Serie A","Darko Lazović","SRB","DF","30",1990,30.7,36,23,20,8,8,21,39,53.8,18,28,4,24,19,55,49,1,"https://fbref.com/en/players/5128bde4/Darko-Lazovic"
2022,"Hellas Verona","Serie A","Giangiacomo Magnani","ITA","DF","25",1995,5.9,10,7,5,5,0,8,16,50,8,5,3,2,10,20,46,0,"https://fbref.com/en/players/cce9f582/Giangiacomo-Magnani"
2022,"Hellas Verona","Serie A","Yıldırım Mert Çetin","TUR","MF","24",1997,0.5,1,0,1,0,0,1,1,100,0,0,0,0,0,1,2,0,"https://fbref.com/en/players/c730da00/Yildirim-Mert-Cetin"
2022,"Hellas Verona","Serie A","Lorenzo Montipò","ITA","GK","25",1996,34,0,0,0,0,0,0,0,NA,0,0,0,0,1,1,16,3,"https://fbref.com/en/players/c1d95617/Lorenzo-Montipo"
2022,"Hellas Verona","Serie A","Ivor Pandur","CRO","GK","21",2000,3,0,0,0,0,0,0,0,NA,0,0,0,0,0,0,2,0,"https://fbref.com/en/players/457cb02f/Ivor-Pandur"
2022,"Hellas Verona","Serie A","Mateusz Praszelik","POL","MF","20",2000,0.3,0,0,0,0,0,0,0,NA,0,0,0,0,0,0,0,0,"https://fbref.com/en/players/ec6773f5/Mateusz-Praszelik"
2022,"Hellas Verona","Serie A","Panagiotis Retsos","GRE","DF","22",1998,0.6,0,0,0,0,0,0,2,0,2,0,0,0,2,2,3,0,"https://fbref.com/en/players/4bd00a50/Panagiotis-Retsos"
2022,"Hellas Verona","Serie A","Giovanni Simeone","ARG","FW","26",1995,29.5,27,15,6,12,9,9,39,23.1,30,37,3,34,6,33,23,0,"https://fbref.com/en/players/343c0d52/Giovanni-Simeone"
2022,"Hellas Verona","Serie A","Bosko Sutalo","CRO","DF","21",2000,10.2,20,13,11,6,3,8,16,50,8,10,5,5,17,37,39,0,"https://fbref.com/en/players/1d0bb7e4/Bosko-Sutalo"
2022,"Hellas Verona","Serie A","Adrien Tameze","CMR","MF,DF","27",1994,28.6,52,29,24,21,7,20,59,33.9,39,40,5,35,52,104,41,0,"https://fbref.com/en/players/8da74c05/Adrien-Tameze"
2022,"Hellas Verona","Serie A","Filippo Terracciano","ITA","DF","18",2003,0.1,0,0,0,0,0,0,0,NA,0,0,0,0,0,0,1,0,"https://fbref.com/en/players/5cbb5ad6/Filippo-Terracciano"
2022,"Hellas Verona","Serie A","Miguel Veloso","POR","MF","35",1986,14.9,23,15,4,17,2,10,16,62.5,6,18,5,13,11,34,18,1,"https://fbref.com/en/players/ab1ca213/Miguel-Veloso"
2022,"Hellas Verona","Serie A","Mattia Zaccagni","ITA","MF","26",1995,2,3,1,1,0,2,1,2,50,1,1,0,1,4,7,0,0,"https://fbref.com/en/players/d85c238b/Mattia-Zaccagni"
2022,"Hertha BSC","Bundesliga","Fredrik André Bjørkan","NOR","DF","22",1998,3.9,12,10,7,4,1,7,9,77.8,2,6,2,4,6,18,8,0,"https://fbref.com/en/players/3724baa1/Fredrik-Andre-Bjorkan"
2022,"Hertha BSC","Bundesliga","Santiago Ascacíbar","ARG","MF","24",1997,26.4,93,54,50,37,6,38,89,42.7,51,31,6,25,41,134,42,0,"https://fbref.com/en/players/e26fcca3/Santiago-Ascacibar"
2022,"Hertha BSC","Bundesliga","Ishak Belfodil","ALG","FW","29",1992,18.2,9,6,4,4,1,4,8,50,4,9,1,8,5,14,16,0,"https://fbref.com/en/players/ff182fdc/Ishak-Belfodil"
2022,"Hertha BSC","Bundesliga","Kevin-Prince Boateng","GHA","MF,FW","34",1987,7.7,6,5,1,4,1,3,9,33.3,6,7,2,5,6,12,11,0,"https://fbref.com/en/players/f4ec4fd0/Kevin-Prince-Boateng"
2022,"Hertha BSC","Bundesliga","Dedryck Boyata","BEL","DF","30",1990,21.1,15,13,11,3,1,8,11,72.7,3,17,13,4,17,32,134,1,"https://fbref.com/en/players/7c473e12/Dedryck-Boyata"
2022,"Hertha BSC","Bundesliga","Matheus Cunha","BRA","FW","22",1999,0.7,0,0,0,0,0,0,0,NA,0,0,0,0,0,0,0,0,"https://fbref.com/en/players/dc62b55d/Matheus-Cunha"
2022,"Hertha BSC","Bundesliga","Márton Dárdai","GER","DF","19",2002,8.4,10,4,8,2,0,8,18,44.4,10,16,6,10,20,30,33,2,"https://fbref.com/en/players/41bff4fa/Marton-Dardai"
2022,"Hertha BSC","Bundesliga","Vladimír Darida","CZE","MF","30",1990,19.8,32,18,15,13,4,13,32,40.6,19,22,3,19,20,52,17,2,"https://fbref.com/en/players/3eb0f2df/Vladimir-Darida"
2022,"Hertha BSC","Bundesliga","Javairô Dilrosun","NED","FW","23",1998,1.5,3,1,1,2,0,1,1,100,0,1,0,1,0,3,0,0,"https://fbref.com/en/players/34a0f5ff/Javairo-Dilrosun"
2022,"Hertha BSC","Bundesliga","Lee Dongjun","KOR","MF,FW","24",1997,1.3,2,1,0,2,0,1,3,33.3,2,2,0,2,2,4,1,0,"https://fbref.com/en/players/96d0b6f0/Lee-Dongjun"
2022,"Hertha BSC","Bundesliga","Julian Eitschberger","GER","DF","17",2004,0.5,0,0,0,0,0,0,1,0,1,1,1,0,2,2,2,0,"https://fbref.com/en/players/943b9602/Julian-Eitschberger"
2022,"Hertha BSC","Bundesliga","Jurgen Ekkelenkamp","NED","MF,FW","21",2000,8,8,3,2,6,0,2,7,28.6,5,9,2,7,4,12,5,0,"https://fbref.com/en/players/73d6a176/Jurgen-Ekkelenkamp"
2022,"Hertha BSC","Bundesliga","Linus Gechter","GER","DF","17",2004,8,15,8,13,2,0,7,14,50,7,12,7,5,11,26,29,0,"https://fbref.com/en/players/ad2b068c/Linus-Gechter"
2022,"Hertha BSC","Bundesliga","Dennis Jastrzembski","POL","DF,FW","21",2000,2.5,2,1,1,1,0,2,8,25,6,1,0,1,5,7,3,0,"https://fbref.com/en/players/6bba916f/Dennis-Jastrzembski"
2022,"Hertha BSC","Bundesliga","Stevan Jovetić","MNE","FW,MF","31",1989,11.3,5,2,0,2,3,1,6,16.7,5,3,0,3,1,6,6,0,"https://fbref.com/en/players/f36c432f/Stevan-Jovetic"
2022,"Hertha BSC","Bundesliga","Anton Kade","GER","FW,MF","17",2004,0.9,4,2,3,1,0,2,8,25,6,3,0,3,3,7,1,0,"https://fbref.com/en/players/6d7598d5/Anton-Kade"
2022,"Hertha BSC","Bundesliga","Marc-Oliver Kempf","GER","DF","26",1995,11.7,10,9,9,1,0,5,14,35.7,9,14,7,7,25,35,49,1,"https://fbref.com/en/players/815c314f/Marc-Oliver-Kempf"
2022,"Hertha BSC","Bundesliga","Lukas Klünter","GER","DF","25",1996,2.2,1,1,1,0,0,1,5,20,4,1,0,1,2,3,2,0,"https://fbref.com/en/players/92948149/Lukas-Klunter"
2022,"Hertha BSC","Bundesliga","Marcel Lotka","POL","GK","20",2001,9.8,1,0,1,0,0,1,1,100,0,0,0,0,1,2,3,3,"https://fbref.com/en/players/5584552e/Marcel-Lotka"
2022,"Hertha BSC","Bundesliga","Dodi Lukebakio","BEL","FW","23",1997,2,2,1,2,0,0,1,3,33.3,2,2,0,2,2,4,0,0,"https://fbref.com/en/players/0c61c77c/Dodi-Lukebakio"
2022,"Hertha BSC","Bundesliga","Myziane Maolida","FRA","FW,MF","22",1999,8.6,7,4,5,1,1,3,9,33.3,6,5,0,5,1,8,6,0,"https://fbref.com/en/players/706a60e1/Myziane-Maolida"
2022,"Hertha BSC","Bundesliga","Maximilian Mittelstädt","GER","DF,FW","24",1997,16.6,52,33,30,12,10,26,50,52,24,28,5,23,46,98,37,0,"https://fbref.com/en/players/88d4144a/Maximilian-Mittelstadt"
2022,"Hertha BSC","Bundesliga","Peter Pekarík","SVK","DF","34",1986,24.8,45,29,33,11,1,32,46,69.6,14,28,10,18,29,74,58,0,"https://fbref.com/en/players/c18d22f5/Peter-Pekarik"
2022,"Hertha BSC","Bundesliga","Krzysztof Piątek","POL","FW","26",1995,3.9,2,2,0,1,1,0,1,0,1,0,0,0,0,2,6,0,"https://fbref.com/en/players/17f3620a/Krzysztof-Piatek"
2022,"Hertha BSC","Bundesliga","Marvin Plattenhardt","GER","DF","29",1992,18.2,25,11,18,6,1,15,27,55.6,12,18,3,15,17,42,52,0,"https://fbref.com/en/players/f7aa75bd/Marvin-Plattenhardt"
2022,"Hertha BSC","Bundesliga","Marco Richter","GER","FW,MF","23",1997,18.9,30,16,14,10,6,13,36,36.1,23,30,4,26,16,46,24,0,"https://fbref.com/en/players/f972644c/Marco-Richter"
2022,"Hertha BSC","Bundesliga","Cimo Röcker","GER","DF","27",1994,0.2,0,0,0,0,0,0,0,NA,0,0,0,0,2,2,0,0,"https://fbref.com/en/players/611b1aae/Cimo-Rocker"
2022,"Hertha BSC","Bundesliga","Alexander Schwolow","GER","GK","29",1992,24.2,0,0,0,0,0,0,1,0,1,0,0,0,2,2,18,3,"https://fbref.com/en/players/0d55d942/Alexander-Schwolow"
2022,"Hertha BSC","Bundesliga","Davie Selke","GER","FW","26",1995,11.2,5,4,1,3,1,1,3,33.3,2,6,1,5,1,6,11,0,"https://fbref.com/en/players/1238a3f9/Davie-Selke"
2022,"Hertha BSC","Bundesliga","Suat Serdar","GER","MF,FW","24",1997,24.6,64,30,24,29,11,25,55,45.5,30,32,3,29,20,84,14,0,"https://fbref.com/en/players/b3325a30/Suat-Serdar"
2022,"Hertha BSC","Bundesliga","Niklas Stark","GER","DF","26",1995,22.6,28,16,18,10,0,12,17,70.6,5,27,17,10,36,64,122,2,"https://fbref.com/en/players/aad48be9/Niklas-Stark"
2022,"Hertha BSC","Bundesliga","Jordan Torunarigha","GER","DF","23",1997,5.4,4,1,1,3,0,4,5,80,1,4,2,2,17,21,30,0,"https://fbref.com/en/players/f86cabbd/Jordan-Torunarigha"
2022,"Hertha BSC","Bundesliga","Lucas Tousart","FRA","MF","24",1997,21.8,42,25,15,22,5,10,34,29.4,24,30,6,24,35,77,55,0,"https://fbref.com/en/players/71ec39ef/Lucas-Tousart"
2022,"Hertha BSC","Bundesliga","Marten Winkler","GER","MF","18",2002,0.3,0,0,0,0,0,0,0,NA,0,0,0,0,0,0,0,0,"https://fbref.com/en/players/e0d515ef/Marten-Winkler"
2022,"Hertha BSC","Bundesliga","Luca Wollschläger","GER","FW,MF","18",2003,0.2,1,1,0,1,0,0,1,0,1,0,0,0,0,1,0,0,"https://fbref.com/en/players/24b8e7bd/Luca-Wollschlager"
2022,"Hertha BSC","Bundesliga","Deyovaisio Zeefuik","NED","DF","23",1998,6.3,11,10,6,4,1,6,12,50,6,12,4,8,11,22,21,1,"https://fbref.com/en/players/58a2e9f6/Deyovaisio-Zeefuik"
2022,"Hoffenheim","Bundesliga","Sargis Adamyan","ARM","FW,MF","28",1993,3.7,8,6,3,4,1,3,11,27.3,8,4,0,4,1,9,2,0,"https://fbref.com/en/players/22919e97/Sargis-Adamyan"
2022,"Hoffenheim","Bundesliga","Kevin Akpoguma","NGA","DF,FW","26",1995,17,33,19,16,11,6,16,28,57.1,12,32,2,30,20,53,29,2,"https://fbref.com/en/players/6ec6fde0/Kevin-Akpoguma"
2022,"Hoffenheim","Bundesliga","Fisnik Asllani","KVX","MF,FW","18",2002,0.1,0,0,0,0,0,0,1,0,1,0,0,0,0,0,0,0,"https://fbref.com/en/players/35f67a30/Fisnik-Asllani"
2022,"Hoffenheim","Bundesliga","Oliver Baumann","GER","GK","31",1990,33,0,0,0,0,0,0,3,0,3,0,0,0,0,0,19,1,"https://fbref.com/en/players/47064058/Oliver-Baumann"
2022,"Hoffenheim","Bundesliga","Christoph Baumgartner","AUT","MF,FW","21",1999,21,28,15,14,7,7,13,32,40.6,19,24,3,21,8,36,16,0,"https://fbref.com/en/players/437f2b00/Christoph-Baumgartner"
2022,"Hoffenheim","Bundesliga","Ihlas Bebou","TOG","FW,DF","27",1994,23.2,22,14,5,12,5,7,21,33.3,14,20,3,17,12,34,25,0,"https://fbref.com/en/players/a53b661f/Ihlas-Bebou"
2022,"Hoffenheim","Bundesliga","Ermin Bičakčić","BIH","DF","31",1990,0.1,0,0,0,0,0,0,0,NA,0,0,0,0,0,0,0,0,"https://fbref.com/en/players/7aac47fe/Ermin-Bicakcic"
2022,"Hoffenheim","Bundesliga","Tom Bischof","GER","MF","16",2005,0.2,0,0,0,0,0,0,0,NA,0,1,0,1,0,0,1,0,"https://fbref.com/en/players/07d3bfec/Tom-Bischof"
2022,"Hoffenheim","Bundesliga","Jacob Bruun Larsen","DEN","FW,MF","22",1998,9,2,1,1,1,0,0,5,0,5,14,3,11,5,7,5,2,"https://fbref.com/en/players/4e204552/Jacob-Bruun-Larsen"
2022,"Hoffenheim","Bundesliga","Justin Che","USA","FW,DF","17",2003,0.5,2,0,1,0,1,1,2,50,1,0,0,0,1,3,0,0,"https://fbref.com/en/players/3c569f37/Justin-Che"
2022,"Hoffenheim","Bundesliga","Moanes Dabbur","ISR","FW,MF","29",1992,14.6,18,10,3,5,10,4,17,23.5,13,10,0,10,5,23,4,0,"https://fbref.com/en/players/eac044ad/Moanes-Dabbur"
2022,"Hoffenheim","Bundesliga","Mijat Gaćinović","SRB","FW,MF","26",1995,1.2,3,3,1,1,1,3,3,100,0,1,0,1,1,4,2,0,"https://fbref.com/en/players/16daec92/Mijat-Gacinovic"
2022,"Hoffenheim","Bundesliga","Dennis Geiger","GER","MF","23",1998,15.3,34,23,9,20,5,17,30,56.7,13,15,1,14,14,48,7,1,"https://fbref.com/en/players/37f606f0/Dennis-Geiger"
2022,"Hoffenheim","Bundesliga","Florian Grillitsch","AUT","DF,MF","25",1995,16.6,37,19,15,21,1,17,31,54.8,14,18,7,11,29,66,36,1,"https://fbref.com/en/players/ffbbc83b/Florian-Grillitsch"
2022,"Hoffenheim","Bundesliga","Benjamin Hübner","GER","DF","32",1989,4.2,9,5,0,7,2,3,5,60,2,2,2,0,9,18,7,0,"https://fbref.com/en/players/99de6b6f/Benjamin-Hubner"
2022,"Hoffenheim","Bundesliga","Marco John","GER","DF","19",2002,0.5,0,0,0,0,0,0,1,0,1,1,0,1,1,1,1,0,"https://fbref.com/en/players/d9e196bf/Marco-John"
2022,"Hoffenheim","Bundesliga","Pavel Kadeřábek","CZE","DF,MF","29",1992,13.3,11,10,6,3,2,5,16,31.3,11,18,6,12,13,24,22,0,"https://fbref.com/en/players/79c90e45/Pavel-Kaderabek"
2022,"Hoffenheim","Bundesliga","Andrej Kramarić","CRO","FW,MF","30",1991,30.1,8,4,1,5,2,7,17,41.2,10,10,0,10,9,17,7,1,"https://fbref.com/en/players/603cb947/Andrej-Kramaric"
2022,"Hoffenheim","Bundesliga","Håvard Nordtveit","NOR","DF","31",1990,3.4,7,6,2,4,1,4,4,100,0,2,1,1,10,17,11,0,"https://fbref.com/en/players/6cafd68d/Havard-Nordtveit"
2022,"Hoffenheim","Bundesliga","Kasim Nuhu","GHA","DF","26",1995,0.1,0,0,0,0,0,0,1,0,1,0,0,0,0,0,1,0,"https://fbref.com/en/players/93a50d2c/Kasim-Nuhu"
2022,"Hoffenheim","Bundesliga","Philipp Pentke","GER","GK","36",1985,1,0,0,0,0,0,0,0,NA,0,0,0,0,0,0,0,0,"https://fbref.com/en/players/c41f7379/Philipp-Pentke"
2022,"Hoffenheim","Bundesliga","Stefan Posch","AUT","DF","24",1997,24.4,48,30,20,26,2,22,39,56.4,17,43,18,25,28,76,71,2,"https://fbref.com/en/players/7f609bfc/Stefan-Posch"
2022,"Hoffenheim","Bundesliga","Nick Proschwitz","GER","FW","34",1986,0.3,0,0,0,0,0,0,0,NA,0,0,0,0,0,0,0,0,"https://fbref.com/en/players/9cf4fd68/Nick-Proschwitz"
2022,"Hoffenheim","Bundesliga","David Raum","GER","DF,FW","23",1998,30.6,52,29,30,10,12,30,64,46.9,34,38,5,33,27,79,39,1,"https://fbref.com/en/players/7d450ed3/David-Raum"
2022,"Hoffenheim","Bundesliga","Chris Richards","USA","DF","21",2000,14.5,26,15,10,15,1,11,18,61.1,7,21,9,12,22,48,50,1,"https://fbref.com/en/players/0a3d6d2b/Chris-Richards"
2022,"Hoffenheim","Bundesliga","Sebastian Rudy","GER","MF","31",1990,8.6,22,12,9,13,0,11,21,52.4,10,8,3,5,11,33,8,1,"https://fbref.com/en/players/80f36c88/Sebastian-Rudy"
2022,"Hoffenheim","Bundesliga","Georginio Rutter","FRA","FW,MF","19",2002,17.9,18,13,4,8,6,6,17,35.3,11,29,1,28,6,24,11,1,"https://fbref.com/en/players/c64c01fc/Georginio-Rutter"
2022,"Hoffenheim","Bundesliga","Diadie Samassékou","MLI","MF","25",1996,18.4,41,26,14,21,6,21,44,47.7,23,27,11,16,28,69,26,0,"https://fbref.com/en/players/08593525/Diadie-Samassekou"
2022,"Hoffenheim","Bundesliga","Robert Skov","DEN","FW,DF","25",1996,4.1,3,2,1,1,1,2,9,22.2,7,2,0,2,3,6,3,0,"https://fbref.com/en/players/ff98492b/Robert-Skov"
2022,"Hoffenheim","Bundesliga","Angelo Stiller","GER","MF","20",2001,18.8,30,17,11,15,4,9,23,39.1,14,32,6,26,9,39,16,2,"https://fbref.com/en/players/3b1ed320/Angelo-Stiller"
2022,"Hoffenheim","Bundesliga","Umut Tohumcu","GER","MF","16",2004,0.1,0,0,0,0,0,0,0,NA,0,0,0,0,0,0,0,0,"https://fbref.com/en/players/e547d3cf/Umut-Tohumcu"
2022,"Hoffenheim","Bundesliga","Kevin Vogt","GER","DF","29",1991,28.5,21,12,15,6,0,11,21,52.4,10,18,7,11,13,34,101,1,"https://fbref.com/en/players/1d8e9add/Kevin-Vogt"
2022,"Inter","Serie A","Nicolò Barella","ITA","MF","24",1997,32.4,63,42,17,35,11,29,55,52.7,26,26,2,24,21,84,8,2,"https://fbref.com/en/players/6928979a/Nicolo-Barella"
2022,"Inter","Serie A","Alessandro Bastoni","ITA","DF","22",1999,25.7,44,25,28,13,3,17,34,50,17,22,12,10,35,79,59,1,"https://fbref.com/en/players/75b86fb3/Alessandro-Bastoni"
2022,"Inter","Serie A","Marcelo Brozović","CRO","MF","28",1992,32.6,77,45,34,35,8,34,68,50,34,28,10,18,37,114,36,2,"https://fbref.com/en/players/33b8d077/Marcelo-Brozovic"
2022,"Inter","Serie A","Felipe Caicedo","ECU","FW,DF","32",1988,0.3,0,0,0,0,0,0,0,NA,0,1,0,1,0,0,0,0,"https://fbref.com/en/players/93b891d1/Felipe-Caicedo"
2022,"Inter","Serie A","Hakan Çalhanoğlu","TUR","MF","27",1994,27.6,41,23,16,19,6,11,40,27.5,29,29,5,24,25,66,12,0,"https://fbref.com/en/players/cd0fa27b/Hakan-Calhanoglu"
2022,"Inter","Serie A","Joaquín Correa","ARG","FW","26",1994,11.4,11,5,2,6,3,1,13,7.7,12,8,1,7,3,14,2,0,"https://fbref.com/en/players/45b9b619/Joaquin-Correa"
2022,"Inter","Serie A","Danilo D'Ambrosio","ITA","DF","32",1988,11.1,30,15,21,8,1,11,22,50,11,21,10,11,8,38,20,0,"https://fbref.com/en/players/44eb9093/Danilo-DAmbrosio"
2022,"Inter","Serie A","Matteo Darmian","ITA","DF","31",1989,16.7,32,16,17,9,6,16,41,39,25,16,1,15,19,51,25,0,"https://fbref.com/en/players/96e0490d/Matteo-Darmian"
2022,"Inter","Serie A","Federico Dimarco","ITA","DF","23",1997,15.9,28,15,10,15,3,13,24,54.2,11,6,1,5,19,47,19,0,"https://fbref.com/en/players/970b8574/Federico-Dimarco"
2022,"Inter","Serie A","Denzel Dumfries","NED","DF","25",1996,22.5,32,12,9,14,9,16,32,50,16,15,6,9,9,41,26,0,"https://fbref.com/en/players/481c9ece/Denzel-Dumfries"
2022,"Inter","Serie A","Edin Džeko","BIH","FW","35",1986,27.4,14,8,7,4,3,8,25,32,17,22,5,17,4,18,35,0,"https://fbref.com/en/players/3bb7f478/Edin-Dzeko"
2022,"Inter","Serie A","Roberto Gagliardini","ITA","MF","27",1994,7.2,12,6,7,4,1,1,13,7.7,12,14,5,9,9,21,7,0,"https://fbref.com/en/players/ce30bfc8/Roberto-Gagliardini"
2022,"Inter","Serie A","Robin Gosens","GER","DF","27",1994,1.9,3,1,1,2,0,0,0,NA,0,5,2,3,3,6,3,0,"https://fbref.com/en/players/2d970560/Robin-Gosens"
2022,"Inter","Serie A","Samir Handanović","SVN","GK","37",1984,37,1,0,1,0,0,1,2,50,1,1,0,1,0,1,6,3,"https://fbref.com/en/players/74419746/Samir-Handanovic"
2022,"Inter","Serie A","Aleksandar Kolarov","SRB","DF","35",1985,0.5,1,1,1,0,0,1,1,100,0,0,0,0,1,2,2,0,"https://fbref.com/en/players/eda40760/Aleksandar-Kolarov"
2022,"Inter","Serie A","Lautaro Martínez","ARG","FW","23",1997,25.4,20,10,3,10,7,6,11,54.5,5,21,1,20,18,38,6,0,"https://fbref.com/en/players/f7036e1c/Lautaro-Martinez"
2022,"Inter","Serie A","Ivan Perišić","CRO","DF","32",1989,31.3,38,22,18,11,9,28,50,56,22,39,7,32,47,85,42,0,"https://fbref.com/en/players/6fe90922/Ivan-Perisic"
2022,"Inter","Serie A","Ionuț Radu","ROU","GK","24",1997,1,0,0,0,0,0,0,0,NA,0,0,0,0,0,0,0,1,"https://fbref.com/en/players/67f649be/Ionut-Radu"
2022,"Inter","Serie A","Andrea Ranocchia","ITA","DF","33",1988,3.8,8,4,5,1,2,1,3,33.3,2,4,3,1,4,12,16,0,"https://fbref.com/en/players/539230cf/Andrea-Ranocchia"
2022,"Inter","Serie A","Alexis Sánchez","CHI","FW","32",1988,9.8,9,8,0,6,3,2,11,18.2,9,4,0,4,2,11,3,0,"https://fbref.com/en/players/2c0f8e9e/Alexis-Sanchez"
2022,"Inter","Serie A","Martin Satriano","URU","FW,MF","20",2001,0.4,1,0,0,0,1,1,1,100,0,0,0,0,0,1,0,0,"https://fbref.com/en/players/86383d0e/Martin-Satriano"
2022,"Inter","Serie A","Stefano Sensi","ITA","MF,FW","25",1995,1.9,4,3,1,3,0,2,4,50,2,2,0,2,0,4,2,0,"https://fbref.com/en/players/b70bde8f/Stefano-Sensi"
2022,"Inter","Serie A","Milan Škriniar","SVK","DF","26",1995,35,47,27,26,17,4,24,42,57.1,18,36,25,11,25,72,90,1,"https://fbref.com/en/players/30f5ffa9/Milan-Skriniar"
2022,"Inter","Serie A","Matías Vecino","URU","MF","29",1991,4.2,7,5,2,3,2,3,9,33.3,6,10,1,9,4,11,7,0,"https://fbref.com/en/players/44ac04e9/Matias-Vecino"
2022,"Inter","Serie A","Arturo Vidal","CHI","MF","34",1987,8.2,26,10,16,9,1,9,26,34.6,17,13,5,8,7,33,7,1,"https://fbref.com/en/players/67cdbc0e/Arturo-Vidal"
2022,"Inter","Serie A","Stefan de Vrij","NED","DF","29",1992,26.8,38,29,22,16,0,12,17,70.6,5,17,8,9,32,70,52,0,"https://fbref.com/en/players/d0d8dd44/Stefan-de-Vrij"
2022,"Inter","Serie A","Mattia Zanotti","ITA","DF","18",2003,0.1,1,0,1,0,0,0,1,0,1,0,0,0,0,1,0,0,"https://fbref.com/en/players/875d65d1/Mattia-Zanotti"
2022,"Juventus","Serie A","Marley Aké","FRA","FW,MF","20",2001,0.9,0,0,0,0,0,0,2,0,2,0,0,0,1,1,0,0,"https://fbref.com/en/players/414e1f69/Marley-Ake"
2022,"Juventus","Serie A","Rodrigo Bentancur","URU","MF","24",1997,12.8,32,18,11,18,3,7,20,35,13,15,2,13,26,58,15,1,"https://fbref.com/en/players/3b8674e6/Rodrigo-Bentancur"
2022,"Juventus","Serie A","Federico Bernardeschi","ITA","MF,FW","27",1994,16.4,16,10,7,4,5,6,13,46.2,7,12,4,8,5,21,15,0,"https://fbref.com/en/players/ee93c1a9/Federico-Bernardeschi"
2022,"Juventus","Serie A","Leonardo Bonucci","ITA","DF","34",1987,22.3,14,5,4,10,0,8,13,61.5,5,22,17,5,26,40,82,0,"https://fbref.com/en/players/52ec54d0/Leonardo-Bonucci"
2022,"Juventus","Serie A","Giorgio Chiellini","ITA","DF","36",1984,15,22,13,17,4,1,7,13,53.8,6,24,18,6,22,44,59,0,"https://fbref.com/en/players/e85fb9b8/Giorgio-Chiellini"
2022,"Juventus","Serie A","Federico Chiesa","ITA","MF,FW","23",1997,9.6,26,19,9,9,8,12,26,46.2,14,7,0,7,4,30,3,0,"https://fbref.com/en/players/b0f7e36c/Federico-Chiesa"
2022,"Juventus","Serie A","Juan Cuadrado","COL","DF,MF","33",1988,27.6,48,23,30,13,5,30,55,54.5,25,23,5,18,29,77,34,0,"https://fbref.com/en/players/0ab1f153/Juan-Cuadrado"
2022,"Juventus","Serie A","Danilo","BRA","DF,MF","30",1991,21,37,26,20,13,4,18,28,64.3,10,21,12,9,32,69,53,1,"https://fbref.com/en/players/94b2001f/Danilo"
2022,"Juventus","Serie A","Mattia De Sciglio","ITA","DF","28",1992,13,24,12,7,9,8,11,24,45.8,13,10,0,10,10,34,30,0,"https://fbref.com/en/players/ae4e2852/Mattia-De-Sciglio"
2022,"Juventus","Serie A","Paulo Dybala","ARG","FW,MF","27",1993,22.9,30,13,7,14,9,8,35,22.9,27,19,0,19,9,39,4,3,"https://fbref.com/en/players/e0921a4f/Paulo-Dybala"
2022,"Juventus","Serie A","Kaio Jorge","BRA","MF,FW","19",2002,1.3,2,1,0,2,0,1,3,33.3,2,1,0,1,0,2,2,0,"https://fbref.com/en/players/0cf465f2/Kaio-Jorge"
2022,"Juventus","Serie A","Moise Kean","ITA","FW","21",2000,12.2,9,4,2,5,2,6,16,37.5,10,5,0,5,3,12,8,1,"https://fbref.com/en/players/3d50bcdb/Moise-Kean"
2022,"Juventus","Serie A","Dejan Kulusevski","SWE","FW,MF","21",2000,8.6,15,12,9,6,0,8,21,38.1,13,14,0,14,5,20,5,0,"https://fbref.com/en/players/df3cda47/Dejan-Kulusevski"
2022,"Juventus","Serie A","Matthijs de Ligt","NED","DF","21",1999,29.7,34,19,21,13,0,15,18,83.3,3,31,21,10,26,60,103,0,"https://fbref.com/en/players/d6e53a3a/Matthijs-de-Ligt"
2022,"Juventus","Serie A","Manuel Locatelli","ITA","MF","23",1998,24,44,25,21,16,7,21,47,44.7,26,43,21,22,22,66,33,0,"https://fbref.com/en/players/a8a874f1/Manuel-Locatelli"
2022,"Juventus","Serie A","Weston McKennie","USA","MF","22",1998,15.2,20,11,11,7,2,8,26,30.8,18,17,8,9,23,43,20,0,"https://fbref.com/en/players/01c3aff5/Weston-McKennie"
2022,"Juventus","Serie A","Arthur Melo","BRA","MF","24",1996,10.7,25,12,10,14,1,13,24,54.2,11,11,2,9,7,32,8,1,"https://fbref.com/en/players/48b3dd60/Arthur-Melo"
2022,"Juventus","Serie A","Fabio Miretti","ITA","MF","17",2003,3.6,4,2,2,2,0,2,9,22.2,7,3,1,2,2,6,3,0,"https://fbref.com/en/players/34693494/Fabio-Miretti"
2022,"Juventus","Serie A","Álvaro Morata","ESP","FW","28",1992,25.6,18,9,4,9,5,8,31,25.8,23,26,1,25,5,23,24,0,"https://fbref.com/en/players/129af0db/Alvaro-Morata"
2022,"Juventus","Serie A","Martin Palumbo","NOR","FW","19",2002,0.1,0,0,0,0,0,0,1,0,1,0,0,0,0,0,0,0,"https://fbref.com/en/players/f8d41a8c/Martin-Palumbo"
2022,"Juventus","Serie A","Luca Pellegrini","ITA","DF","22",1999,12.3,23,10,13,5,5,12,19,63.2,7,9,1,8,5,28,23,0,"https://fbref.com/en/players/3b61c9ec/Luca-Pellegrini"
2022,"Juventus","Serie A","Mattia Perin","ITA","GK","28",1992,4.5,0,0,0,0,0,0,0,NA,0,0,0,0,0,0,3,0,"https://fbref.com/en/players/4c62d0c8/Mattia-Perin"
2022,"Juventus","Serie A","Carlo Pinsoglio","ITA","GK","31",1990,0.5,0,0,0,0,0,0,0,NA,0,0,0,0,0,0,0,0,"https://fbref.com/en/players/f6a06749/Carlo-Pinsoglio"
2022,"Juventus","Serie A","Adrien Rabiot","FRA","MF","26",1995,25.4,64,43,32,24,8,15,34,44.1,19,34,8,26,20,84,41,1,"https://fbref.com/en/players/8794e251/Adrien-Rabiot"
2022,"Juventus","Serie A","Aaron Ramsey","WAL","MF","30",1990,1.1,0,0,0,0,0,0,0,NA,0,0,0,0,1,1,0,0,"https://fbref.com/en/players/ef619b0b/Aaron-Ramsey"
2022,"Juventus","Serie A","Cristiano Ronaldo","POR","FW","36",1985,0.3,1,0,0,1,0,1,1,100,0,0,0,0,0,1,0,0,"https://fbref.com/en/players/dea698d9/Cristiano-Ronaldo"
2022,"Juventus","Serie A","Daniele Rugani","ITA","DF","27",1994,9.8,8,5,4,4,0,4,7,57.1,3,9,4,5,11,19,47,0,"https://fbref.com/en/players/14b8fcdf/Daniele-Rugani"
2022,"Juventus","Serie A","Alex Sandro","BRA","DF","30",1991,19.8,27,16,15,9,3,11,25,44,14,17,6,11,27,54,40,0,"https://fbref.com/en/players/0d82903c/Alex-Sandro"
2022,"Juventus","Serie A","Matìas Soulé","ARG","FW","18",2003,0.1,0,0,0,0,0,0,1,0,1,0,0,0,0,0,0,0,"https://fbref.com/en/players/c13ddd3e/Matias-Soule"
2022,"Juventus","Serie A","Wojciech Szczęsny","POL","GK","31",1990,33,1,1,1,0,0,1,2,50,1,0,0,0,0,1,8,1,"https://fbref.com/en/players/01b8a2b2/Wojciech-Szczesny"
2022,"Juventus","Serie A","Dušan Vlahović","SRB","FW","21",2000,12,0,0,0,0,0,0,4,0,4,3,0,3,0,0,7,0,"https://fbref.com/en/players/79443529/Dusan-Vlahovic"
2022,"Juventus","Serie A","Denis Zakaria","SUI","MF","24",1996,6.6,11,7,3,6,2,3,11,27.3,8,16,3,13,11,22,7,0,"https://fbref.com/en/players/384d58d9/Denis-Zakaria"
2022,"Köln","Bundesliga","Sebastian Andersson","SWE","FW","30",1991,14,11,7,0,3,8,3,9,33.3,6,8,0,8,3,14,14,0,"https://fbref.com/en/players/b4cf5806/Sebastian-Andersson"
2022,"Köln","Bundesliga","Julian Chabot","GER","DF","23",1998,2.3,8,3,4,4,0,2,5,40,3,4,2,2,3,11,5,1,"https://fbref.com/en/players/ae7058f9/Julian-Chabot"
2022,"Köln","Bundesliga","Rafael Czichos","GER","DF","31",1990,15.6,29,18,18,9,2,14,28,50,14,23,13,10,19,48,53,2,"https://fbref.com/en/players/b0a0698b/Rafael-Czichos"
2022,"Köln","Bundesliga","Ondrej Duda","SVK","MF,FW","26",1994,17.9,23,16,4,12,7,6,23,26.1,17,14,2,12,17,40,9,0,"https://fbref.com/en/players/79ca3e23/Ondrej-Duda"
2022,"Köln","Bundesliga","Kingsley Ehizibue","NED","DF","26",1995,7.6,32,18,27,5,0,15,24,62.5,9,13,4,9,9,41,26,0,"https://fbref.com/en/players/76b2817e/Kingsley-Ehizibue"
2022,"Köln","Bundesliga","Jonas Hector","GER","DF","31",1990,28.4,76,39,36,26,14,29,74,39.2,45,59,8,51,50,126,68,1,"https://fbref.com/en/players/c2009df3/Jonas-Hector"
2022,"Köln","Bundesliga","Jannes Horn","GER","DF","24",1997,5.3,6,4,4,2,0,4,8,50,4,1,1,0,3,9,9,0,"https://fbref.com/en/players/2b83fa49/Jannes-Horn"
2022,"Köln","Bundesliga","Timo Horn","GER","GK","28",1993,13,0,0,0,0,0,0,1,0,1,0,0,0,0,0,5,0,"https://fbref.com/en/players/3cd9e95a/Timo-Horn"
2022,"Köln","Bundesliga","Timo Hübers","GER","DF","25",1996,19.3,45,27,28,17,0,27,45,60,18,31,19,12,52,97,95,0,"https://fbref.com/en/players/94302c52/Timo-Hubers"
2022,"Köln","Bundesliga","Florian Kainz","AUT","MF,FW","28",1992,25.8,41,26,9,25,7,23,51,45.1,28,27,3,24,32,73,24,0,"https://fbref.com/en/players/94c18565/Florian-Kainz"
2022,"Köln","Bundesliga","Noah Katterbach","GER","DF","20",2001,0.2,1,1,1,0,0,1,1,100,0,0,0,0,0,1,1,0,"https://fbref.com/en/players/e27de4fa/Noah-Katterbach"
2022,"Köln","Bundesliga","Luca Kilian","GER","DF","21",1999,25.3,42,24,30,9,3,21,41,51.2,20,31,13,18,46,88,109,3,"https://fbref.com/en/players/610aa1e9/Luca-Kilian"
2022,"Köln","Bundesliga","Tim Lemperle","GER","FW,MF","19",2002,1.7,4,1,2,1,1,1,3,33.3,2,1,0,1,2,6,2,0,"https://fbref.com/en/players/792ffa71/Tim-Lemperle"
2022,"Köln","Bundesliga","Dejan Ljubicic","AUT","MF,FW","23",1997,21.9,33,19,12,13,8,13,49,26.5,36,19,1,18,15,48,11,0,"https://fbref.com/en/players/c455a2b2/Dejan-Ljubicic"
2022,"Köln","Bundesliga","Jorge Meré","ESP","DF","24",1997,5.4,9,6,3,6,0,4,7,57.1,3,6,4,2,10,19,19,0,"https://fbref.com/en/players/9f979eb2/Jorge-Mere"
2022,"Köln","Bundesliga","Anthony Modeste","FRA","FW","33",1988,29,10,6,4,5,1,3,18,16.7,15,11,2,9,4,14,29,0,"https://fbref.com/en/players/34e4343c/Anthony-Modeste"
2022,"Köln","Bundesliga","Mathias Olesen","LUX","MF,FW","20",2001,0.2,0,0,0,0,0,0,0,NA,0,0,0,0,1,1,0,0,"https://fbref.com/en/players/86adbcc7/Mathias-Olesen"
2022,"Köln","Bundesliga","Tomáš Ostrák","CZE","MF,FW","21",2000,0.3,1,0,0,0,1,1,3,33.3,2,0,0,0,1,2,0,0,"https://fbref.com/en/players/3ba95f20/Tomas-Ostrak"
2022,"Köln","Bundesliga","Salih Özcan","TUR","MF","23",1998,25.7,42,30,14,23,5,22,51,43.1,29,37,5,32,51,93,35,1,"https://fbref.com/en/players/15413fa5/Salih-Ozcan"
2022,"Köln","Bundesliga","Louis Schaub","AUT","MF,FW","26",1994,7.3,16,10,7,7,2,11,20,55,9,17,3,14,3,19,3,0,"https://fbref.com/en/players/b50ec54b/Louis-Schaub"
2022,"Köln","Bundesliga","Kingsley Schindler","GER","DF,FW","28",1993,3.9,1,0,0,0,1,1,5,20,4,5,1,4,5,6,5,0,"https://fbref.com/en/players/bd527260/Kingsley-Schindler"
2022,"Köln","Bundesliga","Benno Schmitz","GER","DF","26",1994,26.9,57,37,21,27,9,42,86,48.8,44,44,8,36,39,96,39,0,"https://fbref.com/en/players/ad00b1a8/Benno-Schmitz"
2022,"Köln","Bundesliga","Marvin Schwäbe","GER","GK","26",1995,21,0,0,0,0,0,0,0,NA,0,0,0,0,0,0,8,1,"https://fbref.com/en/players/87436846/Marvin-Schwabe"
2022,"Köln","Bundesliga","Ellyes Skhiri","TUN","MF","26",1995,20.2,55,33,25,26,4,22,41,53.7,19,41,7,34,37,92,35,1,"https://fbref.com/en/players/c2211709/Ellyes-Skhiri"
2022,"Köln","Bundesliga","Jan Thielmann","GER","MF,FW","19",2002,13.2,24,16,6,12,6,8,23,34.8,15,23,2,21,10,34,11,0,"https://fbref.com/en/players/fd53759d/Jan-Thielmann"
2022,"Köln","Bundesliga","Mark Uth","GER","MF,FW","29",1991,22.5,32,20,9,14,9,15,49,30.6,34,27,1,26,14,46,13,0,"https://fbref.com/en/players/a3ddb1b9/Mark-Uth"
2022,"Lazio","Serie A","Francesco Acerbi","ITA","DF","33",1988,28.2,25,12,15,9,1,12,19,63.2,7,37,28,9,34,59,92,0,"https://fbref.com/en/players/b96b595c/Francesco-Acerbi"
2022,"Lazio","Serie A","Jean-Daniel Akpa-Akpro","CIV","MF","28",1992,3.5,17,10,7,9,1,7,12,58.3,5,4,2,2,2,19,6,0,"https://fbref.com/en/players/fdf4b948/Jean-Daniel-Akpa-Akpro"
2022,"Lazio","Serie A","Luis Alberto","ESP","MF","28",1992,26.1,29,17,8,11,10,8,52,15.4,44,32,4,28,13,42,7,0,"https://fbref.com/en/players/5294a83f/Luis-Alberto"
2022,"Lazio","Serie A","Felipe Anderson","BRA","FW","28",1993,32.1,71,45,30,33,8,27,99,27.3,72,65,6,59,20,91,16,0,"https://fbref.com/en/players/9f1893b9/Felipe-Anderson"
2022,"Lazio","Serie A","Toma Bašić","CRO","MF","24",1996,10.9,12,8,3,9,0,5,17,29.4,12,13,4,9,4,16,21,0,"https://fbref.com/en/players/80556f08/Toma-Basic"
2022,"Lazio","Serie A","Jovane Cabral","CPV","FW","23",1998,2.1,2,1,1,0,1,0,0,NA,0,1,1,0,1,3,1,0,"https://fbref.com/en/players/e34e086c/Jovane-Cabral"
2022,"Lazio","Serie A","Danilo Cataldi","ITA","MF","26",1994,19,36,17,15,17,4,12,38,31.6,26,24,12,12,17,53,19,1,"https://fbref.com/en/players/ba3d3bea/Danilo-Cataldi"
2022,"Lazio","Serie A","Gonzalo Escalante","ARG","MF","28",1993,0.1,1,0,1,0,0,1,1,100,0,2,1,1,1,2,0,0,"https://fbref.com/en/players/3f79a1c8/Gonzalo-Escalante"
2022,"Lazio","Serie A","Luiz Felipe","ITA","DF","24",1997,27.7,41,23,21,16,4,20,34,58.8,14,40,33,7,33,74,102,1,"https://fbref.com/en/players/15d0c248/Luiz-Felipe"
2022,"Lazio","Serie A","Elseid Hysaj","ALB","DF","27",1994,22.5,46,30,25,17,4,29,45,64.4,16,18,6,12,24,70,34,1,"https://fbref.com/en/players/2f3452eb/Elseid-Hysaj"
2022,"Lazio","Serie A","Ciro Immobile","ITA","FW","31",1990,30.1,10,5,4,4,2,1,15,6.7,14,7,1,6,3,13,16,0,"https://fbref.com/en/players/4431aed2/Ciro-Immobile"
2022,"Lazio","Serie A","Dimitrije Kamenović","SRB","DF","21",2000,0.5,1,1,1,0,0,1,1,100,0,0,0,0,2,3,1,0,"https://fbref.com/en/players/d3e0c826/Dimitrije-Kamenovic"
2022,"Lazio","Serie A","Manuel Lazzari","ITA","DF","27",1993,18.5,28,14,13,15,0,16,26,61.5,10,10,2,8,12,40,16,1,"https://fbref.com/en/players/02caf6e0/Manuel-Lazzari"
2022,"Lazio","Serie A","Lucas Leiva","BRA","MF","34",1987,18.9,55,30,26,25,4,15,53,28.3,38,27,10,17,28,83,37,0,"https://fbref.com/en/players/4c78b5ed/Lucas-Leiva"
2022,"Lazio","Serie A","Anderson Lima","BRA","MF","21",1999,0.7,2,0,1,1,0,0,2,0,2,1,0,1,2,4,1,0,"https://fbref.com/en/players/59be3a74/Anderson-Lima"
2022,"Lazio","Serie A","Adam Marušić","MNE","DF","28",1992,30.2,30,18,16,12,2,13,32,40.6,19,19,8,11,41,71,71,0,"https://fbref.com/en/players/d4535821/Adam-Marusic"
2022,"Lazio","Serie A","Sergej Milinković-Savić","SRB","MF","26",1995,34.4,67,44,20,32,15,29,67,43.3,38,50,9,41,34,101,43,1,"https://fbref.com/en/players/4e6dbac4/Sergej-Milinkovic-Savic"
2022,"Lazio","Serie A","Raúl Moro","ESP","FW","18",2002,2.2,3,3,0,2,1,1,5,20,4,2,0,2,0,3,0,0,"https://fbref.com/en/players/919dd4b1/Raul-Moro"
2022,"Lazio","Serie A","Vedat Muriqi","KVX","FW","27",1994,2.4,1,0,1,0,0,0,5,0,5,0,0,0,0,1,2,0,"https://fbref.com/en/players/0cadc46d/Vedat-Muriqi"
2022,"Lazio","Serie A","Patric","ESP","DF","28",1993,18.3,21,15,17,4,0,9,20,45,11,22,11,11,12,33,44,2,"https://fbref.com/en/players/f7223718/Patric"
2022,"Lazio","Serie A","Pedro","ESP","FW","34",1987,22.6,36,23,8,19,9,16,47,34,31,18,2,16,6,42,8,0,"https://fbref.com/en/players/3ca7254a/Pedro"
2022,"Lazio","Serie A","Ștefan Radu","ROU","DF","34",1986,6.2,9,6,3,6,0,5,9,55.6,4,7,2,5,5,14,15,0,"https://fbref.com/en/players/53de807a/Stefan-Radu"
2022,"Lazio","Serie A","Pepe Reina","ESP","GK","38",1982,15,0,0,0,0,0,0,1,0,1,0,0,0,0,0,1,1,"https://fbref.com/en/players/e358587b/Pepe-Reina"
2022,"Lazio","Serie A","Luka Romero","ARG","FW","16",2004,0.9,2,1,0,1,1,0,2,0,2,0,0,0,1,3,0,0,"https://fbref.com/en/players/ca6edaa0/Luka-Romero"
2022,"Lazio","Serie A","Thomas Strakosha","ALB","GK","26",1995,23,0,0,0,0,0,0,0,NA,0,0,0,0,0,0,7,2,"https://fbref.com/en/players/339fe0e8/Thomas-Strakosha"
2022,"Lazio","Serie A","Denis Vavro","SVK","DF","25",1996,0.1,0,0,0,0,0,0,0,NA,0,0,0,0,0,0,0,0,"https://fbref.com/en/players/08990838/Denis-Vavro"
2022,"Lazio","Serie A","Mattia Zaccagni","ITA","FW","26",1995,20.8,33,16,10,13,10,11,19,57.9,8,17,2,15,20,53,5,0,"https://fbref.com/en/players/d85c238b/Mattia-Zaccagni"
2022,"Leeds United","Premier League","Luke Ayling","ENG","DF","29",1991,25.2,74,42,46,23,5,51,97,52.6,46,46,25,21,28,102,52,1,"https://fbref.com/en/players/420d7c7d/Luke-Ayling"
2022,"Leeds United","Premier League","Patrick Bamford","ENG","FW","27",1993,6.2,1,0,0,1,0,0,3,0,3,8,2,6,2,3,8,0,"https://fbref.com/en/players/93feac6e/Patrick-Bamford"
2022,"Leeds United","Premier League","Lewis Bate","ENG","MF","18",2002,1.6,1,0,0,0,1,0,8,0,8,1,0,1,1,2,1,0,"https://fbref.com/en/players/cd4256d3/Lewis-Bate"
2022,"Leeds United","Premier League","Liam Cooper","SCO","DF","29",1991,20.2,41,23,27,13,1,23,33,69.7,10,29,18,11,43,84,72,2,"https://fbref.com/en/players/dc64b8b3/Liam-Cooper"
2022,"Leeds United","Premier League","Hélder Costa","ANG","MF","27",1994,0.2,0,0,0,0,0,0,0,NA,0,1,0,1,0,0,0,0,"https://fbref.com/en/players/f13d02a6/Helder-Costa"
2022,"Leeds United","Premier League","Charlie Cresswell","ENG","DF","18",2002,1.6,5,2,1,4,0,3,3,100,0,1,1,0,2,7,6,0,"https://fbref.com/en/players/4654e5f5/Charlie-Cresswell"
2022,"Leeds United","Premier League","Stuart Dallas","NIR","DF,MF","30",1991,32.4,93,55,58,31,4,56,105,53.3,49,45,14,31,57,150,63,2,"https://fbref.com/en/players/67ca8566/Stuart-Dallas"
2022,"Leeds United","Premier League","Cody Drameh","ENG","DF,MF","19",2001,1.4,4,2,3,1,0,1,3,33.3,2,0,0,0,1,5,4,0,"https://fbref.com/en/players/e0d1510a/Cody-Drameh"
2022,"Leeds United","Premier League","Junior Firpo","ESP","DF,MF","24",1996,19,61,29,30,26,5,31,59,52.5,28,22,6,16,24,85,37,0,"https://fbref.com/en/players/24f59bb2/Junior-Firpo"
2022,"Leeds United","Premier League","Adam Forshaw","ENG","MF","29",1991,17,53,23,21,27,5,21,54,38.9,33,17,1,16,19,72,12,2,"https://fbref.com/en/players/9f1938ab/Adam-Forshaw"
2022,"Leeds United","Premier League","Leo Fuhr Hjelde","NOR","MF,DF","17",2003,1.7,5,4,3,2,0,3,3,100,0,3,3,0,4,9,7,0,"https://fbref.com/en/players/d102b8a2/Leo-Fuhr-Hjelde"
2022,"Leeds United","Premier League","Joe Gelhardt","ENG","FW,MF","19",2002,8.3,4,3,1,0,3,2,10,20,8,9,0,9,0,4,3,0,"https://fbref.com/en/players/01962d0d/Joe-Gelhardt"
2022,"Leeds United","Premier League","Sam Greenwood","ENG","MF,FW","19",2002,2.6,8,5,0,5,3,4,7,57.1,3,3,0,3,2,10,1,0,"https://fbref.com/en/players/f3354c07/Sam-Greenwood"
2022,"Leeds United","Premier League","Jack Harrison","ENG","FW,MF","24",1996,29.3,57,37,22,22,13,31,76,40.8,45,35,1,34,21,78,19,0,"https://fbref.com/en/players/aa849a12/Jack-Harrison"
2022,"Leeds United","Premier League","Daniel James","WAL","FW,MF","23",1997,26.3,24,14,8,8,8,10,23,43.5,13,18,1,17,8,32,12,0,"https://fbref.com/en/players/c931d9f9/Daniel-James"
2022,"Leeds United","Premier League","Kristoffer Klaesson","NOR","GK","20",2000,0.4,0,0,0,0,0,0,0,NA,0,0,0,0,0,0,0,0,"https://fbref.com/en/players/3f70db80/Kristoffer-Klaesson"
2022,"Leeds United","Premier League","Mateusz Klich","POL","MF","31",1990,23,47,25,18,23,6,25,66,37.9,41,22,4,18,11,58,20,0,"https://fbref.com/en/players/282679b4/Mateusz-Klich"
2022,"Leeds United","Premier League","Robin Koch","GER","MF,DF","25",1996,17.5,21,13,9,10,2,9,34,26.5,25,26,10,16,20,41,44,0,"https://fbref.com/en/players/ea6bc03a/Robin-Koch"
2022,"Leeds United","Premier League","Diego Llorente","ESP","DF","27",1993,26,53,31,32,19,2,33,47,70.2,14,35,17,18,40,93,77,2,"https://fbref.com/en/players/bba30585/Diego-Llorente"
2022,"Leeds United","Premier League","Liam McCarron","SCO","FW","20",2001,0.1,0,0,0,0,0,0,0,NA,0,1,0,1,0,0,0,0,"https://fbref.com/en/players/076bb352/Liam-McCarron"
2022,"Leeds United","Premier League","Stuart McKinstry","SCO","MF","18",2002,0,0,0,0,0,0,0,0,NA,0,0,0,0,0,0,0,0,"https://fbref.com/en/players/1000a059/Stuart-McKinstry"
2022,"Leeds United","Premier League","Illan Meslier","FRA","GK","21",2000,37.6,1,1,1,0,0,1,1,100,0,0,0,0,0,1,27,1,"https://fbref.com/en/players/6b625ac2/Illan-Meslier"
2022,"Leeds United","Premier League","Kalvin Phillips","ENG","MF","25",1995,17.7,54,25,24,25,5,24,57,42.1,33,37,9,28,24,78,18,0,"https://fbref.com/en/players/4f565d77/Kalvin-Phillips"
2022,"Leeds United","Premier League","Raphinha","BRA","FW,MF","24",1996,32.4,51,29,25,14,12,22,71,31,49,43,0,43,29,80,28,1,"https://fbref.com/en/players/3423f250/Raphinha"
2022,"Leeds United","Premier League","Tyler Roberts","WAL","MF,FW","22",1999,11,16,7,6,7,3,9,16,56.3,7,11,1,10,5,21,11,0,"https://fbref.com/en/players/6c17e046/Tyler-Roberts"
2022,"Leeds United","Premier League","Rodrigo","ESP","MF,FW","30",1991,25.2,20,9,7,6,7,4,32,12.5,28,12,0,12,11,31,27,1,"https://fbref.com/en/players/1fb1c435/Rodrigo"
2022,"Leeds United","Premier League","Jamie Shackleton","ENG","DF,MF","21",1999,7.9,27,16,19,7,1,13,25,52,12,11,7,4,8,35,12,1,"https://fbref.com/en/players/8d03ca5a/Jamie-Shackleton"
2022,"Leeds United","Premier League","Pascal Struijk","NED","DF,MF","21",1999,22.8,61,39,34,23,4,30,50,60,20,35,23,12,33,94,60,2,"https://fbref.com/en/players/f4d296e4/Pascal-Struijk"
2022,"Leeds United","Premier League","Crysencio Summerville","NED","MF,FW","19",2001,1.4,5,3,1,1,3,2,3,66.7,1,2,0,2,2,7,0,0,"https://fbref.com/en/players/df04eb4b/Crysencio-Summerville"
2022,"Leicester City","Premier League","Marc Albrighton","ENG","FW,DF","31",1989,12.6,31,19,16,9,6,10,47,21.3,37,15,3,12,14,45,20,0,"https://fbref.com/en/players/b827d5b3/Marc-Albrighton"
2022,"Leicester City","Premier League","Daniel Amartey","GHA","DF","26",1994,23.6,26,13,19,7,0,19,29,65.5,10,30,22,8,21,47,93,4,"https://fbref.com/en/players/1a4ef233/Daniel-Amartey"
2022,"Leicester City","Premier League","Harvey Barnes","ENG","FW,MF","23",1997,23.3,31,16,9,11,11,7,23,30.4,16,24,1,23,5,36,7,0,"https://fbref.com/en/players/3ea50f67/Harvey-Barnes"
2022,"Leicester City","Premier League","Ryan Bertrand","ENG","DF","31",1989,3.7,8,5,3,4,1,2,5,40,3,8,3,5,1,9,7,0,"https://fbref.com/en/players/01226327/Ryan-Bertrand"
2022,"Leicester City","Premier League","Lewis Brunt","ENG","MF","20",2000,0.3,0,0,0,0,0,0,0,NA,0,1,0,1,0,0,0,0,"https://fbref.com/en/players/a2081c6b/Lewis-Brunt"
2022,"Leicester City","Premier League","Timothy Castagne","BEL","DF","25",1995,23.6,67,31,38,22,7,27,43,62.8,16,28,9,19,29,96,54,1,"https://fbref.com/en/players/197640fd/Timothy-Castagne"
2022,"Leicester City","Premier League","Hamza Choudhury","ENG","DF,MF","23",1997,3.2,9,3,4,4,1,3,5,60,2,0,0,0,12,21,10,0,"https://fbref.com/en/players/7d2d3329/Hamza-Choudhury"
2022,"Leicester City","Premier League","Patson Daka","ZAM","FW","22",1998,12.9,15,10,2,8,5,2,19,10.5,17,7,0,7,2,17,8,0,"https://fbref.com/en/players/ca45605e/Patson-Daka"
2022,"Leicester City","Premier League","Kiernan Dewsbury-Hall","ENG","MF","22",1998,23.4,39,24,20,14,5,19,40,47.5,21,37,8,29,21,60,26,1,"https://fbref.com/en/players/5c74c0f5/Kiernan-Dewsbury-Hall"
2022,"Leicester City","Premier League","Jonny Evans","NIR","DF","33",1988,15,24,14,14,8,2,14,22,63.6,8,17,13,4,20,44,59,0,"https://fbref.com/en/players/f8fcd2a5/Jonny-Evans"
2022,"Leicester City","Premier League","Wesley Fofana","FRA","DF","20",2000,7,12,8,11,1,0,7,11,63.6,4,5,2,3,12,24,26,1,"https://fbref.com/en/players/132a82f1/Wesley-Fofana"
2022,"Leicester City","Premier League","Kelechi Iheanacho","NGA","FW","24",1996,14,10,7,2,5,3,3,14,21.4,11,19,0,19,4,14,10,0,"https://fbref.com/en/players/c92e1a31/Kelechi-Iheanacho"
2022,"Leicester City","Premier League","James Justin","ENG","DF","23",1998,11.1,22,13,11,8,3,7,15,46.7,8,16,4,12,17,39,34,0,"https://fbref.com/en/players/fb614c44/James-Justin"
2022,"Leicester City","Premier League","Ademola Lookman","NGA","FW,MF","23",1997,16.1,32,14,10,13,9,10,28,35.7,18,19,1,18,10,42,4,0,"https://fbref.com/en/players/7c104bb7/Ademola-Lookman"
2022,"Leicester City","Premier League","James Maddison","ENG","MF,FW","24",1996,27.3,40,20,8,24,8,14,46,30.4,32,18,3,15,11,51,12,0,"https://fbref.com/en/players/ee38d9c5/James-Maddison"
2022,"Leicester City","Premier League","Kasey McAteer","ENG","FW","19",2001,0,0,0,0,0,0,0,0,NA,0,0,0,0,0,0,0,0,"https://fbref.com/en/players/b2c66859/Kasey-McAteer"
2022,"Leicester City","Premier League","Nampalys Mendy","SEN","MF","29",1992,11.5,12,6,8,4,0,6,17,35.3,11,7,4,3,11,23,11,1,"https://fbref.com/en/players/1598599e/Nampalys-Mendy"
2022,"Leicester City","Premier League","Wilfred Ndidi","NGA","MF,DF","24",1996,18,60,32,32,27,1,22,55,40,33,36,8,28,42,102,54,1,"https://fbref.com/en/players/6b47c5db/Wilfred-Ndidi"
2022,"Leicester City","Premier League","Ricardo Pereira","POR","DF","27",1993,11,37,20,19,13,5,21,40,52.5,19,13,1,12,17,54,39,0,"https://fbref.com/en/players/75a72a99/Ricardo-Pereira"
2022,"Leicester City","Premier League","Ayoze Pérez","ESP","MF,FW","28",1993,4.9,4,2,0,3,1,0,13,0,13,11,1,10,2,6,5,0,"https://fbref.com/en/players/819aa8e7/Ayoze-Perez"
2022,"Leicester City","Premier League","Kasper Schmeichel","DEN","GK","34",1986,37,0,0,0,0,0,0,2,0,2,0,0,0,1,1,15,2,"https://fbref.com/en/players/53af52f3/Kasper-Schmeichel"
2022,"Leicester City","Premier League","Boubakary Soumaré","FRA","MF","22",1999,12.2,19,13,10,8,1,8,17,47.1,9,13,1,12,14,33,18,0,"https://fbref.com/en/players/ae59b359/Boubakary-Soumare"
2022,"Leicester City","Premier League","Çağlar Söyüncü","TUR","DF","25",1996,27.7,47,30,32,12,3,26,42,61.9,16,44,27,17,32,79,115,1,"https://fbref.com/en/players/21166ff4/Caglar-Soyuncu"
2022,"Leicester City","Premier League","Luke Thomas","ENG","DF","20",2001,21.2,50,31,33,13,4,28,65,43.1,37,35,14,21,40,90,55,0,"https://fbref.com/en/players/fc027d02/Luke-Thomas"
2022,"Leicester City","Premier League","Youri Tielemans","BEL","MF","24",1997,29.2,74,38,23,45,6,42,100,42,58,47,13,34,21,95,41,3,"https://fbref.com/en/players/56f7a928/Youri-Tielemans"
2022,"Leicester City","Premier League","Jamie Vardy","ENG","FW","34",1987,20.1,6,5,0,4,2,1,7,14.3,6,9,0,9,1,7,17,0,"https://fbref.com/en/players/45963054/Jamie-Vardy"
2022,"Leicester City","Premier League","Jannik Vestergaard","DEN","DF","28",1992,6.3,15,10,12,3,0,8,15,53.3,7,10,8,2,7,22,36,0,"https://fbref.com/en/players/1900032e/Jannik-Vestergaard"
2022,"Leicester City","Premier League","Danny Ward","WAL","GK","28",1993,1,0,0,0,0,0,0,0,NA,0,0,0,0,0,0,1,0,"https://fbref.com/en/players/d3ce0e89/Danny-Ward"
2022,"Lens","Ligue 1","Ibrahima Baldé","FRA","FW,MF","18",2003,0.6,0,0,0,0,0,0,0,NA,0,0,0,0,0,0,0,0,"https://fbref.com/en/players/a30cb0d4/Ibrahima-Balde"
2022,"Lens","Ligue 1","Simon Banza","FRA","FW","24",1996,1.4,2,1,0,0,2,0,2,0,2,1,0,1,1,3,2,0,"https://fbref.com/en/players/be47b750/Simon-Banza"
2022,"Lens","Ligue 1","Patrick Berg","NOR","MF","23",1997,3.4,14,6,6,8,0,0,4,0,4,2,1,1,4,18,3,0,"https://fbref.com/en/players/e4114f5d/Patrick-Berg"
2022,"Lens","Ligue 1","Charles Boli","FRA","MF,DF","22",1998,0.4,2,1,0,2,0,0,0,NA,0,0,0,0,0,2,0,0,"https://fbref.com/en/players/bbdd999a/Charles-Boli"
2022,"Lens","Ligue 1","Ismaëlben Boura","FRA","DF","20",2000,1.1,2,2,1,1,0,0,0,NA,0,1,1,0,2,4,5,0,"https://fbref.com/en/players/62e02107/Ismaelben-Boura"
2022,"Lens","Ligue 1","Yannick Cahuzac","FRA","MF","36",1985,6.9,5,2,2,3,0,0,5,0,5,8,2,6,9,14,12,0,"https://fbref.com/en/players/677ee102/Yannick-Cahuzac"
2022,"Lens","Ligue 1","Jonathan Clauss","FRA","DF","28",1992,33.8,63,34,33,20,10,22,55,40,33,43,1,42,73,136,51,0,"https://fbref.com/en/players/5219ab4a/Jonathan-Clauss"
2022,"Lens","Ligue 1","David Pereira da Costa","POR","MF,FW","20",2001,16.3,22,12,9,6,7,11,26,42.3,15,12,0,12,13,35,5,0,"https://fbref.com/en/players/59948ef7/David-Pereira-da-Costa"
2022,"Lens","Ligue 1","Kevin Danso","AUT","DF","22",1998,31,41,29,29,12,0,23,34,67.6,11,38,25,13,40,81,111,0,"https://fbref.com/en/players/6e33125f/Kevin-Danso"
2022,"Lens","Ligue 1","Cheick Doucouré","MLI","MF","21",2000,32.7,75,43,34,34,7,35,79,44.3,44,30,7,23,68,143,24,0,"https://fbref.com/en/players/ce4f40c7/Cheick-Doucoure"
2022,"Lens","Ligue 1","Wuilker Faríñez","VEN","GK","23",1998,12.3,0,0,0,0,0,0,0,NA,0,0,0,0,0,0,4,0,"https://fbref.com/en/players/2c127b6f/Wuilker-Farinez"
2022,"Lens","Ligue 1","Seko Fofana","CIV","MF","26",1995,37.3,27,19,11,13,3,12,58,20.7,46,24,2,22,26,53,17,1,"https://fbref.com/en/players/5313ed43/Seko-Fofana"
2022,"Lens","Ligue 1","Steven Fortes","CPV","DF","29",1992,1,2,0,2,0,0,1,2,50,1,2,1,1,0,2,4,0,"https://fbref.com/en/players/574aa9ec/Steven-Fortes"
2022,"Lens","Ligue 1","Przemysław Frankowski","POL","DF","26",1995,27.2,57,39,22,27,8,36,74,48.6,38,27,0,27,28,85,52,0,"https://fbref.com/en/players/00a8d210/Przemyslaw-Frankowski"
2022,"Lens","Ligue 1","Ignatius Ganago","CMR","FW","22",1999,11.4,3,2,1,2,0,2,6,33.3,4,4,0,4,2,5,3,0,"https://fbref.com/en/players/23c63b7f/Ignatius-Ganago"
2022,"Lens","Ligue 1","Jonathan Gradit","FRA","DF","28",1992,34.1,60,28,24,28,8,25,45,55.6,20,39,27,12,65,125,106,0,"https://fbref.com/en/players/06c48679/Jonathan-Gradit"
2022,"Lens","Ligue 1","Massadio Haïdara","MLI","DF","28",1992,12,28,21,18,7,3,15,24,62.5,9,18,4,14,22,50,31,0,"https://fbref.com/en/players/5167c97e/Massadio-Haidara"
2022,"Lens","Ligue 1","Corentin Jean","FRA","FW,MF","26",1995,2.8,9,6,4,4,1,3,6,50,3,5,0,5,1,10,0,0,"https://fbref.com/en/players/7d9b37bf/Corentin-Jean"
2022,"Lens","Ligue 1","Gaël Kakuta","COD","MF,FW","30",1991,18.6,22,14,2,13,7,4,20,20,16,10,0,10,4,26,3,0,"https://fbref.com/en/players/5b1bf5e3/Gael-Kakuta"
2022,"Lens","Ligue 1","Arnaud Kalimuendo","FRA","FW","19",2002,23.9,9,8,1,3,5,2,7,28.6,5,6,1,5,8,17,0,0,"https://fbref.com/en/players/bf4c41f9/Arnaud-Kalimuendo"
2022,"Lens","Ligue 1","Jean-Louis Leca","FRA","GK","35",1985,25.7,0,0,0,0,0,0,0,NA,0,1,0,1,1,1,11,1,"https://fbref.com/en/players/edbe46dc/Jean-Louis-Leca"
2022,"Lens","Ligue 1","Deiver Machado","COL","DF,MF","27",1993,5.8,16,14,11,1,4,12,14,85.7,2,9,1,8,3,19,12,1,"https://fbref.com/en/players/b3f8bdef/Deiver-Machado"
2022,"Lens","Ligue 1","Facundo Medina","ARG","DF","22",1999,28.8,61,42,34,23,4,38,62,61.3,24,24,8,16,37,98,78,3,"https://fbref.com/en/players/6f5ec8bb/Facundo-Medina"
2022,"Lens","Ligue 1","Brayann Pereira","FRA","DF,MF","18",2003,0.2,1,1,1,0,0,1,1,100,0,0,0,0,0,1,1,0,"https://fbref.com/en/players/5c42e7ce/Brayann-Pereira"
2022,"Lens","Ligue 1","Wesley Saïd","FRA","FW,MF","26",1995,7.3,10,5,1,8,1,1,9,11.1,8,4,0,4,2,12,0,0,"https://fbref.com/en/players/90fcf472/Wesley-Said"
2022,"Lens","Ligue 1","Florian Sotoca","FRA","FW,MF","30",1990,27.6,31,19,7,20,4,12,51,23.5,39,31,4,27,25,56,41,0,"https://fbref.com/en/players/7a42d0df/Florian-Sotoca"
2022,"Lens","Ligue 1","Jonathan Varane","FRA","MF","19",2001,0,0,0,0,0,0,0,0,NA,0,0,0,0,0,0,0,0,"https://fbref.com/en/players/4ade359f/Jonathan-Varane"
2022,"Lens","Ligue 1","Christopher Wooh","CMR","DF","19",2001,11.7,29,11,20,8,1,11,18,61.1,7,21,14,7,21,50,40,1,"https://fbref.com/en/players/b003239d/Christopher-Wooh"
2022,"Levante","La Liga","Enis Bardhi","MKD","MF,FW","26",1995,18.9,29,12,12,14,3,12,35,34.3,23,13,2,11,10,39,7,0,"https://fbref.com/en/players/cac2537b/Enis-Bardhi"
2022,"Levante","La Liga","Martín Cáceres","URU","DF","34",1987,7.4,2,2,2,0,0,1,5,20,4,2,2,0,11,13,16,1,"https://fbref.com/en/players/e94d79e3/Martin-Caceres"
2022,"Levante","La Liga","José Campaña","ESP","MF","28",1993,15.8,27,16,13,10,4,12,32,37.5,20,13,2,11,21,48,19,1,"https://fbref.com/en/players/61220da2/Jose-Campana"
2022,"Levante","La Liga","Álex Cantero","ESP","FW,MF","21",2000,6.8,6,4,2,3,1,1,8,12.5,7,2,0,2,1,7,0,0,"https://fbref.com/en/players/4aa253fd/Alex-Cantero"
2022,"Levante","La Liga","Cárdenas","ESP","GK","24",1997,24,1,1,1,0,0,0,3,0,3,0,0,0,1,2,19,0,"https://fbref.com/en/players/e1846dde/Cardenas"
2022,"Levante","La Liga","Carlos Clerc","ESP","DF","29",1992,16.8,35,17,21,10,4,7,19,36.8,12,8,3,5,26,61,32,1,"https://fbref.com/en/players/33a61a52/Carlos-Clerc"
2022,"Levante","La Liga","Coke","ESP","DF","34",1987,1.3,3,2,1,1,1,3,4,75,1,1,0,1,2,5,7,0,"https://fbref.com/en/players/6d8f8441/Coke"
2022,"Levante","La Liga","Óscar Duarte","CRC","DF","32",1989,19.7,18,8,12,6,0,8,23,34.8,15,18,9,9,24,42,102,0,"https://fbref.com/en/players/aa0ac32d/Oscar-Duarte"
2022,"Levante","La Liga","Omar Faraj","SWE","FW","19",2002,0,1,0,1,0,0,1,1,100,0,0,0,0,0,1,0,0,"https://fbref.com/en/players/de627c8a/Omar-Faraj"
2022,"Levante","La Liga","Aitor Fernández","ESP","GK","30",1991,13,2,1,2,0,0,2,2,100,0,0,0,0,0,2,7,0,"https://fbref.com/en/players/a01c3d54/Aitor-Fernandez"
2022,"Levante","La Liga","Enric Franquesa","ESP","DF,FW","24",1997,6.9,5,3,4,0,1,0,1,0,1,4,0,4,7,12,11,0,"https://fbref.com/en/players/40883e3a/Enric-Franquesa"
2022,"Levante","La Liga","Jorge de Frutos","ESP","MF,FW","24",1997,19.6,33,15,14,11,8,10,51,19.6,41,11,1,10,12,45,13,0,"https://fbref.com/en/players/38ce1150/Jorge-de-Frutos"
2022,"Levante","La Liga","Dani Gómez","ESP","FW","23",1998,11.8,7,4,3,2,2,4,12,33.3,8,3,0,3,3,10,5,0,"https://fbref.com/en/players/0e5ddc7c/Dani-Gomez"
2022,"Levante","La Liga","José Luis Morales","ESP","FW,MF","34",1987,30.2,27,17,6,9,12,12,42,28.6,30,29,0,29,4,31,7,0,"https://fbref.com/en/players/4a478107/Jose-Luis-Morales"
2022,"Levante","La Liga","Mickael Malsa","MTQ","MF","25",1995,12.7,37,17,16,18,3,15,42,35.7,27,20,8,12,18,55,15,0,"https://fbref.com/en/players/bbc19252/Mickael-Malsa"
2022,"Levante","La Liga","Roger Martí","ESP","FW","30",1991,23.5,23,14,3,13,7,8,30,26.7,22,14,0,14,2,25,8,0,"https://fbref.com/en/players/0ae4e09a/Roger-Marti"
2022,"Levante","La Liga","Pablo Martínez","ESP","MF","23",1998,7.3,15,8,7,8,0,4,13,30.8,9,6,3,3,15,30,5,0,"https://fbref.com/en/players/ecc77652/Pablo-Martinez"
2022,"Levante","La Liga","Gonzalo Melero","ESP","MF","27",1994,18.8,29,16,10,15,4,16,36,44.4,20,21,8,13,7,36,22,0,"https://fbref.com/en/players/3902e91b/Gonzalo-Melero"
2022,"Levante","La Liga","Jorge Miramón","ESP","DF","32",1989,22,36,19,16,12,8,15,44,34.1,29,15,3,12,35,71,58,0,"https://fbref.com/en/players/7f4c7c9f/Jorge-Miramon"
2022,"Levante","La Liga","Shkodran Mustafi","GER","DF","29",1992,7.3,9,6,6,3,0,5,9,55.6,4,6,3,3,15,24,40,0,"https://fbref.com/en/players/3f2d59fe/Shkodran-Mustafi"
2022,"Levante","La Liga","Sergio Postigo","ESP","DF","32",1988,9.4,11,7,8,2,1,4,8,50,4,7,5,2,7,18,45,1,"https://fbref.com/en/players/474ecac8/Sergio-Postigo"
2022,"Levante","La Liga","Alejandro Primo","ESP","GK","17",2004,1,0,0,0,0,0,0,0,NA,0,0,0,0,0,0,0,0,"https://fbref.com/en/players/f38284bb/Alejandro-Primo"
2022,"Levante","La Liga","Pubill","ESP","DF,MF","18",2003,5.7,12,6,10,2,0,4,8,50,4,7,2,5,4,16,8,2,"https://fbref.com/en/players/365113c0/Pubill"
2022,"Levante","La Liga","Nemanja Radoja","SRB","MF","28",1993,13.5,25,8,9,13,3,8,20,40,12,16,9,7,22,47,16,2,"https://fbref.com/en/players/b5dd3469/Nemanja-Radoja"
2022,"Levante","La Liga","Rober","ESP","DF","26",1995,22.3,36,20,27,7,2,23,39,59,16,25,15,10,30,66,90,1,"https://fbref.com/en/players/c00097d2/Rober"
2022,"Levante","La Liga","Marcelo Saracchi","URU","DF","23",1998,2.1,8,5,6,1,1,2,4,50,2,3,0,3,4,12,7,1,"https://fbref.com/en/players/1c96ad85/Marcelo-Saracchi"
2022,"Levante","La Liga","Roberto Soldado","ESP","FW","36",1985,7.4,3,1,0,1,2,1,3,33.3,2,4,0,4,1,4,7,0,"https://fbref.com/en/players/9d66fbe3/Roberto-Soldado"
2022,"Levante","La Liga","Son","ESP","DF","27",1994,21.9,28,18,16,7,5,17,34,50,17,11,5,6,19,47,33,1,"https://fbref.com/en/players/037dbd30/Son"
2022,"Levante","La Liga","José Luis García Vayá","ESP","MF","22",1998,22.4,46,27,10,31,5,16,41,39,25,24,5,19,38,84,30,0,"https://fbref.com/en/players/27dc1378/Jose-Luis-Garcia-Vaya"
2022,"Levante","La Liga","Rúben Vezo","POR","DF","27",1994,26.9,41,29,28,12,1,26,41,63.4,15,41,25,16,36,77,105,1,"https://fbref.com/en/players/c67cd65c/Ruben-Vezo"
2022,"Levante","La Liga","Nikola Vukčević","MNE","MF","29",1991,1.3,3,2,2,1,0,0,1,0,1,2,0,2,2,5,1,0,"https://fbref.com/en/players/4442fbcd/Nikola-Vukcevic"
2022,"Leverkusen","Bundesliga","Amine Adli","FRA","FW,MF","21",2000,14,27,14,10,14,3,8,15,53.3,7,26,2,24,11,38,12,0,"https://fbref.com/en/players/dcfb17f4/Amine-Adli"
2022,"Leverkusen","Bundesliga","Lucas Alario","ARG","FW","28",1992,7.3,6,5,0,2,4,2,5,40,3,5,0,5,1,7,6,0,"https://fbref.com/en/players/834d0be5/Lucas-Alario"
2022,"Leverkusen","Bundesliga","Nadiem Amiri","GER","MF,FW","24",1996,4.1,8,4,3,2,3,4,8,50,4,4,2,2,5,13,0,0,"https://fbref.com/en/players/555d5edd/Nadiem-Amiri"
2022,"Leverkusen","Bundesliga","Robert Andrich","GER","MF","26",1994,20.2,33,17,18,14,1,14,28,50,14,19,7,12,31,64,46,0,"https://fbref.com/en/players/e0b113a7/Robert-Andrich"
2022,"Leverkusen","Bundesliga","Charles Aránguiz","CHI","MF","32",1989,17.5,45,25,18,21,6,22,52,42.3,30,24,4,20,33,78,21,0,"https://fbref.com/en/players/56413b1f/Charles-Aranguiz"
2022,"Leverkusen","Bundesliga","Sardar Azmoun","IRN","FW,MF","26",1995,4,3,1,0,2,1,0,5,0,5,2,0,2,0,3,8,0,"https://fbref.com/en/players/10549b49/Sardar-Azmoun"
2022,"Leverkusen","Bundesliga","Mitchel Bakker","NED","DF","21",2000,20.2,33,22,16,12,5,20,34,58.8,14,13,2,11,23,56,42,3,"https://fbref.com/en/players/a8567629/Mitchel-Bakker"
2022,"Leverkusen","Bundesliga","Julian Baumgartlinger","AUT","MF,FW","33",1988,1,3,1,2,1,0,1,2,50,1,1,0,1,2,5,0,0,"https://fbref.com/en/players/69374ff5/Julian-Baumgartlinger"
2022,"Leverkusen","Bundesliga","Karim Bellarabi","GER","FW,MF","31",1990,7.6,9,4,4,4,1,3,13,23.1,10,5,0,5,9,18,4,0,"https://fbref.com/en/players/bee0bab1/Karim-Bellarabi"
2022,"Leverkusen","Bundesliga","Iker Bravo","ESP","FW","16",2005,0.1,1,1,0,1,0,0,0,NA,0,0,0,0,0,1,0,0,"https://fbref.com/en/players/db8c8860/Iker-Bravo"
2022,"Leverkusen","Bundesliga","Kerem Demirbay","GER","MF","28",1993,22.8,52,31,19,30,3,16,41,39,25,32,9,23,33,85,21,0,"https://fbref.com/en/players/54b4dc4e/Kerem-Demirbay"
2022,"Leverkusen","Bundesliga","Moussa Diaby","FRA","FW,MF","22",1999,30.7,20,11,8,9,3,5,38,13.2,33,11,0,11,8,28,2,0,"https://fbref.com/en/players/aeed5c06/Moussa-Diaby"
2022,"Leverkusen","Bundesliga","Timothy Fosu-Mensah","NED","DF","23",1998,1.6,5,3,3,1,1,4,4,100,0,1,0,1,2,7,2,0,"https://fbref.com/en/players/a9142dc3/Timothy-Fosu-Mensah"
2022,"Leverkusen","Bundesliga","Jeremie Frimpong","NED","DF","20",2000,22.8,32,18,19,12,1,12,23,52.2,11,24,6,18,17,49,40,2,"https://fbref.com/en/players/74f2e748/Jeremie-Frimpong"
2022,"Leverkusen","Bundesliga","Lennart Grill","GER","GK","22",1999,1,0,0,0,0,0,0,0,NA,0,0,0,0,0,0,0,0,"https://fbref.com/en/players/37998008/Lennart-Grill"
2022,"Leverkusen","Bundesliga","Piero Hincapié","ECU","DF","19",2002,19.5,33,23,23,8,2,19,25,76,6,34,15,19,33,66,56,2,"https://fbref.com/en/players/0c7a48f8/Piero-Hincapie"
2022,"Leverkusen","Bundesliga","Lukáš Hrádecký","FIN","GK","31",1989,32,1,1,1,0,0,1,1,100,0,0,0,0,0,1,10,1,"https://fbref.com/en/players/ad3389d5/Lukas-Hradecky"
2022,"Leverkusen","Bundesliga","Odilon Kossonou","CIV","DF","20",2001,19.9,23,17,16,6,1,15,25,60,10,36,14,22,26,49,66,0,"https://fbref.com/en/players/1f3afdcb/Odilon-Kossonou"
2022,"Leverkusen","Bundesliga","Andrey Lunyov","RUS","GK","29",1991,1,0,0,0,0,0,0,0,NA,0,0,0,0,0,0,0,0,"https://fbref.com/en/players/8a6ab963/Andrey-Lunyov"
2022,"Leverkusen","Bundesliga","Exequiel Palacios","ARG","MF","22",1998,12.2,30,19,12,14,4,15,38,39.5,23,20,1,19,28,58,11,2,"https://fbref.com/en/players/e82adcab/Exequiel-Palacios"
2022,"Leverkusen","Bundesliga","Paulinho","BRA","FW,MF","21",2000,13.5,22,13,6,13,3,13,27,48.1,14,14,1,13,6,28,7,0,"https://fbref.com/en/players/53070b63/Paulinho"
2022,"Leverkusen","Bundesliga","Joel Pohjanpalo","FIN","FW","26",1994,0.1,0,0,0,0,0,0,0,NA,0,0,0,0,0,0,0,0,"https://fbref.com/en/players/ea003d07/Joel-Pohjanpalo"
2022,"Leverkusen","Bundesliga","Panagiotis Retsos","GRE","DF,FW","22",1998,0.4,0,0,0,0,0,0,0,NA,0,0,0,0,1,1,0,1,"https://fbref.com/en/players/4bd00a50/Panagiotis-Retsos"
2022,"Leverkusen","Bundesliga","Patrik Schick","CZE","FW","25",1996,23.1,5,2,2,2,1,1,9,11.1,8,6,1,5,3,8,28,0,"https://fbref.com/en/players/5d4f7d61/Patrik-Schick"
2022,"Leverkusen","Bundesliga","Zidan Sertdemir","DEN","MF,FW","16",2005,0.2,2,2,2,0,0,0,0,NA,0,0,0,0,0,2,0,0,"https://fbref.com/en/players/eec1f7f4/Zidan-Sertdemir"
2022,"Leverkusen","Bundesliga","Daley Sinkgraven","NED","DF","26",1995,3.9,6,2,4,0,2,3,7,42.9,4,3,1,2,3,9,6,0,"https://fbref.com/en/players/73000a79/Daley-Sinkgraven"
2022,"Leverkusen","Bundesliga","Jonathan Tah","GER","DF","25",1996,32,25,18,19,5,1,17,33,51.5,16,31,20,11,43,68,156,0,"https://fbref.com/en/players/bd142efb/Jonathan-Tah"
2022,"Leverkusen","Bundesliga","Edmond Tapsoba","BFA","DF","22",1999,20.2,35,17,24,10,1,20,32,62.5,12,27,15,12,29,64,72,1,"https://fbref.com/en/players/a73c8f95/Edmond-Tapsoba"
2022,"Leverkusen","Bundesliga","Florian Wirtz","GER","MF,FW","18",2003,20.6,25,10,6,16,3,10,28,35.7,18,12,1,11,13,38,4,0,"https://fbref.com/en/players/e7fcf289/Florian-Wirtz"
2022,"Lille","Ligue 1","Benjamin André","FRA","MF","30",1990,30.6,123,69,49,65,9,51,113,45.1,62,49,11,38,50,173,56,0,"https://fbref.com/en/players/ef9c1c95/Benjamin-Andre"
2022,"Lille","Ligue 1","Jonathan Bamba","FRA","MF,FW","25",1996,27,30,12,13,9,8,13,36,36.1,23,24,1,23,21,51,10,0,"https://fbref.com/en/players/b2bd0f6c/Jonathan-Bamba"
2022,"Lille","Ligue 1","Hatem Ben Arfa","FRA","FW,MF","34",1987,3.5,4,2,2,1,1,2,4,50,2,3,0,3,0,4,1,0,"https://fbref.com/en/players/74dc806c/Hatem-Ben-Arfa"
2022,"Lille","Ligue 1","Sven Botman","NED","DF","21",2000,25,24,11,13,11,0,12,18,66.7,6,32,21,11,26,50,116,0,"https://fbref.com/en/players/ccce7025/Sven-Botman"
2022,"Lille","Ligue 1","Domagoj Bradarić","CRO","DF","21",1999,4.6,11,9,8,2,1,7,12,58.3,5,5,2,3,10,21,7,1,"https://fbref.com/en/players/8bbe2df5/Domagoj-Bradaric"
2022,"Lille","Ligue 1","Zeki Çelik","TUR","DF","24",1997,30,64,37,43,17,4,36,63,57.1,27,32,9,23,43,107,62,2,"https://fbref.com/en/players/31a62dc7/Zeki-Celik"
2022,"Lille","Ligue 1","Leonardo César Jardim","BRA","GK","26",1995,17,NA,0,NA,NA,NA,NA,NA,NA,NA,NA,NA,NA,1,NA,NA,NA,"https://fbref.com/en/players/f5dfc256/Leonardo-Cesar-Jardim"
2022,"Lille","Ligue 1","Jonathan David","CAN","FW","21",2000,31.2,24,9,7,11,6,9,30,30,21,14,4,10,5,29,15,0,"https://fbref.com/en/players/ce50fd99/Jonathan-David"
2022,"Lille","Ligue 1","Tiago Djaló","POR","DF","21",2000,25.9,60,39,39,19,2,26,39,66.7,13,26,10,16,24,84,71,0,"https://fbref.com/en/players/b2336681/Tiago-Djalo"
2022,"Lille","Ligue 1","José Fonte","POR","DF","37",1983,38,23,12,14,7,2,11,25,44,14,39,32,7,44,67,159,1,"https://fbref.com/en/players/90f87966/Jose-Fonte"
2022,"Lille","Ligue 1","Angel Gomes","ENG","MF,FW","20",2000,10.6,23,13,6,12,5,10,15,66.7,5,4,0,4,3,26,4,0,"https://fbref.com/en/players/645a3363/Angel-Gomes"
2022,"Lille","Ligue 1","Ivo Grbić","CRO","GK","25",1996,21,0,0,0,0,0,0,0,NA,0,0,0,0,0,0,14,1,"https://fbref.com/en/players/3f034750/Ivo-Grbic"
2022,"Lille","Ligue 1","Gabriel Gudmundsson","SWE","DF,MF","22",1999,14.9,43,31,24,16,3,17,35,48.6,18,15,3,12,20,63,13,0,"https://fbref.com/en/players/d5d22a58/Gabriel-Gudmundsson"
2022,"Lille","Ligue 1","Jonathan Ikone","FRA","MF,FW","23",1998,11.8,11,3,6,4,1,4,11,36.4,7,13,1,12,5,16,4,0,"https://fbref.com/en/players/42eaa028/Jonathan-Ikone"
2022,"Lille","Ligue 1","Isaac Lihadji","FRA","MF,FW","19",2002,2.6,3,3,1,1,1,1,5,20,4,1,0,1,2,5,0,0,"https://fbref.com/en/players/57a46f3f/Isaac-Lihadji"
2022,"Lille","Ligue 1","Reinildo Mandava","MOZ","DF","27",1994,16.9,43,23,29,11,3,32,51,62.7,19,13,4,9,37,80,55,0,"https://fbref.com/en/players/c20bdcd7/Reinildo-Mandava"
2022,"Lille","Ligue 1","Cheikh Niasse","SEN","FW,MF","21",2000,0.5,2,2,0,2,0,2,3,66.7,1,1,1,0,1,3,2,0,"https://fbref.com/en/players/ff20acfe/Cheikh-Niasse"
2022,"Lille","Ligue 1","Amadou Onana","BEL","MF","19",2001,15.1,48,31,17,27,4,18,25,72,7,10,3,7,30,78,19,0,"https://fbref.com/en/players/828657ff/Amadou-Onana"
2022,"Lille","Ligue 1","Jérémy Pied","FRA","DF,FW","32",1989,0.1,0,0,0,0,0,0,0,NA,0,0,0,0,1,1,0,0,"https://fbref.com/en/players/a634b9d2/Jeremy-Pied"
2022,"Lille","Ligue 1","Renato Sanches","POR","MF,FW","23",1997,18.3,19,7,8,10,1,9,26,34.6,17,14,3,11,14,33,7,0,"https://fbref.com/en/players/032f894e/Renato-Sanches"
2022,"Lille","Ligue 1","Timothy Weah","USA","MF,FW","21",2000,18,19,7,8,8,3,10,20,50,10,16,1,15,10,29,7,0,"https://fbref.com/en/players/8eec784d/Timothy-Weah"
2022,"Lille","Ligue 1","Xeka","POR","MF","26",1994,18,47,27,18,24,5,27,56,48.2,29,23,3,20,24,71,26,1,"https://fbref.com/en/players/f3600c02/Xeka"
2022,"Lille","Ligue 1","Yusuf Yazıcı","TUR","MF,FW","24",1997,5.7,10,5,3,6,1,1,9,11.1,8,4,0,4,2,12,1,0,"https://fbref.com/en/players/f5c8b425/Yusuf-Yazici"
2022,"Lille","Ligue 1","Burak Yılmaz","TUR","FW","36",1985,24.6,7,2,0,2,5,2,17,11.8,15,8,1,7,2,9,11,0,"https://fbref.com/en/players/165a2e40/Burak-Yilmaz"
2022,"Lille","Ligue 1","Leny Yoro","FRA","MF","15",2005,0.1,1,0,0,1,0,0,0,NA,0,1,0,1,0,1,0,0,"https://fbref.com/en/players/6763f716/Leny-Yoro"
2022,"Lille","Ligue 1","Edon Zhegrova","KVX","MF,FW","22",1999,5.3,14,5,2,8,4,5,6,83.3,1,4,1,3,2,16,2,0,"https://fbref.com/en/players/34a88e3e/Edon-Zhegrova"
2022,"Liverpool","Premier League","Thiago Alcántara","ESP","MF","30",1991,17,48,29,14,24,10,10,42,23.8,32,22,2,20,26,74,13,2,"https://fbref.com/en/players/77e84962/Thiago-Alcantara"
2022,"Liverpool","Premier League","Trent Alexander-Arnold","ENG","DF","22",1998,31.7,40,23,19,13,8,27,60,45,33,22,4,18,43,83,40,0,"https://fbref.com/en/players/cd1acf9d/Trent-Alexander-Arnold"
2022,"Liverpool","Premier League","Alisson","BRA","GK","28",1992,36,3,1,3,0,0,3,5,60,2,1,0,1,0,3,28,1,"https://fbref.com/en/players/7a2e46a8/Alisson"
2022,"Liverpool","Premier League","Luis Díaz","COL","FW","24",1997,10.6,9,7,3,5,1,2,8,25,6,7,0,7,4,13,2,0,"https://fbref.com/en/players/4a1a9578/Luis-Diaz"
2022,"Liverpool","Premier League","Harvey Elliott","ENG","MF","18",2003,3.8,3,0,1,1,1,0,6,0,6,8,1,7,4,7,2,0,"https://fbref.com/en/players/c8387671/Harvey-Elliott"
2022,"Liverpool","Premier League","Fabinho","BRA","MF","27",1993,25.7,46,25,17,23,6,24,70,34.3,46,33,10,23,39,85,25,1,"https://fbref.com/en/players/7f3b388c/Fabinho"
2022,"Liverpool","Premier League","Roberto Firmino","BRA","FW","29",1991,11,23,14,5,8,10,3,16,18.8,13,20,0,20,4,27,3,0,"https://fbref.com/en/players/4c370d81/Roberto-Firmino"
2022,"Liverpool","Premier League","Joe Gomez","ENG","DF","24",1997,3.7,10,6,5,2,3,5,9,55.6,4,4,1,3,5,15,6,0,"https://fbref.com/en/players/7a11550b/Joe-Gomez"
2022,"Liverpool","Premier League","Kaide Gordon","ENG","FW","16",2004,0.1,1,0,0,0,1,0,0,NA,0,0,0,0,0,1,0,0,"https://fbref.com/en/players/19a9cb70/Kaide-Gordon"
2022,"Liverpool","Premier League","Jordan Henderson","ENG","MF","31",1990,28.9,36,20,9,25,2,17,44,38.6,27,25,1,24,23,59,14,0,"https://fbref.com/en/players/935e6b8f/Jordan-Henderson"
2022,"Liverpool","Premier League","Curtis Jones","ENG","MF","20",2001,9.5,11,9,3,6,2,1,10,10,9,4,0,4,6,17,4,0,"https://fbref.com/en/players/4fb9c88f/Curtis-Jones"
2022,"Liverpool","Premier League","Diogo Jota","POR","FW","24",1996,26.3,39,18,12,18,9,13,55,23.6,42,19,2,17,6,45,6,0,"https://fbref.com/en/players/178ae8f8/Diogo-Jota"
2022,"Liverpool","Premier League","Naby Keïta","GUI","MF","26",1995,13,46,23,17,19,10,26,42,61.9,16,33,2,31,14,60,8,0,"https://fbref.com/en/players/f25c8e3a/Naby-Keita"
2022,"Liverpool","Premier League","Caoimhín Kelleher","IRL","GK","22",1998,2,1,1,1,0,0,1,1,100,0,0,0,0,0,1,1,0,"https://fbref.com/en/players/62d7ef38/Caoimhin-Kelleher"
2022,"Liverpool","Premier League","Ibrahima Konaté","FRA","DF","22",1999,11,16,10,9,6,1,7,10,70,3,13,9,4,16,32,37,1,"https://fbref.com/en/players/5ed9b537/Ibrahima-Konate"
2022,"Liverpool","Premier League","Sadio Mané","SEN","FW","29",1992,31.3,33,20,7,14,12,8,26,30.8,18,30,1,29,8,41,15,0,"https://fbref.com/en/players/c691bfe2/Sadio-Mane"
2022,"Liverpool","Premier League","Joël Matip","CMR","DF","29",1991,31,47,34,23,19,5,20,31,64.5,11,26,14,12,44,91,93,1,"https://fbref.com/en/players/b217ef29/Joel-Matip"
2022,"Liverpool","Premier League","James Milner","ENG","MF,DF","35",1986,9.5,28,16,12,11,5,12,29,41.4,17,19,5,14,17,45,20,0,"https://fbref.com/en/players/2f90f6b8/James-Milner"
2022,"Liverpool","Premier League","Takumi Minamino","JPN","FW,MF","26",1995,2.1,3,2,1,1,1,2,8,25,6,2,0,2,1,4,2,0,"https://fbref.com/en/players/f833a830/Takumi-Minamino"
2022,"Liverpool","Premier League","Tyler Morton","ENG","MF","18",2002,0.7,0,0,0,0,0,0,2,0,2,0,0,0,3,3,0,0,"https://fbref.com/en/players/2bc28bb9/Tyler-Morton"
2022,"Liverpool","Premier League","Divock Origi","BEL","FW","26",1995,1.5,0,0,0,0,0,0,2,0,2,1,0,1,1,1,2,0,"https://fbref.com/en/players/43a166b4/Divock-Origi"
2022,"Liverpool","Premier League","Alex Oxlade-Chamberlain","ENG","MF,FW","27",1993,8.7,15,11,2,8,5,3,14,21.4,11,12,2,10,6,21,5,0,"https://fbref.com/en/players/38c7feef/Alex-Oxlade-Chamberlain"
2022,"Liverpool","Premier League","Andrew Robertson","SCO","DF","27",1994,28.2,36,21,16,15,5,20,35,57.1,15,24,3,21,23,59,61,0,"https://fbref.com/en/players/2e4f5f03/Andrew-Robertson"
2022,"Liverpool","Premier League","Mohamed Salah","EGY","FW","29",1992,30.7,17,8,5,9,3,6,19,31.6,13,7,1,6,6,23,5,0,"https://fbref.com/en/players/e342ad68/Mohamed-Salah"
2022,"Liverpool","Premier League","Kostas Tsimikas","GRE","DF","25",1996,9.7,27,12,12,8,7,12,16,75,4,6,2,4,10,37,22,2,"https://fbref.com/en/players/f315ca93/Kostas-Tsimikas"
2022,"Liverpool","Premier League","Virgil van Dijk","NED","DF","30",1991,34,16,10,11,5,0,11,16,68.8,5,21,14,7,31,47,109,0,"https://fbref.com/en/players/e06683ca/Virgil-van-Dijk"
2022,"Liverpool","Premier League","Neco Williams","WAL","DF","20",2001,0.1,0,0,0,0,0,0,0,NA,0,0,0,0,0,0,0,0,"https://fbref.com/en/players/dd323728/Neco-Williams"
2022,"Lorient","Ligue 1","Laurent Abergel","FRA","MF","28",1993,32.8,110,60,44,53,13,71,166,42.8,95,58,1,57,55,165,13,0,"https://fbref.com/en/players/31626657/Laurent-Abergel"
2022,"Lorient","Ligue 1","Quentin Boisgard","FRA","MF,FW","24",1997,10.6,19,11,6,10,3,8,17,47.1,9,15,0,15,6,25,5,0,"https://fbref.com/en/players/f6496133/Quentin-Boisgard"
2022,"Lorient","Ligue 1","Redwan Bourles","FRA","MF,FW","18",2003,0.2,0,0,0,0,0,0,0,NA,0,0,0,0,0,0,0,0,"https://fbref.com/en/players/5c7895a0/Redwan-Bourles"
2022,"Lorient","Ligue 1","Igor Carioca","BRA","DF","24",1996,17.5,27,16,16,8,3,15,43,34.9,28,17,2,15,25,52,28,0,"https://fbref.com/en/players/e3e32fbb/Igor-Carioca"
2022,"Lorient","Ligue 1","Stéphane Diarra","FRA","MF,FW","22",1998,5.8,11,9,7,3,1,5,10,50,5,4,0,4,7,18,1,0,"https://fbref.com/en/players/29939a1d/Stephane-Diarra"
2022,"Lorient","Ligue 1","Matthieu Dreyer","FRA","GK","32",1989,16,1,1,1,0,0,1,1,100,0,0,0,0,0,1,9,0,"https://fbref.com/en/players/fbf83734/Matthieu-Dreyer"
2022,"Lorient","Ligue 1","Thomas Fontaine","MAD","DF","30",1991,1.9,2,0,1,0,1,0,1,0,1,3,3,0,2,4,4,0,"https://fbref.com/en/players/9f90c06b/Thomas-Fontaine"
2022,"Lorient","Ligue 1","Adrian Grbić","AUT","FW,MF","24",1996,5.8,2,1,0,2,0,2,6,33.3,4,3,1,2,0,2,7,0,"https://fbref.com/en/players/4a987ffa/Adrian-Grbic"
2022,"Lorient","Ligue 1","Pierre-Yves Hamel","FRA","FW,MF","27",1994,0.3,0,0,0,0,0,0,1,0,1,0,0,0,2,2,0,0,"https://fbref.com/en/players/a99da9ec/Pierre-Yves-Hamel"
2022,"Lorient","Ligue 1","Jérôme Hergault","FRA","DF","35",1986,3.9,3,1,1,2,0,2,5,40,3,4,1,3,4,7,7,0,"https://fbref.com/en/players/a84f9a4b/Jerome-Hergault"
2022,"Lorient","Ligue 1","Bonke Innocent","NGA","MF","25",1996,9.7,27,16,10,16,1,11,26,42.3,15,11,3,8,16,43,14,0,"https://fbref.com/en/players/546bb36e/Bonke-Innocent"
2022,"Lorient","Ligue 1","Moritz Jenz","GER","DF","22",1999,15.3,26,12,18,6,2,11,24,45.8,13,19,11,8,28,54,55,0,"https://fbref.com/en/players/ee644761/Moritz-Jenz"
2022,"Lorient","Ligue 1","Ibrahima Koné","MLI","FW","22",1999,8.1,7,4,0,3,4,2,3,66.7,1,8,3,5,1,8,3,0,"https://fbref.com/en/players/04bb2b06/Ibrahima-Kone"
2022,"Lorient","Ligue 1","Julien Laporte","FRA","DF","27",1993,32.1,63,45,35,26,2,32,64,50,32,37,22,15,54,117,174,0,"https://fbref.com/en/players/f066022d/Julien-Laporte"
2022,"Lorient","Ligue 1","Armand Lauriente","FRA","FW,MF","22",1998,27.5,33,18,9,16,8,11,30,36.7,19,27,2,25,15,48,3,0,"https://fbref.com/en/players/2d22cea7/Armand-Lauriente"
2022,"Lorient","Ligue 1","Théo Le Bris","FRA","MF","18",2002,0.7,2,1,1,1,0,1,2,50,1,2,0,2,0,2,1,0,"https://fbref.com/en/players/afe39ca8/Theo-Le-Bris"
2022,"Lorient","Ligue 1","Enzo Le Fée","FRA","MF,FW","21",2000,24.4,70,44,25,36,9,41,90,45.6,49,25,1,24,29,99,18,0,"https://fbref.com/en/players/6f806d99/Enzo-Le-Fee"
2022,"Lorient","Ligue 1","Vincent Le Goff","FRA","DF","31",1989,34,61,38,38,19,4,37,62,59.7,25,18,3,15,37,98,50,0,"https://fbref.com/en/players/2321ea6e/Vincent-Le-Goff"
2022,"Lorient","Ligue 1","Fabien Lemoine","FRA","MF","34",1987,12.4,35,22,20,14,1,17,41,41.5,24,21,4,17,14,49,24,1,"https://fbref.com/en/players/54d51e22/Fabien-Lemoine"
2022,"Lorient","Ligue 1","Samuel Loric","FRA","DF","21",2000,3,7,5,2,3,2,5,8,62.5,3,2,0,2,5,12,9,0,"https://fbref.com/en/players/9004f318/Samuel-Loric"
2022,"Lorient","Ligue 1","Houboulang Mendes","FRA","DF","23",1998,35.8,58,28,37,18,3,40,57,70.2,17,41,21,20,41,99,128,4,"https://fbref.com/en/players/1545cf15/Houboulang-Mendes"
2022,"Lorient","Ligue 1","Terem Moffi","NGA","FW","22",1999,30.1,17,10,3,12,2,9,32,28.1,23,11,2,9,4,21,22,0,"https://fbref.com/en/players/065dc209/Terem-Moffi"
2022,"Lorient","Ligue 1","Thomas Monconduit","FRA","MF","30",1991,25,41,25,19,17,5,20,57,35.1,37,21,10,11,22,63,51,1,"https://fbref.com/en/players/84d94b91/Thomas-Monconduit"
2022,"Lorient","Ligue 1","Jérémy Morel","MAD","DF","37",1984,6.7,13,9,8,4,1,6,6,100,0,9,7,2,7,20,31,0,"https://fbref.com/en/players/e97150c0/Jeremy-Morel"
2022,"Lorient","Ligue 1","Baptiste Mouazan","FRA","MF","19",2001,1.1,4,3,2,2,0,1,3,33.3,2,3,0,3,1,5,1,0,"https://fbref.com/en/players/81ac108d/Baptiste-Mouazan"
2022,"Lorient","Ligue 1","Paul Nardi","FRA","GK","27",1994,22,1,0,1,0,0,1,2,50,1,0,0,0,0,1,10,2,"https://fbref.com/en/players/2d70dbe5/Paul-Nardi"
2022,"Lorient","Ligue 1","Dango Ouattara","BFA","MF,FW","19",2002,9,21,15,9,11,1,11,23,47.8,12,10,1,9,14,35,15,1,"https://fbref.com/en/players/2f9e4435/Dango-Ouattara"
2022,"Lorient","Ligue 1","Léo Pétrot","FRA","DF","24",1997,20.2,31,17,23,8,0,21,29,72.4,8,33,17,16,22,53,86,0,"https://fbref.com/en/players/00638016/Leo-Petrot"
2022,"Lorient","Ligue 1","Sambou Soumano","SEN","FW,MF","20",2001,5,4,1,1,2,1,2,2,100,0,3,0,3,1,5,7,0,"https://fbref.com/en/players/7cc00776/Sambou-Soumano"
2022,"Lyon","Ligue 1","Houssem Aouar","FRA","MF,FW","23",1998,27.8,46,30,9,25,12,27,54,50,27,26,1,25,20,66,5,0,"https://fbref.com/en/players/a5db0bec/Houssem-Aouar"
2022,"Lyon","Ligue 1","Bradley Barcola","FRA","FW,MF","18",2002,2.9,7,4,2,3,2,1,8,12.5,7,7,1,6,2,9,1,0,"https://fbref.com/en/players/a0d55a09/Bradley-Barcola"
2022,"Lyon","Ligue 1","Jérôme Boateng","GER","DF","32",1988,18,20,15,11,9,0,9,17,52.9,8,20,10,10,20,40,73,0,"https://fbref.com/en/players/2db2fd7b/Jerome-Boateng"
2022,"Lyon","Ligue 1","Maxence Caqueret","FRA","MF","21",2000,25.9,73,40,29,36,8,30,80,37.5,50,38,10,28,43,116,26,2,"https://fbref.com/en/players/f81ef10d/Maxence-Caqueret"
2022,"Lyon","Ligue 1","Rayan Cherki","FRA","FW,MF","17",2003,4.9,6,2,1,3,2,4,9,44.4,5,2,0,2,1,7,0,0,"https://fbref.com/en/players/b34c63a5/Rayan-Cherki"
2022,"Lyon","Ligue 1","Maxwel Cornet","CIV","DF","24",1996,0.7,3,1,1,0,2,3,4,75,1,0,0,0,1,4,1,0,"https://fbref.com/en/players/beb391dd/Maxwel-Cornet"
2022,"Lyon","Ligue 1","Damien Da Silva","FRA","DF","33",1988,12.5,13,9,7,5,1,5,9,55.6,4,15,10,5,22,35,53,1,"https://fbref.com/en/players/1ec7e1c5/Damien-Da-Silva"
2022,"Lyon","Ligue 1","Moussa Dembélé","FRA","FW","25",1996,24.5,18,9,5,5,8,6,15,40,9,13,0,13,8,26,30,1,"https://fbref.com/en/players/e7986081/Moussa-Dembele"
2022,"Lyon","Ligue 1","Jason Denayer","BEL","DF","26",1995,11.1,11,4,8,3,0,6,7,85.7,1,8,7,1,16,27,52,0,"https://fbref.com/en/players/47af88b8/Jason-Denayer"
2022,"Lyon","Ligue 1","Sinaly Diomande","CIV","DF","20",2001,6.4,6,3,4,2,0,5,6,83.3,1,6,6,0,12,18,26,0,"https://fbref.com/en/players/6de23ab0/Sinaly-Diomande"
2022,"Lyon","Ligue 1","Leo Dubois","FRA","DF","26",1994,19.4,43,27,22,14,7,27,46,58.7,19,27,3,24,22,65,35,1,"https://fbref.com/en/players/ff0ab48c/Leo-Dubois"
2022,"Lyon","Ligue 1","Romain Faivre","FRA","FW,MF","23",1998,9.9,10,4,2,6,2,4,13,30.8,9,4,0,4,3,13,2,0,"https://fbref.com/en/players/745ca0a3/Romain-Faivre"
2022,"Lyon","Ligue 1","Bruno Guimarães","BRA","MF","23",1997,18.2,50,31,20,25,5,23,59,39,36,21,4,17,21,71,11,1,"https://fbref.com/en/players/82518f62/Bruno-Guimaraes"
2022,"Lyon","Ligue 1","Malo Gusto","FRA","DF","18",2003,20.9,55,35,29,21,5,24,40,60,16,21,6,15,33,88,41,1,"https://fbref.com/en/players/d56b9520/Malo-Gusto"
2022,"Lyon","Ligue 1","Henrique","BRA","DF","27",1994,12.3,13,7,10,1,2,5,16,31.3,11,13,1,12,22,35,14,0,"https://fbref.com/en/players/f28474a4/Henrique"
2022,"Lyon","Ligue 1","Tino Kadewere","ZIM","FW","25",1996,5.6,7,5,2,2,3,4,13,30.8,9,7,0,7,4,11,1,1,"https://fbref.com/en/players/7d08063d/Tino-Kadewere"
2022,"Lyon","Ligue 1","Habib Keita","MLI","MF,FW","19",2002,0.1,0,0,0,0,0,0,0,NA,0,0,0,0,0,0,0,0,"https://fbref.com/en/players/cc588cbe/Habib-Keita"
2022,"Lyon","Ligue 1","Anthony Lopes","POR","GK","30",1990,33.1,0,0,0,0,0,0,0,NA,0,0,0,0,3,3,12,3,"https://fbref.com/en/players/f00de885/Anthony-Lopes"
2022,"Lyon","Ligue 1","Castello Lukeba","FRA","DF","18",2002,23.3,34,19,27,7,0,15,23,65.2,8,18,9,9,38,72,64,2,"https://fbref.com/en/players/5b9512c5/Castello-Lukeba"
2022,"Lyon","Ligue 1","Marcelo","BRA","DF","34",1987,2,4,3,0,4,0,4,6,66.7,2,3,2,1,4,8,10,0,"https://fbref.com/en/players/e3d0b0c4/Marcelo"
2022,"Lyon","Ligue 1","Thiago Mendes","BRA","MF,DF","29",1992,20.7,36,22,18,16,2,12,30,40,18,24,5,19,34,70,56,1,"https://fbref.com/en/players/c6e5d20f/Thiago-Mendes"
2022,"Lyon","Ligue 1","Tanguy Ndombele","FRA","MF","24",1996,7.8,25,14,5,17,3,12,19,63.2,7,8,3,5,3,28,6,2,"https://fbref.com/en/players/5cdddffa/Tanguy-Ndombele"
2022,"Lyon","Ligue 1","Emerson Palmieri","ITA","DF","26",1994,25.2,46,25,16,22,8,22,34,64.7,12,23,8,15,27,73,66,0,"https://fbref.com/en/players/e0bc6fdc/Emerson-Palmieri"
2022,"Lyon","Ligue 1","Lucas Paquetá","BRA","MF,FW","23",1997,30,68,38,24,26,18,17,51,33.3,34,43,5,38,9,77,22,0,"https://fbref.com/en/players/9b6f7fd5/Lucas-Paqueta"
2022,"Lyon","Ligue 1","Julian Pollersbeck","GER","GK","26",1994,4.8,0,0,0,0,0,0,0,NA,0,0,0,0,1,1,1,0,"https://fbref.com/en/players/d6f6ce93/Julian-Pollersbeck"
2022,"Lyon","Ligue 1","Jeff Reine-Adélaïde","FRA","MF,DF","23",1998,2.2,5,3,4,1,0,4,5,80,1,2,0,2,0,5,0,1,"https://fbref.com/en/players/d504b3e1/Jeff-Reine-Adelaide"
2022,"Lyon","Ligue 1","Xherdan Shaqiri","SUI","FW,MF","29",1991,7.5,7,3,0,5,2,2,10,20,8,2,0,2,2,9,2,0,"https://fbref.com/en/players/6421ec64/Xherdan-Shaqiri"
2022,"Lyon","Ligue 1","Islam Slimani","ALG","FW","33",1988,6.4,3,2,0,1,2,1,6,16.7,5,4,0,4,2,5,5,0,"https://fbref.com/en/players/ffec9769/Islam-Slimani"
2022,"Lyon","Ligue 1","Tetê","BRA","FW,MF","21",2000,6.5,10,5,4,5,1,3,13,23.1,10,4,0,4,3,13,1,0,"https://fbref.com/en/players/7120a04d/Tete"
2022,"Lyon","Ligue 1","Karl Toko Ekambi","CMR","FW","28",1992,25.5,13,7,4,6,3,4,21,19,17,26,0,26,20,33,5,0,"https://fbref.com/en/players/5ceba7fc/Karl-Toko-Ekambi"
2022,"M'Gladbach","Bundesliga","László Bénes","SVK","MF","23",1997,2.7,5,3,1,3,1,1,6,16.7,5,5,2,3,2,7,5,0,"https://fbref.com/en/players/fe888e39/Laszlo-Benes"
2022,"M'Gladbach","Bundesliga","Keanan Bennetts","ENG","FW,DF","22",1999,0.6,2,0,1,1,0,1,1,100,0,1,0,1,0,2,0,0,"https://fbref.com/en/players/f4c7c708/Keanan-Bennetts"
2022,"M'Gladbach","Bundesliga","Ramy Bensebaini","ALG","DF","26",1995,22.4,42,30,24,15,3,27,44,61.4,17,33,7,26,39,81,77,1,"https://fbref.com/en/players/378825c7/Ramy-Bensebaini"
2022,"M'Gladbach","Bundesliga","Louis Beyer","GER","DF","21",2000,15.4,46,27,32,13,1,23,39,59,16,18,5,13,15,61,52,2,"https://fbref.com/en/players/9af1f9ff/Louis-Beyer"
2022,"M'Gladbach","Bundesliga","Nico Elvedi","SUI","DF","24",1996,27,40,24,23,17,0,22,36,61.1,14,33,22,11,34,74,83,1,"https://fbref.com/en/players/48035304/Nico-Elvedi"
2022,"M'Gladbach","Bundesliga","Breel Embolo","SUI","FW","24",1997,24.1,16,11,1,12,3,3,8,37.5,5,14,2,12,6,22,7,0,"https://fbref.com/en/players/0b4f388a/Breel-Embolo"
2022,"M'Gladbach","Bundesliga","Marvin Friedrich","GER","DF","25",1995,6.7,14,8,10,4,0,9,11,81.8,2,5,3,2,5,19,26,0,"https://fbref.com/en/players/b77f44a4/Marvin-Friedrich"
2022,"M'Gladbach","Bundesliga","Matthias Ginter","GER","DF","27",1994,26.2,36,22,20,13,3,27,40,67.5,13,21,10,11,33,69,76,0,"https://fbref.com/en/players/f521b80a/Matthias-Ginter"
2022,"M'Gladbach","Bundesliga","Patrick Herrmann","GER","DF,FW","30",1991,8.4,15,7,5,6,4,9,24,37.5,15,10,1,9,6,21,8,0,"https://fbref.com/en/players/dfb6490a/Patrick-Herrmann"
2022,"M'Gladbach","Bundesliga","Jonas Hofmann","GER","MF,FW","29",1992,23.1,30,20,6,17,7,17,42,40.5,25,23,0,23,12,42,10,0,"https://fbref.com/en/players/2903a856/Jonas-Hofmann"
2022,"M'Gladbach","Bundesliga","Tony Jantschke","GER","DF","31",1990,2.5,6,5,2,4,0,3,6,50,3,3,2,1,5,11,8,0,"https://fbref.com/en/players/34b54da7/Tony-Jantschke"
2022,"M'Gladbach","Bundesliga","Kouadio Koné","FRA","MF","20",2001,24.3,60,37,29,28,3,25,42,59.5,17,27,4,23,34,94,12,0,"https://fbref.com/en/players/86574238/Kouadio-Kone"
2022,"M'Gladbach","Bundesliga","Christoph Kramer","GER","MF","30",1991,8.3,28,11,15,10,3,12,28,42.9,16,18,5,13,12,40,9,0,"https://fbref.com/en/players/496aeede/Christoph-Kramer"
2022,"M'Gladbach","Bundesliga","Stefan Lainer","AUT","DF","28",1992,16.3,19,11,9,7,3,12,28,42.9,16,24,5,19,14,33,31,0,"https://fbref.com/en/players/4aea5077/Stefan-Lainer"
2022,"M'Gladbach","Bundesliga","Torben Müsel","GER","MF","22",1999,0.1,0,0,0,0,0,0,0,NA,0,0,0,0,0,0,0,0,"https://fbref.com/en/players/d01b9ad6/Torben-Musel"
2022,"M'Gladbach","Bundesliga","Luca Netz","GER","DF,FW","18",2003,15.5,24,11,12,10,2,11,40,27.5,29,24,4,20,13,37,33,1,"https://fbref.com/en/players/e79269bd/Luca-Netz"
2022,"M'Gladbach","Bundesliga","Florian Neuhaus","GER","MF","24",1997,23.6,55,28,24,26,5,27,64,42.2,37,38,6,32,31,86,19,4,"https://fbref.com/en/players/36a59ba4/Florian-Neuhaus"
2022,"M'Gladbach","Bundesliga","Connor Noß","IRL","MF","20",2001,0.6,1,0,0,1,0,0,1,0,1,1,1,0,0,1,0,0,"https://fbref.com/en/players/ccc6d365/Connor-Noss"
2022,"M'Gladbach","Bundesliga","Alassane Pléa","FRA","MF,FW","28",1993,23,18,14,6,9,3,7,20,35,13,9,1,8,4,22,9,0,"https://fbref.com/en/players/bc6bd723/Alassane-Plea"
2022,"M'Gladbach","Bundesliga","Joe Scally","USA","DF","18",2002,21.2,40,30,21,14,5,17,41,41.5,24,27,4,23,22,62,38,0,"https://fbref.com/en/players/236f02cd/Joe-Scally"
2022,"M'Gladbach","Bundesliga","Tobias Sippel","GER","GK","33",1988,1,0,0,0,0,0,0,0,NA,0,0,0,0,0,0,0,0,"https://fbref.com/en/players/0d8a37c2/Tobias-Sippel"
2022,"M'Gladbach","Bundesliga","Yann Sommer","SUI","GK","32",1988,33,0,0,0,0,0,0,2,0,2,0,0,0,3,3,8,3,"https://fbref.com/en/players/420c18a1/Yann-Sommer"
2022,"M'Gladbach","Bundesliga","Lars Stindl","GER","MF,FW","32",1988,18.1,23,15,6,14,3,9,33,27.3,24,28,2,26,10,33,14,0,"https://fbref.com/en/players/7cd6badb/Lars-Stindl"
2022,"M'Gladbach","Bundesliga","Marcus Thuram","FRA","FW","23",1997,10.9,6,5,0,5,1,1,4,25,3,5,0,5,5,11,5,0,"https://fbref.com/en/players/6f8cd6d0/Marcus-Thuram"
2022,"M'Gladbach","Bundesliga","Hannes Wolf","AUT","FW,MF","22",1999,3.4,23,12,4,13,6,10,20,50,10,10,0,10,2,25,1,0,"https://fbref.com/en/players/be42a291/Hannes-Wolf"
2022,"M'Gladbach","Bundesliga","Denis Zakaria","SUI","MF,DF","24",1996,15.5,23,14,9,10,4,12,35,34.3,23,25,5,20,19,42,22,1,"https://fbref.com/en/players/384d58d9/Denis-Zakaria"
2022,"Mainz 05","Bundesliga","Leandro Barreiro Martins","LUX","MF","21",2000,19.9,63,32,23,27,13,29,50,58,21,23,6,17,32,95,23,0,"https://fbref.com/en/players/00242b75/Leandro-Barreiro-Martins"
2022,"Mainz 05","Bundesliga","Stefan Bell","GER","DF","29",1991,31.8,54,23,37,16,1,30,63,47.6,33,26,15,11,41,95,112,1,"https://fbref.com/en/players/857a5abe/Stefan-Bell"
2022,"Mainz 05","Bundesliga","Jean-Paul Boëtius","NED","MF","27",1994,20,40,23,18,17,5,22,53,41.5,31,41,3,38,25,65,11,0,"https://fbref.com/en/players/635f2732/Jean-Paul-Boetius"
2022,"Mainz 05","Bundesliga","Daniel Brosinski","GER","DF","33",1988,4.3,2,1,1,1,0,1,1,100,0,6,0,6,3,5,9,0,"https://fbref.com/en/players/a7813ac4/Daniel-Brosinski"
2022,"Mainz 05","Bundesliga","Delano Burgzorg","NED","MF","22",1998,0.3,1,1,1,0,0,0,1,0,1,0,0,0,0,1,0,0,"https://fbref.com/en/players/05e2d5ea/Delano-Burgzorg"
2022,"Mainz 05","Bundesliga","Jonathan Burkardt","GER","FW,MF","21",2000,29,17,8,0,10,7,6,25,24,19,31,5,26,8,25,16,0,"https://fbref.com/en/players/05f99a4a/Jonathan-Burkardt"
2022,"Mainz 05","Bundesliga","Finn Dahmen","GER","GK","23",1998,2,0,0,0,0,0,0,0,NA,0,0,0,0,0,0,2,0,"https://fbref.com/en/players/dee3013b/Finn-Dahmen"
2022,"Mainz 05","Bundesliga","Stephan Fürstner","GER","MF","33",1987,0.1,0,0,0,0,0,0,2,0,2,0,0,0,0,0,1,0,"https://fbref.com/en/players/18c2e247/Stephan-Furstner"
2022,"Mainz 05","Bundesliga","Alexander Hack","GER","DF","27",1993,23,52,26,35,17,0,29,46,63,17,31,14,17,51,103,95,1,"https://fbref.com/en/players/a5ec3ede/Alexander-Hack"
2022,"Mainz 05","Bundesliga","Marcus Ingvartsen","DEN","FW,MF","25",1996,7.6,3,2,2,0,1,3,9,33.3,6,6,0,6,6,9,7,1,"https://fbref.com/en/players/271b8617/Marcus-Ingvartsen"
2022,"Mainz 05","Bundesliga","Lee Jae-sung","KOR","MF,FW","28",1992,16,30,12,8,14,8,6,27,22.2,21,20,2,18,18,48,18,0,"https://fbref.com/en/players/34b0387f/Lee-Jae-sung"
2022,"Mainz 05","Bundesliga","Luca Kilian","GER","FW","21",1999,0,0,0,0,0,0,0,0,NA,0,0,0,0,0,0,0,0,"https://fbref.com/en/players/610aa1e9/Luca-Kilian"
2022,"Mainz 05","Bundesliga","Dominik Kohr","GER","MF","27",1994,17.9,40,20,18,19,3,16,42,38.1,26,21,2,19,35,75,22,0,"https://fbref.com/en/players/0fbecd11/Dominik-Kohr"
2022,"Mainz 05","Bundesliga","Anderson Lucoqui","ANG","DF","24",1997,8.3,22,10,11,6,5,11,22,50,11,15,3,12,11,33,10,0,"https://fbref.com/en/players/5569bf9a/Anderson-Lucoqui"
2022,"Mainz 05","Bundesliga","Aarón Martín","ESP","DF","24",1997,25.5,54,33,32,18,4,24,55,43.6,31,24,4,20,20,74,35,0,"https://fbref.com/en/players/2f3e911a/Aaron-Martin"
2022,"Mainz 05","Bundesliga","Paul Nebel","GER","MF,FW","18",2002,2.5,5,3,3,1,1,2,3,66.7,1,0,0,0,0,5,1,0,"https://fbref.com/en/players/1b6d8083/Paul-Nebel"
2022,"Mainz 05","Bundesliga","David Nemeth","AUT","DF","20",2001,3.5,3,2,2,1,0,1,3,33.3,2,5,1,4,6,9,11,1,"https://fbref.com/en/players/da76715c/David-Nemeth"
2022,"Mainz 05","Bundesliga","Moussa Niakhate","FRA","DF","25",1996,28.5,40,23,25,13,2,20,33,60.6,13,37,11,26,50,90,69,1,"https://fbref.com/en/players/00242715/Moussa-Niakhate"
2022,"Mainz 05","Bundesliga","Karim Onisiwo","AUT","FW","29",1992,26.2,18,10,4,6,8,7,22,31.8,15,27,2,25,7,25,8,0,"https://fbref.com/en/players/f26834c7/Karim-Onisiwo"
2022,"Mainz 05","Bundesliga","Matondo-Merveille Papela","GER","MF","20",2001,0.9,3,2,2,1,0,2,3,66.7,1,2,0,2,2,5,0,0,"https://fbref.com/en/players/b4b08774/Matondo-Merveille-Papela"
2022,"Mainz 05","Bundesliga","Romario Rösch","GER","MF","22",1999,0,0,0,0,0,0,0,0,NA,0,0,0,0,0,0,0,0,"https://fbref.com/en/players/87ebfdb8/Romario-Rosch"
2022,"Mainz 05","Bundesliga","Jerry St. Juste","NED","DF","24",1996,6.7,13,9,7,6,0,7,8,87.5,1,7,3,4,14,27,14,0,"https://fbref.com/en/players/90339309/Jerry-St-Juste"
2022,"Mainz 05","Bundesliga","Anton Stach","GER","MF","22",1998,20.7,28,19,14,13,1,15,38,39.5,23,24,5,19,51,79,25,0,"https://fbref.com/en/players/0f59a7bf/Anton-Stach"
2022,"Mainz 05","Bundesliga","Kevin Stöger","AUT","MF","27",1993,4.7,10,5,5,5,0,4,10,40,6,6,0,6,5,15,1,1,"https://fbref.com/en/players/e5649a78/Kevin-Stoger"
2022,"Mainz 05","Bundesliga","Ádám Szalai","HUN","FW","33",1987,2.9,3,2,0,2,1,0,2,0,2,2,0,2,0,3,0,0,"https://fbref.com/en/players/53e07d0b/Adam-Szalai"
2022,"Mainz 05","Bundesliga","Niklas Tauer","GER","DF,MF","20",2001,5.4,16,9,9,7,0,9,14,64.3,5,6,2,4,9,25,14,0,"https://fbref.com/en/players/27270af4/Niklas-Tauer"
2022,"Mainz 05","Bundesliga","Silvan Widmer","SUI","DF","28",1993,32.4,60,28,32,20,8,36,61,59,25,44,16,28,43,103,59,2,"https://fbref.com/en/players/f68b64fc/Silvan-Widmer"
2022,"Mainz 05","Bundesliga","Robin Zentner","GER","GK","26",1994,32,2,2,2,0,0,2,2,100,0,0,0,0,2,4,21,1,"https://fbref.com/en/players/5c4bf6ba/Robin-Zentner"
2022,"Mallorca","La Liga","Amath","SEN","FW,MF","25",1996,9.8,21,11,11,6,4,7,17,41.2,10,12,0,12,7,28,7,0,"https://fbref.com/en/players/f3b1d9a2/Amath"
2022,"Mallorca","La Liga","Josep Antoni Gayá","ESP","DF","21",2000,0.6,0,0,0,0,0,0,0,NA,0,1,0,1,1,1,3,1,"https://fbref.com/en/players/4a5f2032/Josep-Antoni-Gaya"
2022,"Mallorca","La Liga","Iddrisu Baba","GHA","MF","25",1996,21.5,57,30,31,23,3,25,43,58.1,18,19,5,14,24,81,34,1,"https://fbref.com/en/players/bfd381b3/Iddrisu-Baba"
2022,"Mallorca","La Liga","Rodrigo Battaglia","ARG","MF","30",1991,13.1,32,16,13,19,0,15,30,50,15,21,10,11,10,42,36,0,"https://fbref.com/en/players/d637fc22/Rodrigo-Battaglia"
2022,"Mallorca","La Liga","Jaume Costa","ESP","DF","33",1988,20.3,35,26,23,7,5,23,31,74.2,8,22,7,15,23,58,55,0,"https://fbref.com/en/players/808d48f3/Jaume-Costa"
2022,"Mallorca","La Liga","Aleix Febas","ESP","MF","25",1996,1.3,4,1,0,4,0,2,4,50,2,0,0,0,0,4,0,0,"https://fbref.com/en/players/38126309/Aleix-Febas"
2022,"Mallorca","La Liga","Iñigo Ruiz de Galarreta","ESP","MF","27",1993,15.3,40,21,14,21,5,14,30,46.7,16,16,2,14,20,60,21,0,"https://fbref.com/en/players/91f7631f/Inigo-Ruiz-de-Galarreta"
2022,"Mallorca","La Liga","Giovanni González","URU","DF","26",1994,4.1,9,3,4,4,1,3,5,60,2,7,2,5,4,13,14,0,"https://fbref.com/en/players/1fc474ae/Giovanni-Gonzalez"
2022,"Mallorca","La Liga","Dominik Greif","SVK","GK","24",1997,1,0,0,0,0,0,0,0,NA,0,0,0,0,0,0,0,0,"https://fbref.com/en/players/30061f53/Dominik-Greif"
2022,"Mallorca","La Liga","Clément Grenier","FRA","MF","30",1991,0.7,0,0,0,0,0,0,0,NA,0,1,1,0,0,0,1,0,"https://fbref.com/en/players/8b298f56/Clement-Grenier"
2022,"Mallorca","La Liga","Matthew Hoppe","USA","FW,MF","20",2001,1.5,1,0,0,0,1,0,3,0,3,0,0,0,0,1,0,0,"https://fbref.com/en/players/1bc432b7/Matthew-Hoppe"
2022,"Mallorca","La Liga","Lago Junior","CIV","FW,MF","30",1990,2,3,2,3,0,0,3,5,60,2,0,0,0,2,5,2,0,"https://fbref.com/en/players/360d70f8/Lago-Junior"
2022,"Mallorca","La Liga","Lee Kangin","KOR","MF,FW","20",2001,15.7,13,6,2,9,2,5,29,17.2,24,11,1,10,5,18,7,0,"https://fbref.com/en/players/8455ad90/Lee-Kangin"
2022,"Mallorca","La Liga","Takefusa Kubo","JPN","FW,MF","20",2001,17.8,31,19,12,14,5,10,24,41.7,14,24,3,21,8,39,4,0,"https://fbref.com/en/players/16aa3654/Takefusa-Kubo"
2022,"Mallorca","La Liga","Javier Llabrés","ESP","FW,MF","18",2002,1.5,2,1,0,1,1,1,2,50,1,1,0,1,0,2,0,0,"https://fbref.com/en/players/38b0cf42/Javier-Llabres"
2022,"Mallorca","La Liga","Pablo Maffeo","ESP","DF","24",1997,32.7,84,47,48,28,8,38,69,55.1,31,30,13,17,46,130,74,0,"https://fbref.com/en/players/5db04597/Pablo-Maffeo"
2022,"Mallorca","La Liga","Jordi Mboula","ESP","FW","22",1999,4.8,8,2,3,3,2,5,9,55.6,4,7,1,6,3,11,3,0,"https://fbref.com/en/players/4887118d/Jordi-Mboula"
2022,"Mallorca","La Liga","Vedat Muriqi","KVX","FW","27",1994,16,6,3,1,3,2,1,7,14.3,6,12,0,12,6,12,29,0,"https://fbref.com/en/players/0cadc46d/Vedat-Muriqi"
2022,"Mallorca","La Liga","Fernando Niño","ESP","FW","20",2000,9.8,10,4,3,2,5,2,12,16.7,10,9,2,7,3,13,15,0,"https://fbref.com/en/players/81d5c497/Fernando-Nino"
2022,"Mallorca","La Liga","Brian Oliván","ESP","DF","27",1994,24.3,33,20,22,9,2,12,23,52.2,11,17,7,10,28,61,63,0,"https://fbref.com/en/players/a3e4bf46/Brian-Olivan"
2022,"Mallorca","La Liga","Abdón Prats","ESP","FW","28",1992,7.1,2,2,1,0,1,1,5,20,4,5,0,5,1,3,6,0,"https://fbref.com/en/players/d1b060e2/Abdon-Prats"
2022,"Mallorca","La Liga","Antonio Raillo","ESP","DF","29",1991,17,16,7,10,4,2,5,6,83.3,1,17,14,3,18,34,81,0,"https://fbref.com/en/players/b857bd29/Antonio-Raillo"
2022,"Mallorca","La Liga","Manolo Reina","ESP","GK","36",1985,21,0,0,0,0,0,0,0,NA,0,0,0,0,1,1,6,2,"https://fbref.com/en/players/605eb473/Manolo-Reina"
2022,"Mallorca","La Liga","Sergio Rico","ESP","GK","27",1993,14,0,0,0,0,0,0,0,NA,0,0,0,0,0,0,5,2,"https://fbref.com/en/players/5f0241b2/Sergio-Rico"
2022,"Mallorca","La Liga","Ángel Rodríguez","ESP","FW,MF","34",1987,17.2,15,9,6,7,2,4,21,19,17,15,1,14,3,18,13,0,"https://fbref.com/en/players/8cfc2f69/Angel-Rodriguez"
2022,"Mallorca","La Liga","Dani Rodríguez","ESP","MF,FW","33",1988,31.5,53,31,20,24,9,15,46,32.6,31,28,3,25,20,73,27,0,"https://fbref.com/en/players/70f8e0bd/Dani-Rodriguez"
2022,"Mallorca","La Liga","Leonardo Román","ESP","GK","21",2000,2,0,0,0,0,0,0,0,NA,0,0,0,0,0,0,2,0,"https://fbref.com/en/players/924ff27e/Leonardo-Roman"
2022,"Mallorca","La Liga","Franco Russo","ARG","DF","26",1994,16.3,19,10,10,9,0,13,31,41.9,18,14,9,5,27,46,73,1,"https://fbref.com/en/players/b75ac54b/Franco-Russo"
2022,"Mallorca","La Liga","Antonio Sánchez","ESP","MF,FW","24",1997,18,53,24,29,17,7,19,49,38.8,30,32,2,30,32,85,32,1,"https://fbref.com/en/players/a254bbe0/Antonio-Sanchez"
2022,"Mallorca","La Liga","Joan Sastre Vanrell","ESP","DF","24",1997,2.9,6,3,5,0,1,3,4,75,1,3,0,3,2,8,10,0,"https://fbref.com/en/players/f9acf8bf/Joan-Sastre-Vanrell"
2022,"Mallorca","La Liga","Aleksandar Sedlar","SRB","DF,MF","29",1991,4.5,5,3,4,1,0,3,5,60,2,4,4,0,5,10,19,0,"https://fbref.com/en/players/a35134ae/Aleksandar-Sedlar"
2022,"Mallorca","La Liga","Salva Sevilla","ESP","MF","37",1984,16.7,18,12,8,8,2,6,17,35.3,11,12,6,6,14,32,11,0,"https://fbref.com/en/players/75bd85ea/Salva-Sevilla"
2022,"Mallorca","La Liga","Martin Valjent","SVK","DF","25",1995,35.3,31,19,18,12,1,13,24,54.2,11,34,26,8,31,62,173,1,"https://fbref.com/en/players/f2c6ac01/Martin-Valjent"
2022,"Manchester City","Premier League","Nathan Aké","NED","DF","26",1995,10.3,16,9,7,8,1,6,8,75,2,7,5,2,8,24,23,0,"https://fbref.com/en/players/eaeca114/Nathan-Ake"
2022,"Manchester City","Premier League","João Cancelo","POR","DF","27",1994,35.9,83,54,33,35,15,46,91,50.5,45,25,3,22,59,142,45,1,"https://fbref.com/en/players/bd6351cd/Joao-Cancelo"
2022,"Manchester City","Premier League","Kayky Chagas","BRA","FW","18",2003,0.1,0,0,0,0,0,0,0,NA,0,0,0,0,0,0,0,0,"https://fbref.com/en/players/17734ea0/Kayky-Chagas"
2022,"Manchester City","Premier League","Kevin De Bruyne","BEL","MF","30",1991,24.5,32,16,4,15,13,12,37,32.4,25,32,2,30,6,38,16,0,"https://fbref.com/en/players/e46012d4/Kevin-De-Bruyne"
2022,"Manchester City","Premier League","Liam Delap","ENG","FW","18",2003,0.1,0,0,0,0,0,0,0,NA,0,0,0,0,0,0,0,0,"https://fbref.com/en/players/dd897ee7/Liam-Delap"
2022,"Manchester City","Premier League","Rúben Dias","POR","DF","24",1997,26.7,26,19,11,12,3,8,15,53.3,7,19,13,6,23,49,66,0,"https://fbref.com/en/players/31c69ef1/Ruben-Dias"
2022,"Manchester City","Premier League","Ederson","BRA","GK","27",1993,37,2,1,2,0,0,0,2,0,2,0,0,0,0,2,12,0,"https://fbref.com/en/players/3bb7b8b4/Ederson"
2022,"Manchester City","Premier League","CJ Egan-Riley","ENG","DF","18",2003,0,1,1,1,0,0,1,1,100,0,0,0,0,0,1,0,0,"https://fbref.com/en/players/d313e8ff/CJ-Egan-Riley"
2022,"Manchester City","Premier League","Fernandinho","BRA","MF,DF","36",1985,10.7,21,10,7,10,4,9,27,33.3,18,8,2,6,8,29,13,1,"https://fbref.com/en/players/101da2b5/Fernandinho"
2022,"Manchester City","Premier League","Phil Foden","ENG","FW","21",2000,23.6,16,8,10,4,2,7,17,41.2,10,9,0,9,11,27,5,0,"https://fbref.com/en/players/ed1e53f3/Phil-Foden"
2022,"Manchester City","Premier League","Jack Grealish","ENG","FW","25",1995,21.3,18,17,4,10,4,5,13,38.5,8,11,1,10,8,26,7,0,"https://fbref.com/en/players/b0b4fd3e/Jack-Grealish"
2022,"Manchester City","Premier League","İlkay Gündoğan","GER","MF","30",1990,20.6,23,9,10,12,1,12,31,38.7,19,11,1,10,15,38,10,0,"https://fbref.com/en/players/819b3158/Ilkay-Gundogan"
2022,"Manchester City","Premier League","Gabriel Jesus","BRA","FW","24",1997,20.9,18,12,2,4,12,6,26,23.1,20,18,0,18,15,33,8,0,"https://fbref.com/en/players/b66315ae/Gabriel-Jesus"
2022,"Manchester City","Premier League","Aymeric Laporte","ESP","DF","27",1994,31.4,33,15,22,10,1,14,20,70,6,15,10,5,20,53,64,2,"https://fbref.com/en/players/119b9a8e/Aymeric-Laporte"
2022,"Manchester City","Premier League","Riyad Mahrez","ALG","FW","30",1991,16.6,11,3,5,4,2,5,19,26.3,14,15,1,14,6,17,6,0,"https://fbref.com/en/players/892d5bb1/Riyad-Mahrez"
2022,"Manchester City","Premier League","James Mcatee","ENG","MF,FW","18",2002,0.2,0,0,0,0,0,0,2,0,2,0,0,0,0,0,0,0,"https://fbref.com/en/players/96593e89/James-Mcatee"
2022,"Manchester City","Premier League","Benjamin Mendy","FRA","DF","27",1994,0.9,2,2,1,1,0,2,6,33.3,4,0,0,0,0,2,0,0,"https://fbref.com/en/players/5271c8f1/Benjamin-Mendy"
2022,"Manchester City","Premier League","Cole Palmer","ENG","FW,MF","19",2002,1.4,2,1,1,1,0,0,2,0,2,3,0,3,1,3,0,0,"https://fbref.com/en/players/dc7f8a28/Cole-Palmer"
2022,"Manchester City","Premier League","Rodri","ESP","MF","25",1996,32,72,43,24,38,10,32,59,54.2,27,28,5,23,28,100,45,0,"https://fbref.com/en/players/6434f10d/Rodri"
2022,"Manchester City","Premier League","Bernardo Silva","POR","MF,FW","26",1994,31.7,57,29,19,19,19,31,67,46.3,36,24,2,22,20,77,19,0,"https://fbref.com/en/players/3eb22ec9/Bernardo-Silva"
2022,"Manchester City","Premier League","Zack Steffen","USA","GK","26",1995,1,0,0,0,0,0,0,0,NA,0,0,0,0,0,0,2,0,"https://fbref.com/en/players/42130443/Zack-Steffen"
2022,"Manchester City","Premier League","Raheem Sterling","ENG","FW","26",1994,23.6,23,10,3,11,9,10,23,43.5,13,12,0,12,12,35,3,0,"https://fbref.com/en/players/b400bde0/Raheem-Sterling"
2022,"Manchester City","Premier League","John Stones","ENG","DF","27",1994,12.4,5,3,3,2,0,2,3,66.7,1,3,3,0,11,16,27,1,"https://fbref.com/en/players/5eecec3d/John-Stones"
2022,"Manchester City","Premier League","Ferrán Torres","ESP","FW","21",2000,3.4,2,2,0,1,1,0,3,0,3,2,0,2,0,2,1,0,"https://fbref.com/en/players/9e1035f8/Ferran-Torres"
2022,"Manchester City","Premier League","Kyle Walker","ENG","DF","31",1990,19.5,15,6,7,7,1,8,17,47.1,9,14,4,10,14,29,16,1,"https://fbref.com/en/players/86dd77d1/Kyle-Walker"
2022,"Manchester City","Premier League","Oleksandr Zinchenko","UKR","DF","24",1996,11.6,20,14,7,10,3,11,20,55,9,11,3,8,14,34,15,1,"https://fbref.com/en/players/51cf8561/Oleksandr-Zinchenko"
2022,"Manchester Utd","Premier League","Eric Bailly","CIV","DF","27",1994,2.4,5,4,4,0,1,3,4,75,1,4,2,2,3,8,11,0,"https://fbref.com/en/players/a1232f4e/Eric-Bailly"
2022,"Manchester Utd","Premier League","Donny van de Beek","NED","MF","24",1997,0.8,6,4,4,1,1,1,2,50,1,5,1,4,2,8,1,0,"https://fbref.com/en/players/50dc94ce/Donny-van-de-Beek"
2022,"Manchester Utd","Premier League","Edinson Cavani","URU","FW","34",1987,8.5,4,1,0,3,1,2,8,25,6,6,0,6,2,6,8,0,"https://fbref.com/en/players/527f063d/Edinson-Cavani"
2022,"Manchester Utd","Premier League","Diogo Dalot","POR","DF","22",1999,20,55,41,35,12,8,31,57,54.4,26,24,13,11,29,84,59,0,"https://fbref.com/en/players/d9565625/Diogo-Dalot"
2022,"Manchester Utd","Premier League","Anthony Elanga","SWE","FW","19",2002,13.5,26,20,12,12,2,15,29,51.7,14,17,1,16,9,35,7,0,"https://fbref.com/en/players/2fba6108/Anthony-Elanga"
2022,"Manchester Utd","Premier League","Bruno Fernandes","POR","MF","26",1994,34.6,54,28,26,22,6,26,91,28.6,65,36,0,36,17,71,42,2,"https://fbref.com/en/players/507c7bdf/Bruno-Fernandes"
2022,"Manchester Utd","Premier League","Fred","BRA","MF","28",1993,22.5,63,27,32,24,7,22,79,27.8,57,38,11,27,32,95,24,0,"https://fbref.com/en/players/b853e0ad/Fred"
2022,"Manchester Utd","Premier League","Alejandro Garnacho","ESP","FW,MF","17",2004,0.1,0,0,0,0,0,0,1,0,1,0,0,0,0,0,0,0,"https://fbref.com/en/players/7aa8adfe/Alejandro-Garnacho"
2022,"Manchester Utd","Premier League","David de Gea","ESP","GK","30",1990,38,0,0,0,0,0,0,0,NA,0,0,0,0,0,0,11,2,"https://fbref.com/en/players/7ba6d84e/David-de-Gea"
2022,"Manchester Utd","Premier League","Mason Greenwood","ENG","FW,MF","19",2001,14.1,15,9,9,1,5,3,9,33.3,6,5,0,5,1,16,6,0,"https://fbref.com/en/players/58eee997/Mason-Greenwood"
2022,"Manchester Utd","Premier League","Daniel James","WAL","FW","23",1997,1.4,2,1,0,2,0,0,0,NA,0,2,0,2,0,2,1,0,"https://fbref.com/en/players/c931d9f9/Daniel-James"
2022,"Manchester Utd","Premier League","Phil Jones","ENG","DF","29",1992,1.8,5,5,3,1,1,2,3,66.7,1,4,4,0,3,8,8,0,"https://fbref.com/en/players/def899bd/Phil-Jones"
2022,"Manchester Utd","Premier League","Victor Lindelöf","SWE","DF","27",1994,26.2,16,11,9,7,0,9,14,64.3,5,26,17,9,25,41,96,0,"https://fbref.com/en/players/f5deef4c/Victor-Lindelof"
2022,"Manchester Utd","Premier League","Jesse Lingard","ENG","FW,MF","28",1992,4.1,9,7,4,3,2,2,6,33.3,4,4,0,4,0,9,1,0,"https://fbref.com/en/players/810e3c74/Jesse-Lingard"
2022,"Manchester Utd","Premier League","Harry Maguire","ENG","DF","28",1993,27.9,34,21,22,8,4,19,31,61.3,12,36,29,7,32,66,101,3,"https://fbref.com/en/players/d8931174/Harry-Maguire"
2022,"Manchester Utd","Premier League","Anthony Martial","FRA","FW","25",1995,2.4,0,0,0,0,0,0,1,0,1,1,0,1,0,0,1,0,"https://fbref.com/en/players/8b788c01/Anthony-Martial"
2022,"Manchester Utd","Premier League","Juan Mata","ESP","MF","33",1988,2.6,6,4,2,3,1,3,5,60,2,1,0,1,1,7,1,0,"https://fbref.com/en/players/29733c72/Juan-Mata"
2022,"Manchester Utd","Premier League","Nemanja Matić","SRB","MF","32",1988,15.4,31,18,19,11,1,15,31,48.4,16,21,6,15,31,62,21,3,"https://fbref.com/en/players/eb7822d7/Nemanja-Matic"
2022,"Manchester Utd","Premier League","Scott McTominay","SCO","MF","24",1996,26.5,65,33,32,24,9,30,61,49.2,31,45,10,35,31,96,60,1,"https://fbref.com/en/players/d93c2511/Scott-McTominay"
2022,"Manchester Utd","Premier League","Hannibal Mejbri","TUN","FW","18",2003,0.8,2,1,1,1,0,1,1,100,0,0,0,0,0,2,0,0,"https://fbref.com/en/players/ca22ccb0/Hannibal-Mejbri"
2022,"Manchester Utd","Premier League","Paul Pogba","FRA","MF,FW","28",1993,15,13,9,5,7,1,6,28,21.4,22,11,0,11,13,26,16,0,"https://fbref.com/en/players/867239d3/Paul-Pogba"
2022,"Manchester Utd","Premier League","Marcus Rashford","ENG","FW,MF","23",1997,13.7,6,5,1,4,1,2,13,15.4,11,10,1,9,5,11,5,1,"https://fbref.com/en/players/a1d5bd30/Marcus-Rashford"
2022,"Manchester Utd","Premier League","Cristiano Ronaldo","POR","FW","36",1985,27.3,8,6,1,5,2,2,6,33.3,4,8,0,8,2,10,29,0,"https://fbref.com/en/players/dea698d9/Cristiano-Ronaldo"
2022,"Manchester Utd","Premier League","Jadon Sancho","ENG","FW,MF","21",2000,21.1,14,8,9,4,1,8,22,36.4,14,19,0,19,15,29,5,3,"https://fbref.com/en/players/dbf053da/Jadon-Sancho"
2022,"Manchester Utd","Premier League","Luke Shaw","ENG","DF","26",1995,17.8,21,13,9,9,3,12,21,57.1,9,22,11,11,9,30,22,2,"https://fbref.com/en/players/9c94165b/Luke-Shaw"
2022,"Manchester Utd","Premier League","Shola Shoretire","ENG","MF","17",2004,0.2,0,0,0,0,0,0,0,NA,0,0,0,0,0,0,0,0,"https://fbref.com/en/players/00f0482f/Shola-Shoretire"
2022,"Manchester Utd","Premier League","Alex Telles","BRA","DF","28",1992,18.4,48,27,35,9,4,27,43,62.8,16,17,4,13,26,74,45,0,"https://fbref.com/en/players/e73c9bb2/Alex-Telles"
2022,"Manchester Utd","Premier League","Raphaël Varane","FRA","DF","28",1993,20.3,28,19,21,6,1,10,22,45.5,12,18,9,9,18,46,82,1,"https://fbref.com/en/players/9f8e9423/Raphael-Varane"
2022,"Manchester Utd","Premier League","Aaron Wan-Bissaka","ENG","DF","23",1997,19.9,49,36,25,18,6,14,20,70,6,24,14,10,34,83,41,2,"https://fbref.com/en/players/9e525177/Aaron-Wan-Bissaka"
2022,"Marseille","Ligue 1","Jordan Amavi","FRA","DF,FW","27",1994,1.4,6,5,3,1,2,5,10,50,5,1,0,1,1,7,3,0,"https://fbref.com/en/players/22721b88/Jordan-Amavi"
2022,"Marseille","Ligue 1","Cédric Bakambu","COD","FW","30",1991,4,2,0,1,0,1,0,3,0,3,2,0,2,0,2,1,0,"https://fbref.com/en/players/0af4dcf0/Cedric-Bakambu"
2022,"Marseille","Ligue 1","Leonardo Balerdi","ARG","DF","22",1999,10.6,9,6,9,0,0,5,14,35.7,9,11,4,7,19,28,30,0,"https://fbref.com/en/players/7c3ed041/Leonardo-Balerdi"
2022,"Marseille","Ligue 1","Salim Ben Seghir","FRA","MF","18",2003,0,0,0,0,0,0,0,0,NA,0,0,0,0,0,0,0,0,"https://fbref.com/en/players/1f6298f2/Salim-Ben-Seghir"
2022,"Marseille","Ligue 1","Darío Benedetto","ARG","FW,MF","31",1990,0.6,0,0,0,0,0,0,0,NA,0,2,0,2,0,0,0,0,"https://fbref.com/en/players/bef0a7ac/Dario-Benedetto"
2022,"Marseille","Ligue 1","Duje Ćaleta-Car","CRO","DF","24",1996,22.9,21,8,15,6,0,11,14,78.6,3,11,7,4,24,45,55,2,"https://fbref.com/en/players/94f8d10c/Duje-Caleta-Car"
2022,"Marseille","Ligue 1","Konrad De La Fuente","USA","FW,MF","20",2001,8.7,11,7,8,2,1,7,11,63.6,4,5,0,5,2,13,4,0,"https://fbref.com/en/players/4b77bb89/Konrad-De-La-Fuente"
2022,"Marseille","Ligue 1","Bamba Dieng","SEN","FW","21",2000,10.8,17,11,5,5,7,4,14,28.6,10,7,0,7,5,22,8,0,"https://fbref.com/en/players/40774c6b/Bamba-Dieng"
2022,"Marseille","Ligue 1","Gerson","BRA","MF,FW","24",1997,28.3,42,17,16,20,6,8,35,22.9,27,26,4,22,16,58,16,2,"https://fbref.com/en/players/8827bf46/Gerson"
2022,"Marseille","Ligue 1","Álvaro González","ESP","DF","31",1990,5,1,1,1,0,0,1,1,100,0,0,0,0,1,2,9,0,"https://fbref.com/en/players/42dcf26d/Alvaro-Gonzalez"
2022,"Marseille","Ligue 1","Mattéo Guendouzi","FRA","MF","22",1999,35,45,30,10,26,9,13,47,27.7,34,15,1,14,16,61,18,0,"https://fbref.com/en/players/5ea8ef20/Matteo-Guendouzi"
2022,"Marseille","Ligue 1","Pape Gueye","SEN","MF","22",1999,17,38,19,15,22,1,16,31,51.6,15,15,3,12,24,62,16,0,"https://fbref.com/en/players/7155e3e1/Pape-Gueye"
2022,"Marseille","Ligue 1","Amine Harit","MAR","FW,MF","24",1997,12.9,18,11,9,9,0,9,17,52.9,8,10,0,10,4,22,2,0,"https://fbref.com/en/players/e7d59f4f/Amine-Harit"
2022,"Marseille","Ligue 1","Luis Henrique","BRA","FW,MF","19",2001,7.8,4,3,2,1,1,2,5,40,3,2,0,2,5,9,1,0,"https://fbref.com/en/players/f36d5624/Luis-Henrique"
2022,"Marseille","Ligue 1","Boubacar Kamara","FRA","MF,DF","21",1999,30.9,68,38,27,36,5,26,47,55.3,21,29,10,19,46,114,44,1,"https://fbref.com/en/players/cc77354e/Boubacar-Kamara"
2022,"Marseille","Ligue 1","Sead Kolašinac","BIH","DF","28",1993,4.9,7,6,2,3,2,5,8,62.5,3,4,0,4,0,7,7,1,"https://fbref.com/en/players/3935e52e/Sead-Kolasinac"
2022,"Marseille","Ligue 1","Pol Lirola","ESP","DF,FW","23",1997,19.7,28,16,15,9,4,13,28,46.4,15,15,0,15,13,41,22,0,"https://fbref.com/en/players/ff800ed8/Pol-Lirola"
2022,"Marseille","Ligue 1","Pau López","ESP","GK","26",1994,29,0,0,0,0,0,0,1,0,1,0,0,0,0,0,12,1,"https://fbref.com/en/players/20b9f052/Pau-Lopez"
2022,"Marseille","Ligue 1","Steve Mandanda","FRA","GK","36",1985,9,0,0,0,0,0,0,1,0,1,1,0,1,1,1,4,1,"https://fbref.com/en/players/1d2d5cc8/Steve-Mandanda"
2022,"Marseille","Ligue 1","Arkadiusz Milik","POL","FW","27",1994,15.7,9,2,0,5,4,4,18,22.2,14,9,1,8,3,12,10,1,"https://fbref.com/en/players/85613cf0/Arkadiusz-Milik"
2022,"Marseille","Ligue 1","Dimitri Payet","FRA","FW,MF","34",1987,28.8,16,8,4,10,2,7,31,22.6,24,9,0,9,9,25,3,0,"https://fbref.com/en/players/58ae47b2/Dimitri-Payet"
2022,"Marseille","Ligue 1","Luan Peres Petroni","BRA","DF","27",1994,29.8,65,35,33,25,7,36,52,69.2,16,26,12,14,43,108,64,1,"https://fbref.com/en/players/a5549ec1/Luan-Peres-Petroni"
2022,"Marseille","Ligue 1","Nemanja Radonjić","SRB","FW","25",1996,0.2,0,0,0,0,0,0,0,NA,0,0,0,0,0,0,0,0,"https://fbref.com/en/players/0630eb63/Nemanja-Radonjic"
2022,"Marseille","Ligue 1","Valentin Rongier","FRA","MF,DF","26",1994,24.4,77,51,36,36,5,28,60,46.7,32,26,5,21,33,110,14,0,"https://fbref.com/en/players/ed45c4a5/Valentin-Rongier"
2022,"Marseille","Ligue 1","William Saliba","FRA","DF","20",2001,36,54,32,36,16,2,27,35,77.1,8,24,16,8,48,102,85,0,"https://fbref.com/en/players/972aeb2a/William-Saliba"
2022,"Marseille","Ligue 1","Oussama Targhalline","MAR","FW","19",2002,0.1,0,0,0,0,0,0,0,NA,0,0,0,0,0,0,0,0,"https://fbref.com/en/players/abd56820/Oussama-Targhalline"
2022,"Marseille","Ligue 1","Cengiz Ünder","TUR","FW,MF","24",1997,24.4,18,13,5,6,7,5,18,27.8,13,13,2,11,14,32,9,0,"https://fbref.com/en/players/1880614f/Cengiz-Under"
2022,"Metz","Ligue 1","Sofiane Alakouch","MAR","DF,MF","23",1998,1.8,7,4,3,4,0,2,5,40,3,4,0,4,1,8,4,0,"https://fbref.com/en/players/5314e067/Sofiane-Alakouch"
2022,"Metz","Ligue 1","Ibrahim Amadou","FRA","DF,MF","28",1993,9,16,8,10,6,0,8,15,53.3,7,4,2,2,14,30,26,0,"https://fbref.com/en/players/9260926b/Ibrahim-Amadou"
2022,"Metz","Ligue 1","Amine Bassi","FRA","MF,FW","23",1997,2,6,3,2,3,1,1,3,33.3,2,5,0,5,0,6,0,0,"https://fbref.com/en/players/ced1d98f/Amine-Bassi"
2022,"Metz","Ligue 1","Farid Boulaya","ALG","MF,FW","28",1993,17,18,10,7,9,2,14,38,36.8,24,8,2,6,12,30,5,0,"https://fbref.com/en/players/a0791826/Farid-Boulaya"
2022,"Metz","Ligue 1","Dylan Bronn","TUN","DF","26",1995,28.3,47,29,33,13,1,20,31,64.5,11,32,19,13,40,87,78,1,"https://fbref.com/en/players/edd81e2a/Dylan-Bronn"
2022,"Metz","Ligue 1","Marc-Aurèle Caillard","FRA","GK","27",1994,17.1,0,0,0,0,0,0,2,0,2,0,0,0,2,2,9,1,"https://fbref.com/en/players/5ee6e943/Marc-Aurele-Caillard"
2022,"Metz","Ligue 1","Fali Candé","GNB","DF","23",1998,10.8,30,18,13,15,2,13,31,41.9,18,11,2,9,6,36,21,0,"https://fbref.com/en/players/3cc4bb19/Fali-Cande"
2022,"Metz","Ligue 1","Fabien Centonze","FRA","DF","25",1996,17.6,33,21,22,9,2,13,32,40.6,19,37,8,29,32,65,51,0,"https://fbref.com/en/players/3c6bbbab/Fabien-Centonze"
2022,"Metz","Ligue 1","Thomas Delaine","FRA","DF","29",1992,25.7,48,35,34,12,2,22,42,52.4,20,20,7,13,27,75,31,0,"https://fbref.com/en/players/8332db56/Thomas-Delaine"
2022,"Metz","Ligue 1","Mamadou Fofana","MLI","DF","23",1998,0.4,1,1,0,1,0,1,2,50,1,2,1,1,1,2,2,0,"https://fbref.com/en/players/4c4ffacc/Mamadou-Fofana"
2022,"Metz","Ligue 1","Vagner Gonçalves","CPV","FW","25",1996,1,2,1,0,2,0,1,1,100,0,0,0,0,1,3,0,0,"https://fbref.com/en/players/743fd71f/Vagner-Goncalves"
2022,"Metz","Ligue 1","Lamine Gueye","SEN","FW,MF","23",1998,6.2,5,5,1,1,3,3,7,42.9,4,4,0,4,6,11,1,0,"https://fbref.com/en/players/9d5dcc23/Lamine-Gueye"
2022,"Metz","Ligue 1","Jemerson","BRA","DF","28",1992,13.4,37,25,30,7,0,18,26,69.2,8,23,8,15,25,62,33,1,"https://fbref.com/en/players/7cab69b5/Jemerson"
2022,"Metz","Ligue 1","Lenny Joseph","FRA","FW,MF","20",2000,1.7,2,1,1,1,0,0,0,NA,0,3,0,3,0,2,0,0,"https://fbref.com/en/players/d1828392/Lenny-Joseph"
2022,"Metz","Ligue 1","Jean-Armel Kana-Biyik","CMR","DF","32",1989,7.4,10,6,8,2,0,4,9,44.4,5,11,4,7,16,26,22,1,"https://fbref.com/en/players/76a4233b/Jean-Armel-Kana-Biyik"
2022,"Metz","Ligue 1","Boubakar Kouyaté","MLI","DF","24",1997,29.6,84,50,56,28,0,48,77,62.3,29,63,33,30,79,163,217,3,"https://fbref.com/en/players/562a4799/Boubakar-Kouyate"
2022,"Metz","Ligue 1","Lenny Lacroix","FRA","DF","18",2003,2.2,9,7,8,1,0,5,8,62.5,3,5,1,4,10,19,5,0,"https://fbref.com/en/players/5413ef36/Lenny-Lacroix"
2022,"Metz","Ligue 1","Didier Lamkel Zé","CMR","FW","24",1996,6.7,3,1,1,0,2,1,3,33.3,2,3,1,2,1,4,7,0,"https://fbref.com/en/players/b229aa13/Didier-Lamkel-Ze"
2022,"Metz","Ligue 1","Louis Mafouta","CTA","FW","27",1994,5.8,0,0,0,0,0,0,5,0,5,1,0,1,0,0,4,0,"https://fbref.com/en/players/bec3d251/Louis-Mafouta"
2022,"Metz","Ligue 1","Habib Maïga","CIV","MF","25",1996,14.1,47,28,29,13,5,24,48,50,24,20,7,13,14,61,18,0,"https://fbref.com/en/players/e768de1f/Habib-Maiga"
2022,"Metz","Ligue 1","Pape Matar Sarr","SEN","MF","18",2002,23.7,45,26,21,23,1,18,39,46.2,21,33,3,30,29,74,22,0,"https://fbref.com/en/players/feb5d972/Pape-Matar-Sarr"
2022,"Metz","Ligue 1","Amadou Mbengue","SEN","DF,MF","19",2002,6.8,19,10,10,9,0,11,22,50,11,7,2,5,10,29,19,0,"https://fbref.com/en/players/14d2670e/Amadou-Mbengue"
2022,"Metz","Ligue 1","Georges Mikautadze","GEO","FW","20",2000,0,0,0,0,0,0,0,0,NA,0,0,0,0,0,0,0,0,"https://fbref.com/en/players/4788cb6b/Georges-Mikautadze"
2022,"Metz","Ligue 1","William Mikelbrencis","FRA","DF","17",2004,6.8,11,5,6,4,1,6,9,66.7,3,6,3,3,5,16,9,0,"https://fbref.com/en/players/14df1d7f/William-Mikelbrencis"
2022,"Metz","Ligue 1","Kévin N'Doram","FRA","MF","25",1996,13.7,10,8,3,5,2,3,20,15,17,24,5,19,19,29,21,0,"https://fbref.com/en/players/e50623a0/Kevin-NDoram"
2022,"Metz","Ligue 1","Papa Ndiaga Yade","SEN","DF,FW","21",2000,7.7,15,10,8,7,0,8,18,44.4,10,4,1,3,10,25,9,0,"https://fbref.com/en/players/87e9c7cd/Papa-Ndiaga-Yade"
2022,"Metz","Ligue 1","Opa Nguette","SEN","FW,MF","27",1994,11.6,21,14,9,6,6,5,14,35.7,9,13,3,10,2,23,9,0,"https://fbref.com/en/players/75a63397/Opa-Nguette"
2022,"Metz","Ligue 1","Sikou Niakaté","FRA","DF","22",1999,7.3,8,7,8,0,0,4,11,36.4,7,5,3,2,27,35,34,0,"https://fbref.com/en/players/8eef18aa/Sikou-Niakate"
2022,"Metz","Ligue 1","Ibrahima Niane","SEN","FW","22",1999,17.6,1,1,0,1,0,0,5,0,5,6,1,5,3,4,16,0,"https://fbref.com/en/players/46faabfa/Ibrahima-Niane"
2022,"Metz","Ligue 1","Alexandre Oukidja","ALG","GK","33",1988,20.8,0,0,0,0,0,0,1,0,1,1,0,1,1,1,17,2,"https://fbref.com/en/players/ae7d0ecd/Alexandre-Oukidja"
2022,"Metz","Ligue 1","Vincent Pajot","FRA","MF","30",1990,25.7,86,56,35,47,4,20,46,43.5,26,33,6,27,51,137,38,0,"https://fbref.com/en/players/f86ca403/Vincent-Pajot"
2022,"Metz","Ligue 1","Nicolas de Préville","FRA","FW,MF","30",1991,21.9,17,8,7,8,2,3,19,15.8,16,12,4,8,5,22,11,0,"https://fbref.com/en/players/b0547a87/Nicolas-de-Preville"
2022,"Metz","Ligue 1","Warren Tchimbembé","CGO","MF","23",1998,2.3,1,1,0,1,0,0,1,0,1,2,1,1,2,3,2,0,"https://fbref.com/en/players/93b8f9f4/Warren-Tchimbembe"
2022,"Metz","Ligue 1","Cheikh Tidiane Sabaly","SEN","FW,MF","22",1999,1.7,6,3,1,4,1,2,2,100,0,1,0,1,0,6,1,0,"https://fbref.com/en/players/9ddf7fae/Cheikh-Tidiane-Sabaly"
2022,"Metz","Ligue 1","Boubacar Traoré","MLI","MF","19",2001,19.2,43,26,18,23,2,10,39,25.6,29,29,5,24,25,68,11,1,"https://fbref.com/en/players/999ceb5f/Boubacar-Traore"
2022,"Metz","Ligue 1","Matthieu Udol","FRA","DF","25",1996,11.2,23,14,11,10,2,12,18,66.7,6,20,7,13,31,54,29,1,"https://fbref.com/en/players/cc41f558/Matthieu-Udol"
2022,"Milan","Serie A","Tiemoué Bakayoko","FRA","MF","26",1994,5.6,19,13,9,7,3,5,16,31.3,11,8,1,7,9,28,10,2,"https://fbref.com/en/players/59bf127b/Tiemoue-Bakayoko"
2022,"Milan","Serie A","Fodé Ballo-Touré","SEN","DF","24",1997,5,18,14,5,13,0,4,9,44.4,5,6,2,4,3,21,5,0,"https://fbref.com/en/players/f449640d/Fode-Ballo-Toure"
2022,"Milan","Serie A","Ismaël Bennacer","ALG","MF","23",1997,16.9,44,30,22,15,7,21,50,42,29,20,4,16,25,69,15,0,"https://fbref.com/en/players/db092d3b/Ismael-Bennacer"
2022,"Milan","Serie A","Davide Calabria","ITA","DF","24",1996,23.5,62,37,31,23,8,37,72,51.4,35,25,5,20,23,85,40,1,"https://fbref.com/en/players/2146785a/Davide-Calabria"
2022,"Milan","Serie A","Samu Castillejo","ESP","FW,MF","26",1995,1.4,4,2,0,2,2,1,8,12.5,7,4,1,3,2,6,1,0,"https://fbref.com/en/players/130a7a3f/Samu-Castillejo"
2022,"Milan","Serie A","Andrea Conti","ITA","DF","27",1994,0.1,0,0,0,0,0,0,0,NA,0,0,0,0,0,0,0,0,"https://fbref.com/en/players/8fef5412/Andrea-Conti"
2022,"Milan","Serie A","Brahim Díaz","ESP","MF","21",1999,20.6,23,17,3,11,9,8,22,36.4,14,11,0,11,8,31,4,0,"https://fbref.com/en/players/407feb71/Brahim-Diaz"
2022,"Milan","Serie A","Alessandro Florenzi","ITA","DF,FW","30",1991,12.8,28,14,14,7,7,14,32,43.8,18,9,2,7,27,55,10,1,"https://fbref.com/en/players/e288d4b3/Alessandro-Florenzi"
2022,"Milan","Serie A","Matteo Gabbia","ITA","DF","21",1999,6,4,3,1,3,0,0,4,0,4,2,2,0,8,12,12,0,"https://fbref.com/en/players/c235e803/Matteo-Gabbia"
2022,"Milan","Serie A","Olivier Giroud","FRA","FW","34",1986,21,15,11,4,6,5,3,17,17.6,14,13,4,9,3,18,19,0,"https://fbref.com/en/players/16ceb862/Olivier-Giroud"
2022,"Milan","Serie A","Theo Hernández","FRA","DF","23",1997,30.1,53,35,34,14,5,29,40,72.5,11,16,3,13,23,76,29,3,"https://fbref.com/en/players/d4c9725f/Theo-Hernandez"
2022,"Milan","Serie A","Zlatan Ibrahimović","SWE","FW","39",1981,11.3,0,0,0,0,0,0,2,0,2,2,1,1,3,3,9,0,"https://fbref.com/en/players/4cde5509/Zlatan-Ibrahimovic"
2022,"Milan","Serie A","Pierre Kalulu","FRA","DF","21",2000,21.6,61,36,36,21,4,17,22,77.3,5,36,15,21,26,87,54,0,"https://fbref.com/en/players/85f7d1be/Pierre-Kalulu"
2022,"Milan","Serie A","Franck Kessié","CIV","MF","24",1996,25.6,41,23,12,24,5,17,26,65.4,9,39,10,29,23,64,22,0,"https://fbref.com/en/players/05e19d6a/Franck-Kessie"
2022,"Milan","Serie A","Simon Kjær","DEN","DF","32",1989,8.9,20,12,9,8,3,6,12,50,6,17,13,4,9,29,39,0,"https://fbref.com/en/players/8b8a56ce/Simon-Kjaer"
2022,"Milan","Serie A","Rade Krunić","BIH","MF,FW","27",1993,15.7,33,18,16,14,3,15,31,48.4,16,19,2,17,16,49,17,0,"https://fbref.com/en/players/817c6964/Rade-Krunic"
2022,"Milan","Serie A","Rafael Leão","POR","FW","22",1999,28.9,17,7,3,9,5,10,20,50,10,12,1,11,12,29,8,0,"https://fbref.com/en/players/20730eae/Rafael-Leao"
2022,"Milan","Serie A","Mike Maignan","FRA","GK","26",1995,32,2,1,2,0,0,2,2,100,0,0,0,0,1,3,4,2,"https://fbref.com/en/players/fcb38f57/Mike-Maignan"
2022,"Milan","Serie A","Daniel Maldini","ITA","MF","19",2001,1.6,8,3,4,3,1,2,6,33.3,4,4,0,4,1,9,0,0,"https://fbref.com/en/players/801831fe/Daniel-Maldini"
2022,"Milan","Serie A","Junior Messias","BRA","FW,MF","30",1991,15.9,34,18,11,14,9,15,34,44.1,19,11,1,10,17,51,17,0,"https://fbref.com/en/players/f49c4ae9/Junior-Messias"
2022,"Milan","Serie A","Pietro Pellegri","ITA","FW","20",2001,1.5,2,2,0,1,1,0,1,0,1,0,0,0,0,2,1,0,"https://fbref.com/en/players/a44d3a3c/Pietro-Pellegri"
2022,"Milan","Serie A","Ante Rebić","CRO","FW","27",1993,9.9,14,8,3,6,5,7,20,35,13,14,0,14,3,17,3,1,"https://fbref.com/en/players/536cebe5/Ante-Rebic"
2022,"Milan","Serie A","Alessio Romagnoli","ITA","DF","26",1995,15.7,24,14,14,10,0,14,18,77.8,4,21,12,9,19,43,45,0,"https://fbref.com/en/players/3ead85f9/Alessio-Romagnoli"
2022,"Milan","Serie A","Alexis Saelemaekers","BEL","FW","22",1999,20.7,43,22,12,17,14,15,51,29.4,36,19,0,19,15,58,8,0,"https://fbref.com/en/players/ee251371/Alexis-Saelemaekers"
2022,"Milan","Serie A","Luca Stanga","ITA","DF","19",2002,0,1,0,0,1,0,0,0,NA,0,0,0,0,0,1,0,0,"https://fbref.com/en/players/2967bcd0/Luca-Stanga"
2022,"Milan","Serie A","Ciprian Tătărușanu","ROU","GK","35",1986,6,0,0,0,0,0,0,1,0,1,0,0,0,0,0,2,1,"https://fbref.com/en/players/b056e3da/Ciprian-Tatarusanu"
2022,"Milan","Serie A","Fikayo Tomori","ENG","DF","23",1997,30.2,73,44,36,34,3,18,26,69.2,8,37,23,14,45,118,84,1,"https://fbref.com/en/players/7edfbb8a/Fikayo-Tomori"
2022,"Milan","Serie A","Sandro Tonali","ITA","MF","21",2000,28.9,54,37,23,25,6,21,41,51.2,20,26,8,18,34,88,19,0,"https://fbref.com/en/players/0db169ae/Sandro-Tonali"
2022,"Monaco","Ligue 1","Ruben Aguilar","FRA","DF","28",1993,23.8,78,53,39,32,7,43,68,63.2,25,19,4,15,44,122,57,0,"https://fbref.com/en/players/3dd738a1/Ruben-Aguilar"
2022,"Monaco","Ligue 1","Maghnes Akliouche","FRA","MF,FW","19",2002,0.6,2,0,0,2,0,0,1,0,1,2,0,2,0,2,0,0,"https://fbref.com/en/players/b625b241/Maghnes-Akliouche"
2022,"Monaco","Ligue 1","Benoît Badiashile","FRA","DF","20",2001,20.4,36,19,21,15,0,14,23,60.9,9,18,12,6,28,64,68,1,"https://fbref.com/en/players/06df8256/Benoit-Badiashile"
2022,"Monaco","Ligue 1","Wissam Ben Yedder","FRA","FW","30",1990,28.1,18,8,1,11,6,6,15,40,9,12,1,11,0,18,1,0,"https://fbref.com/en/players/942b4f90/Wissam-Ben-Yedder"
2022,"Monaco","Ligue 1","Myron Boadu","NED","FW","20",2001,10.7,9,7,2,3,4,1,5,20,4,6,0,6,2,11,1,0,"https://fbref.com/en/players/5b479568/Myron-Boadu"
2022,"Monaco","Ligue 1","Krépin Diatta","SEN","MF,DF","22",1999,3.2,3,2,1,0,2,1,3,33.3,2,2,0,2,1,4,0,0,"https://fbref.com/en/players/8104e41e/Krepin-Diatta"
2022,"Monaco","Ligue 1","Sofiane Diop","FRA","MF,FW","21",2000,21.6,38,20,12,19,7,15,47,31.9,32,10,0,10,23,61,4,0,"https://fbref.com/en/players/19053e31/Sofiane-Diop"
2022,"Monaco","Ligue 1","Axel Disasi","FRA","DF","23",1998,30.2,42,27,20,21,1,23,39,59,16,40,30,10,26,68,75,0,"https://fbref.com/en/players/ad82197c/Axel-Disasi"
2022,"Monaco","Ligue 1","Cesc Fàbregas","ESP","MF","34",1987,0.4,1,0,0,1,0,1,1,100,0,0,0,0,1,2,0,0,"https://fbref.com/en/players/33508c78/Cesc-Fabregas"
2022,"Monaco","Ligue 1","Youssouf Fofana","FRA","MF","22",1999,24.3,69,43,19,41,9,29,56,51.8,27,29,7,22,32,101,22,2,"https://fbref.com/en/players/822d51d7/Youssouf-Fofana"
2022,"Monaco","Ligue 1","Aleksandr Golovin","RUS","FW,MF","25",1996,16.7,40,22,10,18,12,18,41,43.9,23,26,1,25,12,52,8,0,"https://fbref.com/en/players/3708e9fa/Aleksandr-Golovin"
2022,"Monaco","Ligue 1","Wilson Isidor","FRA","FW,MF","20",2000,0.6,0,0,0,0,0,0,4,0,4,1,0,1,0,0,0,0,"https://fbref.com/en/players/a671316d/Wilson-Isidor"
2022,"Monaco","Ligue 1","Ismail Jakobs","SEN","DF,FW","21",1999,13.4,32,16,14,15,3,16,35,45.7,19,16,1,15,17,49,31,0,"https://fbref.com/en/players/a0415710/Ismail-Jakobs"
2022,"Monaco","Ligue 1","Félix Lemaréchal","CIV","MF","17",2003,0.1,0,0,0,0,0,0,1,0,1,0,0,0,0,0,0,0,"https://fbref.com/en/players/8ca9415f/Felix-Lemarechal"
2022,"Monaco","Ligue 1","Jean Lucas","BRA","MF","23",1998,16.1,43,25,14,24,5,17,40,42.5,23,15,5,10,13,56,4,1,"https://fbref.com/en/players/a99138af/Jean-Lucas"
2022,"Monaco","Ligue 1","Guillermo Maripán","CHI","DF","27",1994,20.4,36,24,27,9,0,20,40,50,20,21,14,7,25,61,66,1,"https://fbref.com/en/players/d9764034/Guillermo-Maripan"
2022,"Monaco","Ligue 1","Gelson Martins","POR","MF,FW","26",1995,21.2,42,27,10,26,6,21,59,35.6,38,26,1,25,17,59,4,0,"https://fbref.com/en/players/3ef0fa48/Gelson-Martins"
2022,"Monaco","Ligue 1","Eliot Matazo","BEL","MF","19",2002,8.8,8,7,4,4,0,2,11,18.2,9,11,3,8,13,21,9,0,"https://fbref.com/en/players/15944afd/Eliot-Matazo"
2022,"Monaco","Ligue 1","Chrislain Matsima","FRA","DF","19",2002,1.5,3,2,1,2,0,2,7,28.6,5,3,3,0,1,4,6,1,"https://fbref.com/en/players/cf1ef7ec/Chrislain-Matsima"
2022,"Monaco","Ligue 1","Alexander Nübel","GER","GK","24",1996,38,0,0,0,0,0,0,1,0,1,0,0,0,0,0,11,1,"https://fbref.com/en/players/afb0c500/Alexander-Nubel"
2022,"Monaco","Ligue 1","Strahinja Pavlović","SRB","DF","20",2001,5,23,16,8,13,2,8,12,66.7,4,5,3,2,9,32,15,0,"https://fbref.com/en/players/25146df0/Strahinja-Pavlovic"
2022,"Monaco","Ligue 1","Tiago Ribeiro","POR","FW","19",2002,0,0,0,0,0,0,0,0,NA,0,0,0,0,0,0,0,0,"https://fbref.com/en/players/507d7569/Tiago-Ribeiro"
2022,"Monaco","Ligue 1","Djibril Sidibé","FRA","DF","29",1992,10.5,24,13,13,8,3,9,24,37.5,15,10,1,9,16,40,13,0,"https://fbref.com/en/players/4c5b714f/Djibril-Sidibe"
2022,"Monaco","Ligue 1","Caio Henrique Oliveira Silva","BRA","DF","24",1997,29.6,53,30,31,18,4,28,59,47.5,31,30,6,24,27,80,37,3,"https://fbref.com/en/players/30af8b93/Caio-Henrique-Oliveira-Silva"
2022,"Monaco","Ligue 1","Aurélien Tchouaméni","FRA","MF","21",2000,32.5,86,45,33,49,4,29,55,52.7,26,39,7,32,101,187,34,0,"https://fbref.com/en/players/4f255115/Aurelien-Tchouameni"
2022,"Monaco","Ligue 1","Vanderson","BRA","FW,DF","20",2001,12.4,35,19,10,19,6,15,23,65.2,8,17,4,13,13,48,12,0,"https://fbref.com/en/players/ee45fd85/Vanderson"
2022,"Monaco","Ligue 1","Kevin Volland","GER","MF,FW","29",1992,27.1,24,10,2,18,4,6,31,19.4,25,20,0,20,3,27,9,0,"https://fbref.com/en/players/64f69877/Kevin-Volland"
2022,"Montpellier","Ligue 1","Dimitry Bertaud","FRA","GK","23",1998,9.3,0,0,0,0,0,0,1,0,1,0,0,0,0,0,5,1,"https://fbref.com/en/players/380a15e2/Dimitry-Bertaud"
2022,"Montpellier","Ligue 1","Rémy Cabella","FRA","MF,FW","31",1990,3.5,15,7,4,8,3,5,15,33.3,10,7,0,7,5,20,1,0,"https://fbref.com/en/players/148e136f/Remy-Cabella"
2022,"Montpellier","Ligue 1","Joris Chotard","FRA","MF","19",2001,32.6,59,30,33,23,3,36,78,46.2,42,27,15,12,42,101,56,0,"https://fbref.com/en/players/7909ffa4/Joris-Chotard"
2022,"Montpellier","Ligue 1","Nicolas Cozza","FRA","DF","22",1999,30.8,80,47,50,23,7,35,65,53.8,30,35,19,16,38,118,82,1,"https://fbref.com/en/players/8f325097/Nicolas-Cozza"
2022,"Montpellier","Ligue 1","Sacha Delaye","FRA","MF,FW","19",2002,2.9,8,6,3,2,3,2,8,25,6,1,0,1,1,9,1,1,"https://fbref.com/en/players/e4448c8c/Sacha-Delaye"
2022,"Montpellier","Ligue 1","Andy Delort","ALG","FW","29",1991,3,2,0,0,1,1,0,1,0,1,1,0,1,0,2,4,0,"https://fbref.com/en/players/d33c706e/Andy-Delort"
2022,"Montpellier","Ligue 1","Sepe Elye Wahi","FRA","FW","18",2003,19.8,18,10,9,6,3,6,16,37.5,10,7,0,7,4,22,4,0,"https://fbref.com/en/players/0d7b6576/Sepe-Elye-Wahi"
2022,"Montpellier","Ligue 1","Maxime Estève","FRA","DF","19",2002,20.6,27,18,22,4,1,15,27,55.6,12,31,24,7,22,49,69,1,"https://fbref.com/en/players/1a066e69/Maxime-Esteve"
2022,"Montpellier","Ligue 1","Jordan Ferri","FRA","MF","29",1992,32.3,55,35,28,23,4,29,87,33.3,58,21,5,16,30,85,35,0,"https://fbref.com/en/players/375622c5/Jordan-Ferri"
2022,"Montpellier","Ligue 1","Valère Germain","FRA","FW","31",1990,21.9,23,14,6,11,6,8,31,25.8,23,13,1,12,9,32,27,0,"https://fbref.com/en/players/ea0ff634/Valere-Germain"
2022,"Montpellier","Ligue 1","Nicholas Gioacchini","USA","FW,MF","21",2000,5.5,7,5,3,2,2,4,10,40,6,8,0,8,4,11,5,0,"https://fbref.com/en/players/79ab7593/Nicholas-Gioacchini"
2022,"Montpellier","Ligue 1","Yanis Guermouche","FRA","MF,FW","20",2001,0.1,2,1,0,1,1,1,1,100,0,0,0,0,0,2,0,0,"https://fbref.com/en/players/642f9f79/Yanis-Guermouche"
2022,"Montpellier","Ligue 1","Gaëtan Laborde","FRA","FW","27",1994,3.8,2,2,1,1,0,2,4,50,2,3,0,3,5,7,5,0,"https://fbref.com/en/players/7cdda3bf/Gaetan-Laborde"
2022,"Montpellier","Ligue 1","Léo Leroy","FRA","MF","21",2000,7,31,21,17,11,3,12,34,35.3,22,20,4,16,8,39,8,0,"https://fbref.com/en/players/fcc84a07/Leo-Leroy"
2022,"Montpellier","Ligue 1","Béni Makouana","CGO","FW,MF","18",2002,3.6,2,2,0,0,2,0,1,0,1,1,0,1,3,5,2,0,"https://fbref.com/en/players/654f49ca/Beni-Makouana"
2022,"Montpellier","Ligue 1","Stephy Mavididi","ENG","FW,MF","23",1998,25.5,24,13,11,7,6,14,39,35.9,25,23,2,21,8,32,11,0,"https://fbref.com/en/players/30144daa/Stephy-Mavididi"
2022,"Montpellier","Ligue 1","Pedro Mendes","POR","DF","30",1990,0.2,1,1,1,0,0,0,0,NA,0,1,1,0,0,1,2,0,"https://fbref.com/en/players/6690ef25/Pedro-Mendes"
2022,"Montpellier","Ligue 1","Florent Mollet","FRA","FW,MF","29",1991,29.2,31,22,14,12,5,14,57,24.6,43,27,4,23,24,55,13,0,"https://fbref.com/en/players/7e82a78f/Florent-Mollet"
2022,"Montpellier","Ligue 1","Jonas Omlin","SUI","GK","27",1994,28.7,2,1,2,0,0,2,3,66.7,1,0,0,0,0,2,12,3,"https://fbref.com/en/players/c631f952/Jonas-Omlin"
2022,"Montpellier","Ligue 1","Ambroise Oyongo","CMR","DF","30",1991,7.3,13,4,7,4,2,9,15,60,6,5,1,4,6,19,17,0,"https://fbref.com/en/players/e3e05edf/Ambroise-Oyongo"
2022,"Montpellier","Ligue 1","Mihailo Ristić","SRB","DF","25",1995,20,44,32,26,16,2,25,43,58.1,18,16,6,10,17,61,48,0,"https://fbref.com/en/players/ea0aa7e0/Mihailo-Ristic"
2022,"Montpellier","Ligue 1","Mamadou Sakho","FRA","DF","31",1990,28.6,34,22,26,8,0,16,26,61.5,10,41,34,7,41,75,134,4,"https://fbref.com/en/players/87935cf3/Mamadou-Sakho"
2022,"Montpellier","Ligue 1","Junior Sambia","FRA","DF,FW","24",1996,17,22,13,12,7,3,13,22,59.1,9,22,3,19,21,43,31,0,"https://fbref.com/en/players/24eb7ed6/Junior-Sambia"
2022,"Montpellier","Ligue 1","Téji Savanier","FRA","MF","29",1991,26.8,46,27,18,19,9,21,59,35.6,38,23,1,22,25,71,12,1,"https://fbref.com/en/players/6bde367b/Teji-Savanier"
2022,"Montpellier","Ligue 1","Arnaud Souquet","FRA","DF","29",1992,25.9,56,35,30,17,9,32,65,49.2,33,21,7,14,34,90,60,1,"https://fbref.com/en/players/4e0afc5d/Arnaud-Souquet"
2022,"Montpellier","Ligue 1","Thuler","BRA","DF","22",1999,9.5,21,12,17,4,0,8,15,53.3,7,9,7,2,9,30,30,0,"https://fbref.com/en/players/db23d9fc/Thuler"
2022,"Nantes","Ligue 1","Mohamed Achi","FRA","MF","19",2002,0.1,0,0,0,0,0,0,0,NA,0,0,0,0,0,0,0,0,"https://fbref.com/en/players/1e93fc5d/Mohamed-Achi"
2022,"Nantes","Ligue 1","Dennis Appiah","FRA","DF","29",1992,23.3,55,34,35,18,2,28,48,58.3,20,30,13,17,27,82,74,0,"https://fbref.com/en/players/feb5d3ab/Dennis-Appiah"
2022,"Nantes","Ligue 1","Jean-Kévin Augustin","FRA","FW,MF","24",1997,0.9,1,0,0,0,1,0,3,0,3,1,0,1,0,1,0,0,"https://fbref.com/en/players/97bfa797/Jean-Kevin-Augustin"
2022,"Nantes","Ligue 1","Ludovic Blas","FRA","MF,FW","23",1997,32.9,33,18,7,20,6,15,44,34.1,29,33,3,30,31,64,6,1,"https://fbref.com/en/players/6191093d/Ludovic-Blas"
2022,"Nantes","Ligue 1","Osman Bukari","GHA","FW,MF","22",1998,11.2,18,8,7,6,5,8,22,36.4,14,8,0,8,8,26,1,0,"https://fbref.com/en/players/eab85789/Osman-Bukari"
2022,"Nantes","Ligue 1","Jean-Charles Castelletto","CMR","DF","26",1995,27.9,45,24,27,17,1,25,35,71.4,10,38,27,11,30,75,73,0,"https://fbref.com/en/players/e0f3a1f6/Jean-Charles-Castelletto"
2022,"Nantes","Ligue 1","Pedro Chirivella","ESP","MF","24",1997,29.3,49,31,14,26,9,25,70,35.7,45,23,2,21,37,86,11,0,"https://fbref.com/en/players/68a26d51/Pedro-Chirivella"
2022,"Nantes","Ligue 1","Marcus Coco","FRA","MF,FW","25",1996,10.3,34,14,17,11,6,8,18,44.4,10,11,1,10,10,44,15,0,"https://fbref.com/en/players/3010aefb/Marcus-Coco"
2022,"Nantes","Ligue 1","Sébastien Corchia","FRA","DF","30",1990,14.7,33,20,17,11,5,24,42,57.1,18,24,3,21,13,46,36,0,"https://fbref.com/en/players/0e7ccfc4/Sebastien-Corchia"
2022,"Nantes","Ligue 1","Kalifa Coulibaly","MLI","FW","29",1991,9.4,5,1,1,1,3,0,4,0,4,2,2,0,0,5,11,0,"https://fbref.com/en/players/9980269a/Kalifa-Coulibaly"
2022,"Nantes","Ligue 1","Wylan Cyprien","FRA","MF","26",1995,16.6,33,17,12,18,3,13,32,40.6,19,16,6,10,10,43,14,2,"https://fbref.com/en/players/3e092724/Wylan-Cyprien"
2022,"Nantes","Ligue 1","Lohann Doucet","FRA","MF,DF","18",2002,0.1,0,0,0,0,0,0,0,NA,0,0,0,0,1,1,0,0,"https://fbref.com/en/players/dff0c299/Lohann-Doucet"
2022,"Nantes","Ligue 1","Renaud Emond","BEL","FW,MF","29",1991,2.1,1,0,0,1,0,0,4,0,4,2,1,1,0,1,1,0,"https://fbref.com/en/players/5c9ac7f0/Renaud-Emond"
2022,"Nantes","Ligue 1","Fábio","BRA","DF","31",1990,18.5,61,40,31,23,7,36,74,48.6,38,29,7,22,35,96,31,1,"https://fbref.com/en/players/bc7b4580/Fabio"
2022,"Nantes","Ligue 1","Willem Geubbels","FRA","FW,MF","19",2001,6,8,5,4,2,2,5,12,41.7,7,5,0,5,6,14,5,0,"https://fbref.com/en/players/9836e892/Willem-Geubbels"
2022,"Nantes","Ligue 1","Andrei Girotto","BRA","DF,MF","29",1992,35,85,52,49,32,4,52,103,50.5,51,67,33,34,69,154,143,0,"https://fbref.com/en/players/3befc2b6/Andrei-Girotto"
2022,"Nantes","Ligue 1","Randal Kolo Muani","FRA","FW,MF","22",1998,32.8,28,14,7,10,11,10,25,40,15,14,3,11,6,34,31,0,"https://fbref.com/en/players/c0b3669f/Randal-Kolo-Muani"
2022,"Nantes","Ligue 1","Alban Lafont","FRA","GK","22",1999,38,3,3,3,0,0,3,8,37.5,5,1,0,1,1,4,25,2,"https://fbref.com/en/players/4e7db402/Alban-Lafont"
2022,"Nantes","Ligue 1","Yannis M'Bemba","FRA","DF,FW","20",2001,0.1,0,0,0,0,0,0,0,NA,0,0,0,0,0,0,1,0,"https://fbref.com/en/players/080de72a/Yannis-MBemba"
2022,"Nantes","Ligue 1","Quentin Merlin","FRA","DF,MF","19",2002,21.4,45,28,19,20,6,26,49,53.1,23,25,4,21,27,72,29,2,"https://fbref.com/en/players/0bfca6a1/Quentin-Merlin"
2022,"Nantes","Ligue 1","Samuel Moutoussamy","COD","MF","24",1996,16.8,48,32,20,20,8,23,62,37.1,39,14,2,12,17,65,16,0,"https://fbref.com/en/players/af0c835b/Samuel-Moutoussamy"
2022,"Nantes","Ligue 1","Nicolas Pallois","FRA","DF","33",1987,27.2,51,33,40,11,0,34,59,57.6,25,40,19,21,53,104,116,1,"https://fbref.com/en/players/779847d6/Nicolas-Pallois"
2022,"Nantes","Ligue 1","Roli Pereira de Sa","FRA","MF","24",1996,6.4,12,4,3,5,4,3,20,15,17,6,0,6,6,18,3,0,"https://fbref.com/en/players/60f58477/Roli-Pereira-de-Sa"
2022,"Nantes","Ligue 1","Moses Simon","NGA","FW,MF","26",1995,25.9,17,11,6,5,6,11,23,47.8,12,14,3,11,12,29,5,0,"https://fbref.com/en/players/5f3eaaf5/Moses-Simon"
2022,"Nantes","Ligue 1","Abdoulaye Sylla","GUI","DF","21",2000,1.7,4,4,2,1,1,2,4,50,2,5,3,2,1,5,3,0,"https://fbref.com/en/players/2aeb43f1/Abdoulaye-Sylla"
2022,"Nantes","Ligue 1","Charles Traore","MLI","DF","29",1992,8,16,12,10,4,2,2,13,15.4,11,11,4,7,15,31,30,0,"https://fbref.com/en/players/de488e56/Charles-Traore"
2022,"Napoli","Serie A","Diego Demme","GER","MF","29",1991,7.7,21,12,4,13,4,10,21,47.6,11,11,2,9,9,30,2,0,"https://fbref.com/en/players/dc3fa3b5/Diego-Demme"
2022,"Napoli","Serie A","Giovanni Di Lorenzo","ITA","DF","27",1993,31.9,58,36,30,20,8,33,58,56.9,25,28,10,18,38,96,46,1,"https://fbref.com/en/players/230a2fac/Giovanni-Di-Lorenzo"
2022,"Napoli","Serie A","Elif Elmas","MKD","FW,MF","21",1999,18,25,15,10,10,5,12,28,42.9,16,13,2,11,8,33,17,0,"https://fbref.com/en/players/cf007308/Elif-Elmas"
2022,"Napoli","Serie A","Gianluca Gaetano","ITA","MF","21",2000,0.2,1,1,1,0,0,1,2,50,1,0,0,0,2,3,0,0,"https://fbref.com/en/players/3b387cc7/Gianluca-Gaetano"
2022,"Napoli","Serie A","Faouzi Ghoulam","ALG","DF","30",1991,3.7,3,1,1,2,0,0,3,0,3,2,1,1,3,6,10,0,"https://fbref.com/en/players/c5adc293/Faouzi-Ghoulam"
2022,"Napoli","Serie A","Lorenzo Insigne","ITA","FW","30",1991,25.4,23,14,8,12,3,8,44,18.2,36,30,1,29,20,43,3,1,"https://fbref.com/en/players/2f557579/Lorenzo-Insigne"
2022,"Napoli","Serie A","Juan Jesus","BRA","DF","30",1991,14.2,25,17,14,11,0,12,18,66.7,6,21,16,5,9,34,34,0,"https://fbref.com/en/players/79083382/Juan-Jesus"
2022,"Napoli","Serie A","Kalidou Koulibaly","SEN","DF","30",1991,26.7,39,23,31,6,2,25,38,65.8,13,41,25,16,29,68,90,1,"https://fbref.com/en/players/da974c7b/Kalidou-Koulibaly"
2022,"Napoli","Serie A","Stanislav Lobotka","SVK","MF","26",1994,18.7,39,24,16,20,3,14,36,38.9,22,9,1,8,12,51,13,1,"https://fbref.com/en/players/e1cbb531/Stanislav-Lobotka"
2022,"Napoli","Serie A","Hirving Lozano","MEX","FW","26",1995,17.9,28,20,12,11,5,8,30,26.7,22,24,0,24,9,37,9,0,"https://fbref.com/en/players/a69e4806/Hirving-Lozano"
2022,"Napoli","Serie A","Kévin Malcuit","MAR","DF,MF","30",1991,3.2,4,2,4,0,0,2,2,100,0,3,0,3,8,12,6,0,"https://fbref.com/en/players/d6a889ea/Kevin-Malcuit"
2022,"Napoli","Serie A","Kostas Manolas","GRE","DF","30",1991,3.5,2,2,1,1,0,2,3,66.7,1,2,1,1,4,6,10,1,"https://fbref.com/en/players/c707411f/Kostas-Manolas"
2022,"Napoli","Serie A","Davide Marfella","ITA","GK","21",1999,0.1,0,0,0,0,0,0,0,NA,0,0,0,0,0,0,0,0,"https://fbref.com/en/players/880fcdbb/Davide-Marfella"
2022,"Napoli","Serie A","Alex Meret","ITA","GK","24",1997,6.9,0,0,0,0,0,0,0,NA,0,0,0,0,0,0,3,1,"https://fbref.com/en/players/9413b19f/Alex-Meret"
2022,"Napoli","Serie A","Dries Mertens","BEL","FW,MF","34",1987,15.4,16,7,1,11,4,3,16,18.8,13,8,2,6,9,25,2,0,"https://fbref.com/en/players/89b2c8a9/Dries-Mertens"
2022,"Napoli","Serie A","Victor Osimhen","NGA","FW","22",1998,22,10,5,1,2,7,2,6,33.3,4,16,3,13,3,13,17,0,"https://fbref.com/en/players/8c90fd7a/Victor-Osimhen"
2022,"Napoli","Serie A","David Ospina","COL","GK","32",1988,31,0,0,0,0,0,0,0,NA,0,0,0,0,1,1,11,1,"https://fbref.com/en/players/82b1198a/David-Ospina"
2022,"Napoli","Serie A","Adam Ounas","ALG","MF,FW","24",1996,3.6,6,1,0,3,3,3,7,42.9,4,3,0,3,2,8,3,0,"https://fbref.com/en/players/ed90babd/Adam-Ounas"
2022,"Napoli","Serie A","Andrea Petagna","ITA","FW","26",1995,6.5,3,3,0,3,0,1,4,25,3,1,0,1,0,3,5,0,"https://fbref.com/en/players/03f946ed/Andrea-Petagna"
2022,"Napoli","Serie A","Matteo Politano","ITA","FW","27",1993,18.3,24,12,8,11,5,15,54,27.8,39,11,2,9,13,37,5,0,"https://fbref.com/en/players/5e861944/Matteo-Politano"
2022,"Napoli","Serie A","Amir Rrahmani","KVX","DF","27",1994,32.5,21,11,15,5,1,15,19,78.9,4,36,25,11,19,40,89,0,"https://fbref.com/en/players/4b3e1a38/Amir-Rrahmani"
2022,"Napoli","Serie A","Mário Rui","POR","DF","30",1991,33.2,68,43,32,28,8,39,84,46.4,45,31,7,24,40,108,50,0,"https://fbref.com/en/players/0b5a292a/Mario-Rui"
2022,"Napoli","Serie A","Fabián Ruiz Peña","ESP","MF","25",1996,26.5,55,33,22,29,4,29,67,43.3,38,34,1,33,22,77,32,0,"https://fbref.com/en/players/c0c7ff58/Fabian-Ruiz-Pena"
2022,"Napoli","Serie A","Axel Tuanzebe","ENG","DF","23",1997,0.1,0,0,0,0,0,0,0,NA,0,1,1,0,0,0,0,0,"https://fbref.com/en/players/2baec6ce/Axel-Tuanzebe"
2022,"Napoli","Serie A","Andre-Frank Zambo Anguissa","CMR","MF","25",1995,21.4,50,26,24,17,9,25,51,49,26,31,5,26,24,74,33,1,"https://fbref.com/en/players/6bb2c084/Andre-Frank-Zambo-Anguissa"
2022,"Napoli","Serie A","Alessandro Zanoli","ITA","DF","20",2000,5.1,10,7,6,3,1,3,5,60,2,2,1,1,4,14,16,0,"https://fbref.com/en/players/3b12b11f/Alessandro-Zanoli"
2022,"Napoli","Serie A","Piotr Zieliński","POL","MF","27",1994,23.2,19,12,5,9,5,6,21,28.6,15,13,2,11,8,27,4,0,"https://fbref.com/en/players/a5296e55/Piotr-Zielinski"
2022,"Newcastle Utd","Premier League","Miguel Almirón","PAR","MF,FW","27",1994,19.1,47,29,23,17,7,11,44,25,33,14,1,13,20,67,13,0,"https://fbref.com/en/players/862a1c15/Miguel-Almiron"
2022,"Newcastle Utd","Premier League","Dan Burn","ENG","DF","29",1992,16,16,11,11,4,1,7,11,63.6,4,22,14,8,20,36,101,0,"https://fbref.com/en/players/b2d31e83/Dan-Burn"
2022,"Newcastle Utd","Premier League","Ciaran Clark","IRL","DF","31",1989,11.3,13,10,4,7,2,9,14,64.3,5,14,11,3,13,26,43,1,"https://fbref.com/en/players/2b91cf8e/Ciaran-Clark"
2022,"Newcastle Utd","Premier League","Karl Darlow","ENG","GK","30",1990,8,0,0,0,0,0,0,0,NA,0,0,0,0,0,0,5,1,"https://fbref.com/en/players/cde3309f/Karl-Darlow"
2022,"Newcastle Utd","Premier League","Martin Dúbravka","SVK","GK","32",1989,26,1,1,1,0,0,0,1,0,1,0,0,0,0,1,8,2,"https://fbref.com/en/players/3a949a25/Martin-Dubravka"
2022,"Newcastle Utd","Premier League","Paul Dummett","WAL","DF","29",1991,2.2,7,3,3,4,0,5,8,62.5,3,5,0,5,3,10,5,0,"https://fbref.com/en/players/3fe6bd8c/Paul-Dummett"
2022,"Newcastle Utd","Premier League","Federico Fernández","ARG","DF","32",1989,5.8,3,0,3,0,0,2,5,40,3,10,10,0,4,7,28,0,"https://fbref.com/en/players/f25b010f/Federico-Fernandez"
2022,"Newcastle Utd","Premier League","Ryan Fraser","SCO","FW,MF","27",1994,16.3,10,3,5,3,2,5,13,38.5,8,11,1,10,11,21,11,0,"https://fbref.com/en/players/d56543a0/Ryan-Fraser"
2022,"Newcastle Utd","Premier League","Dwight Gayle","ENG","FW,DF","30",1990,0.4,1,0,0,1,0,0,1,0,1,0,0,0,1,2,0,0,"https://fbref.com/en/players/e58a03c6/Dwight-Gayle"
2022,"Newcastle Utd","Premier League","Bruno Guimarães","BRA","MF","23",1997,11.5,44,23,18,22,4,21,38,55.3,17,25,6,19,9,53,13,0,"https://fbref.com/en/players/82518f62/Bruno-Guimaraes"
2022,"Newcastle Utd","Premier League","Isaac Hayden","ENG","MF,DF","26",1995,11.1,28,14,11,14,3,12,29,41.4,17,17,8,9,14,42,24,0,"https://fbref.com/en/players/c951a6df/Isaac-Hayden"
2022,"Newcastle Utd","Premier League","Jeff Hendrick","IRL","MF","29",1992,0.8,1,1,0,1,0,1,1,100,0,0,0,0,0,1,1,0,"https://fbref.com/en/players/989d5705/Jeff-Hendrick"
2022,"Newcastle Utd","Premier League","Joelinton","BRA","MF,FW","24",1996,28.4,72,38,30,33,9,26,61,42.6,35,46,11,35,34,106,50,2,"https://fbref.com/en/players/c17bfb65/Joelinton"
2022,"Newcastle Utd","Premier League","Emil Krafth","SWE","DF","26",1994,18.2,37,16,25,11,1,27,36,75,9,16,10,6,25,62,56,0,"https://fbref.com/en/players/77cf6852/Emil-Krafth"
2022,"Newcastle Utd","Premier League","Jamaal Lascelles","ENG","DF","27",1993,22.9,15,7,9,5,1,4,12,33.3,8,38,28,10,22,37,121,1,"https://fbref.com/en/players/450ab6fc/Jamaal-Lascelles"
2022,"Newcastle Utd","Premier League","Jamal Lewis","NIR","DF","23",1998,2.9,8,6,6,1,1,3,4,75,1,3,2,1,3,11,8,0,"https://fbref.com/en/players/efb9215a/Jamal-Lewis"
2022,"Newcastle Utd","Premier League","Sean Longstaff","ENG","MF","23",1997,16.3,54,34,18,31,5,24,65,36.9,41,18,6,12,9,63,18,0,"https://fbref.com/en/players/a2b105e0/Sean-Longstaff"
2022,"Newcastle Utd","Premier League","Javier Manquillo","ESP","DF","27",1994,14,39,29,28,10,1,21,36,58.3,15,15,6,9,10,49,32,0,"https://fbref.com/en/players/758dd7f0/Javier-Manquillo"
2022,"Newcastle Utd","Premier League","Jacob Murphy","ENG","FW,DF","26",1995,16.4,49,26,34,11,4,26,41,63.4,15,20,2,18,23,72,17,0,"https://fbref.com/en/players/de112b84/Jacob-Murphy"
2022,"Newcastle Utd","Premier League","Matt Ritchie","SCO","DF","31",1989,14.9,22,15,10,10,2,10,27,37,17,10,2,8,13,35,26,0,"https://fbref.com/en/players/71ef519e/Matt-Ritchie"
2022,"Newcastle Utd","Premier League","Allan Saint-Maximin","FRA","FW,MF","24",1997,31.2,13,8,6,4,3,3,17,17.6,14,13,2,11,11,24,3,0,"https://fbref.com/en/players/2b16cb1a/Allan-Saint-Maximin"
2022,"Newcastle Utd","Premier League","Fabian Schär","SUI","DF","29",1991,24,16,11,11,3,2,8,16,50,8,27,18,9,32,48,95,2,"https://fbref.com/en/players/c8aa95da/Fabian-Schar"
2022,"Newcastle Utd","Premier League","Jonjo Shelvey","ENG","MF","29",1992,22,30,17,12,18,0,14,34,41.2,20,22,7,15,22,52,20,2,"https://fbref.com/en/players/3727dd3c/Jonjo-Shelvey"
2022,"Newcastle Utd","Premier League","Matt Targett","ENG","DF","25",1995,16,41,26,26,14,1,24,37,64.9,13,15,4,11,25,66,39,1,"https://fbref.com/en/players/e514ab62/Matt-Targett"
2022,"Newcastle Utd","Premier League","Kieran Trippier","ENG","DF","30",1990,4.8,17,10,8,8,1,10,16,62.5,6,10,3,7,10,27,10,0,"https://fbref.com/en/players/21512407/Kieran-Trippier"
2022,"Newcastle Utd","Premier League","Joe Willock","ENG","MF","21",1999,22.6,64,37,30,28,6,29,68,42.6,39,37,6,31,21,85,10,1,"https://fbref.com/en/players/a3b03921/Joe-Willock"
2022,"Newcastle Utd","Premier League","Callum Wilson","ENG","FW","29",1992,15.4,9,8,1,5,3,1,4,25,3,7,2,5,3,12,10,0,"https://fbref.com/en/players/c596fcb0/Callum-Wilson"
2022,"Newcastle Utd","Premier League","Chris Wood","NZL","FW","29",1991,14.7,2,0,1,1,0,1,2,50,1,5,2,3,2,4,9,0,"https://fbref.com/en/players/4e9a0555/Chris-Wood"
2022,"Newcastle Utd","Premier League","Freddie Woodman","ENG","GK","24",1997,4,0,0,0,0,0,0,0,NA,0,0,0,0,0,0,0,1,"https://fbref.com/en/players/19e50035/Freddie-Woodman"
2022,"Nice","Ligue 1","Jordan Amavi","FRA","DF","27",1994,4.6,16,10,8,7,1,10,17,58.8,7,3,1,2,15,31,7,0,"https://fbref.com/en/players/22721b88/Jordan-Amavi"
2022,"Nice","Ligue 1","Youcef Atal","ALG","DF","25",1996,12.7,29,19,17,10,2,14,25,56,11,13,2,11,32,61,21,0,"https://fbref.com/en/players/6a827d8e/Youcef-Atal"
2022,"Nice","Ligue 1","Danilo Barbosa","BRA","DF","25",1996,1,0,0,0,0,0,0,0,NA,0,1,1,0,2,2,10,0,"https://fbref.com/en/players/0557ff4f/Danilo-Barbosa"
2022,"Nice","Ligue 1","Melvin Bard","FRA","DF","20",2000,28.8,59,37,38,17,4,41,63,65.1,22,33,10,23,51,110,56,0,"https://fbref.com/en/players/1ddbc7ca/Melvin-Bard"
2022,"Nice","Ligue 1","Walter Benítez","ARG","GK","28",1993,37,0,0,0,0,0,0,2,0,2,1,0,1,0,0,12,2,"https://fbref.com/en/players/8a2248b4/Walter-Benitez"
2022,"Nice","Ligue 1","Hicham Boudaoui","ALG","MF","21",1999,18,31,18,15,10,6,13,36,36.1,23,17,4,13,18,49,15,0,"https://fbref.com/en/players/f9d5908e/Hicham-Boudaoui"
2022,"Nice","Ligue 1","Bilal Brahimi","ALG","MF","21",2000,4.2,1,1,0,1,0,0,2,0,2,1,0,1,2,3,1,0,"https://fbref.com/en/players/02bcaf8e/Bilal-Brahimi"
2022,"Nice","Ligue 1","Marcin Bułka","POL","GK","21",1999,1,0,0,0,0,0,0,0,NA,0,0,0,0,0,0,0,0,"https://fbref.com/en/players/db87a2c4/Marcin-Bulka"
2022,"Nice","Ligue 1","Alexis Claude-Maurice","FRA","MF","23",1998,2.3,2,0,1,0,1,1,4,25,3,7,0,7,3,5,1,0,"https://fbref.com/en/players/741418c3/Alexis-Claude-Maurice"
2022,"Nice","Ligue 1","Lucas Da Cunha","FRA","MF","20",2001,4.4,13,7,2,7,4,6,11,54.5,5,2,0,2,1,14,2,0,"https://fbref.com/en/players/007faf7a/Lucas-Da-Cunha"
2022,"Nice","Ligue 1","Flavius Daniliuc","AUT","DF","20",2001,14.4,46,31,26,17,3,34,43,79.1,9,13,7,6,14,60,34,1,"https://fbref.com/en/players/7ef972c3/Flavius-Daniliuc"
2022,"Nice","Ligue 1","Dante","BRA","DF","37",1983,31.9,42,29,30,12,0,23,33,69.7,10,43,27,16,49,91,96,1,"https://fbref.com/en/players/fd2bc67d/Dante"
2022,"Nice","Ligue 1","Andy Delort","ALG","FW","29",1991,27.2,15,9,3,5,7,7,12,58.3,5,13,4,9,9,24,14,0,"https://fbref.com/en/players/d33c706e/Andy-Delort"
2022,"Nice","Ligue 1","Kasper Dolberg","DEN","FW","23",1997,16.6,9,4,4,3,2,3,9,33.3,6,15,1,14,6,15,17,0,"https://fbref.com/en/players/cc83b74d/Kasper-Dolberg"
2022,"Nice","Ligue 1","Amine Gouiri","FRA","FW,MF","21",2000,30.6,22,13,2,13,7,10,32,31.3,22,22,5,17,11,33,17,1,"https://fbref.com/en/players/aad56ca3/Amine-Gouiri"
2022,"Nice","Ligue 1","Evann Guessand","FRA","FW","20",2001,4.9,9,8,2,5,2,3,8,37.5,5,4,0,4,0,9,1,0,"https://fbref.com/en/players/b73f17f8/Evann-Guessand"
2022,"Nice","Ligue 1","Hassane Kamara","CIV","MF,DF","27",1994,6,13,10,4,6,3,5,8,62.5,3,10,2,8,9,22,4,0,"https://fbref.com/en/players/19a12bed/Hassane-Kamara"
2022,"Nice","Ligue 1","Justin Kluivert","NED","MF","22",1999,20.8,19,9,6,12,1,5,21,23.8,16,13,1,12,14,33,6,0,"https://fbref.com/en/players/4c3a6744/Justin-Kluivert"
2022,"Nice","Ligue 1","Mario Lemina","GAB","MF","27",1993,21.9,62,35,25,33,4,28,38,73.7,10,32,9,23,48,110,37,0,"https://fbref.com/en/players/2b471f99/Mario-Lemina"
2022,"Nice","Ligue 1","Jordan Lotomba","SUI","DF","22",1998,19.8,33,17,21,9,3,16,30,53.3,14,17,4,13,12,45,28,0,"https://fbref.com/en/players/fc4cf6a7/Jordan-Lotomba"
2022,"Nice","Ligue 1","Myziane Maolida","FRA","MF","22",1999,0.4,1,0,0,1,0,0,0,NA,0,1,0,1,0,1,0,0,"https://fbref.com/en/players/706a60e1/Myziane-Maolida"
2022,"Nice","Ligue 1","Dan Ndoye","SUI","FW,MF","20",2000,2.3,0,0,0,0,0,0,2,0,2,4,0,4,0,0,0,0,"https://fbref.com/en/players/8e697a8f/Dan-Ndoye"
2022,"Nice","Ligue 1","Pablo Rosario","NED","MF","24",1997,30.3,59,37,18,32,9,26,66,39.4,40,33,7,26,38,97,43,0,"https://fbref.com/en/players/1a6b7ea4/Pablo-Rosario"
2022,"Nice","Ligue 1","Morgan Schneiderlin","FRA","MF","31",1989,7.2,21,12,9,11,1,6,13,46.2,7,8,2,6,20,41,18,0,"https://fbref.com/en/players/51b41c5c/Morgan-Schneiderlin"
2022,"Nice","Ligue 1","Calvin Stengs","NED","MF","22",1998,11.9,16,7,6,9,1,7,20,35,13,10,0,10,8,24,6,0,"https://fbref.com/en/players/8f7e6783/Calvin-Stengs"
2022,"Nice","Ligue 1","Khéphren Thuram-Ulie","FRA","MF","20",2001,21.1,33,19,11,18,4,17,35,48.6,18,31,11,20,28,61,19,0,"https://fbref.com/en/players/7d9397f8/Khephren-Thuram-Ulie"
2022,"Nice","Ligue 1","Jean-Clair Todibo","FRA","DF","21",1999,34.6,59,37,43,15,1,39,60,65,21,45,21,24,51,110,130,2,"https://fbref.com/en/players/88f130ed/Jean-Clair-Todibo"
2022,"Norwich City","Premier League","Max Aarons","ENG","DF","21",2000,32,64,44,49,15,0,37,55,67.3,18,39,19,20,28,92,96,1,"https://fbref.com/en/players/774cf58b/Max-Aarons"
2022,"Norwich City","Premier League","Sam Byram","ENG","DF","27",1993,11.4,24,15,17,6,1,19,27,70.4,8,21,11,10,22,46,48,0,"https://fbref.com/en/players/1bf811d4/Sam-Byram"
2022,"Norwich City","Premier League","Todd Cantwell","ENG","FW,MF","23",1998,4.9,15,13,8,6,1,6,17,35.3,11,2,0,2,3,18,2,0,"https://fbref.com/en/players/f63d8a4b/Todd-Cantwell"
2022,"Norwich City","Premier League","Kieran Dowell","ENG","FW,MF","23",1997,10.1,18,7,8,7,3,9,32,28.1,23,10,1,9,7,25,4,0,"https://fbref.com/en/players/2f6ec02a/Kieran-Dowell"
2022,"Norwich City","Premier League","Dimitris Giannoulis","GRE","DF","25",1995,13,36,21,17,17,2,24,36,66.7,12,22,6,16,19,55,41,1,"https://fbref.com/en/players/112c495e/Dimitris-Giannoulis"
2022,"Norwich City","Premier League","Ben Gibson","ENG","DF","28",1993,27.7,23,16,17,6,0,7,12,58.3,5,36,30,6,27,50,139,2,"https://fbref.com/en/players/bcfb0142/Ben-Gibson"
2022,"Norwich City","Premier League","Billy Gilmour","SCO","MF","20",2001,20.6,41,21,16,21,4,14,52,26.9,38,21,4,17,17,58,29,0,"https://fbref.com/en/players/df10e27c/Billy-Gilmour"
2022,"Norwich City","Premier League","Angus Gunn","ENG","GK","25",1996,9,0,0,0,0,0,0,0,NA,0,0,0,0,0,0,11,0,"https://fbref.com/en/players/e082af5b/Angus-Gunn"
2022,"Norwich City","Premier League","Grant Hanley","SCO","DF","29",1991,32.2,44,25,28,14,2,18,35,51.4,17,56,45,11,56,100,176,2,"https://fbref.com/en/players/e9254eec/Grant-Hanley"
2022,"Norwich City","Premier League","Adam Idah","IRL","FW,MF","20",2001,6.9,9,6,2,5,2,2,3,66.7,1,4,2,2,3,12,7,0,"https://fbref.com/en/players/291e3ec3/Adam-Idah"
2022,"Norwich City","Premier League","Ozan Kabak","TUR","DF","21",2000,10.2,10,5,4,6,0,5,9,55.6,4,19,11,8,16,26,26,0,"https://fbref.com/en/players/2d61d13a/Ozan-Kabak"
2022,"Norwich City","Premier League","Tim Krul","NED","GK","33",1988,29,1,1,1,0,0,1,4,25,3,0,0,0,0,1,10,4,"https://fbref.com/en/players/f23f9d20/Tim-Krul"
2022,"Norwich City","Premier League","Pierre Lees-Melou","FRA","MF","28",1993,25.2,58,36,23,29,6,25,92,27.2,67,37,11,26,25,83,23,0,"https://fbref.com/en/players/f5044e54/Pierre-Lees-Melou"
2022,"Norwich City","Premier League","Kenny McLean","SCO","MF","29",1992,30.1,42,22,18,20,4,17,59,28.8,42,29,7,22,34,76,54,0,"https://fbref.com/en/players/471f16b3/Kenny-McLean"
2022,"Norwich City","Premier League","Bali Mumba","ENG","DF","19",2001,0.5,1,1,1,0,0,0,0,NA,0,0,0,0,0,1,5,0,"https://fbref.com/en/players/2d760d7b/Bali-Mumba"
2022,"Norwich City","Premier League","Mathias Normann","NOR","MF","25",1996,18.3,34,21,19,14,1,17,46,37,29,17,8,9,19,53,43,1,"https://fbref.com/en/players/8996350d/Mathias-Normann"
2022,"Norwich City","Premier League","Andrew Omobamidele","IRL","DF","19",2002,4.2,8,6,5,3,0,5,11,45.5,6,8,8,0,5,13,13,0,"https://fbref.com/en/players/c393a6c4/Andrew-Omobamidele"
2022,"Norwich City","Premier League","Teemu Pukki","FIN","FW","31",1990,36.1,23,11,2,14,7,6,29,20.7,23,21,1,20,4,27,3,0,"https://fbref.com/en/players/0745b37d/Teemu-Pukki"
2022,"Norwich City","Premier League","Przemysław Płacheta","POL","FW,MF","23",1998,5.6,4,3,3,1,0,2,7,28.6,5,3,1,2,2,6,5,1,"https://fbref.com/en/players/3c33f9d9/Przemyslaw-Placheta"
2022,"Norwich City","Premier League","Milot Rashica","KVX","FW,MF","25",1996,24.8,31,19,12,12,7,11,30,36.7,19,22,3,19,15,46,23,0,"https://fbref.com/en/players/6c6a3300/Milot-Rashica"
2022,"Norwich City","Premier League","Jon Rowe","ENG","FW,MF","18",2003,2.5,3,2,2,1,0,2,3,66.7,1,7,0,7,3,6,1,0,"https://fbref.com/en/players/8c12f884/Jon-Rowe"
2022,"Norwich City","Premier League","Lukas Rupp","GER","MF","30",1991,8.5,9,4,5,3,1,4,15,26.7,11,11,1,10,9,18,7,0,"https://fbref.com/en/players/3faa1780/Lukas-Rupp"
2022,"Norwich City","Premier League","Josh Sargent","USA","FW,MF","21",2000,17.5,26,14,15,7,4,14,39,35.9,25,29,2,27,11,37,18,2,"https://fbref.com/en/players/a8d4428b/Josh-Sargent"
2022,"Norwich City","Premier League","Tony Springett","ENG","MF,FW","18",2002,1.6,2,1,1,1,0,1,4,25,3,0,0,0,0,2,2,0,"https://fbref.com/en/players/35be8087/Tony-Springett"
2022,"Norwich City","Premier League","Jakob Sørensen","DEN","MF,DF","23",1998,6.7,22,11,6,14,2,10,20,50,10,7,3,4,10,32,19,0,"https://fbref.com/en/players/953c30b0/Jakob-Sorensen"
2022,"Norwich City","Premier League","Christos Tzolis","GRE","FW,MF","19",2002,3.7,5,3,3,1,1,2,9,22.2,7,3,0,3,1,6,1,0,"https://fbref.com/en/players/9f333379/Christos-Tzolis"
2022,"Norwich City","Premier League","Brandon Williams","ENG","DF","20",2000,23.6,55,37,35,18,2,36,64,56.3,28,26,6,20,44,99,50,0,"https://fbref.com/en/players/5e74d6c8/Brandon-Williams"
2022,"Norwich City","Premier League","Christoph Zimmermann","GER","DF","28",1993,1.7,6,3,5,1,0,3,4,75,1,0,0,0,1,7,4,0,"https://fbref.com/en/players/2d5f03bf/Christoph-Zimmermann"
2022,"Osasuna","La Liga","José Ángel","ESP","DF","31",1989,12,20,13,9,9,2,9,14,64.3,5,6,1,5,10,30,21,0,"https://fbref.com/en/players/3024e383/Jose-Angel"
2022,"Osasuna","La Liga","Jesús Areso","ESP","DF","22",1999,2.1,3,3,2,1,0,0,2,0,2,0,0,0,0,3,2,1,"https://fbref.com/en/players/94e01ec6/Jesus-Areso"
2022,"Osasuna","La Liga","Ezequiel Ávila","ARG","FW,MF","27",1994,20.8,17,7,6,7,4,7,21,33.3,14,14,2,12,13,30,15,1,"https://fbref.com/en/players/253a06b9/Ezequiel-Avila"
2022,"Osasuna","La Liga","Barbero","ESP","FW,MF","22",1998,0.2,0,0,0,0,0,0,0,NA,0,0,0,0,0,0,1,0,"https://fbref.com/en/players/981c1863/Barbero"
2022,"Osasuna","La Liga","Kike Barja","ESP","MF,FW","24",1997,9.6,15,11,4,7,4,8,22,36.4,14,10,1,9,9,24,4,0,"https://fbref.com/en/players/aad53e64/Kike-Barja"
2022,"Osasuna","La Liga","Iker Benito","ESP","FW,MF","18",2002,1.3,2,1,1,0,1,0,1,0,1,2,0,2,0,2,2,0,"https://fbref.com/en/players/50cbc806/Iker-Benito"
2022,"Osasuna","La Liga","Darko Brašanac","SRB","MF","29",1992,26.7,35,22,19,14,2,14,40,35,26,25,8,17,25,60,15,0,"https://fbref.com/en/players/4accb7e0/Darko-Brasanac"
2022,"Osasuna","La Liga","Ante Budimir","CRO","FW","30",1991,19.3,24,10,3,15,6,6,19,31.6,13,22,4,18,3,27,16,0,"https://fbref.com/en/players/8f3565b3/Ante-Budimir"
2022,"Osasuna","La Liga","Juan Cruz Armada","ESP","DF","29",1992,21.5,28,21,15,12,1,8,16,50,8,15,12,3,16,44,58,1,"https://fbref.com/en/players/a56da3ba/Juan-Cruz-Armada"
2022,"Osasuna","La Liga","Unai Dufur","ESP","DF","22",1999,1,0,0,0,0,0,0,0,NA,0,1,0,1,4,4,4,0,"https://fbref.com/en/players/c261b5dd/Unai-Dufur"
2022,"Osasuna","La Liga","David García","ESP","DF","27",1994,34.5,28,14,15,11,2,12,22,54.5,10,27,21,6,52,80,168,0,"https://fbref.com/en/players/3e42f707/David-Garcia"
2022,"Osasuna","La Liga","Rubén García","ESP","MF,FW","28",1993,26.4,43,26,12,23,8,16,49,32.7,33,31,4,27,24,67,16,0,"https://fbref.com/en/players/5c96b017/Ruben-Garcia"
2022,"Osasuna","La Liga","Unai García","ESP","DF","29",1992,15.6,21,12,14,6,1,14,17,82.4,3,19,11,8,22,43,78,0,"https://fbref.com/en/players/4a633cfe/Unai-Garcia"
2022,"Osasuna","La Liga","Jaume Grau","ESP","MF","24",1997,0,1,1,1,0,0,0,1,0,1,0,0,0,0,1,0,0,"https://fbref.com/en/players/fc3d2006/Jaume-Grau"
2022,"Osasuna","La Liga","Aridane Hernández","EQG","DF","32",1989,12.9,12,9,10,2,0,3,13,23.1,10,11,9,2,20,32,71,0,"https://fbref.com/en/players/132ac341/Aridane-Hernandez"
2022,"Osasuna","La Liga","Sergio Herrera","ESP","GK","28",1993,36,3,2,3,0,0,3,6,50,3,1,0,1,1,4,18,0,"https://fbref.com/en/players/a4995f48/Sergio-Herrera"
2022,"Osasuna","La Liga","Robert Ibáñez","ESP","MF,FW","28",1993,1,3,3,2,0,1,1,2,50,1,1,0,1,1,4,1,0,"https://fbref.com/en/players/c7429db3/Robert-Ibanez"
2022,"Osasuna","La Liga","Kike","ESP","FW","31",1989,20.7,11,7,3,4,4,3,23,13,20,10,1,9,3,14,12,0,"https://fbref.com/en/players/e897d8ba/Kike"
2022,"Osasuna","La Liga","Javi Martínez","ESP","MF,FW","21",1999,9.8,21,14,8,11,2,10,29,34.5,19,6,0,6,9,30,10,0,"https://fbref.com/en/players/3672b352/Javi-Martinez"
2022,"Osasuna","La Liga","Jon Moncayola","ESP","MF","23",1998,32.4,40,20,18,18,4,17,44,38.6,27,26,9,17,20,60,43,0,"https://fbref.com/en/players/9939e168/Jon-Moncayola"
2022,"Osasuna","La Liga","Javier Ontiveros","ESP","FW,MF","23",1997,0.4,0,0,0,0,0,0,2,0,2,0,0,0,1,1,0,1,"https://fbref.com/en/players/a83d8b0c/Javier-Ontiveros"
2022,"Osasuna","La Liga","Iñigo Pérez","ESP","MF","33",1988,3.8,3,2,2,1,0,2,4,50,2,1,0,1,0,3,3,0,"https://fbref.com/en/players/bc61cc65/Inigo-Perez"
2022,"Osasuna","La Liga","Juan Pérez","ESP","GK","25",1996,2,0,0,0,0,0,0,1,0,1,0,0,0,0,0,1,1,"https://fbref.com/en/players/8f29e08b/Juan-Perez"
2022,"Osasuna","La Liga","Jonás Ramalho","ESP","DF","28",1993,2.7,4,2,2,2,0,2,3,66.7,1,4,1,3,3,7,9,0,"https://fbref.com/en/players/be3a0121/Jonas-Ramalho"
2022,"Osasuna","La Liga","Manuel Sánchez","ESP","DF","20",2000,25.1,72,34,41,22,9,43,79,54.4,36,28,3,25,18,90,43,0,"https://fbref.com/en/players/ffacd3d5/Manuel-Sanchez"
2022,"Osasuna","La Liga","Oier Sanjurjo","ESP","MF","35",1986,8.4,10,6,3,7,0,2,19,10.5,17,8,3,5,1,11,9,0,"https://fbref.com/en/players/466824fb/Oier-Sanjurjo"
2022,"Osasuna","La Liga","Roberto Torres","ESP","MF,FW","32",1989,9,7,4,3,1,3,3,15,20,12,8,0,8,8,15,4,0,"https://fbref.com/en/players/d733aa38/Roberto-Torres"
2022,"Osasuna","La Liga","Lucas Torró","ESP","MF","27",1994,30.3,71,40,25,38,8,29,57,50.9,28,32,11,21,47,118,55,0,"https://fbref.com/en/players/0e4fef6e/Lucas-Torro"
2022,"Osasuna","La Liga","Nacho Vidal","ESP","DF","26",1995,32.2,83,47,49,25,9,39,77,50.6,38,32,14,18,58,141,79,0,"https://fbref.com/en/players/3a9c4b7b/Nacho-Vidal"
2022,"Paris S-G","Ligue 1","Juan Bernat","ESP","DF,MF","28",1993,10.6,24,14,10,10,4,13,18,72.2,5,8,0,8,8,32,16,0,"https://fbref.com/en/players/433dc9a2/Juan-Bernat"
2022,"Paris S-G","Ligue 1","Nathan Bitu Mazala","FRA","DF","18",2002,0.1,0,0,0,0,0,0,0,NA,0,1,0,1,0,0,0,0,"https://fbref.com/en/players/0f697e02/Nathan-Bitu-Mazala"
2022,"Paris S-G","Ligue 1","El Chadaille Bitshiabu","FRA","DF","16",2005,0.1,0,0,0,0,0,0,0,NA,0,0,0,0,0,0,2,0,"https://fbref.com/en/players/2180c761/El-Chadaille-Bitshiabu"
2022,"Paris S-G","Ligue 1","Colin Dagba","FRA","DF","22",1998,1.8,4,2,2,2,0,3,6,50,3,4,2,2,2,6,1,0,"https://fbref.com/en/players/29c02c9f/Colin-Dagba"
2022,"Paris S-G","Ligue 1","Ángel Di María","ARG","FW","33",1988,18.3,29,18,6,13,10,14,37,37.8,23,17,0,17,6,35,3,0,"https://fbref.com/en/players/19cda00b/Angel-Di-Maria"
2022,"Paris S-G","Ligue 1","Abdou Diallo","SEN","DF","25",1996,9.7,22,14,10,9,3,8,14,57.1,6,6,2,4,10,32,19,1,"https://fbref.com/en/players/fc62f087/Abdou-Diallo"
2022,"Paris S-G","Ligue 1","Junior Dina Ebimbe","FRA","MF","20",2000,3.5,9,4,3,4,2,2,3,66.7,1,5,3,2,2,11,1,0,"https://fbref.com/en/players/95bb6ddc/Junior-Dina-Ebimbe"
2022,"Paris S-G","Ligue 1","Gianluigi Donnarumma","ITA","GK","22",1999,17,0,0,0,0,0,0,0,NA,0,0,0,0,0,0,9,2,"https://fbref.com/en/players/08f5afaa/Gianluigi-Donnarumma"
2022,"Paris S-G","Ligue 1","Julian Draxler","GER","FW,MF","27",1993,6.1,3,2,0,3,0,0,4,0,4,3,0,3,5,8,3,0,"https://fbref.com/en/players/1a992676/Julian-Draxler"
2022,"Paris S-G","Ligue 1","Idrissa Gana Gueye","SEN","MF","31",1989,18.2,60,36,24,24,12,18,44,40.9,26,23,4,19,24,84,13,0,"https://fbref.com/en/players/72c812f3/Idrissa-Gana-Gueye"
2022,"Paris S-G","Ligue 1","Djeidi Gassama","FRA","FW","17",2003,0,0,0,0,0,0,0,0,NA,0,1,1,0,0,0,0,0,"https://fbref.com/en/players/bbdb2789/Djeidi-Gassama"
2022,"Paris S-G","Ligue 1","Ismaël Gharbi","ESP","FW","17",2004,0,0,0,0,0,0,0,0,NA,0,0,0,0,0,0,0,0,"https://fbref.com/en/players/5b3cfa12/Ismael-Gharbi"
2022,"Paris S-G","Ligue 1","Achraf Hakimi","MAR","DF","22",1998,27.5,74,51,38,27,9,40,72,55.6,32,26,5,21,28,102,23,2,"https://fbref.com/en/players/e42d61c7/Achraf-Hakimi"
2022,"Paris S-G","Ligue 1","Ander Herrera","ESP","MF","31",1989,12.1,29,17,7,16,6,14,39,35.9,25,22,8,14,14,43,8,0,"https://fbref.com/en/players/436a9dd0/Ander-Herrera"
2022,"Paris S-G","Ligue 1","Mauro Icardi","ARG","FW","28",1993,11.4,5,3,1,3,1,3,7,42.9,4,3,0,3,5,10,12,0,"https://fbref.com/en/players/43b78598/Mauro-Icardi"
2022,"Paris S-G","Ligue 1","Arnaud Kalimuendo","FRA","FW","19",2002,0.1,0,0,0,0,0,0,0,NA,0,0,0,0,0,0,0,0,"https://fbref.com/en/players/bf4c41f9/Arnaud-Kalimuendo"
2022,"Paris S-G","Ligue 1","Thilo Kehrer","GER","DF","24",1996,16.8,21,14,9,11,1,9,21,42.9,12,19,11,8,24,45,29,0,"https://fbref.com/en/players/51dbeea9/Thilo-Kehrer"
2022,"Paris S-G","Ligue 1","Presnel Kimpembe","FRA","DF","25",1995,28.6,34,19,18,15,1,14,23,60.9,9,20,14,6,38,72,73,1,"https://fbref.com/en/players/aef6e670/Presnel-Kimpembe"
2022,"Paris S-G","Ligue 1","Alexandre Letellier","FRA","GK","30",1990,0.1,0,0,0,0,0,0,0,NA,0,0,0,0,0,0,0,0,"https://fbref.com/en/players/96fcd380/Alexandre-Letellier"
2022,"Paris S-G","Ligue 1","Marquinhos","BRA","DF","27",1994,31.8,37,14,25,11,1,20,35,57.1,15,35,19,16,16,53,102,0,"https://fbref.com/en/players/d5f2f82b/Marquinhos"
2022,"Paris S-G","Ligue 1","Kylian Mbappé","FRA","FW","22",1998,33.6,11,8,1,4,6,7,13,53.8,6,6,0,6,5,16,13,0,"https://fbref.com/en/players/42fd9c7f/Kylian-Mbappe"
2022,"Paris S-G","Ligue 1","Nuno Mendes","POR","DF","19",2002,18.4,48,29,23,18,7,25,47,53.2,22,27,5,22,21,69,17,1,"https://fbref.com/en/players/f20e4cc9/Nuno-Mendes"
2022,"Paris S-G","Ligue 1","Lionel Messi","ARG","FW,MF","34",1987,23.9,10,3,1,5,4,3,13,23.1,10,5,0,5,4,14,0,0,"https://fbref.com/en/players/d70ce98e/Lionel-Messi"
2022,"Paris S-G","Ligue 1","Edouard Michut","FRA","MF","18",2003,0.8,0,0,0,0,0,0,2,0,2,2,0,2,1,1,2,0,"https://fbref.com/en/players/fe6c1add/Edouard-Michut"
2022,"Paris S-G","Ligue 1","Keylor Navas","CRC","GK","34",1986,20.6,0,0,0,0,0,0,0,NA,0,0,0,0,0,0,5,1,"https://fbref.com/en/players/ecada4fc/Keylor-Navas"
2022,"Paris S-G","Ligue 1","Neymar","BRA","FW,MF","29",1992,20.6,29,19,5,12,12,12,36,33.3,24,9,1,8,4,33,2,1,"https://fbref.com/en/players/69384e5d/Neymar"
2022,"Paris S-G","Ligue 1","Leandro Paredes","ARG","MF","27",1994,9.3,23,13,9,11,3,12,24,50,12,10,6,4,10,33,5,2,"https://fbref.com/en/players/dff153a4/Leandro-Paredes"
2022,"Paris S-G","Ligue 1","Danilo Pereira","POR","MF","29",1991,22.6,33,17,10,20,3,14,28,50,14,19,10,9,37,70,29,1,"https://fbref.com/en/players/8fd9996f/Danilo-Pereira"
2022,"Paris S-G","Ligue 1","Rafinha","BRA","FW,MF","28",1993,2.4,14,8,3,9,2,7,11,63.6,4,3,0,3,4,18,0,0,"https://fbref.com/en/players/0c2ac3cb/Rafinha"
2022,"Paris S-G","Ligue 1","Sergio Ramos","ESP","DF","35",1986,8.9,12,5,6,6,0,8,15,53.3,7,4,2,2,8,20,27,0,"https://fbref.com/en/players/08511d65/Sergio-Ramos"
2022,"Paris S-G","Ligue 1","Sergio Rico","ESP","GK","27",1993,0.3,0,0,0,0,0,0,0,NA,0,0,0,0,0,0,1,0,"https://fbref.com/en/players/5f0241b2/Sergio-Rico"
2022,"Paris S-G","Ligue 1","Pablo Sarabia","ESP","FW","29",1992,0.2,0,0,0,0,0,0,1,0,1,0,0,0,0,0,0,0,"https://fbref.com/en/players/9744ff80/Pablo-Sarabia"
2022,"Paris S-G","Ligue 1","Xavi Simons","NED","MF,FW","18",2003,1.5,1,1,0,1,0,1,2,50,1,3,0,3,0,1,0,0,"https://fbref.com/en/players/da4d670f/Xavi-Simons"
2022,"Paris S-G","Ligue 1","Marco Verratti","ITA","MF","28",1992,21.5,60,40,16,30,14,32,64,50,32,36,10,26,18,78,14,2,"https://fbref.com/en/players/1467af0d/Marco-Verratti"
2022,"Paris S-G","Ligue 1","Georginio Wijnaldum","NED","MF","30",1990,18.4,15,9,2,12,1,11,19,57.9,8,13,3,10,9,24,7,0,"https://fbref.com/en/players/eb58eef0/Georginio-Wijnaldum"
2022,"Paris S-G","Ligue 1","Sekou Yansané","GUI","FW","18",2003,0.2,0,0,0,0,0,0,1,0,1,0,0,0,0,0,1,0,"https://fbref.com/en/players/bce37ac0/Sekou-Yansane"
2022,"RB Leipzig","Bundesliga","Tyler Adams","USA","MF","22",1999,15,23,7,5,16,2,7,25,28,18,24,1,23,16,39,19,2,"https://fbref.com/en/players/2b09d998/Tyler-Adams"
2022,"RB Leipzig","Bundesliga","Angeliño","ESP","DF","24",1997,25.5,28,21,14,13,1,14,30,46.7,16,24,3,21,29,57,40,0,"https://fbref.com/en/players/30941e96/Angelino"
2022,"RB Leipzig","Bundesliga","Solomon Bonnah","NED","DF","17",2003,0.1,0,0,0,0,0,0,0,NA,0,1,0,1,1,1,0,0,"https://fbref.com/en/players/dd7b6eb8/Solomon-Bonnah"
2022,"RB Leipzig","Bundesliga","Brian Brobbey","NED","FW,MF","19",2002,1.5,1,0,0,1,0,1,1,100,0,1,0,1,0,1,0,0,"https://fbref.com/en/players/4c184730/Brian-Brobbey"
2022,"RB Leipzig","Bundesliga","Emil Forsberg","SWE","MF","29",1991,19,21,12,2,11,8,7,22,31.8,15,18,0,18,2,23,2,1,"https://fbref.com/en/players/9a2e0ccc/Emil-Forsberg"
2022,"RB Leipzig","Bundesliga","Péter Gulácsi","HUN","GK","31",1990,33,0,0,0,0,0,0,0,NA,0,0,0,0,1,1,15,1,"https://fbref.com/en/players/bcb2ccd8/Peter-Gulacsi"
2022,"RB Leipzig","Bundesliga","Joško Gvardiol","CRO","DF","19",2002,26.8,47,31,28,17,2,22,39,56.4,17,30,11,19,51,98,62,2,"https://fbref.com/en/players/5ad50391/Josko-Gvardiol"
2022,"RB Leipzig","Bundesliga","Amadou Haidara","MLI","MF","23",1998,14.7,30,14,11,19,0,17,37,45.9,20,22,6,16,16,46,8,1,"https://fbref.com/en/players/92432bc6/Amadou-Haidara"
2022,"RB Leipzig","Bundesliga","Marcel Halstenberg","GER","DF","29",1991,5.6,10,7,6,4,0,6,11,54.5,5,6,0,6,7,17,11,0,"https://fbref.com/en/players/8ff2354e/Marcel-Halstenberg"
2022,"RB Leipzig","Bundesliga","Hwang Hee-chan","KOR","FW","25",1996,0.5,0,0,0,0,0,0,0,NA,0,0,0,0,1,1,0,0,"https://fbref.com/en/players/169fd162/Hwang-Hee-chan"
2022,"RB Leipzig","Bundesliga","Benjamin Henrichs","GER","DF","24",1997,12.7,30,21,18,6,6,12,22,54.5,10,16,1,15,19,49,14,0,"https://fbref.com/en/players/0a89e877/Benjamin-Henrichs"
2022,"RB Leipzig","Bundesliga","Kevin Kampl","SVN","MF","30",1990,21.1,41,19,16,20,5,10,42,23.8,32,24,5,19,24,65,17,0,"https://fbref.com/en/players/b825a650/Kevin-Kampl"
2022,"RB Leipzig","Bundesliga","Lukas Klostermann","GER","DF","25",1996,18.3,29,16,11,15,3,13,19,68.4,6,16,3,13,26,55,58,0,"https://fbref.com/en/players/ca8033cb/Lukas-Klostermann"
2022,"RB Leipzig","Bundesliga","Konrad Laimer","AUT","MF","24",1997,13.8,38,24,11,22,5,24,53,45.3,29,29,3,26,4,42,9,0,"https://fbref.com/en/players/c1b7847c/Konrad-Laimer"
2022,"RB Leipzig","Bundesliga","Josep Martinez","ESP","GK","23",1998,1,0,0,0,0,0,0,0,NA,0,0,0,0,0,0,0,0,"https://fbref.com/en/players/11d8aff0/Josep-Martinez"
2022,"RB Leipzig","Bundesliga","Ilaix Moriba","GUI","MF","18",2003,0.4,0,0,0,0,0,0,4,0,4,2,0,2,1,1,0,0,"https://fbref.com/en/players/f4c69aa6/Ilaix-Moriba"
2022,"RB Leipzig","Bundesliga","Nordi Mukiele","FRA","DF,FW","23",1997,20.5,35,22,23,9,3,14,27,51.9,13,31,5,26,31,66,44,2,"https://fbref.com/en/players/ac73ec79/Nordi-Mukiele"
2022,"RB Leipzig","Bundesliga","Christopher Nkunku","FRA","FW,MF","23",1997,30.3,23,10,10,11,2,9,35,25.7,26,23,2,21,15,38,15,0,"https://fbref.com/en/players/7c56da38/Christopher-Nkunku"
2022,"RB Leipzig","Bundesliga","Hugo Novoa","ESP","MF,FW","18",2003,1.5,4,4,2,0,2,2,7,28.6,5,2,0,2,1,5,0,0,"https://fbref.com/en/players/5458f670/Hugo-Novoa"
2022,"RB Leipzig","Bundesliga","Dani Olmo","ESP","MF,FW","23",1998,8.3,14,6,5,7,2,5,18,27.8,13,5,1,4,4,18,1,0,"https://fbref.com/en/players/ae44e8e2/Dani-Olmo"
2022,"RB Leipzig","Bundesliga","Willi Orban","HUN","DF","28",1992,29.4,32,22,20,11,1,13,25,52,12,40,24,16,44,76,123,2,"https://fbref.com/en/players/20030c06/Willi-Orban"
2022,"RB Leipzig","Bundesliga","Yussuf Poulsen","DEN","FW,MF","27",1994,12,13,4,3,6,4,3,13,23.1,10,13,0,13,3,16,9,0,"https://fbref.com/en/players/d2416c2e/Yussuf-Poulsen"
2022,"RB Leipzig","Bundesliga","Sidney Raebiger","GER","MF","16",2005,0,0,0,0,0,0,0,0,NA,0,0,0,0,0,0,0,0,"https://fbref.com/en/players/a8090a41/Sidney-Raebiger"
2022,"RB Leipzig","Bundesliga","Marcel Sabitzer","AUT","MF,FW","27",1994,0.5,2,1,1,1,0,1,1,100,0,0,0,0,1,3,0,0,"https://fbref.com/en/players/e280527c/Marcel-Sabitzer"
2022,"RB Leipzig","Bundesliga","André Silva","POR","FW","25",1995,23.1,13,9,2,3,8,4,13,30.8,9,20,2,18,2,15,15,0,"https://fbref.com/en/players/3effaa34/Andre-Silva"
2022,"RB Leipzig","Bundesliga","Mohamed Simakan","FRA","DF","21",2000,22.3,48,27,25,21,2,27,41,65.9,14,22,11,11,40,88,46,1,"https://fbref.com/en/players/fcb27134/Mohamed-Simakan"
2022,"RB Leipzig","Bundesliga","Dominik Szoboszlai","HUN","MF,FW","20",2000,17.1,17,12,5,9,3,8,27,29.6,19,30,3,27,10,27,15,0,"https://fbref.com/en/players/934e1968/Dominik-Szoboszlai"
2022,"RB Leipzig","Bundesliga","Philipp Tschauner","GER","GK","35",1985,0,0,0,0,0,0,0,0,NA,0,0,0,0,0,0,0,0,"https://fbref.com/en/players/73e2f6eb/Philipp-Tschauner"
2022,"RB Leipzig","Bundesliga","Joscha Wosz","GER","DF","19",2002,0.1,0,0,0,0,0,0,0,NA,0,0,0,0,0,0,0,0,"https://fbref.com/en/players/80c9e555/Joscha-Wosz"
2022,"Rayo Vallecano","La Liga","Álvaro Aguirre","ESP","FW","21",2000,0.1,0,0,0,0,0,0,0,NA,0,0,0,0,0,0,0,0,"https://fbref.com/en/players/93b054dc/Alvaro-Aguirre"
2022,"Rayo Vallecano","La Liga","Alejandro Asensio","ESP","FW","20",2000,0.1,0,0,0,0,0,0,0,NA,0,0,0,0,0,0,0,0,"https://fbref.com/en/players/b4c23f36/Alejandro-Asensio"
2022,"Rayo Vallecano","La Liga","Iván Balliu","ALB","DF","29",1992,35,45,22,25,11,9,19,31,61.3,12,24,5,19,39,84,64,0,"https://fbref.com/en/players/cee88597/Ivan-Balliu"
2022,"Rayo Vallecano","La Liga","Bebé","CPV","FW","31",1990,9.6,6,5,1,3,2,4,16,25,12,18,0,18,3,9,6,0,"https://fbref.com/en/players/d8712bf9/Bebe"
2022,"Rayo Vallecano","La Liga","Catena","ESP","DF","26",1994,36,39,23,24,15,0,25,42,59.5,17,26,19,7,30,69,168,3,"https://fbref.com/en/players/274ab13c/Catena"
2022,"Rayo Vallecano","La Liga","Pathé Ciss","SEN","MF","27",1994,12.2,31,15,20,8,3,12,26,46.2,14,16,6,10,30,61,27,0,"https://fbref.com/en/players/9a0408b6/Pathe-Ciss"
2022,"Rayo Vallecano","La Liga","Santi Comesaña","ESP","MF","24",1996,29.8,87,56,45,33,9,40,104,38.5,64,46,6,40,33,120,30,0,"https://fbref.com/en/players/5ae499d0/Santi-Comesana"
2022,"Rayo Vallecano","La Liga","Stole Dimitrievski","MKD","GK","27",1993,30.8,0,0,0,0,0,0,0,NA,0,0,0,0,1,1,14,3,"https://fbref.com/en/players/fc70e345/Stole-Dimitrievski"
2022,"Rayo Vallecano","La Liga","Radamel Falcao","COL","FW","35",1986,9.3,2,1,0,1,1,1,4,25,3,4,1,3,2,4,11,0,"https://fbref.com/en/players/66116290/Radamel-Falcao"
2022,"Rayo Vallecano","La Liga","Álvaro García","ESP","FW,MF","28",1992,33.3,42,23,15,18,9,8,35,22.9,27,27,3,24,42,84,24,0,"https://fbref.com/en/players/90bbd822/Alvaro-Garcia"
2022,"Rayo Vallecano","La Liga","Francisco Garcia","ESP","DF","21",1999,33.6,60,35,44,12,4,39,73,53.4,34,34,8,26,45,105,53,0,"https://fbref.com/en/players/7226539b/Francisco-Garcia"
2022,"Rayo Vallecano","La Liga","Sergi Guardiola","ESP","FW","30",1991,19,10,9,3,5,2,1,21,4.8,20,14,2,12,4,14,17,0,"https://fbref.com/en/players/32974271/Sergi-Guardiola"
2022,"Rayo Vallecano","La Liga","Mario Hernández","ESP","DF,FW","22",1999,4.4,10,4,7,3,0,5,9,55.6,4,1,0,1,4,14,7,0,"https://fbref.com/en/players/90162357/Mario-Hernandez"
2022,"Rayo Vallecano","La Liga","Unai López","ESP","MF","25",1995,12.9,19,9,6,10,3,10,33,30.3,23,7,0,7,10,29,8,1,"https://fbref.com/en/players/88050721/Unai-Lopez"
2022,"Rayo Vallecano","La Liga","Nikola Maraš","SRB","DF","25",1995,11.6,13,9,12,1,0,9,15,60,6,17,13,4,15,28,51,0,"https://fbref.com/en/players/b9d0446f/Nikola-Maras"
2022,"Rayo Vallecano","La Liga","Andrés Martín","ESP","FW,MF","22",1999,2.1,0,0,0,0,0,0,1,0,1,1,0,1,0,0,0,0,"https://fbref.com/en/players/2ae30661/Andres-Martin"
2022,"Rayo Vallecano","La Liga","Martín Merquelanz","ESP","FW,MF","26",1995,1.9,2,1,2,0,0,2,6,33.3,4,2,0,2,0,2,1,0,"https://fbref.com/en/players/ddd5348b/Martin-Merquelanz"
2022,"Rayo Vallecano","La Liga","Randy Ntekja","FRA","FW,MF","23",1997,16.2,24,13,9,11,4,8,19,42.1,11,21,1,20,8,32,12,0,"https://fbref.com/en/players/a6103274/Randy-Ntekja"
2022,"Rayo Vallecano","La Liga","Isaac Palazón Camacho","ESP","FW,MF","26",1994,25.4,42,28,20,19,3,18,59,30.5,41,31,3,28,13,55,22,0,"https://fbref.com/en/players/49dbab27/Isaac-Palazon-Camacho"
2022,"Rayo Vallecano","La Liga","José Pozo","ESP","MF,DF","25",1996,0.8,2,2,0,2,0,2,3,66.7,1,1,0,1,0,2,1,0,"https://fbref.com/en/players/fc8b614b/Jose-Pozo"
2022,"Rayo Vallecano","La Liga","Yacine Qasmi","MAR","FW","30",1991,0,0,0,0,0,0,0,0,NA,0,0,0,0,0,0,0,0,"https://fbref.com/en/players/3b3cbebb/Yacine-Qasmi"
2022,"Rayo Vallecano","La Liga","Kévin Rodrigues","POR","DF,FW","27",1994,4.8,15,11,8,7,0,6,10,60,4,10,1,9,7,22,6,0,"https://fbref.com/en/players/f1bed920/Kevin-Rodrigues"
2022,"Rayo Vallecano","La Liga","Esteban Saveljich","MNE","DF","30",1991,18.9,18,11,11,7,0,9,15,60,6,20,12,8,16,34,69,0,"https://fbref.com/en/players/79f2a5f5/Esteban-Saveljich"
2022,"Rayo Vallecano","La Liga","Mario Suárez","ESP","DF","34",1987,7.9,9,4,7,2,0,3,9,33.3,6,6,4,2,7,16,37,1,"https://fbref.com/en/players/7106f0a0/Mario-Suarez"
2022,"Rayo Vallecano","La Liga","Mamadou Sylla","SEN","FW","27",1994,2.8,1,1,1,0,0,0,1,0,1,2,0,2,4,5,3,0,"https://fbref.com/en/players/e5ec95f8/Mamadou-Sylla"
2022,"Rayo Vallecano","La Liga","Óscar Trejo","ARG","MF","33",1988,22.3,42,24,14,18,10,15,50,30,35,26,1,25,13,55,11,0,"https://fbref.com/en/players/fc647b34/Oscar-Trejo"
2022,"Rayo Vallecano","La Liga","Óscar Valentín","ESP","MF","26",1994,28.5,102,53,46,51,5,44,105,41.9,61,56,10,46,39,141,43,0,"https://fbref.com/en/players/592f3158/Oscar-Valentin"
2022,"Rayo Vallecano","La Liga","Luca Zidane","FRA","GK","23",1998,7.2,0,0,0,0,0,0,1,0,1,0,0,0,0,0,1,1,"https://fbref.com/en/players/c818c4d9/Luca-Zidane"
2022,"Real Madrid","La Liga","David Alaba","AUT","DF","29",1992,29.4,23,13,15,6,2,9,19,47.4,10,26,15,11,22,45,70,1,"https://fbref.com/en/players/05439de2/David-Alaba"
2022,"Real Madrid","La Liga","Marco Asensio","ESP","FW,MF","25",1996,19.2,12,8,6,4,2,4,18,22.2,14,8,1,7,12,24,6,1,"https://fbref.com/en/players/45af8a54/Marco-Asensio"
2022,"Real Madrid","La Liga","Gareth Bale","WAL","FW","32",1989,3.1,2,1,1,0,1,1,4,25,3,2,0,2,2,4,1,0,"https://fbref.com/en/players/a58bb1e1/Gareth-Bale"
2022,"Real Madrid","La Liga","Karim Benzema","FRA","FW","33",1987,28.8,11,9,5,3,3,2,9,22.2,7,10,0,10,4,15,13,0,"https://fbref.com/en/players/70d74ece/Karim-Benzema"
2022,"Real Madrid","La Liga","Blanco","ESP","MF","21",2000,0.3,2,0,1,1,0,0,0,NA,0,1,1,0,1,3,0,0,"https://fbref.com/en/players/506daeac/Blanco"
2022,"Real Madrid","La Liga","Eduardo Camavinga","FRA","MF","18",2002,13.7,52,35,22,20,10,20,38,52.6,18,20,2,18,17,69,14,1,"https://fbref.com/en/players/7b9c2d84/Eduardo-Camavinga"
2022,"Real Madrid","La Liga","Dani Carvajal","ESP","DF","29",1992,17.2,43,28,21,15,7,15,26,57.7,11,22,8,14,20,63,38,2,"https://fbref.com/en/players/4958bfb2/Dani-Carvajal"
2022,"Real Madrid","La Liga","Casemiro","BRA","MF","29",1992,28.5,79,51,45,30,4,30,67,44.8,37,65,19,46,38,117,65,3,"https://fbref.com/en/players/4d224fe8/Casemiro"
2022,"Real Madrid","La Liga","Dani Ceballos","ESP","MF","24",1996,3.1,7,5,4,3,0,1,5,20,4,8,2,6,4,11,2,0,"https://fbref.com/en/players/c0617e2b/Dani-Ceballos"
2022,"Real Madrid","La Liga","Thibaut Courtois","BEL","GK","29",1992,36,1,0,1,0,0,1,2,50,1,0,0,0,0,1,9,1,"https://fbref.com/en/players/1840e36d/Thibaut-Courtois"
2022,"Real Madrid","La Liga","Mario Gila","ESP","DF","20",2000,0.3,1,0,1,0,0,0,1,0,1,0,0,0,1,2,1,0,"https://fbref.com/en/players/9c435456/Mario-Gila"
2022,"Real Madrid","La Liga","Peter González","DOM","MF,DF","19",2002,0.3,0,0,0,0,0,0,0,NA,0,0,0,0,1,1,0,0,"https://fbref.com/en/players/1ccd3dae/Peter-Gonzalez"
2022,"Real Madrid","La Liga","Miguel Gutiérrez","ESP","DF","20",2001,2.9,7,5,5,0,2,3,5,60,2,0,0,0,2,9,2,0,"https://fbref.com/en/players/7e98cff1/Miguel-Gutierrez"
2022,"Real Madrid","La Liga","Eden Hazard","BEL","FW,MF","30",1991,8,6,3,3,2,1,3,7,42.9,4,3,0,3,2,8,0,0,"https://fbref.com/en/players/a39bb753/Eden-Hazard"
2022,"Real Madrid","La Liga","Isco","ESP","MF,FW","29",1992,3.7,9,5,4,4,1,5,12,41.7,7,1,0,1,2,11,1,0,"https://fbref.com/en/players/a0b4bb3e/Isco"
2022,"Real Madrid","La Liga","Luka Jović","SRB","FW","23",1997,4.1,1,1,0,1,0,0,1,0,1,3,0,3,1,2,4,0,"https://fbref.com/en/players/4d8cd038/Luka-Jovic"
2022,"Real Madrid","La Liga","Vinicius Júnior","BRA","FW","21",2000,29.9,46,24,23,19,4,15,50,30,35,25,0,25,6,52,6,0,"https://fbref.com/en/players/7111d552/Vinicius-Junior"
2022,"Real Madrid","La Liga","Toni Kroos","GER","MF","31",1990,23.4,34,26,13,17,4,14,36,38.9,22,16,3,13,12,46,13,1,"https://fbref.com/en/players/6ce1f46f/Toni-Kroos"
2022,"Real Madrid","La Liga","Latasa","ESP","FW","20",2001,0.1,0,0,0,0,0,0,0,NA,0,0,0,0,0,0,0,0,"https://fbref.com/en/players/2bea832e/Latasa"
2022,"Real Madrid","La Liga","Andriy Lunin","UKR","GK","22",1999,2,0,0,0,0,0,0,0,NA,0,0,0,0,0,0,2,0,"https://fbref.com/en/players/3061e1ec/Andriy-Lunin"
2022,"Real Madrid","La Liga","Marcelo","BRA","DF","33",1988,5.8,8,4,2,3,3,5,10,50,5,7,2,5,1,9,11,0,"https://fbref.com/en/players/603116a7/Marcelo"
2022,"Real Madrid","La Liga","Mariano","DOM","FW","27",1993,3.8,2,0,2,0,0,0,0,NA,0,2,0,2,1,3,3,0,"https://fbref.com/en/players/5c4dc0ff/Mariano"
2022,"Real Madrid","La Liga","Ferland Mendy","FRA","DF","26",1995,19.3,24,14,11,10,3,8,14,57.1,6,8,2,6,18,42,27,3,"https://fbref.com/en/players/3cefcaef/Ferland-Mendy"
2022,"Real Madrid","La Liga","Éder Militão","BRA","DF","23",1998,33.7,50,32,30,12,8,20,39,51.3,19,42,20,22,52,102,107,3,"https://fbref.com/en/players/2784f898/Eder-Militao"
2022,"Real Madrid","La Liga","Luka Modrić","CRO","MF","35",1985,22.6,18,10,8,7,3,6,27,22.2,21,10,4,6,20,38,9,0,"https://fbref.com/en/players/6025fab1/Luka-Modric"
2022,"Real Madrid","La Liga","Nacho","ESP","DF","31",1990,17.3,18,14,9,9,0,12,22,54.5,10,22,15,7,34,52,50,0,"https://fbref.com/en/players/2946f9a1/Nacho"
2022,"Real Madrid","La Liga","Rodrygo","BRA","FW","20",2001,16.9,18,14,7,4,7,3,18,16.7,15,21,0,21,11,29,3,0,"https://fbref.com/en/players/8f5e92a6/Rodrygo"
2022,"Real Madrid","La Liga","Sergio Santos","ESP","DF","20",2001,0.1,0,0,0,0,0,0,0,NA,0,0,0,0,0,0,0,0,"https://fbref.com/en/players/cf59e05f/Sergio-Santos"
2022,"Real Madrid","La Liga","Jesús Vallejo","ESP","DF","24",1997,3.8,7,5,7,0,0,5,6,83.3,1,9,8,1,6,13,16,0,"https://fbref.com/en/players/c2111b45/Jesus-Vallejo"
2022,"Real Madrid","La Liga","Federico Valverde","URU","MF","23",1998,20.4,36,16,11,16,9,12,31,38.7,19,23,5,18,24,60,12,0,"https://fbref.com/en/players/0959c2a2/Federico-Valverde"
2022,"Real Madrid","La Liga","Lucas Vázquez","ESP","DF","30",1991,20.4,43,22,24,9,10,17,35,48.6,18,25,7,18,20,63,41,1,"https://fbref.com/en/players/fd51b456/Lucas-Vazquez"
2022,"Real Sociedad","La Liga","Ander Barrenetxea","ESP","FW,MF","19",2001,6.1,15,10,9,6,0,8,18,44.4,10,7,0,7,2,17,2,0,"https://fbref.com/en/players/200e89e1/Ander-Barrenetxea"
2022,"Real Sociedad","La Liga","Jon Bautista","ESP","MF","26",1995,0.5,3,0,0,3,0,0,1,0,1,1,0,1,1,4,1,0,"https://fbref.com/en/players/debc6b55/Jon-Bautista"
2022,"Real Sociedad","La Liga","Cristo","ESP","DF","21",2000,0.2,0,0,0,0,0,0,0,NA,0,0,0,0,0,0,0,0,"https://fbref.com/en/players/ad81ba78/Cristo"
2022,"Real Sociedad","La Liga","Naïs Djouahra","FRA","FW,MF","21",1999,2.4,7,3,2,2,3,4,8,50,4,3,0,3,2,9,2,0,"https://fbref.com/en/players/3594a357/Nais-Djouahra"
2022,"Real Sociedad","La Liga","Aritz Elustondo","ESP","DF","27",1994,23.4,21,14,16,5,0,10,20,50,10,19,13,6,29,50,86,0,"https://fbref.com/en/players/f7dc2ae5/Aritz-Elustondo"
2022,"Real Sociedad","La Liga","Andoni Gorosabel","ESP","DF","24",1996,25.4,47,31,32,9,6,25,47,53.2,22,16,3,13,18,65,49,0,"https://fbref.com/en/players/6f5f82c0/Andoni-Gorosabel"
2022,"Real Sociedad","La Liga","Ander Guevara","ESP","MF","24",1997,9.6,18,13,6,10,2,10,17,58.8,7,12,6,6,12,30,8,0,"https://fbref.com/en/players/8e48dc61/Ander-Guevara"
2022,"Real Sociedad","La Liga","Jon Guridi","ESP","MF","26",1995,2.3,5,3,2,3,0,1,4,25,3,3,1,2,3,8,4,0,"https://fbref.com/en/players/4c0a6a48/Jon-Guridi"
2022,"Real Sociedad","La Liga","Asier Illarramendi","ESP","MF","31",1990,4.2,9,5,5,3,1,1,10,10,9,5,1,4,4,13,12,0,"https://fbref.com/en/players/5ce0b5ba/Asier-Illarramendi"
2022,"Real Sociedad","La Liga","Alexander Isak","SWE","FW","21",1999,23.8,7,4,1,3,3,2,12,16.7,10,14,2,12,3,10,10,0,"https://fbref.com/en/players/8e92be30/Alexander-Isak"
2022,"Real Sociedad","La Liga","Adnan Januzaj","BEL","FW,MF","26",1995,18.1,17,11,5,8,4,9,24,37.5,15,15,3,12,12,29,15,0,"https://fbref.com/en/players/4737cebe/Adnan-Januzaj"
2022,"Real Sociedad","La Liga","Robin Le Normand","FRA","DF","24",1996,37,49,32,36,8,5,28,36,77.8,8,34,22,12,48,97,125,0,"https://fbref.com/en/players/9a64e67e/Robin-Le-Normand"
2022,"Real Sociedad","La Liga","Julen Lobete","ESP","FW,MF","20",2000,3.2,4,3,3,0,1,1,2,50,1,6,1,5,1,5,1,0,"https://fbref.com/en/players/a952a529/Julen-Lobete"
2022,"Real Sociedad","La Liga","Ander Martin","ESP","FW,MF","20",2000,1,1,0,0,1,0,1,1,100,0,0,0,0,3,4,1,0,"https://fbref.com/en/players/e1e75690/Ander-Martin"
2022,"Real Sociedad","La Liga","Mikel Merino","ESP","MF","25",1996,32.1,71,38,21,40,10,26,67,38.8,41,50,10,40,21,92,56,2,"https://fbref.com/en/players/d080ed5e/Mikel-Merino"
2022,"Real Sociedad","La Liga","Aihen Muñoz","ESP","DF","23",1997,14.9,28,17,14,13,1,18,29,62.1,11,11,1,10,17,45,34,0,"https://fbref.com/en/players/228b0d9d/Aihen-Munoz"
2022,"Real Sociedad","La Liga","Roberto Navarro","ESP","MF,FW","19",2002,2.2,5,3,1,1,3,3,5,60,2,2,0,2,2,7,2,0,"https://fbref.com/en/players/c997b942/Roberto-Navarro"
2022,"Real Sociedad","La Liga","Mikel Oyarzabal","ESP","FW,MF","24",1997,18.6,18,10,7,7,4,7,21,33.3,14,18,2,16,10,28,16,1,"https://fbref.com/en/players/8c3c640c/Mikel-Oyarzabal"
2022,"Real Sociedad","La Liga","Jon Pacheco","ESP","DF","20",2001,4.2,6,4,4,2,0,3,3,100,0,6,4,2,6,12,18,0,"https://fbref.com/en/players/44150beb/Jon-Pacheco"
2022,"Real Sociedad","La Liga","Portu","ESP","FW,MF","29",1992,17.7,16,7,2,6,8,3,19,15.8,16,21,3,18,7,23,8,0,"https://fbref.com/en/players/1bda5842/Portu"
2022,"Real Sociedad","La Liga","Rafinha","BRA","MF","28",1993,11.7,43,27,17,20,6,16,28,57.1,12,21,2,19,12,55,4,0,"https://fbref.com/en/players/0c2ac3cb/Rafinha"
2022,"Real Sociedad","La Liga","Álex Remiro","ESP","GK","26",1995,35,0,0,0,0,0,0,0,NA,0,0,0,0,1,1,24,2,"https://fbref.com/en/players/374ee424/Alex-Remiro"
2022,"Real Sociedad","La Liga","Diego Rico","ESP","DF","28",1993,18.3,41,20,19,17,5,22,45,48.9,23,29,4,25,30,71,54,0,"https://fbref.com/en/players/d9ba39fc/Diego-Rico"
2022,"Real Sociedad","La Liga","Mathew Ryan","AUS","GK","29",1992,3,0,0,0,0,0,0,0,NA,0,0,0,0,0,0,2,0,"https://fbref.com/en/players/4535e4bb/Mathew-Ryan"
2022,"Real Sociedad","La Liga","David Silva","ESP","MF","35",1986,19.1,28,17,10,11,7,3,20,15,17,13,3,10,7,35,12,0,"https://fbref.com/en/players/e2716bd0/David-Silva"
2022,"Real Sociedad","La Liga","Alex Sola","ESP","DF,FW","22",1999,0.5,1,1,1,0,0,1,3,33.3,2,1,0,1,2,3,3,0,"https://fbref.com/en/players/5fa714d5/Alex-Sola"
2022,"Real Sociedad","La Liga","Alexander Sørloth","NOR","FW","25",1995,19.6,20,7,4,10,6,7,17,41.2,10,14,1,13,4,24,15,0,"https://fbref.com/en/players/e92cd3f7/Alexander-Sorloth"
2022,"Real Sociedad","La Liga","Beñat Turrientes","ESP","MF","19",2002,2.3,0,0,0,0,0,0,4,0,4,1,0,1,2,2,2,0,"https://fbref.com/en/players/068f4dec/Benat-Turrientes"
2022,"Real Sociedad","La Liga","Germán Valera","ESP","FW","19",2002,0.6,3,2,3,0,0,1,1,100,0,0,0,0,0,3,1,0,"https://fbref.com/en/players/84f55b4a/German-Valera"
2022,"Real Sociedad","La Liga","Joseba Zaldúa","ESP","DF","29",1992,13,31,22,20,8,3,16,22,72.7,6,14,4,10,13,44,35,0,"https://fbref.com/en/players/5ca20b7a/Joseba-Zaldua"
2022,"Real Sociedad","La Liga","Igor Zubeldia","ESP","DF","24",1997,18.3,20,10,12,8,0,12,18,66.7,6,16,6,10,27,47,53,0,"https://fbref.com/en/players/5c7845f6/Igor-Zubeldia"
2022,"Real Sociedad","La Liga","Martín Zubimendi","ESP","MF","22",1999,28.8,52,25,19,30,3,22,44,50,22,30,13,17,49,101,48,1,"https://fbref.com/en/players/3ee0dd59/Martin-Zubimendi"
2022,"Reims","Ligue 1","Yunis Abdelhamid","MAR","DF","33",1987,33.1,48,27,34,14,0,16,32,50,16,50,25,25,68,116,104,0,"https://fbref.com/en/players/32c2d95f/Yunis-Abdelhamid"
2022,"Reims","Ligue 1","Martin Adeline","FRA","MF,FW","17",2003,3.9,15,11,5,8,2,8,16,50,8,0,0,0,11,26,6,0,"https://fbref.com/en/players/7587446d/Martin-Adeline"
2022,"Reims","Ligue 1","Mitchell van Bergen","NED","FW,MF","21",1999,10.9,8,5,7,0,1,6,15,40,9,9,0,9,4,12,7,0,"https://fbref.com/en/players/0b2c9aec/Mitchell-van-Bergen"
2022,"Reims","Ligue 1","Valon Berisha","KVX","MF,FW","28",1993,5.1,10,7,2,5,3,2,10,20,8,9,0,9,4,14,3,0,"https://fbref.com/en/players/d5575935/Valon-Berisha"
2022,"Reims","Ligue 1","El Bilal Touré","MLI","FW","19",2001,13.3,13,6,4,6,3,2,7,28.6,5,10,3,7,6,19,19,0,"https://fbref.com/en/players/47c609d5/El-Bilal-Toure"
2022,"Reims","Ligue 1","Maxime Busi","BEL","DF","21",1999,14.4,26,15,20,5,1,19,36,52.8,17,19,5,14,17,43,28,0,"https://fbref.com/en/players/7b082ec2/Maxime-Busi"
2022,"Reims","Ligue 1","Mathieu Cafaro","FRA","MF,FW","24",1997,2.1,4,2,3,1,0,0,7,0,7,2,0,2,3,7,1,0,"https://fbref.com/en/players/2a657da0/Mathieu-Cafaro"
2022,"Reims","Ligue 1","Jens Cajuste","SWE","MF,FW","21",1999,4,10,6,6,2,2,6,17,35.3,11,7,2,5,5,15,6,0,"https://fbref.com/en/players/928a4a61/Jens-Cajuste"
2022,"Reims","Ligue 1","Moreto Cassamã","GNB","MF","23",1998,8.9,12,6,7,4,1,3,19,15.8,16,10,5,5,9,21,5,0,"https://fbref.com/en/players/f54d2149/Moreto-Cassama"
2022,"Reims","Ligue 1","Xavier Chavalerin","FRA","MF","30",1991,2.4,4,4,2,1,1,1,3,33.3,2,2,0,2,5,9,2,1,"https://fbref.com/en/players/279ddf6a/Xavier-Chavalerin"
2022,"Reims","Ligue 1","Ibrahim Diakité","GUI","MF","17",2003,0,0,0,0,0,0,0,1,0,1,0,0,0,0,0,0,0,"https://fbref.com/en/players/d8c19a60/Ibrahim-Diakite"
2022,"Reims","Ligue 1","Anastasios Donis","GRE","FW,MF","24",1996,4.1,8,7,4,2,2,2,6,33.3,4,3,0,3,0,8,1,0,"https://fbref.com/en/players/0f26fd24/Anastasios-Donis"
2022,"Reims","Ligue 1","Fodé Doucouré","MLI","DF,FW","20",2001,1.7,12,9,9,3,0,9,11,81.8,2,1,0,1,4,16,6,0,"https://fbref.com/en/players/1bfe34dc/Fode-Doucoure"
2022,"Reims","Ligue 1","Kamory Doumbia","MLI","MF,FW","18",2003,3.9,8,2,2,5,1,5,13,38.5,8,9,3,6,3,11,3,0,"https://fbref.com/en/players/9226aa22/Kamory-Doumbia"
2022,"Reims","Ligue 1","Moussa Doumbia","MLI","FW","26",1994,1,0,0,0,0,0,0,1,0,1,0,0,0,0,0,0,0,"https://fbref.com/en/players/6481421d/Moussa-Doumbia"
2022,"Reims","Ligue 1","Hugo Ekitike","FRA","FW","19",2002,14.1,18,10,8,6,4,4,11,36.4,7,9,2,7,6,24,15,0,"https://fbref.com/en/players/5b92d896/Hugo-Ekitike"
2022,"Reims","Ligue 1","Wout Faes","BEL","DF","23",1998,37,40,24,30,9,1,25,33,75.8,8,47,37,10,53,93,169,2,"https://fbref.com/en/players/9c221d14/Wout-Faes"
2022,"Reims","Ligue 1","Alexis Flips","FRA","MF,DF","21",2000,11.7,37,21,21,9,7,22,45,48.9,23,21,0,21,24,61,17,0,"https://fbref.com/en/players/caef7840/Alexis-Flips"
2022,"Reims","Ligue 1","Thomas Foket","BEL","DF,FW","26",1994,24.8,28,19,12,13,3,18,40,45,22,26,4,22,33,61,35,0,"https://fbref.com/en/players/90eb507d/Thomas-Foket"
2022,"Reims","Ligue 1","Andrew Gravillon","GLP","DF","23",1998,23.7,32,24,19,13,0,17,27,63,10,25,15,10,33,65,83,1,"https://fbref.com/en/players/49136c42/Andrew-Gravillon"
2022,"Reims","Ligue 1","Fraser Hornby","SCO","FW,MF","21",1999,3.9,3,1,1,2,0,0,2,0,2,3,0,3,4,7,5,0,"https://fbref.com/en/players/29aee77c/Fraser-Hornby"
2022,"Reims","Ligue 1","Ilan Kebbal","ALG","MF,FW","23",1998,19.7,31,15,13,10,8,12,44,27.3,32,16,0,16,13,44,3,0,"https://fbref.com/en/players/37d04e90/Ilan-Kebbal"
2022,"Reims","Ligue 1","Samuel Koeberlé","FRA","FW","16",2004,0,0,0,0,0,0,0,0,NA,0,0,0,0,0,0,0,0,"https://fbref.com/en/players/6751b938/Samuel-Koeberle"
2022,"Reims","Ligue 1","Philippe Koffi","FRA","FW","19",2002,4.2,4,0,0,3,1,0,2,0,2,2,1,1,3,7,3,0,"https://fbref.com/en/players/9f1c2822/Philippe-Koffi"
2022,"Reims","Ligue 1","Ghislain Konan","CIV","DF","25",1995,26.9,35,19,19,15,1,16,30,53.3,14,35,8,27,28,63,45,0,"https://fbref.com/en/players/6b2c894b/Ghislain-Konan"
2022,"Reims","Ligue 1","Banzouzi Locko","FRA","MF,DF","19",2002,11.2,28,19,13,11,4,14,24,58.3,10,20,8,12,14,42,15,0,"https://fbref.com/en/players/40221fa7/Banzouzi-Locko"
2022,"Reims","Ligue 1","Dion Lopy","SEN","MF","19",2002,18.2,53,29,22,24,7,21,53,39.6,32,20,4,16,22,75,17,0,"https://fbref.com/en/players/64c14d49/Dion-Lopy"
2022,"Reims","Ligue 1","Azor Matusiwa","NED","MF","23",1998,27.4,58,32,28,26,4,26,55,47.3,29,49,19,30,62,120,43,0,"https://fbref.com/en/players/a17a94d6/Azor-Matusiwa"
2022,"Reims","Ligue 1","Moustapha Mbow","SEN","DF","21",2000,1,6,6,3,2,1,3,3,100,0,0,0,0,1,7,6,0,"https://fbref.com/en/players/3f3a2cba/Moustapha-Mbow"
2022,"Reims","Ligue 1","Nathanael Mbuku","FRA","FW,MF","19",2002,15.8,14,13,4,7,3,2,8,25,6,14,0,14,11,25,4,0,"https://fbref.com/en/players/46750e9c/Nathanael-Mbuku"
2022,"Reims","Ligue 1","Marshall Munetsi","ZIM","MF,DF","25",1996,20.9,34,17,21,11,2,17,39,43.6,22,39,13,26,43,77,72,2,"https://fbref.com/en/players/2acf0cd7/Marshall-Munetsi"
2022,"Reims","Ligue 1","Predrag Rajković","SRB","GK","25",1995,38,2,2,2,0,0,2,3,66.7,1,1,0,1,1,3,21,1,"https://fbref.com/en/players/58ad9383/Predrag-Rajkovic"
2022,"Reims","Ligue 1","Kaj Sierhuis","NED","FW","23",1998,0.9,1,1,1,0,0,1,3,33.3,2,0,0,0,0,1,1,0,"https://fbref.com/en/players/9c2b1f11/Kaj-Sierhuis"
2022,"Reims","Ligue 1","Sambou Sissoko","FRA","MF,DF","22",1999,2,12,6,6,4,2,6,8,75,2,2,0,2,2,14,7,0,"https://fbref.com/en/players/e4bb1f08/Sambou-Sissoko"
2022,"Reims","Ligue 1","Arber Zeneli","KVX","FW","26",1995,4.5,1,0,0,0,1,1,5,20,4,0,0,0,1,2,1,0,"https://fbref.com/en/players/095e4199/Arber-Zeneli"
2022,"Rennes","Ligue 1","Matthis Abline","FRA","FW","18",2003,1.1,0,0,0,0,0,0,0,NA,0,2,0,2,0,0,1,0,"https://fbref.com/en/players/0e46fa2f/Matthis-Abline"
2022,"Rennes","Ligue 1","Nayef Aguerd","MAR","DF","25",1996,30.4,27,18,16,11,0,14,24,58.3,10,24,14,10,24,51,127,1,"https://fbref.com/en/players/288e1e13/Nayef-Aguerd"
2022,"Rennes","Ligue 1","Doğan Alemdar","TUR","GK","18",2002,12,0,0,0,0,0,0,0,NA,0,0,0,0,0,0,9,1,"https://fbref.com/en/players/9e17ccff/Dogan-Alemdar"
2022,"Rennes","Ligue 1","Lorenz Assignon","TOG","DF","21",2000,6.8,15,10,11,3,1,5,9,55.6,4,3,1,2,11,26,19,0,"https://fbref.com/en/players/b026bbf6/Lorenz-Assignon"
2022,"Rennes","Ligue 1","Loïc Bade","FRA","DF","21",2000,10.9,6,5,4,2,0,3,5,60,2,12,10,2,12,18,48,0,"https://fbref.com/en/players/114bbdee/Loic-Bade"
2022,"Rennes","Ligue 1","Jeanöel Belocian","FRA","DF","16",2005,0.1,0,0,0,0,0,0,0,NA,0,0,0,0,0,0,0,0,"https://fbref.com/en/players/c678ddd7/Jeanoel-Belocian"
2022,"Rennes","Ligue 1","Benjamin Bourigeaud","FRA","FW,MF","27",1994,35.5,46,24,16,18,12,24,67,35.8,43,33,3,30,30,76,44,0,"https://fbref.com/en/players/20e73fac/Benjamin-Bourigeaud"
2022,"Rennes","Ligue 1","Eduardo Camavinga","FRA","MF","18",2002,1.6,4,1,2,1,1,2,5,40,3,1,1,0,1,5,3,0,"https://fbref.com/en/players/7b9c2d84/Eduardo-Camavinga"
2022,"Rennes","Ligue 1","Romain Del Castillo","FRA","MF,FW","25",1996,0.3,2,1,0,1,1,2,2,100,0,0,0,0,1,3,0,0,"https://fbref.com/en/players/0be95d34/Romain-Del-Castillo"
2022,"Rennes","Ligue 1","Andy Diouf","FRA","MF","18",2003,0.2,1,1,1,0,0,1,1,100,0,1,0,1,0,1,0,0,"https://fbref.com/en/players/9b5237b1/Andy-Diouf"
2022,"Rennes","Ligue 1","Jeremy Doku","BEL","FW,MF","19",2002,5.2,10,5,3,5,2,3,6,50,3,4,0,4,3,13,0,0,"https://fbref.com/en/players/fffea3e5/Jeremy-Doku"
2022,"Rennes","Ligue 1","Alfred Gomis","SEN","GK","27",1993,25,1,0,1,0,0,1,2,50,1,0,0,0,1,2,8,2,"https://fbref.com/en/players/cecbce23/Alfred-Gomis"
2022,"Rennes","Ligue 1","Sehrou Guirassy","GUI","FW","25",1996,11.3,4,2,1,2,1,1,7,14.3,6,4,0,4,1,5,8,0,"https://fbref.com/en/players/923f4dda/Sehrou-Guirassy"
2022,"Rennes","Ligue 1","Gaëtan Laborde","FRA","FW","27",1994,30.3,19,7,5,8,6,3,22,13.6,19,29,3,26,8,27,16,0,"https://fbref.com/en/players/7cdda3bf/Gaetan-Laborde"
2022,"Rennes","Ligue 1","Lovro Majer","CRO","MF,FW","23",1998,20.4,32,21,9,14,9,11,42,26.2,31,26,2,24,11,43,9,0,"https://fbref.com/en/players/fc46aab1/Lovro-Majer"
2022,"Rennes","Ligue 1","Jonas Martin","FRA","MF","31",1990,23.4,35,20,12,21,2,19,53,35.8,34,17,3,14,22,57,28,1,"https://fbref.com/en/players/468fdbad/Jonas-Martin"
2022,"Rennes","Ligue 1","Birger Meling","NOR","DF","26",1994,20.3,43,27,25,11,7,23,31,74.2,8,23,7,16,22,65,40,0,"https://fbref.com/en/players/70c52749/Birger-Meling"
2022,"Rennes","Ligue 1","Warmed Omari","FRA","DF","21",2000,31.1,33,17,22,10,1,15,23,65.2,8,20,13,7,31,64,94,5,"https://fbref.com/en/players/4534a352/Warmed-Omari"
2022,"Rennes","Ligue 1","Romain Salin","FRA","GK","37",1984,1,0,0,0,0,0,0,0,NA,0,0,0,0,0,0,0,0,"https://fbref.com/en/players/74733221/Romain-Salin"
2022,"Rennes","Ligue 1","Baptiste Santamaria","FRA","MF,DF","26",1995,28,52,27,15,31,6,24,44,54.5,20,33,12,21,33,85,42,0,"https://fbref.com/en/players/5e22e2a4/Baptiste-Santamaria"
2022,"Rennes","Ligue 1","Kamaldeen Sulemana","GHA","MF,FW","19",2002,11.3,23,12,7,9,7,10,17,58.8,7,10,1,9,4,27,5,0,"https://fbref.com/en/players/a62f8bf1/Kamaldeen-Sulemana"
2022,"Rennes","Ligue 1","Flavien Tait","FRA","MF","28",1993,23.6,28,19,13,9,6,13,40,32.5,27,15,4,11,19,47,13,1,"https://fbref.com/en/players/a0f9b535/Flavien-Tait"
2022,"Rennes","Ligue 1","Loum Tchaouna","FRA","FW,MF","17",2003,1,3,1,1,2,0,1,5,20,4,0,0,0,2,5,0,0,"https://fbref.com/en/players/a3c8b4d3/Loum-Tchaouna"
2022,"Rennes","Ligue 1","Mathys Tel","FRA","FW,MF","16",2005,0.6,2,1,1,1,0,0,0,NA,0,0,0,0,1,3,2,0,"https://fbref.com/en/players/829aa60c/Mathys-Tel"
2022,"Rennes","Ligue 1","Martin Terrier","FRA","FW,MF","24",1997,30.9,55,33,22,16,17,25,43,58.1,18,29,3,26,18,73,17,0,"https://fbref.com/en/players/5148dcc5/Martin-Terrier"
2022,"Rennes","Ligue 1","Hamari Traoré","MLI","DF","29",1992,32.1,63,36,25,26,12,41,59,69.5,18,29,8,21,37,100,81,1,"https://fbref.com/en/players/a4b1028a/Hamari-Traore"
2022,"Rennes","Ligue 1","Adrien Truffert","FRA","DF","19",2001,18.2,29,21,17,9,3,11,24,45.8,13,25,5,20,19,48,30,0,"https://fbref.com/en/players/5d0e0a1f/Adrien-Truffert"
2022,"Rennes","Ligue 1","Chimuanya Ugochukwu","FRA","MF","17",2004,4.5,13,9,5,5,3,9,19,47.4,10,7,2,5,4,17,2,0,"https://fbref.com/en/players/1df4a109/Chimuanya-Ugochukwu"
2022,"Roma","Serie A","Tammy Abraham","ENG","FW","23",1997,34.3,27,13,7,14,6,9,22,40.9,13,17,3,14,5,32,27,0,"https://fbref.com/en/players/f586779e/Tammy-Abraham"
2022,"Roma","Serie A","Felix Afena-Gyan","GHA","FW,MF","18",2003,7.4,10,3,1,6,3,4,7,57.1,3,4,0,4,3,13,0,0,"https://fbref.com/en/players/0154d290/Felix-Afena-Gyan"
2022,"Roma","Serie A","Edoardo Bove","ITA","MF,DF","19",2002,0.8,1,1,1,0,0,0,2,0,2,1,0,1,1,2,0,0,"https://fbref.com/en/players/ae94a6c5/Edoardo-Bove"
2022,"Roma","Serie A","Riccardo Calafiori","ITA","DF","19",2002,1.9,5,4,2,2,1,1,5,20,4,3,0,3,3,8,1,0,"https://fbref.com/en/players/aded8e6f/Riccardo-Calafiori"
2022,"Roma","Serie A","Bryan Cristante","ITA","MF","26",1995,29.8,79,39,31,39,9,37,69,53.6,32,31,5,26,40,119,45,0,"https://fbref.com/en/players/16657b95/Bryan-Cristante"
2022,"Roma","Serie A","Ebrima Darboe","GAM","MF","20",2001,0.7,1,1,0,1,0,0,0,NA,0,0,0,0,1,2,0,1,"https://fbref.com/en/players/cf043a33/Ebrima-Darboe"
2022,"Roma","Serie A","Amadou Diawara","GUI","MF","24",1997,1.9,7,2,5,2,0,1,3,33.3,2,2,0,2,0,7,1,0,"https://fbref.com/en/players/bf309d24/Amadou-Diawara"
2022,"Roma","Serie A","Roger Ibanez","BRA","DF","22",1998,32.1,54,32,31,19,4,26,43,60.5,17,26,7,19,62,116,104,2,"https://fbref.com/en/players/82efe6fa/Roger-Ibanez"
2022,"Roma","Serie A","Rick Karsdorp","NED","DF,FW","26",1995,32,53,38,33,13,7,28,50,56,22,22,5,17,34,87,26,1,"https://fbref.com/en/players/9f84febe/Rick-Karsdorp"
2022,"Roma","Serie A","Dimitrios Keramitsis","GRE","MF","17",2004,0,0,0,0,0,0,0,0,NA,0,0,0,0,0,0,0,0,"https://fbref.com/en/players/6f30a1d5/Dimitrios-Keramitsis"
2022,"Roma","Serie A","Marash Kumbulla","ALB","DF","21",2000,11.4,21,13,13,7,1,8,15,53.3,7,17,8,9,16,37,26,0,"https://fbref.com/en/players/a40819d9/Marash-Kumbulla"
2022,"Roma","Serie A","Ainsley Maitland-Niles","ENG","DF","23",1997,5.4,8,6,5,0,3,5,14,35.7,9,7,0,7,6,14,7,0,"https://fbref.com/en/players/e3a5814e/Ainsley-Maitland-Niles"
2022,"Roma","Serie A","Gianluca Mancini","ITA","DF","25",1996,32,41,25,22,18,1,18,33,54.5,15,38,19,19,39,80,69,0,"https://fbref.com/en/players/5aa53281/Gianluca-Mancini"
2022,"Roma","Serie A","Borja Mayoral","ESP","FW,DF","24",1997,1.1,0,0,0,0,0,0,0,NA,0,0,0,0,0,0,0,0,"https://fbref.com/en/players/64e8ed6d/Borja-Mayoral"
2022,"Roma","Serie A","Henrikh Mkhitaryan","ARM","MF,FW","32",1989,27.7,45,29,11,27,7,17,52,32.7,35,33,2,31,22,67,33,0,"https://fbref.com/en/players/dd0daf32/Henrikh-Mkhitaryan"
2022,"Roma","Serie A","Sérgio Oliveira","POR","MF","29",1992,9.9,27,14,11,14,2,15,30,50,15,13,0,13,10,37,7,0,"https://fbref.com/en/players/947e036f/Sergio-Oliveira"
2022,"Roma","Serie A","Rui Patrício","POR","GK","33",1988,38,0,0,0,0,0,0,0,NA,0,1,0,1,0,0,10,3,"https://fbref.com/en/players/79b0d6a0/Rui-Patricio"
2022,"Roma","Serie A","Lorenzo Pellegrini","ITA","MF","25",1996,25.4,35,14,10,17,8,16,60,26.7,44,29,1,28,27,62,20,0,"https://fbref.com/en/players/4a5a45c7/Lorenzo-Pellegrini"
2022,"Roma","Serie A","Carles Pérez","ESP","MF,FW","23",1998,6.2,8,3,3,1,4,3,12,25,9,10,0,10,2,10,2,0,"https://fbref.com/en/players/a8f21b9f/Carles-Perez"
2022,"Roma","Serie A","Bryan Reynolds","USA","DF","20",2001,0,0,0,0,0,0,0,1,0,1,0,0,0,0,0,1,0,"https://fbref.com/en/players/2306bf5c/Bryan-Reynolds"
2022,"Roma","Serie A","Stephan El Shaarawy","ITA","FW,DF","28",1992,11.7,13,8,4,9,0,4,6,66.7,2,10,2,8,11,24,8,0,"https://fbref.com/en/players/d3aaad90/Stephan-El-Shaarawy"
2022,"Roma","Serie A","Eldor Shomurodov","UZB","FW,MF","26",1995,8.7,5,4,0,4,1,1,10,10,9,8,0,8,2,7,5,0,"https://fbref.com/en/players/57469b2d/Eldor-Shomurodov"
2022,"Roma","Serie A","Chris Smalling","ENG","DF","31",1989,23.2,36,23,28,8,0,18,25,72,7,32,24,8,26,62,92,1,"https://fbref.com/en/players/b6964eb6/Chris-Smalling"
2022,"Roma","Serie A","Leonardo Spinazzola","ITA","DF","28",1993,1.4,0,0,0,0,0,0,1,0,1,4,1,3,0,0,3,0,"https://fbref.com/en/players/3626daea/Leonardo-Spinazzola"
2022,"Roma","Serie A","Jordan Veretout","FRA","MF","28",1993,25.8,34,25,20,12,2,15,39,38.5,24,12,1,11,27,61,22,1,"https://fbref.com/en/players/4a56052c/Jordan-Veretout"
2022,"Roma","Serie A","Matías Viña","URU","DF,FW","23",1997,17.4,46,30,27,14,5,29,59,49.2,30,26,3,23,25,71,33,0,"https://fbref.com/en/players/08eb3b58/Matias-Vina"
2022,"Roma","Serie A","Cristian Volpato","ITA","FW,MF","17",2003,0.4,1,1,0,0,1,1,1,100,0,0,0,0,0,1,0,0,"https://fbref.com/en/players/72f87f25/Cristian-Volpato"
2022,"Roma","Serie A","Nicola Zalewski","POL","DF","19",2002,8.8,32,19,17,11,4,21,35,60,14,18,1,17,16,48,4,0,"https://fbref.com/en/players/45191c29/Nicola-Zalewski"
2022,"Roma","Serie A","Nicolò Zaniolo","ITA","FW,MF","22",1999,21.9,24,15,0,15,9,6,28,21.4,22,19,0,19,7,31,6,0,"https://fbref.com/en/players/9907b1c8/Nicolo-Zaniolo"
2022,"Saint-Étienne","Ligue 1","Charles Abi","FRA","FW","21",2000,0.5,0,0,0,0,0,0,1,0,1,2,0,2,0,0,0,0,"https://fbref.com/en/players/469d3d84/Charles-Abi"
2022,"Saint-Étienne","Ligue 1","Adil Aouchiche","FRA","MF,FW","19",2002,12,13,6,5,5,3,5,33,15.2,28,18,1,17,17,30,4,0,"https://fbref.com/en/players/b94b8be1/Adil-Aouchiche"
2022,"Saint-Étienne","Ligue 1","Stefan Bajic","FRA","GK","19",2001,5.7,0,0,0,0,0,0,0,NA,0,0,0,0,0,0,4,0,"https://fbref.com/en/players/be13e5a8/Stefan-Bajic"
2022,"Saint-Étienne","Ligue 1","Abdoulaye Bakayoko","FRA","DF","18",2002,3.4,15,9,13,2,0,8,12,66.7,4,5,4,1,12,27,15,0,"https://fbref.com/en/players/ee95585f/Abdoulaye-Bakayoko"
2022,"Saint-Étienne","Ligue 1","Paul Bernardoni","FRA","GK","24",1997,19,0,0,0,0,0,0,0,NA,0,0,0,0,0,0,14,2,"https://fbref.com/en/players/28dabd43/Paul-Bernardoni"
2022,"Saint-Étienne","Ligue 1","Denis Bouanga","GAB","FW,MF","26",1994,27.1,46,25,14,13,19,22,63,34.9,41,30,0,30,8,54,34,1,"https://fbref.com/en/players/0b0cbe5b/Denis-Bouanga"
2022,"Saint-Étienne","Ligue 1","Ryad Boudebouz","ALG","MF,FW","31",1990,25,27,15,11,12,4,12,29,41.4,17,17,2,15,10,37,5,0,"https://fbref.com/en/players/1001ae82/Ryad-Boudebouz"
2022,"Saint-Étienne","Ligue 1","Lucas Calodat","FRA","DF","19",2002,0,0,0,0,0,0,0,0,NA,0,0,0,0,0,0,0,0,"https://fbref.com/en/players/7a72e960/Lucas-Calodat"
2022,"Saint-Étienne","Ligue 1","Mahdi Camara","FRA","MF,DF","23",1998,34.1,101,57,39,50,12,39,70,55.7,31,44,8,36,57,158,35,1,"https://fbref.com/en/players/8577e60a/Mahdi-Camara"
2022,"Saint-Étienne","Ligue 1","Enzo Crivelli","FRA","FW,MF","26",1995,1.1,1,0,0,0,1,0,0,NA,0,0,0,0,0,1,1,0,"https://fbref.com/en/players/06f33dc8/Enzo-Crivelli"
2022,"Saint-Étienne","Ligue 1","Elhadji Dieye","SEN","FW,MF","19",2002,0.4,3,2,2,1,0,0,1,0,1,2,0,2,1,4,0,0,"https://fbref.com/en/players/6a04bb7c/Elhadji-Dieye"
2022,"Saint-Étienne","Ligue 1","Assane Dioussé","SEN","MF","23",1997,0.3,1,1,1,0,0,1,1,100,0,0,0,0,0,1,0,0,"https://fbref.com/en/players/7f622eef/Assane-Diousse"
2022,"Saint-Étienne","Ligue 1","Bryan Djile Nokoué","CMR","DF,MF","19",2002,0.6,3,3,1,2,0,2,2,100,0,1,0,1,1,4,2,0,"https://fbref.com/en/players/75186a6a/Bryan-Djile-Nokoue"
2022,"Saint-Étienne","Ligue 1","Lamine Ghezali","FRA","DF","22",1999,0,0,0,0,0,0,0,0,NA,0,1,0,1,0,0,0,0,"https://fbref.com/en/players/ce84946a/Lamine-Ghezali"
2022,"Saint-Étienne","Ligue 1","Lucas Gourna-Douath","FRA","MF","17",2003,20,45,26,22,18,5,21,36,58.3,15,22,3,19,13,58,9,2,"https://fbref.com/en/players/3cd7820a/Lucas-Gourna-Douath"
2022,"Saint-Étienne","Ligue 1","Etienne Green","ENG","GK","21",2000,13.3,1,1,1,0,0,0,0,NA,0,0,0,0,1,2,9,0,"https://fbref.com/en/players/667b65da/Etienne-Green"
2022,"Saint-Étienne","Ligue 1","Romain Hamouma","FRA","FW,MF","34",1987,9.8,10,7,1,5,4,2,13,15.4,11,8,0,8,4,14,1,0,"https://fbref.com/en/players/0b4d8274/Romain-Hamouma"
2022,"Saint-Étienne","Ligue 1","Juan Ignacio Ramírez","URU","FW","24",1997,1.4,2,1,0,1,1,0,0,NA,0,0,0,0,0,2,0,0,"https://fbref.com/en/players/ad513a6b/Juan-Ignacio-Ramirez"
2022,"Saint-Étienne","Ligue 1","Wahbi Khazri","TUN","FW,MF","30",1991,24.7,33,18,7,17,9,9,34,26.5,25,21,0,21,12,45,7,0,"https://fbref.com/en/players/2677a1de/Wahbi-Khazri"
2022,"Saint-Étienne","Ligue 1","Timothée Kolodziejczak","FRA","DF","29",1991,28.5,43,24,22,14,7,20,36,55.6,16,29,7,22,60,103,72,1,"https://fbref.com/en/players/ab096c6f/Timothee-Kolodziejczak"
2022,"Saint-Étienne","Ligue 1","Jean-Philippe Krasso","CIV","FW","24",1997,5,7,5,0,5,2,2,10,20,8,7,1,6,0,7,1,0,"https://fbref.com/en/players/037f2523/Jean-Philippe-Krasso"
2022,"Saint-Étienne","Ligue 1","Yanis Lhery","FRA","FW,MF","18",2003,0.8,0,0,0,0,0,0,0,NA,0,4,0,4,0,0,0,0,"https://fbref.com/en/players/cc972842/Yanis-Lhery"
2022,"Saint-Étienne","Ligue 1","Yvann Macon","FRA","DF","22",1998,17,41,22,24,14,3,16,42,38.1,26,18,4,14,18,59,27,0,"https://fbref.com/en/players/0bb6e193/Yvann-Macon"
2022,"Saint-Étienne","Ligue 1","Eliaquim Mangala","FRA","DF","30",1991,13.1,17,12,12,5,0,8,12,66.7,4,11,8,3,17,34,61,1,"https://fbref.com/en/players/f520049f/Eliaquim-Mangala"
2022,"Saint-Étienne","Ligue 1","Aimen Moueffek","FRA","MF","20",2001,4.8,7,4,2,3,2,2,8,25,6,3,0,3,2,9,4,0,"https://fbref.com/en/players/2591b066/Aimen-Moueffek"
2022,"Saint-Étienne","Ligue 1","Harold Moukoudi","CMR","DF","23",1997,18.5,25,12,17,8,0,14,25,56,11,27,14,13,35,60,48,0,"https://fbref.com/en/players/5f26e0c5/Harold-Moukoudi"
2022,"Saint-Étienne","Ligue 1","Mickael Nade","FRA","DF","22",1999,28.5,57,35,37,18,2,23,38,60.5,15,29,15,14,60,117,84,0,"https://fbref.com/en/players/a6b6fa6e/Mickael-Nade"
2022,"Saint-Étienne","Ligue 1","Yvan Neyou","CMR","MF","24",1997,10.4,29,13,14,12,3,9,27,33.3,18,8,3,5,23,52,13,0,"https://fbref.com/en/players/0ad37003/Yvan-Neyou"
2022,"Saint-Étienne","Ligue 1","Arnaud Nordin","FRA","FW,MF","23",1998,20.8,21,11,8,8,5,8,22,36.4,14,19,0,19,6,27,8,0,"https://fbref.com/en/players/7b9a9e25/Arnaud-Nordin"
2022,"Saint-Étienne","Ligue 1","Maxence Rivera","FRA","FW","19",2002,0.1,0,0,0,0,0,0,0,NA,0,0,0,0,0,0,0,0,"https://fbref.com/en/players/46a7b605/Maxence-Rivera"
2022,"Saint-Étienne","Ligue 1","Mathys Saban","FRA","FW,MF","19",2002,0.8,4,2,2,2,0,1,1,100,0,1,0,1,0,4,0,0,"https://fbref.com/en/players/7d9f3d69/Mathys-Saban"
2022,"Saint-Étienne","Ligue 1","Falaye Sacko","MLI","DF","26",1995,7.4,15,10,14,1,0,13,16,81.3,3,11,7,4,4,19,18,2,"https://fbref.com/en/players/6388e356/Falaye-Sacko"
2022,"Saint-Étienne","Ligue 1","Bakary Sako","MLI","FW,MF","33",1988,1.7,0,0,0,0,0,0,1,0,1,3,1,2,0,0,0,0,"https://fbref.com/en/players/381d7d54/Bakary-Sako"
2022,"Saint-Étienne","Ligue 1","Gabriel Silva","BRA","DF,MF","30",1991,7.9,12,7,7,2,3,9,13,69.2,4,9,3,6,18,30,13,0,"https://fbref.com/en/players/4914ed4a/Gabriel-Silva"
2022,"Saint-Étienne","Ligue 1","Nelson Sissoko","FRA","DF","24",1997,0.5,2,0,2,0,0,1,1,100,0,0,0,0,0,2,2,0,"https://fbref.com/en/players/12bd0579/Nelson-Sissoko"
2022,"Saint-Étienne","Ligue 1","Saidou Sow","GUI","DF","19",2002,11,28,17,21,6,1,16,21,76.2,5,15,5,10,23,51,34,0,"https://fbref.com/en/players/f6b94e8d/Saidou-Sow"
2022,"Saint-Étienne","Ligue 1","Sada Thioub","SEN","DF,MF","26",1995,10.6,13,8,5,8,0,6,14,42.9,8,9,0,9,10,23,8,0,"https://fbref.com/en/players/f4bc42b1/Sada-Thioub"
2022,"Saint-Étienne","Ligue 1","Miguel Trauco","PER","DF,MF","28",1992,12.4,25,18,16,8,1,12,22,54.5,10,13,4,9,23,48,17,0,"https://fbref.com/en/players/e4b72e34/Miguel-Trauco"
2022,"Saint-Étienne","Ligue 1","Zaydou Youssouf","FRA","MF","22",1999,17.3,48,26,21,25,2,14,34,41.2,20,11,3,8,17,65,13,0,"https://fbref.com/en/players/e2f9bb5f/Zaydou-Youssouf"
2022,"Salernitana","Serie A","Ramzi Aya","ITA","DF","30",1990,1.5,1,1,1,0,0,1,1,100,0,0,0,0,0,1,4,0,"https://fbref.com/en/players/6a1f66a7/Ramzi-Aya"
2022,"Salernitana","Serie A","Vid Belec","SVN","GK","31",1990,21.5,0,0,0,0,0,0,0,NA,0,0,0,0,0,0,9,1,"https://fbref.com/en/players/4f8ce0e1/Vid-Belec"
2022,"Salernitana","Serie A","Luka Bogdan","CRO","DF","25",1996,4.4,6,3,6,0,0,4,8,50,4,3,2,1,6,12,21,0,"https://fbref.com/en/players/cb678320/Luka-Bogdan"
2022,"Salernitana","Serie A","Emil Bohinen","NOR","MF","22",1999,7.8,15,9,4,9,2,10,20,50,10,17,3,14,12,27,14,0,"https://fbref.com/en/players/c83c203f/Emil-Bohinen"
2022,"Salernitana","Serie A","Federico Bonazzoli","ITA","FW,MF","24",1997,20.7,24,12,9,8,7,6,25,24,19,17,1,16,6,30,7,0,"https://fbref.com/en/players/bf57eaab/Federico-Bonazzoli"
2022,"Salernitana","Serie A","Leonardo Capezzi","ITA","MF","26",1995,1.9,3,1,0,3,0,1,4,25,3,8,4,4,0,3,2,0,"https://fbref.com/en/players/07ea0ef2/Leonardo-Capezzi"
2022,"Salernitana","Serie A","Lassana Coulibaly","MLI","MF","25",1996,25.9,58,32,29,26,3,24,62,38.7,38,40,13,27,22,80,27,0,"https://fbref.com/en/players/85a44ecc/Lassana-Coulibaly"
2022,"Salernitana","Serie A","Mamadou Coulibaly","SEN","MF","22",1999,9,15,12,8,5,2,7,20,35,13,9,0,9,11,26,9,0,"https://fbref.com/en/players/c976160c/Mamadou-Coulibaly"
2022,"Salernitana","Serie A","Filippo Delli Carri","ITA","DF","22",1999,3.7,6,4,4,2,0,5,14,35.7,9,6,2,4,4,10,14,0,"https://fbref.com/en/players/d2e8fd9b/Filippo-Delli-Carri"
2022,"Salernitana","Serie A","Francesco Di Tacchio","ITA","MF","31",1990,13.9,17,7,5,10,2,9,25,36,16,16,8,8,22,39,25,0,"https://fbref.com/en/players/b5c3ff9f/Francesco-Di-Tacchio"
2022,"Salernitana","Serie A","Radu Drăgușin","ROU","DF","19",2002,5.4,5,4,2,3,0,4,10,40,6,7,3,4,13,18,17,0,"https://fbref.com/en/players/620922ed/Radu-Dragusin"
2022,"Salernitana","Serie A","Éderson","BRA","MF","22",1999,12.7,29,18,11,14,4,14,26,53.8,12,11,2,9,19,48,8,0,"https://fbref.com/en/players/a9202def/Ederson"
2022,"Salernitana","Serie A","Federico Fazio","ARG","DF","34",1987,15.9,17,11,10,6,1,9,12,75,3,21,16,5,27,44,67,1,"https://fbref.com/en/players/4e358a2d/Federico-Fazio"
2022,"Salernitana","Serie A","Vincenzo Fiorillo","ITA","GK","31",1990,1,0,0,0,0,0,0,0,NA,0,0,0,0,0,0,1,0,"https://fbref.com/en/players/a2565f79/Vincenzo-Fiorillo"
2022,"Salernitana","Serie A","Riccardo Gagliolo","SWE","DF","31",1990,12.6,23,12,16,4,3,16,27,59.3,11,15,8,7,28,51,52,0,"https://fbref.com/en/players/173061c0/Riccardo-Gagliolo"
2022,"Salernitana","Serie A","Cedric Gondo","CIV","FW","24",1996,7.8,5,2,2,2,1,2,5,40,3,2,0,2,3,8,2,0,"https://fbref.com/en/players/ff37d2ef/Cedric-Gondo"
2022,"Salernitana","Serie A","Norbert Gyömbér","SVK","DF","29",1992,28.5,53,32,40,11,2,33,50,66,17,38,24,14,44,97,126,1,"https://fbref.com/en/players/0be276c6/Norbert-Gyomber"
2022,"Salernitana","Serie A","Paweł Jaroszyński","POL","DF","26",1994,5.7,10,5,7,3,0,5,7,71.4,2,4,0,4,10,20,19,0,"https://fbref.com/en/players/958a601f/Pawel-Jaroszynski"
2022,"Salernitana","Serie A","Grigoris Kastanos","CYP","MF,FW","23",1998,15,30,19,9,19,2,7,23,30.4,16,21,5,16,22,52,8,0,"https://fbref.com/en/players/2a82aa85/Grigoris-Kastanos"
2022,"Salernitana","Serie A","Wajdi Kechrida","TUN","DF,MF","25",1995,10.6,9,6,6,3,0,8,13,61.5,5,10,2,8,8,17,15,0,"https://fbref.com/en/players/11962fe7/Wajdi-Kechrida"
2022,"Salernitana","Serie A","Julian Kristoffersen","NOR","FW","24",1997,0.1,0,0,0,0,0,0,0,NA,0,0,0,0,0,0,0,0,"https://fbref.com/en/players/b804c280/Julian-Kristoffersen"
2022,"Salernitana","Serie A","Pasquale Mazzocchi","ITA","DF","26",1995,14.1,28,19,15,11,2,14,34,41.2,20,5,0,5,11,39,31,0,"https://fbref.com/en/players/eb0ec070/Pasquale-Mazzocchi"
2022,"Salernitana","Serie A","Mikael","BRA","FW,MF","22",1999,1,1,1,0,1,0,0,0,NA,0,0,0,0,0,1,1,0,"https://fbref.com/en/players/33502726/Mikael"
2022,"Salernitana","Serie A","Andrei Motoc","ROU","DF","19",2002,1,1,1,0,1,0,0,0,NA,0,2,2,0,2,3,1,0,"https://fbref.com/en/players/b64073a0/Andrei-Motoc"
2022,"Salernitana","Serie A","Lys Mousset","FRA","MF,FW","25",1996,1.8,1,0,0,1,0,0,0,NA,0,2,0,2,0,1,0,0,"https://fbref.com/en/players/d9cfca3d/Lys-Mousset"
2022,"Salernitana","Serie A","Simeon Nwankwo","NGA","FW","29",1992,9.4,5,5,0,4,1,4,10,40,6,8,3,5,3,8,10,0,"https://fbref.com/en/players/80dbbd10/Simeon-Nwankwo"
2022,"Salernitana","Serie A","Joel Obi","NGA","MF,DF","30",1991,12.7,23,14,5,14,4,5,12,41.7,7,17,6,11,10,33,7,0,"https://fbref.com/en/players/614c38fb/Joel-Obi"
2022,"Salernitana","Serie A","Diego Perotti","ARG","MF,FW","33",1988,3.2,11,5,7,1,3,4,13,30.8,9,1,0,1,2,13,6,0,"https://fbref.com/en/players/a40d5a0c/Diego-Perotti"
2022,"Salernitana","Serie A","Mario Perrone","ITA","DF","18",2003,0.2,0,0,0,0,0,0,0,NA,0,0,0,0,0,0,0,0,"https://fbref.com/en/players/6cd33e2a/Mario-Perrone"
2022,"Salernitana","Serie A","Ivan Radovanović","SRB","DF,MF","32",1988,11.7,11,7,8,3,0,7,19,36.8,12,14,7,7,7,18,29,0,"https://fbref.com/en/players/023937a9/Ivan-Radovanovic"
2022,"Salernitana","Serie A","Luca Ranieri","ITA","DF","22",1999,23.4,38,21,23,11,4,19,33,57.6,14,18,8,10,22,60,67,0,"https://fbref.com/en/players/8c63fae5/Luca-Ranieri"
2022,"Salernitana","Serie A","Franck Ribéry","FRA","MF,FW","38",1983,15.8,17,10,6,6,5,8,13,61.5,5,12,0,12,3,20,1,0,"https://fbref.com/en/players/f61c7c4e/Franck-Ribery"
2022,"Salernitana","Serie A","Matteo Ruggeri","ITA","DF","19",2002,7.5,8,4,5,2,1,7,10,70,3,6,1,5,2,10,25,0,"https://fbref.com/en/players/ae9898c5/Matteo-Ruggeri"
2022,"Salernitana","Serie A","Alessandro Russo","ITA","MF","17",2003,0.3,1,0,1,0,0,0,1,0,1,0,0,0,0,1,1,0,"https://fbref.com/en/players/7152082d/Alessandro-Russo"
2022,"Salernitana","Serie A","Andrea Schiavone","ITA","MF","28",1993,6.3,14,8,5,9,0,10,23,43.5,13,13,3,10,8,22,12,0,"https://fbref.com/en/players/4b55eb4d/Andrea-Schiavone"
2022,"Salernitana","Serie A","Luigi Sepe","ITA","GK","30",1991,15.5,0,0,0,0,0,0,0,NA,0,0,0,0,1,1,3,0,"https://fbref.com/en/players/343f753a/Luigi-Sepe"
2022,"Salernitana","Serie A","Stefan Strandberg","NOR","DF","31",1990,10.4,13,8,10,3,0,8,11,72.7,3,15,13,2,9,22,49,0,"https://fbref.com/en/players/6d5e62b0/Stefan-Strandberg"
2022,"Salernitana","Serie A","Simone Verdi","ITA","FW,MF","29",1992,9.2,12,8,5,2,5,9,20,45,11,4,0,4,3,15,1,0,"https://fbref.com/en/players/0375723e/Simone-Verdi"
2022,"Salernitana","Serie A","Edoardo Vergani","ITA","FW,MF","20",2001,1.1,2,2,2,0,0,0,0,NA,0,2,2,0,0,2,2,0,"https://fbref.com/en/players/2873973b/Edoardo-Vergani"
2022,"Salernitana","Serie A","Freddie Veseli","ALB","DF","28",1992,6.6,7,2,4,3,0,5,6,83.3,1,10,5,5,4,11,19,0,"https://fbref.com/en/players/d541e703/Freddie-Veseli"
2022,"Salernitana","Serie A","Nadir Zortea","ITA","DF,MF","22",1999,15.7,21,15,9,7,5,11,19,57.9,8,14,2,12,7,28,33,0,"https://fbref.com/en/players/82598b71/Nadir-Zortea"
2022,"Salernitana","Serie A","Milan Đurić","BIH","FW","31",1990,24.1,1,1,0,1,0,1,3,33.3,2,6,1,5,2,3,32,0,"https://fbref.com/en/players/405f6586/Milan-Djuric"
2022,"Sampdoria","Serie A","Kristoffer Askildsen","NOR","MF","20",2001,8.4,18,6,7,11,0,9,19,47.4,10,14,7,7,15,33,15,0,"https://fbref.com/en/players/a69cc629/Kristoffer-Askildsen"
2022,"Sampdoria","Serie A","Emil Audero","ITA","GK","24",1997,28.4,3,1,3,0,0,3,5,60,2,0,0,0,2,5,17,2,"https://fbref.com/en/players/649b01d8/Emil-Audero"
2022,"Sampdoria","Serie A","Tommaso Augello","ITA","DF","26",1994,26.6,36,20,22,8,6,17,29,58.6,12,19,4,15,29,65,68,1,"https://fbref.com/en/players/3cd3b384/Tommaso-Augello"
2022,"Sampdoria","Serie A","Bartosz Bereszyński","POL","DF","29",1992,32.7,64,38,34,25,5,37,80,46.3,43,38,12,26,42,106,73,1,"https://fbref.com/en/players/61b3978f/Bartosz-Bereszynski"
2022,"Sampdoria","Serie A","Antonio Candreva","ITA","MF,FW","34",1987,34.7,27,16,9,11,7,19,55,34.5,36,23,2,21,33,60,19,0,"https://fbref.com/en/players/356c9002/Antonio-Candreva"
2022,"Sampdoria","Serie A","Francesco Caputo","ITA","FW","33",1987,31,5,2,1,3,1,1,6,16.7,5,5,0,5,2,7,10,0,"https://fbref.com/en/players/5bd72174/Francesco-Caputo"
2022,"Sampdoria","Serie A","Julian Chabot","GER","DF","23",1998,5.4,12,10,8,4,0,8,10,80,2,7,4,3,9,21,28,1,"https://fbref.com/en/players/ae7058f9/Julian-Chabot"
2022,"Sampdoria","Serie A","Riccardo Ciervo","ITA","MF,DF","19",2002,2.5,8,3,4,3,1,2,6,33.3,4,1,0,1,2,10,2,0,"https://fbref.com/en/players/da77b60b/Riccardo-Ciervo"
2022,"Sampdoria","Serie A","Omar Colley","GAM","DF","28",1992,30.5,47,36,32,14,1,22,32,68.8,10,31,19,12,80,127,135,2,"https://fbref.com/en/players/8b95acda/Omar-Colley"
2022,"Sampdoria","Serie A","Andrea Conti","ITA","DF,MF","27",1994,2.6,4,2,2,1,1,3,6,50,3,4,0,4,7,11,4,0,"https://fbref.com/en/players/8fef5412/Andrea-Conti"
2022,"Sampdoria","Serie A","Mikkel Damsgaard","DEN","MF,FW","21",2000,6.4,27,13,12,11,4,20,36,55.6,16,16,1,15,7,34,7,0,"https://fbref.com/en/players/215f3907/Mikkel-Damsgaard"
2022,"Sampdoria","Serie A","Fabio Depaoli","ITA","MF,DF","24",1997,1.2,3,1,1,2,0,0,2,0,2,2,1,1,1,4,2,0,"https://fbref.com/en/players/d97f2e8d/Fabio-Depaoli"
2022,"Sampdoria","Serie A","Radu Drăgușin","ROU","DF","19",2002,6.9,4,3,2,2,0,2,6,33.3,4,8,4,4,10,14,33,0,"https://fbref.com/en/players/620922ed/Radu-Dragusin"
2022,"Sampdoria","Serie A","Albin Ekdal","SWE","MF","32",1989,18.2,43,28,17,21,5,26,56,46.4,30,27,7,20,29,72,25,0,"https://fbref.com/en/players/f503ea63/Albin-Ekdal"
2022,"Sampdoria","Serie A","Wladimiro Falcone","ITA","GK","26",1995,9.5,0,0,0,0,0,0,0,NA,0,0,0,0,1,1,5,0,"https://fbref.com/en/players/9f5a610b/Wladimiro-Falcone"
2022,"Sampdoria","Serie A","Alex Ferrari","ITA","DF","27",1994,18.3,40,22,28,9,3,19,33,57.6,14,31,22,9,39,79,63,1,"https://fbref.com/en/players/d0dbca9f/Alex-Ferrari"
2022,"Sampdoria","Serie A","Manolo Gabbiadini","ITA","FW,MF","29",1991,12.7,6,4,3,2,1,1,7,14.3,6,5,2,3,3,9,10,0,"https://fbref.com/en/players/8f866fe8/Manolo-Gabbiadini"
2022,"Sampdoria","Serie A","Sebastian Giovinco","ITA","MF","34",1987,0.4,0,0,0,0,0,0,1,0,1,0,0,0,0,0,0,0,"https://fbref.com/en/players/2b7c18ae/Sebastian-Giovinco"
2022,"Sampdoria","Serie A","Giangiacomo Magnani","ITA","DF","25",1995,2.7,4,2,4,0,0,1,1,100,0,2,2,0,7,11,12,0,"https://fbref.com/en/players/cce9f582/Giangiacomo-Magnani"
2022,"Sampdoria","Serie A","Nicola Murru","ITA","DF","26",1994,10.9,22,17,10,11,1,8,13,61.5,5,17,3,14,7,29,20,1,"https://fbref.com/en/players/d183e9d6/Nicola-Murru"
2022,"Sampdoria","Serie A","Fabio Quagliarella","ITA","FW","38",1983,18.5,6,2,2,2,2,2,15,13.3,13,14,1,13,3,9,12,0,"https://fbref.com/en/players/ee4f2f3b/Fabio-Quagliarella"
2022,"Sampdoria","Serie A","Nicola Ravaglia","ITA","GK","32",1988,0.1,0,0,0,0,0,0,0,NA,0,0,0,0,0,0,0,0,"https://fbref.com/en/players/d7a35008/Nicola-Ravaglia"
2022,"Sampdoria","Serie A","Tomás Rincón","VEN","MF","33",1988,13,22,13,9,10,3,13,34,38.2,21,15,2,13,18,40,11,0,"https://fbref.com/en/players/f1cfc209/Tomas-Rincon"
2022,"Sampdoria","Serie A","Abdelhamid Sabiri","MAR","MF,FW","24",1996,9.9,34,18,10,15,9,7,25,28,18,10,2,8,7,41,3,0,"https://fbref.com/en/players/4830e0af/Abdelhamid-Sabiri"
2022,"Sampdoria","Serie A","Stefano Sensi","ITA","MF,FW","25",1995,8.4,18,9,10,6,2,10,23,43.5,13,2,0,2,6,24,4,0,"https://fbref.com/en/players/b70bde8f/Stefano-Sensi"
2022,"Sampdoria","Serie A","Adrien Silva","POR","MF","32",1989,12,24,12,14,5,5,9,33,27.3,24,15,5,10,23,47,23,0,"https://fbref.com/en/players/d6f88a1d/Adrien-Silva"
2022,"Sampdoria","Serie A","Vladyslav Supriaha","UKR","FW","21",2000,0.2,0,0,0,0,0,0,1,0,1,0,0,0,0,0,0,0,"https://fbref.com/en/players/73affbb6/Vladyslav-Supriaha"
2022,"Sampdoria","Serie A","Morten Thorsby","NOR","MF","25",1996,32.7,46,26,15,23,8,28,56,50,28,37,12,25,25,71,39,0,"https://fbref.com/en/players/d1b49282/Morten-Thorsby"
2022,"Sampdoria","Serie A","Ernesto Torregrossa","VEN","FW","29",1992,1.3,2,1,1,0,1,1,2,50,1,0,0,0,0,2,1,0,"https://fbref.com/en/players/bf39bdec/Ernesto-Torregrossa"
2022,"Sampdoria","Serie A","Simone Trimboli","ITA","MF","19",2002,0.7,2,1,2,0,0,2,2,100,0,0,0,0,2,4,0,0,"https://fbref.com/en/players/f5f21026/Simone-Trimboli"
2022,"Sampdoria","Serie A","Valerio Verre","ITA","MF,FW","27",1994,4.7,7,5,1,4,2,4,9,44.4,5,7,0,7,0,7,5,0,"https://fbref.com/en/players/33ecf462/Valerio-Verre"
2022,"Sampdoria","Serie A","Ronaldo Vieira","GNB","MF","23",1998,5.5,NA,6,NA,NA,NA,NA,NA,NA,NA,NA,NA,NA,5,NA,NA,NA,"https://fbref.com/en/players/75e60d75/Ronaldo-Vieira"
2022,"Sampdoria","Serie A","Gerard Yepes","ESP","MF,DF","18",2002,0.2,1,0,0,1,0,1,1,100,0,1,0,1,0,1,0,0,"https://fbref.com/en/players/ee9040b4/Gerard-Yepes"
2022,"Sampdoria","Serie A","Maya Yoshida","JPN","DF","32",1988,20.3,17,10,8,9,0,8,15,53.3,7,27,20,7,28,45,72,1,"https://fbref.com/en/players/caffaf5a/Maya-Yoshida"
2022,"Sassuolo","Serie A","Kaan Ayhan","TUR","DF","26",1994,15,20,12,14,6,0,7,15,46.7,8,20,14,6,13,33,57,0,"https://fbref.com/en/players/2200181e/Kaan-Ayhan"
2022,"Sassuolo","Serie A","Domenico Berardi","ITA","FW","26",1994,31.3,32,19,9,16,7,15,57,26.3,42,39,2,37,31,63,23,0,"https://fbref.com/en/players/53a0e358/Domenico-Berardi"
2022,"Sassuolo","Serie A","Jeremie Boga","CIV","FW,MF","24",1997,7.4,7,4,1,2,4,2,3,66.7,1,3,0,3,2,9,1,1,"https://fbref.com/en/players/fe012aca/Jeremie-Boga"
2022,"Sassuolo","Serie A","Francesco Caputo","ITA","FW","33",1987,1.7,0,0,0,0,0,0,0,NA,0,0,0,0,0,0,0,0,"https://fbref.com/en/players/5bd72174/Francesco-Caputo"
2022,"Sassuolo","Serie A","Emil Ceide","NOR","FW,MF","19",2001,0.6,1,1,0,1,0,1,2,50,1,1,0,1,0,1,0,0,"https://fbref.com/en/players/98a84572/Emil-Ceide"
2022,"Sassuolo","Serie A","Vlad Chiricheș","ROU","DF","31",1989,25.6,28,15,19,9,0,10,21,47.6,11,34,21,13,41,69,71,4,"https://fbref.com/en/players/c316607a/Vlad-Chiriches"
2022,"Sassuolo","Serie A","Andrea Consigli","ITA","GK","34",1987,36.9,0,0,0,0,0,0,2,0,2,0,0,0,0,0,23,3,"https://fbref.com/en/players/8cabdc1e/Andrea-Consigli"
2022,"Sassuolo","Serie A","Grégoire Defrel","MTQ","FW","30",1991,15.1,15,9,4,8,3,6,16,37.5,10,11,1,10,4,19,11,0,"https://fbref.com/en/players/854ee61a/Gregoire-Defrel"
2022,"Sassuolo","Serie A","Davide Frattesi","ITA","MF","21",1999,31.7,46,16,26,18,2,26,52,50,26,44,12,32,29,75,62,1,"https://fbref.com/en/players/2a7d27c1/Davide-Frattesi"
2022,"Sassuolo","Serie A","Edoardo Goldaniga","ITA","DF,MF","27",1993,0,0,0,0,0,0,0,0,NA,0,0,0,0,0,0,0,0,"https://fbref.com/en/players/4b029b31/Edoardo-Goldaniga"
2022,"Sassuolo","Serie A","Abdou Harroui","NED","MF","23",1998,5,11,4,4,7,0,8,11,72.7,3,14,0,14,4,15,5,0,"https://fbref.com/en/players/65fd099c/Abdou-Harroui"
2022,"Sassuolo","Serie A","Matheus Henrique","BRA","MF","23",1997,12,10,3,6,3,1,6,24,25,18,14,2,12,7,17,12,1,"https://fbref.com/en/players/a2d9f138/Matheus-Henrique"
2022,"Sassuolo","Serie A","Hamed Junior Traorè","CIV","FW,MF","21",2000,19.7,32,18,8,14,10,10,46,21.7,36,22,2,20,12,44,6,1,"https://fbref.com/en/players/570bb4b9/Hamed-Junior-Traore"
2022,"Sassuolo","Serie A","Giorgos Kyriakopoulos","GRE","DF,FW","25",1996,21.9,30,14,19,7,4,19,38,50,19,32,9,23,11,41,52,0,"https://fbref.com/en/players/0a483542/Giorgos-Kyriakopoulos"
2022,"Sassuolo","Serie A","Maxime Lopez","FRA","MF","23",1997,32.6,69,36,40,27,2,35,87,40.2,52,33,7,26,42,111,38,1,"https://fbref.com/en/players/20094685/Maxime-Lopez"
2022,"Sassuolo","Serie A","Francesco Magnanelli","ITA","MF","36",1984,3,5,4,4,1,0,1,9,11.1,8,3,1,2,1,6,3,0,"https://fbref.com/en/players/07767f42/Francesco-Magnanelli"
2022,"Sassuolo","Serie A","Gian Marco Ferrari","ITA","DF","29",1992,34.7,16,11,10,6,0,10,23,43.5,13,37,27,10,43,59,114,2,"https://fbref.com/en/players/8650af85/Gian-Marco-Ferrari"
2022,"Sassuolo","Serie A","Mert Müldür","TUR","DF","22",1999,22.7,52,35,43,7,2,27,49,55.1,22,25,6,19,24,76,44,1,"https://fbref.com/en/players/1295552e/Mert-Muldur"
2022,"Sassuolo","Serie A","Brian Oddei","ITA","FW","18",2002,0.1,0,0,0,0,0,0,0,NA,0,0,0,0,0,0,0,0,"https://fbref.com/en/players/97e8ea97/Brian-Oddei"
2022,"Sassuolo","Serie A","Gianluca Pegolo","ITA","GK","40",1981,1,0,0,0,0,0,0,0,NA,0,0,0,0,0,0,0,1,"https://fbref.com/en/players/f058ed1f/Gianluca-Pegolo"
2022,"Sassuolo","Serie A","Federico Peluso","ITA","DF","37",1984,0.1,1,1,0,1,0,1,1,100,0,0,0,0,0,1,0,0,"https://fbref.com/en/players/4f2908e5/Federico-Peluso"
2022,"Sassuolo","Serie A","Giacomo Raspadori","ITA","MF,FW","21",2000,30.4,29,18,5,15,9,11,38,28.9,27,29,3,26,9,38,11,0,"https://fbref.com/en/players/6e058f06/Giacomo-Raspadori"
2022,"Sassuolo","Serie A","Rogério","BRA","DF","23",1998,19.2,21,13,12,5,4,15,22,68.2,7,20,8,12,18,39,42,1,"https://fbref.com/en/players/10e7f486/Rogerio"
2022,"Sassuolo","Serie A","Ruan","BRA","DF","22",1999,2.4,7,4,7,0,0,3,4,75,1,6,5,1,2,9,24,1,"https://fbref.com/en/players/a378a02a/Ruan"
2022,"Sassuolo","Serie A","Luigi Samele","ITA","FW","19",2002,0.1,0,0,0,0,0,0,0,NA,0,0,0,0,0,0,1,0,"https://fbref.com/en/players/548fea2f/Luigi-Samele"
2022,"Sassuolo","Serie A","Giacomo Satalino","ITA","GK","22",1999,0.1,0,0,0,0,0,0,0,NA,0,0,0,0,0,0,0,0,"https://fbref.com/en/players/b1f0b916/Giacomo-Satalino"
2022,"Sassuolo","Serie A","Gianluca Scamacca","ITA","FW","22",1999,23.8,19,14,2,5,12,5,21,23.8,16,16,1,15,5,24,22,1,"https://fbref.com/en/players/8790f988/Gianluca-Scamacca"
2022,"Sassuolo","Serie A","Jeremy Toljan","GER","DF","26",1994,15.5,18,10,12,4,2,13,20,65,7,12,5,7,12,30,41,0,"https://fbref.com/en/players/a96e5dc0/Jeremy-Toljan"
2022,"Sassuolo","Serie A","Filip Đuričić","SRB","MF,FW","29",1992,7.5,13,10,7,1,5,5,13,38.5,8,7,1,6,4,17,1,0,"https://fbref.com/en/players/eccbe56a/Filip-Djuricic"
2022,"Sevilla","La Liga","Marcos Acuña","ARG","DF","29",1991,25.1,50,29,27,14,9,30,46,65.2,16,22,5,17,14,64,25,1,"https://fbref.com/en/players/81442ecb/Marcos-Acuna"
2022,"Sevilla","La Liga","Ludwig Augustinsson","SWE","DF,FW","27",1994,8.8,18,14,11,3,4,8,13,61.5,5,10,3,7,5,23,21,0,"https://fbref.com/en/players/9fec8860/Ludwig-Augustinsson"
2022,"Sevilla","La Liga","Yassine Bounou","MAR","GK","30",1991,31,0,0,0,0,0,0,0,NA,0,0,0,0,0,0,11,1,"https://fbref.com/en/players/f6798fc3/Yassine-Bounou"
2022,"Sevilla","La Liga","Diego Carlos","BRA","DF","28",1993,32.9,35,24,20,13,2,16,24,66.7,8,48,33,15,24,59,120,5,"https://fbref.com/en/players/b4a014b1/Diego-Carlos"
2022,"Sevilla","La Liga","Carmona","ESP","DF","19",2002,0.3,0,0,0,0,0,0,0,NA,0,0,0,0,1,1,0,0,"https://fbref.com/en/players/2dce876a/Carmona"
2022,"Sevilla","La Liga","Jesús Corona","MEX","FW,DF","28",1993,12.9,12,7,7,5,0,3,6,50,3,4,0,4,8,20,6,0,"https://fbref.com/en/players/fb938d24/Jesus-Corona"
2022,"Sevilla","La Liga","Thomas Delaney","DEN","MF","29",1991,17.2,41,24,17,21,3,16,30,53.3,14,19,10,9,13,54,35,0,"https://fbref.com/en/players/fe641c1a/Thomas-Delaney"
2022,"Sevilla","La Liga","Javier Díaz","ESP","GK","24",1997,1,0,0,0,0,0,0,0,NA,0,0,0,0,0,0,0,0,"https://fbref.com/en/players/17a1299d/Javier-Diaz"
2022,"Sevilla","La Liga","Marko Dmitrović","SRB","GK","29",1992,6,0,0,0,0,0,0,0,NA,0,0,0,0,0,0,3,1,"https://fbref.com/en/players/ac295d9e/Marko-Dmitrovic"
2022,"Sevilla","La Liga","Youssef En-Nesyri","MAR","FW","24",1997,14.2,10,5,5,2,3,4,11,36.4,7,9,1,8,4,14,18,0,"https://fbref.com/en/players/04e17fd5/Youssef-En-Nesyri"
2022,"Sevilla","La Liga","Fernando","BRA","MF,DF","34",1987,20.6,24,17,14,9,1,12,33,36.4,21,21,13,8,29,53,32,2,"https://fbref.com/en/players/41f32541/Fernando"
2022,"Sevilla","La Liga","Papu Gómez","ARG","FW,MF","33",1988,19.8,19,11,9,5,5,9,35,25.7,26,15,2,13,7,26,12,2,"https://fbref.com/en/players/6e4df551/Papu-Gomez"
2022,"Sevilla","La Liga","Nemanja Gudelj","SRB","DF,MF","29",1991,11.6,16,7,10,4,2,5,8,62.5,3,14,9,5,22,38,37,0,"https://fbref.com/en/players/0076ab7f/Nemanja-Gudelj"
2022,"Sevilla","La Liga","Munir El Haddadi","MAR","FW,MF","25",1995,5.3,8,4,1,6,1,2,8,25,6,7,1,6,5,13,2,0,"https://fbref.com/en/players/8696bc90/Munir-El-Haddadi"
2022,"Sevilla","La Liga","Oussama Idrissi","MAR","MF,FW","25",1996,1.4,1,0,0,1,0,0,1,0,1,1,0,1,1,2,1,0,"https://fbref.com/en/players/34caa4b3/Oussama-Idrissi"
2022,"Sevilla","La Liga","Joan Jordán","ESP","MF","27",1994,27.9,61,30,22,31,8,28,65,43.1,37,27,6,21,30,91,18,1,"https://fbref.com/en/players/2a0c8ba4/Joan-Jordan"
2022,"Sevilla","La Liga","Jules Koundé","FRA","DF","22",1998,30.4,40,17,27,10,3,18,28,64.3,10,33,18,15,21,61,101,2,"https://fbref.com/en/players/4d1666ff/Jules-Kounde"
2022,"Sevilla","La Liga","Érik Lamela","ARG","FW,MF","29",1992,11.3,31,18,12,14,5,10,29,34.5,19,11,0,11,5,36,3,0,"https://fbref.com/en/players/abe66106/Erik-Lamela"
2022,"Sevilla","La Liga","Luismi","ESP","FW,MF","20",2001,0.1,0,0,0,0,0,0,0,NA,0,0,0,0,0,0,0,0,"https://fbref.com/en/players/acf5410c/Luismi"
2022,"Sevilla","La Liga","Anthony Martial","FRA","FW,MF","25",1995,5.4,2,1,0,0,2,2,6,33.3,4,4,0,4,0,2,3,0,"https://fbref.com/en/players/8b788c01/Anthony-Martial"
2022,"Sevilla","La Liga","Rafa Mir","ESP","FW","24",1997,20.1,4,3,1,1,2,0,11,0,11,4,3,1,0,4,17,0,"https://fbref.com/en/players/bbf5c11b/Rafa-Mir"
2022,"Sevilla","La Liga","Gonzalo Montiel","ARG","DF","24",1997,11.8,15,4,8,5,2,12,24,50,12,8,2,6,10,25,22,0,"https://fbref.com/en/players/374d5158/Gonzalo-Montiel"
2022,"Sevilla","La Liga","Jesús Navas","ESP","DF","35",1985,19.8,18,13,11,5,2,9,17,52.9,8,15,2,13,17,35,26,1,"https://fbref.com/en/players/3f10bd22/Jesus-Navas"
2022,"Sevilla","La Liga","Lucas Ocampos","ARG","FW","27",1994,23.6,45,24,23,18,4,23,55,41.8,32,35,1,34,9,54,24,1,"https://fbref.com/en/players/a08b974a/Lucas-Ocampos"
2022,"Sevilla","La Liga","Pedro Ortiz","ESP","MF","20",2000,0.1,0,0,0,0,0,0,0,NA,0,0,0,0,0,0,1,0,"https://fbref.com/en/players/f9358b61/Pedro-Ortiz"
2022,"Sevilla","La Liga","Ivan Rakitić","CRO","MF","33",1988,24.2,40,22,12,23,5,13,40,32.5,27,31,8,23,23,63,35,0,"https://fbref.com/en/players/89f951b5/Ivan-Rakitic"
2022,"Sevilla","La Liga","Karim Rekik","NED","DF","26",1994,12.2,11,8,4,6,1,2,9,22.2,7,11,6,5,9,20,19,0,"https://fbref.com/en/players/3376a776/Karim-Rekik"
2022,"Sevilla","La Liga","Óscar Rodríguez Arnaiz","ESP","FW,MF","23",1998,4.6,4,3,1,3,0,2,3,66.7,1,2,0,2,5,9,7,1,"https://fbref.com/en/players/19709006/Oscar-Rodriguez-Arnaiz"
2022,"Sevilla","La Liga","Iván Romero","ESP","FW","20",2001,2,2,2,0,2,0,0,0,NA,0,1,0,1,2,4,0,0,"https://fbref.com/en/players/2fbe6af0/Ivan-Romero"
2022,"Sevilla","La Liga","Juan Sánchez","ESP","","17",2003,0.1,NA,0,NA,NA,NA,NA,NA,NA,NA,NA,NA,NA,0,NA,NA,NA,"https://fbref.com/en/players/ff4f78e1/Juan-Sanchez"
2022,"Sevilla","La Liga","Valentino Scotta","ESP","DF","19",2001,0,0,0,0,0,0,0,0,NA,0,0,0,0,0,0,0,0,"https://fbref.com/en/players/98529579/Valentino-Scotta"
2022,"Sevilla","La Liga","Suso","ESP","FW","27",1993,4.3,4,3,1,3,0,3,13,23.1,10,4,0,4,0,4,0,0,"https://fbref.com/en/players/4e219ad2/Suso"
2022,"Sevilla","La Liga","Óliver Torres","ESP","MF,FW","26",1994,11.2,22,12,8,7,7,8,25,32,17,10,1,9,6,28,4,0,"https://fbref.com/en/players/58a9a4d9/Oliver-Torres"
2022,"Southampton","Premier League","Che Adams","SCO","FW","25",1996,22.7,13,6,5,5,3,2,16,12.5,14,18,2,16,8,21,18,0,"https://fbref.com/en/players/f2bf1b0f/Che-Adams"
2022,"Southampton","Premier League","Adam Armstrong","ENG","FW","24",1997,15.7,10,4,2,2,6,0,6,0,6,13,1,12,3,13,6,0,"https://fbref.com/en/players/68c720b5/Adam-Armstrong"
2022,"Southampton","Premier League","Stuart Armstrong","SCO","MF","29",1992,16.4,27,19,15,6,6,9,23,39.1,14,10,1,9,8,35,15,0,"https://fbref.com/en/players/97333cf5/Stuart-Armstrong"
2022,"Southampton","Premier League","Jan Bednarek","POL","DF","25",1996,29.2,32,15,18,13,1,19,33,57.6,14,48,27,21,72,104,141,0,"https://fbref.com/en/players/4115ce4e/Jan-Bednarek"
2022,"Southampton","Premier League","Armando Broja","ALB","FW","19",2001,21.9,12,5,2,7,3,2,9,22.2,7,17,1,16,3,15,11,0,"https://fbref.com/en/players/97220da2/Armando-Broja"
2022,"Southampton","Premier League","Willy Caballero","ARG","GK","39",1981,2,0,0,0,0,0,0,0,NA,0,0,0,0,0,0,2,1,"https://fbref.com/en/players/a179d516/Willy-Caballero"
2022,"Southampton","Premier League","Ibrahima Diallo","FRA","MF","22",1999,11.4,22,11,10,9,3,10,24,41.7,14,7,0,7,9,31,10,0,"https://fbref.com/en/players/11ff3d56/Ibrahima-Diallo"
2022,"Southampton","Premier League","Moussa Djenepo","MLI","MF","23",1998,5.1,9,3,3,5,1,3,11,27.3,8,6,1,5,2,11,6,1,"https://fbref.com/en/players/254147d4/Moussa-Djenepo"
2022,"Southampton","Premier League","Mohamed Elyounoussi","NOR","MF,FW","26",1994,22.7,36,17,14,15,7,11,39,28.2,28,23,2,21,12,48,28,0,"https://fbref.com/en/players/68dc0dac/Mohamed-Elyounoussi"
2022,"Southampton","Premier League","Fraser Forster","ENG","GK","33",1988,19,1,0,1,0,0,0,1,0,1,0,0,0,0,1,23,2,"https://fbref.com/en/players/c3e39f12/Fraser-Forster"
2022,"Southampton","Premier League","Valentino Livramento","ENG","DF","18",2002,24.5,54,28,30,18,6,27,45,60,18,23,9,14,47,101,50,1,"https://fbref.com/en/players/afed6722/Valentino-Livramento"
2022,"Southampton","Premier League","Shane Long","IRL","FW","34",1987,3.4,9,5,2,4,3,1,1,100,0,4,0,4,0,9,2,0,"https://fbref.com/en/players/9f472354/Shane-Long"
2022,"Southampton","Premier League","Lyanco","BRA","DF","24",1997,10.1,18,15,11,7,0,10,18,55.6,8,18,13,5,13,31,50,1,"https://fbref.com/en/players/b5bf1770/Lyanco"
2022,"Southampton","Premier League","Alex McCarthy","ENG","GK","31",1989,17,0,0,0,0,0,0,0,NA,0,0,0,0,0,0,4,0,"https://fbref.com/en/players/36c2ca73/Alex-McCarthy"
2022,"Southampton","Premier League","Romain Perraud","FRA","DF","23",1997,18,34,22,18,14,2,16,29,55.2,13,24,6,18,17,51,42,0,"https://fbref.com/en/players/6dfd8f05/Romain-Perraud"
2022,"Southampton","Premier League","Nathan Redmond","ENG","MF,FW","27",1994,20.4,22,14,9,9,4,7,30,23.3,23,21,2,19,8,30,16,0,"https://fbref.com/en/players/ab651565/Nathan-Redmond"
2022,"Southampton","Premier League","Oriol Romeu","ESP","MF","29",1991,32.1,77,39,25,45,7,28,73,38.4,45,39,8,31,51,128,43,0,"https://fbref.com/en/players/4b511457/Oriol-Romeu"
2022,"Southampton","Premier League","Mohammed Salisu","GHA","DF","22",1999,33,80,47,54,22,4,40,65,61.5,25,49,26,23,78,158,158,4,"https://fbref.com/en/players/0b33f6ad/Mohammed-Salisu"
2022,"Southampton","Premier League","William Smallbone","IRL","MF,FW","21",2000,1.5,4,4,2,2,0,1,3,33.3,2,4,0,4,2,6,0,0,"https://fbref.com/en/players/5e105217/William-Smallbone"
2022,"Southampton","Premier League","Jack Stephens","ENG","DF","27",1994,9,19,12,13,5,1,6,16,37.5,10,12,7,5,19,38,42,0,"https://fbref.com/en/players/6adbc307/Jack-Stephens"
2022,"Southampton","Premier League","Nathan Tella","ENG","MF,FW","22",1999,8.9,13,9,5,7,1,6,17,35.3,11,13,0,13,6,19,9,0,"https://fbref.com/en/players/f1e94cd6/Nathan-Tella"
2022,"Southampton","Premier League","Yan Valery","TUN","DF","22",1999,4.1,8,6,4,3,1,4,9,44.4,5,6,3,3,6,14,19,1,"https://fbref.com/en/players/531a4aa8/Yan-Valery"
2022,"Southampton","Premier League","Theo Walcott","ENG","MF,FW","32",1989,4.2,4,2,2,0,2,1,5,20,4,3,0,3,5,9,2,0,"https://fbref.com/en/players/1ecb65be/Theo-Walcott"
2022,"Southampton","Premier League","Kyle Walker-Peters","ENG","DF","24",1997,29.3,57,33,28,21,8,26,38,68.4,12,29,8,21,37,94,53,1,"https://fbref.com/en/players/984a5a64/Kyle-Walker-Peters"
2022,"Southampton","Premier League","James Ward-Prowse","ENG","MF","26",1994,35.7,41,24,12,24,5,19,70,27.1,51,43,15,28,40,81,45,1,"https://fbref.com/en/players/3515d404/James-Ward-Prowse"
2022,"Spezia","Serie A","Kevin Agudelo","COL","MF,FW","22",1998,13.7,44,26,13,26,5,7,20,35,13,22,0,22,8,52,6,0,"https://fbref.com/en/players/46fa7204/Kevin-Agudelo"
2022,"Spezia","Serie A","Kelvin Amian","FRA","DF","23",1998,29.4,66,42,43,18,5,30,41,73.2,11,39,21,18,32,98,75,0,"https://fbref.com/en/players/bcc81786/Kelvin-Amian"
2022,"Spezia","Serie A","Janis Antiste","FRA","FW","18",2002,8.8,18,11,6,6,6,5,13,38.5,8,7,1,6,4,22,6,0,"https://fbref.com/en/players/38d9ce53/Janis-Antiste"
2022,"Spezia","Serie A","Simone Bastoni","ITA","MF,DF","24",1996,25.4,52,34,28,17,7,21,65,32.3,44,38,11,27,30,82,31,0,"https://fbref.com/en/players/1ac232b8/Simone-Bastoni"
2022,"Spezia","Serie A","Nicolò Bertola","ITA","MF,DF","18",2003,0.4,3,2,3,0,0,3,4,75,1,0,0,0,3,6,1,0,"https://fbref.com/en/players/04b40c58/Nicolo-Bertola"
2022,"Spezia","Serie A","Mehdi Bourabia","MAR","MF","29",1991,3.1,5,1,2,3,0,3,11,27.3,8,7,6,1,3,8,10,0,"https://fbref.com/en/players/0d077b88/Mehdi-Bourabia"
2022,"Spezia","Serie A","Ebrima Colley","GAM","FW,MF","21",2000,4.4,6,1,3,2,1,1,7,14.3,6,8,0,8,3,9,2,0,"https://fbref.com/en/players/bf356094/Ebrima-Colley"
2022,"Spezia","Serie A","Martin Erlic","CRO","DF","23",1998,28.6,28,16,18,10,0,10,18,55.6,8,54,39,15,28,56,122,1,"https://fbref.com/en/players/0fee6bda/Martin-Erlic"
2022,"Spezia","Serie A","Salvador Ferrer","ESP","DF,MF","23",1998,16.6,32,18,15,9,8,12,25,48,13,24,12,12,18,50,46,0,"https://fbref.com/en/players/eb76987d/Salvador-Ferrer"
2022,"Spezia","Serie A","Emmanuel Gyasi","GHA","FW,MF","27",1994,33.7,47,30,31,9,7,21,41,51.2,20,22,4,18,16,63,43,1,"https://fbref.com/en/players/f9758dae/Emmanuel-Gyasi"
2022,"Spezia","Serie A","Petko Hristov","BUL","DF","22",1999,13.9,17,10,11,6,0,10,16,62.5,6,29,23,6,19,36,47,0,"https://fbref.com/en/players/d8800a46/Petko-Hristov"
2022,"Spezia","Serie A","Jakub Kiwior","POL","MF","21",2000,21.8,50,27,25,19,6,26,57,45.6,31,38,15,23,40,90,53,0,"https://fbref.com/en/players/dc3e663e/Jakub-Kiwior"
2022,"Spezia","Serie A","Viktor Kovalenko","UKR","MF","25",1996,14.7,16,10,7,8,1,9,21,42.9,12,16,3,13,13,29,8,0,"https://fbref.com/en/players/9d60028d/Viktor-Kovalenko"
2022,"Spezia","Serie A","Giulio Maggiore","ITA","MF","23",1998,31.3,58,32,20,32,6,31,77,40.3,46,30,5,25,29,87,33,0,"https://fbref.com/en/players/957e4c87/Giulio-Maggiore"
2022,"Spezia","Serie A","Rey Manaj","ALB","FW","24",1997,19.6,19,12,3,11,5,6,26,23.1,20,16,0,16,4,23,13,0,"https://fbref.com/en/players/7703afb6/Rey-Manaj"
2022,"Spezia","Serie A","Samuel Mráz","SVK","FW","24",1997,0.6,0,0,0,0,0,0,0,NA,0,1,0,1,0,0,0,0,"https://fbref.com/en/players/be6c1ccc/Samuel-Mraz"
2022,"Spezia","Serie A","Aurélien Nguiamba","FRA","MF","22",1999,0.6,3,2,1,2,0,2,3,66.7,1,2,1,1,0,3,1,0,"https://fbref.com/en/players/de135234/Aurelien-Nguiamba"
2022,"Spezia","Serie A","Dimitris Nikolaou","GRE","DF","22",1998,36,39,26,29,7,3,22,34,64.7,12,48,24,24,49,88,132,1,"https://fbref.com/en/players/cf961d8d/Dimitris-Nikolaou"
2022,"Spezia","Serie A","M'Bala Nzola","ANG","FW","24",1996,11.9,2,2,0,0,2,1,6,16.7,5,8,0,8,0,2,13,0,"https://fbref.com/en/players/a4948e67/MBala-Nzola"
2022,"Spezia","Serie A","Suf Podgoreanu","ISR","FW","19",2002,1.3,2,0,1,1,0,1,4,25,3,2,0,2,1,3,3,0,"https://fbref.com/en/players/d697a2d0/Suf-Podgoreanu"
2022,"Spezia","Serie A","Ivan Provedel","ITA","GK","27",1994,30.7,0,0,0,0,0,0,1,0,1,0,0,0,2,2,10,2,"https://fbref.com/en/players/277da414/Ivan-Provedel"
2022,"Spezia","Serie A","Arkadiusz Reca","POL","DF","26",1995,19.7,31,19,21,3,7,20,30,66.7,10,20,7,13,32,63,47,2,"https://fbref.com/en/players/6213fd82/Arkadiusz-Reca"
2022,"Spezia","Serie A","Jacopo Sala","ITA","MF","29",1991,9.8,22,11,10,10,2,13,30,43.3,17,6,0,6,14,36,11,0,"https://fbref.com/en/players/da5a981b/Jacopo-Sala"
2022,"Spezia","Serie A","Eddie Salcedo","ITA","MF,FW","19",2001,4.8,1,1,0,0,1,0,1,0,1,2,1,1,0,1,7,1,"https://fbref.com/en/players/0489bb30/Eddie-Salcedo"
2022,"Spezia","Serie A","Aimar Sher","SWE","MF","18",2002,0.5,2,1,1,1,0,0,1,0,1,1,0,1,3,5,1,0,"https://fbref.com/en/players/ef301f96/Aimar-Sher"
2022,"Spezia","Serie A","Dávid Strelec","SVK","FW,MF","20",2001,5.6,4,4,1,2,1,2,9,22.2,7,8,1,7,2,6,1,0,"https://fbref.com/en/players/2cb9486d/David-Strelec"
2022,"Spezia","Serie A","Daniele Verde","ITA","FW,MF","25",1996,21.7,11,4,8,2,1,9,20,45,11,17,2,15,18,29,8,0,"https://fbref.com/en/players/d3298c99/Daniele-Verde"
2022,"Spezia","Serie A","Luca Vignali","ITA","DF,MF","25",1996,0.9,1,1,0,1,0,0,3,0,3,0,0,0,1,2,1,0,"https://fbref.com/en/players/c1e8e74e/Luca-Vignali"
2022,"Spezia","Serie A","Jeroen Zoet","NED","GK","30",1991,7,1,0,1,0,0,1,1,100,0,0,0,0,0,1,4,0,"https://fbref.com/en/players/cc1a0c57/Jeroen-Zoet"
2022,"Spezia","Serie A","Petar Zovko","BIH","GK","19",2002,0.3,0,0,0,0,0,0,0,NA,0,0,0,0,0,0,1,0,"https://fbref.com/en/players/54f6afe3/Petar-Zovko"
2022,"Strasbourg","Ligue 1","Jean-Eudes Aholou","CIV","MF","27",1994,11.2,16,9,4,9,3,5,19,26.3,14,8,1,7,19,35,7,0,"https://fbref.com/en/players/48b28bfd/Jean-Eudes-Aholou"
2022,"Strasbourg","Ligue 1","Ludovic Ajorque","FRA","FW","27",1994,30.4,36,25,5,19,12,7,40,17.5,33,28,3,25,8,44,31,1,"https://fbref.com/en/players/462475ed/Ludovic-Ajorque"
2022,"Strasbourg","Ligue 1","Jean-Ricner Bellegarde","FRA","MF","23",1998,25.9,51,32,21,21,9,17,41,41.5,24,29,4,25,27,78,19,0,"https://fbref.com/en/players/10f0fdd3/Jean-Ricner-Bellegarde"
2022,"Strasbourg","Ligue 1","Anthony Caci","FRA","DF","24",1997,26.6,65,34,35,24,6,33,55,60,22,22,3,19,33,98,49,1,"https://fbref.com/en/players/0118c54c/Anthony-Caci"
2022,"Strasbourg","Ligue 1","Mehdi Chahiri","MAR","DF","25",1996,0.2,1,1,1,0,0,1,1,100,0,0,0,0,0,1,0,0,"https://fbref.com/en/players/1787195f/Mehdi-Chahiri"
2022,"Strasbourg","Ligue 1","Habib Diallo","SEN","FW","26",1995,17.1,9,5,0,8,1,0,8,0,8,13,4,9,4,13,11,0,"https://fbref.com/en/players/6605d143/Habib-Diallo"
2022,"Strasbourg","Ligue 1","Mouhamadou Diarra","SEN","MF","17",2004,1.2,2,1,1,1,0,1,1,100,0,0,0,0,0,2,0,0,"https://fbref.com/en/players/6d0fe035/Mouhamadou-Diarra"
2022,"Strasbourg","Ligue 1","Alexander Djiku","GHA","DF","26",1994,29.9,50,37,33,13,4,18,35,51.4,17,30,13,17,61,111,90,2,"https://fbref.com/en/players/43e7a164/Alexander-Djiku"
2022,"Strasbourg","Ligue 1","Ismaël Doukouré","FRA","DF","18",2003,0.2,0,0,0,0,0,0,0,NA,0,0,0,0,0,0,1,0,"https://fbref.com/en/players/0512a60a/Ismael-Doukoure"
2022,"Strasbourg","Ligue 1","Karol Fila","POL","DF","23",1998,6.2,10,8,5,4,1,4,8,50,4,7,2,5,4,14,6,0,"https://fbref.com/en/players/50ac8941/Karol-Fila"
2022,"Strasbourg","Ligue 1","Kévin Gameiro","FRA","FW","34",1987,26.5,19,10,5,9,5,6,18,33.3,12,22,1,21,6,25,1,0,"https://fbref.com/en/players/42276181/Kevin-Gameiro"
2022,"Strasbourg","Ligue 1","Frederic Guilbert","FRA","DF","26",1994,28,69,39,33,24,12,32,62,51.6,30,37,11,26,55,124,39,0,"https://fbref.com/en/players/5d8d7454/Frederic-Guilbert"
2022,"Strasbourg","Ligue 1","Nordine Kandil","FRA","MF,FW","19",2001,1,2,1,2,0,0,1,1,100,0,1,1,0,0,2,0,0,"https://fbref.com/en/players/c5908bc4/Nordine-Kandil"
2022,"Strasbourg","Ligue 1","Eiji Kawashima","JPN","GK","38",1983,1,0,0,0,0,0,0,0,NA,0,0,0,0,0,0,0,0,"https://fbref.com/en/players/a4527d33/Eiji-Kawashima"
2022,"Strasbourg","Ligue 1","Maxime Le Marchand","FRA","DF","31",1989,9.6,17,8,16,1,0,8,10,80,2,9,5,4,14,31,32,0,"https://fbref.com/en/players/321a71a7/Maxime-Le-Marchand"
2022,"Strasbourg","Ligue 1","Dimitri Liénard","FRA","DF,MF","33",1988,22.7,71,43,40,21,10,46,77,59.7,31,12,0,12,21,92,28,0,"https://fbref.com/en/players/f7691f63/Dimitri-Lienard"
2022,"Strasbourg","Ligue 1","Abdul Majeed Waris","GHA","FW,MF","29",1991,3.6,5,3,2,3,0,5,10,50,5,2,0,2,0,5,1,0,"https://fbref.com/en/players/46907171/Abdul-Majeed-Waris"
2022,"Strasbourg","Ligue 1","Dion Moise Sahi","CIV","FW,MF","19",2001,1.4,0,0,0,0,0,0,0,NA,0,1,0,1,1,1,1,0,"https://fbref.com/en/players/cdc4458b/Dion-Moise-Sahi"
2022,"Strasbourg","Ligue 1","Lebo Mothiba","RSA","FW","25",1996,0,0,0,0,0,0,0,0,NA,0,0,0,0,0,0,0,0,"https://fbref.com/en/players/3eaf8817/Lebo-Mothiba"
2022,"Strasbourg","Ligue 1","Gerzino Nyamsi","FRA","DF","24",1997,33.2,35,21,24,9,2,20,27,74.1,7,25,16,9,25,60,90,1,"https://fbref.com/en/players/6043997c/Gerzino-Nyamsi"
2022,"Strasbourg","Ligue 1","Lucas Perrin","FRA","DF","22",1998,27.8,43,32,24,17,2,26,45,57.8,19,28,11,17,42,85,67,0,"https://fbref.com/en/players/49070d66/Lucas-Perrin"
2022,"Strasbourg","Ligue 1","Sanjin Prcić","BIH","MF","27",1993,24.3,47,28,14,27,6,14,29,48.3,15,18,3,15,47,94,19,0,"https://fbref.com/en/players/51c30111/Sanjin-Prcic"
2022,"Strasbourg","Ligue 1","Matz Sels","BEL","GK","29",1992,37,1,1,1,0,0,0,0,NA,0,0,0,0,1,2,22,0,"https://fbref.com/en/players/834b5c4c/Matz-Sels"
2022,"Strasbourg","Ligue 1","Mahame Siby","MLI","DF","25",1996,0.2,0,0,0,0,0,0,0,NA,0,0,0,0,1,1,2,0,"https://fbref.com/en/players/6d075c67/Mahame-Siby"
2022,"Strasbourg","Ligue 1","Ibrahima Sissoko","FRA","MF,DF","23",1997,25.6,47,23,18,20,9,19,46,41.3,27,32,11,21,35,82,31,0,"https://fbref.com/en/players/0f8418aa/Ibrahima-Sissoko"
2022,"Strasbourg","Ligue 1","Adrien Thomasson","FRA","MF","27",1993,26.5,64,31,18,27,19,30,93,32.3,63,56,4,52,29,93,16,1,"https://fbref.com/en/players/c76b7567/Adrien-Thomasson"
2022,"Stuttgart","Bundesliga","Naouirou Ahamada","FRA","MF,DF","19",2002,0.7,1,0,1,0,0,1,3,33.3,2,0,0,0,0,1,0,0,"https://fbref.com/en/players/a6c58494/Naouirou-Ahamada"
2022,"Stuttgart","Bundesliga","Waldemar Anton","GER","DF","25",1996,28.8,40,26,22,15,3,19,32,59.4,13,27,16,11,32,72,116,1,"https://fbref.com/en/players/5e66fa06/Waldemar-Anton"
2022,"Stuttgart","Bundesliga","Fabian Bredlow","GER","GK","26",1995,4,0,0,0,0,0,0,0,NA,0,0,0,0,0,0,1,0,"https://fbref.com/en/players/d28339cb/Fabian-Bredlow"
2022,"Stuttgart","Bundesliga","Tanguy Coulibaly","FRA","FW,MF","20",2001,12,27,15,14,11,2,9,19,47.4,10,14,2,12,4,31,10,0,"https://fbref.com/en/players/05ba9d7c/Tanguy-Coulibaly"
2022,"Stuttgart","Bundesliga","Daniel Didavi","GER","MF,FW","31",1990,3.1,6,2,0,4,2,4,7,57.1,3,4,1,3,1,7,1,0,"https://fbref.com/en/players/d3096421/Daniel-Didavi"
2022,"Stuttgart","Bundesliga","Lilian Egloff","GER","MF,DF","18",2002,0.3,1,0,0,1,0,0,0,NA,0,1,0,1,0,1,0,0,"https://fbref.com/en/players/2f7fec15/Lilian-Egloff"
2022,"Stuttgart","Bundesliga","Wataru Endo","JPN","MF","28",1993,32.2,73,41,34,34,5,31,72,43.1,41,43,12,31,30,103,64,0,"https://fbref.com/en/players/c149016b/Wataru-Endo"
2022,"Stuttgart","Bundesliga","Wahidullah Faghir","DEN","FW","18",2003,1.4,0,0,0,0,0,0,1,0,1,2,0,2,0,0,0,0,"https://fbref.com/en/players/93c9e7d9/Wahidullah-Faghir"
2022,"Stuttgart","Bundesliga","Ömer Faruk Beyaz","TUR","DF,MF","17",2003,0.8,4,3,1,3,0,1,5,20,4,0,0,0,2,6,0,0,"https://fbref.com/en/players/8307b663/Omer-Faruk-Beyaz"
2022,"Stuttgart","Bundesliga","Philipp Förster","GER","MF,FW","26",1995,10.7,20,13,4,12,4,11,26,42.3,15,12,1,11,3,23,2,0,"https://fbref.com/en/players/76fa965f/Philipp-Forster"
2022,"Stuttgart","Bundesliga","Chris Führich","GER","FW,MF","23",1998,19,28,16,10,10,8,18,39,46.2,21,31,2,29,8,36,9,0,"https://fbref.com/en/players/0cf778df/Chris-Fuhrich"
2022,"Stuttgart","Bundesliga","Hamadi Al Ghaddioui","MAR","FW","30",1990,5.5,5,4,2,1,2,0,4,0,4,3,1,2,0,5,4,0,"https://fbref.com/en/players/5723931e/Hamadi-Al-Ghaddioui"
2022,"Stuttgart","Bundesliga","Hiroki Ito","JPN","DF","22",1999,26.1,43,31,21,19,3,25,43,58.1,18,40,19,21,53,96,95,0,"https://fbref.com/en/players/204dded0/Hiroki-Ito"
2022,"Stuttgart","Bundesliga","Sasa Kalajdzic","AUT","FW","24",1997,13.6,10,6,2,5,3,3,11,27.3,8,5,0,5,2,12,14,0,"https://fbref.com/en/players/15f24fe7/Sasa-Kalajdzic"
2022,"Stuttgart","Bundesliga","Atakan Karazor","GER","MF","24",1996,21.1,48,24,18,27,3,18,36,50,18,37,14,23,34,82,47,0,"https://fbref.com/en/players/5762be5c/Atakan-Karazor"
2022,"Stuttgart","Bundesliga","Silas Katompa","COD","FW,MF","22",1998,3.1,5,4,4,0,1,3,7,42.9,4,5,0,5,2,7,1,0,"https://fbref.com/en/players/de4cac2d/Silas-Katompa"
2022,"Stuttgart","Bundesliga","Marc-Oliver Kempf","GER","DF","26",1995,9.3,13,8,7,4,2,3,10,30,7,16,14,2,16,29,26,2,"https://fbref.com/en/players/815c314f/Marc-Oliver-Kempf"
2022,"Stuttgart","Bundesliga","Philipp Klement","GER","MF","28",1992,3.8,7,3,1,4,2,3,3,100,0,6,1,5,1,8,0,0,"https://fbref.com/en/players/0cddeaa7/Philipp-Klement"
2022,"Stuttgart","Bundesliga","Mateo Klimowicz","GER","MF,FW","21",2000,6.7,13,6,6,7,0,5,16,31.3,11,2,0,2,4,17,3,0,"https://fbref.com/en/players/2b7c56b4/Mateo-Klimowicz"
2022,"Stuttgart","Bundesliga","Matej Maglica","CRO","MF","22",1998,0.1,0,0,0,0,0,0,1,0,1,0,0,0,0,0,0,0,"https://fbref.com/en/players/36cf2caf/Matej-Maglica"
2022,"Stuttgart","Bundesliga","Orel Mangala","BEL","MF","23",1998,20.6,17,10,5,7,5,11,22,50,11,11,4,7,12,29,19,1,"https://fbref.com/en/players/a572e291/Orel-Mangala"
2022,"Stuttgart","Bundesliga","Omar Marmoush","EGY","FW","22",1999,17.5,26,17,6,14,6,4,20,20,16,9,1,8,7,33,6,0,"https://fbref.com/en/players/0e0102eb/Omar-Marmoush"
2022,"Stuttgart","Bundesliga","Roberto Massimo","GER","DF,FW","20",2000,9.7,14,5,6,7,1,4,16,25,12,9,0,9,3,17,6,0,"https://fbref.com/en/players/fc62fdf4/Roberto-Massimo"
2022,"Stuttgart","Bundesliga","Konstantinos Mavropanos","GRE","DF","23",1997,30.1,57,39,35,21,1,30,51,58.8,21,46,23,23,69,126,174,2,"https://fbref.com/en/players/00963611/Konstantinos-Mavropanos"
2022,"Stuttgart","Bundesliga","Enzo Millot","FRA","MF","19",2002,0.6,2,0,0,2,0,0,1,0,1,0,0,0,1,3,1,0,"https://fbref.com/en/players/f76022e7/Enzo-Millot"
2022,"Stuttgart","Bundesliga","Clinton Mola","ENG","DF","20",2001,1.3,3,1,2,1,0,2,4,50,2,5,5,0,3,6,2,0,"https://fbref.com/en/players/29ddfb9c/Clinton-Mola"
2022,"Stuttgart","Bundesliga","Florian Müller","GER","GK","23",1997,30,0,0,0,0,0,0,1,0,1,1,0,1,0,0,13,2,"https://fbref.com/en/players/cbac6ec9/Florian-Muller"
2022,"Stuttgart","Bundesliga","Nikolas Nartey","DEN","MF,DF","21",2000,4.5,6,3,0,5,1,3,9,33.3,6,4,2,2,7,13,5,0,"https://fbref.com/en/players/30261ba1/Nikolas-Nartey"
2022,"Stuttgart","Bundesliga","Mohamed Sankoh","NED","FW","17",2003,0,0,0,0,0,0,0,0,NA,0,0,0,0,0,0,0,0,"https://fbref.com/en/players/be625686/Mohamed-Sankoh"
2022,"Stuttgart","Bundesliga","Borna Sosa","CRO","DF,FW","23",1998,27.8,22,12,14,5,3,12,26,46.2,14,30,3,27,26,48,61,0,"https://fbref.com/en/players/af0d79a9/Borna-Sosa"
2022,"Stuttgart","Bundesliga","Pascal Stenzel","GER","DF","25",1996,10,24,11,15,5,4,17,33,51.5,16,13,3,10,11,35,25,0,"https://fbref.com/en/players/99f7e9aa/Pascal-Stenzel"
2022,"Stuttgart","Bundesliga","Erik Thommy","GER","FW,MF","26",1994,3,2,0,0,2,0,1,2,50,1,3,0,3,4,6,0,0,"https://fbref.com/en/players/df8e7b62/Erik-Thommy"
2022,"Stuttgart","Bundesliga","Alexis Tibidi","FRA","MF,FW","17",2003,4.3,7,3,1,3,3,3,4,75,1,4,0,4,3,10,2,0,"https://fbref.com/en/players/ca6f4846/Alexis-Tibidi"
2022,"Stuttgart","Bundesliga","Tiago Tomás","POR","FW","19",2002,11.9,8,4,0,7,1,0,6,0,6,3,0,3,4,12,1,0,"https://fbref.com/en/players/b492126a/Tiago-Tomas"
2022,"Torino","Serie A","Ola Aina","NGA","DF","24",1996,16,27,19,11,10,6,15,23,65.2,8,17,3,14,28,55,30,0,"https://fbref.com/en/players/246d153b/Ola-Aina"
2022,"Torino","Serie A","Cristian Ansaldi","ARG","DF","34",1986,7.7,20,9,11,7,2,10,13,76.9,3,9,1,8,6,26,10,0,"https://fbref.com/en/players/bbafc0c4/Cristian-Ansaldi"
2022,"Torino","Serie A","Daniele Baselli","ITA","MF,FW","29",1992,1.7,3,3,2,0,1,2,6,33.3,4,0,0,0,1,4,2,0,"https://fbref.com/en/players/ea06dd97/Daniele-Baselli"
2022,"Torino","Serie A","Andrea Belotti","ITA","FW","27",1993,15.2,7,3,2,2,3,3,12,25,9,12,4,8,2,9,9,0,"https://fbref.com/en/players/d705ba44/Andrea-Belotti"
2022,"Torino","Serie A","Etrit Berisha","ALB","GK","32",1989,10,0,0,0,0,0,0,0,NA,0,0,0,0,0,0,4,0,"https://fbref.com/en/players/ee833569/Etrit-Berisha"
2022,"Torino","Serie A","Josip Brekalo","CRO","MF","23",1998,25.4,9,5,5,1,3,3,21,14.3,18,16,1,15,4,13,7,1,"https://fbref.com/en/players/d4a2533d/Josip-Brekalo"
2022,"Torino","Serie A","Gleison Bremer","BRA","DF","24",1997,32.1,49,24,27,22,0,18,28,64.3,10,54,23,31,105,154,137,0,"https://fbref.com/en/players/5fd5ed86/Gleison-Bremer"
2022,"Torino","Serie A","Alessandro Buongiorno","ITA","DF","22",1999,13.1,20,9,9,8,3,9,13,69.2,4,12,6,6,31,51,44,0,"https://fbref.com/en/players/4ae67f27/Alessandro-Buongiorno"
2022,"Torino","Serie A","Koffi Djidji","CIV","DF","28",1992,19.3,48,29,21,23,4,14,18,77.8,4,20,9,11,34,82,60,0,"https://fbref.com/en/players/933d3b51/Koffi-Djidji"
2022,"Torino","Serie A","Luca Gemello","ITA","GK","21",2000,1,0,0,0,0,0,0,0,NA,0,0,0,0,0,0,0,0,"https://fbref.com/en/players/53e494ec/Luca-Gemello"
2022,"Torino","Serie A","Armando Izzo","ITA","DF","29",1992,5.8,16,9,14,2,0,9,11,81.8,2,5,4,1,17,33,21,0,"https://fbref.com/en/players/89976232/Armando-Izzo"
2022,"Torino","Serie A","Ben Lhassine Kone","CIV","MF","21",2000,0.9,3,3,1,2,0,1,2,50,1,0,0,0,1,4,1,0,"https://fbref.com/en/players/7452c7a8/Ben-Lhassine-Kone"
2022,"Torino","Serie A","Karol Linetty","POL","MF,FW","26",1995,10,14,8,3,4,7,6,18,33.3,12,8,0,8,3,17,2,0,"https://fbref.com/en/players/d023d70f/Karol-Linetty"
2022,"Torino","Serie A","Saša Lukić","SRB","MF","24",1996,33.1,51,34,17,27,7,19,43,44.2,24,34,6,28,24,75,41,0,"https://fbref.com/en/players/c6e8cf1f/Sasa-Lukic"
2022,"Torino","Serie A","Rolando Mandragora","ITA","MF","24",1997,14.7,21,10,3,16,2,12,21,57.1,9,18,4,14,10,31,13,0,"https://fbref.com/en/players/c7259b83/Rolando-Mandragora"
2022,"Torino","Serie A","Vanja Milinković-Savić","SRB","GK","24",1997,27,0,0,0,0,0,0,1,0,1,0,0,0,0,0,7,2,"https://fbref.com/en/players/9fa26bc2/Vanja-Milinkovic-Savic"
2022,"Torino","Serie A","Pietro Pellegri","ITA","FW","20",2001,2.4,1,1,0,1,0,0,4,0,4,0,0,0,0,1,5,0,"https://fbref.com/en/players/a44d3a3c/Pietro-Pellegri"
2022,"Torino","Serie A","Marko Pjaca","CRO","MF","26",1995,12.8,7,4,1,4,2,3,8,37.5,5,10,2,8,4,11,2,0,"https://fbref.com/en/players/2c38b327/Marko-Pjaca"
2022,"Torino","Serie A","Tommaso Pobega","ITA","MF","22",1999,24.9,48,30,17,20,11,21,40,52.5,19,32,3,29,25,73,38,0,"https://fbref.com/en/players/55a1cac2/Tommaso-Pobega"
2022,"Torino","Serie A","Dennis Praet","BEL","MF","27",1994,17.1,19,10,6,8,5,8,22,36.4,14,12,1,11,3,22,4,0,"https://fbref.com/en/players/86695068/Dennis-Praet"
2022,"Torino","Serie A","Samuele Ricci","ITA","MF","19",2001,8,8,4,4,2,2,2,5,40,3,7,1,6,14,22,9,0,"https://fbref.com/en/players/9823be92/Samuele-Ricci"
2022,"Torino","Serie A","Tomás Rincón","VEN","MF","33",1988,1.8,2,2,2,0,0,0,3,0,3,3,1,2,2,4,4,0,"https://fbref.com/en/players/f1cfc209/Tomas-Rincon"
2022,"Torino","Serie A","Ricardo Rodríguez","SUI","DF","28",1992,27.5,36,21,11,23,2,18,33,54.5,15,22,8,14,41,77,48,1,"https://fbref.com/en/players/7f78ad23/Ricardo-Rodriguez"
2022,"Torino","Serie A","Antonio Sanabria","PAR","FW","25",1996,20,3,2,0,1,2,1,4,25,3,11,4,7,2,5,10,0,"https://fbref.com/en/players/0a447501/Antonio-Sanabria"
2022,"Torino","Serie A","Demba Seck","SEN","MF,FW","20",2001,1.6,2,1,0,2,0,0,0,NA,0,0,0,0,0,2,0,0,"https://fbref.com/en/players/16463a79/Demba-Seck"
2022,"Torino","Serie A","Wilfried Singo","CIV","DF","20",2000,29,55,35,24,24,7,24,34,70.6,10,26,6,20,23,78,47,0,"https://fbref.com/en/players/8b609c34/Wilfried-Singo"
2022,"Torino","Serie A","Simone Verdi","ITA","MF,FW","29",1992,0.5,1,1,0,1,0,0,0,NA,0,0,0,0,0,1,0,0,"https://fbref.com/en/players/0375723e/Simone-Verdi"
2022,"Torino","Serie A","Mërgim Vojvoda","KVX","DF","26",1995,22,38,23,23,11,4,20,36,55.6,16,27,8,19,20,58,51,0,"https://fbref.com/en/players/be2706c0/Mergim-Vojvoda"
2022,"Torino","Serie A","Magnus Warming","DEN","MF,FW","21",2000,0.6,1,1,0,1,0,0,0,NA,0,2,0,2,0,1,0,0,"https://fbref.com/en/players/55e098cd/Magnus-Warming"
2022,"Torino","Serie A","Simone Zaza","ITA","FW,DF","30",1991,1.4,2,2,1,1,0,1,1,100,0,3,0,3,0,2,3,0,"https://fbref.com/en/players/9592289a/Simone-Zaza"
2022,"Torino","Serie A","David Zima","CZE","DF","20",2000,14.6,20,12,8,11,1,9,20,45,11,15,13,2,23,43,42,0,"https://fbref.com/en/players/acf7e795/David-Zima"
2022,"Tottenham","Premier League","Dele Alli","ENG","MF","25",1996,7.3,14,8,10,3,1,5,17,29.4,12,22,5,17,6,20,16,0,"https://fbref.com/en/players/cea4ee8f/Dele-Alli"
2022,"Tottenham","Premier League","Rodrigo Bentancur","URU","MF","24",1997,15.1,36,18,14,14,8,16,32,50,16,24,9,15,20,56,35,0,"https://fbref.com/en/players/3b8674e6/Rodrigo-Bentancur"
2022,"Tottenham","Premier League","Steven Bergwijn","NED","FW,MF","23",1997,6.3,3,2,2,1,0,1,10,10,9,3,0,3,1,4,8,0,"https://fbref.com/en/players/a29b1131/Steven-Bergwijn"
2022,"Tottenham","Premier League","Bryan","ESP","FW,MF","20",2001,1,3,0,1,0,2,1,2,50,1,2,0,2,0,3,0,0,"https://fbref.com/en/players/7b5ab7f2/Bryan"
2022,"Tottenham","Premier League","Ben Davies","WAL","DF","28",1993,28.2,36,21,20,12,4,13,26,50,13,32,19,13,30,66,75,1,"https://fbref.com/en/players/44781702/Ben-Davies"
2022,"Tottenham","Premier League","Eric Dier","ENG","DF","27",1994,34.1,15,9,6,8,1,7,14,50,7,37,32,5,27,42,142,1,"https://fbref.com/en/players/ac861941/Eric-Dier"
2022,"Tottenham","Premier League","Matt Doherty","IRL","DF","29",1992,9.7,18,12,5,11,2,8,14,57.1,6,11,2,9,13,31,20,0,"https://fbref.com/en/players/d557d734/Matt-Doherty"
2022,"Tottenham","Premier League","Emerson","BRA","DF,MF","22",1999,25.4,72,47,50,16,6,36,67,53.7,31,25,2,23,22,94,92,1,"https://fbref.com/en/players/df8b52a5/Emerson"
2022,"Tottenham","Premier League","Son Heung-min","KOR","MF,FW","29",1992,33.4,15,6,5,7,3,5,23,21.7,18,27,6,21,13,28,8,0,"https://fbref.com/en/players/92e7e919/Son-Heung-min"
2022,"Tottenham","Premier League","Pierre Højbjerg","DEN","MF","25",1995,35.5,78,45,31,38,9,38,85,44.7,47,61,13,48,48,126,54,0,"https://fbref.com/en/players/8b04d6c1/Pierre-Hojbjerg"
2022,"Tottenham","Premier League","Harry Kane","ENG","FW","28",1993,35.9,15,5,2,10,3,7,18,38.9,11,26,8,18,3,18,39,0,"https://fbref.com/en/players/21a66f6a/Harry-Kane"
2022,"Tottenham","Premier League","Dejan Kulusevski","SWE","MF,FW","21",2000,14,19,13,7,10,2,5,23,21.7,18,14,0,14,13,32,3,0,"https://fbref.com/en/players/df3cda47/Dejan-Kulusevski"
2022,"Tottenham","Premier League","Hugo Lloris","FRA","GK","34",1986,38,1,1,1,0,0,1,2,50,1,0,0,0,1,2,24,3,"https://fbref.com/en/players/8f62b6ee/Hugo-Lloris"
2022,"Tottenham","Premier League","Giovani Lo Celso","ARG","MF,FW","25",1996,2.6,8,4,4,2,2,4,10,40,6,6,1,5,1,9,0,1,"https://fbref.com/en/players/d7553721/Giovani-Lo-Celso"
2022,"Tottenham","Premier League","Lucas Moura","BRA","FW,MF","28",1992,19.7,25,10,7,14,4,8,35,22.9,27,19,0,19,18,43,19,0,"https://fbref.com/en/players/2b622f01/Lucas-Moura"
2022,"Tottenham","Premier League","Tanguy Ndombele","FRA","MF","24",1996,5.4,10,7,3,5,2,1,8,12.5,7,5,0,5,1,11,1,0,"https://fbref.com/en/players/5cdddffa/Tanguy-Ndombele"
2022,"Tottenham","Premier League","Sergio Reguilón","ESP","DF,MF","24",1996,21.3,40,24,15,18,7,22,43,51.2,21,20,8,12,31,71,45,1,"https://fbref.com/en/players/3353737a/Sergio-Reguilon"
2022,"Tottenham","Premier League","Joe Rodon","WAL","DF","23",1997,1,0,0,0,0,0,0,0,NA,0,2,1,1,0,0,7,0,"https://fbref.com/en/players/8d62d31a/Joe-Rodon"
2022,"Tottenham","Premier League","Cristian Romero","ARG","DF","23",1998,20.5,62,39,39,21,2,22,34,64.7,12,46,21,25,33,95,74,1,"https://fbref.com/en/players/a3d94a58/Cristian-Romero"
2022,"Tottenham","Premier League","Davinson Sánchez","COL","DF","25",1996,18.1,41,22,25,14,2,19,28,67.9,9,24,16,8,30,71,54,3,"https://fbref.com/en/players/da7b447d/Davinson-Sanchez"
2022,"Tottenham","Premier League","Dane Scarlett","ENG","MF","17",2004,0,0,0,0,0,0,0,0,NA,0,0,0,0,0,0,0,0,"https://fbref.com/en/players/21945a9e/Dane-Scarlett"
2022,"Tottenham","Premier League","Ryan Sessegnon","ENG","DF,MF","21",2000,11.6,25,19,14,7,4,11,22,50,11,18,3,15,7,32,26,0,"https://fbref.com/en/players/6aa3e78b/Ryan-Sessegnon"
2022,"Tottenham","Premier League","Oliver Skipp","ENG","MF","20",2000,15,33,19,14,18,1,15,31,48.4,16,19,7,12,12,45,10,1,"https://fbref.com/en/players/6250083a/Oliver-Skipp"
2022,"Tottenham","Premier League","Japhet Tanganga","ENG","DF","22",1999,8.2,14,8,7,6,1,9,19,47.4,10,13,5,8,9,23,31,0,"https://fbref.com/en/players/e9971f2d/Japhet-Tanganga"
2022,"Tottenham","Premier League","Harry Winks","ENG","MF","25",1996,10.1,15,10,4,9,2,8,21,38.1,13,14,3,11,16,31,10,2,"https://fbref.com/en/players/2f7acede/Harry-Winks"
2022,"Troyes","Ligue 1","Karim Azamoum","FRA","DF","31",1990,4.3,6,5,4,2,0,3,5,60,2,4,2,2,1,7,10,0,"https://fbref.com/en/players/eaf71a5e/Karim-Azamoum"
2022,"Troyes","Ligue 1","Giulian Biancone","FRA","DF,MF","21",2000,25.5,70,42,44,22,4,40,69,58,29,23,8,15,53,123,71,1,"https://fbref.com/en/players/de40e38c/Giulian-Biancone"
2022,"Troyes","Ligue 1","Mamadou Camara","FRA","FW","20",2001,0.4,1,1,1,0,0,0,0,NA,0,0,0,0,0,1,0,0,"https://fbref.com/en/players/316e70c7/Mamadou-Camara"
2022,"Troyes","Ligue 1","Nassim Chadli","FRA","MF,DF","20",2001,1.1,5,3,3,0,2,2,4,50,2,1,0,1,0,5,0,0,"https://fbref.com/en/players/5c61496e/Nassim-Chadli"
2022,"Troyes","Ligue 1","Dylan Chambost","FRA","MF,FW","23",1997,8.4,16,11,6,9,1,4,25,16,21,9,2,7,8,24,4,0,"https://fbref.com/en/players/dbde4959/Dylan-Chambost"
2022,"Troyes","Ligue 1","Xavier Chavalerin","FRA","MF","30",1991,30.2,49,26,19,25,5,12,55,21.8,43,32,5,27,39,88,36,0,"https://fbref.com/en/players/279ddf6a/Xavier-Chavalerin"
2022,"Troyes","Ligue 1","Abdu Conté","POR","DF","23",1998,15,22,12,16,5,1,12,24,50,12,12,2,10,4,26,10,0,"https://fbref.com/en/players/cfa49cc1/Abdu-Conte"
2022,"Troyes","Ligue 1","Tristan Dingomé","CMR","MF,FW","30",1991,12,23,11,10,12,1,10,18,55.6,8,7,1,6,9,32,3,0,"https://fbref.com/en/players/92b56413/Tristan-Dingome"
2022,"Troyes","Ligue 1","Brandon Domingues","FRA","MF,FW","21",2000,2.6,6,2,2,4,0,2,3,66.7,1,3,0,3,3,9,0,0,"https://fbref.com/en/players/2a00c6c0/Brandon-Domingues"
2022,"Troyes","Ligue 1","Gauthier Gallon","FRA","GK","28",1993,31,3,0,3,0,0,1,1,100,0,0,0,0,2,5,12,1,"https://fbref.com/en/players/db3164e1/Gauthier-Gallon"
2022,"Troyes","Ligue 1","Jimmy Giraudon","FRA","DF","29",1992,18,14,6,10,4,0,7,22,31.8,15,24,14,10,37,51,68,1,"https://fbref.com/en/players/6ba71da5/Jimmy-Giraudon"
2022,"Troyes","Ligue 1","Oualid El Hajjam","MAR","DF","30",1991,11.9,22,11,12,6,4,15,23,65.2,8,12,6,6,22,44,28,0,"https://fbref.com/en/players/9f29c204/Oualid-El-Hajjam"
2022,"Troyes","Ligue 1","Suk Hyun-jun","KOR","FW,MF","30",1991,1.7,0,0,0,0,0,0,0,NA,0,2,0,2,0,0,2,0,"https://fbref.com/en/players/7ffaf233/Suk-Hyun-jun"
2022,"Troyes","Ligue 1","Issa Kaboré","BFA","DF","20",2001,25,45,22,22,14,9,20,38,52.6,18,27,2,25,20,65,38,1,"https://fbref.com/en/players/c066d1a5/Issa-Kabore"
2022,"Troyes","Ligue 1","Youssouf Koné","MLI","DF","26",1995,10.9,30,18,21,8,1,19,30,63.3,11,8,3,5,10,40,25,0,"https://fbref.com/en/players/e6eadfb8/Youssouf-Kone"
2022,"Troyes","Ligue 1","Rominigue Kouamé","MLI","MF","24",1996,33,47,22,24,20,3,19,58,32.8,39,33,5,28,46,93,22,2,"https://fbref.com/en/players/86a2ba20/Rominigue-Kouame"
2022,"Troyes","Ligue 1","Mykola Kukharevych","UKR","FW","20",2001,0.2,0,0,0,0,0,0,0,NA,0,0,0,0,0,0,0,0,"https://fbref.com/en/players/8197a269/Mykola-Kukharevych"
2022,"Troyes","Ligue 1","Yasser Larouci","ALG","DF","20",2001,3.8,6,5,2,4,0,3,3,100,0,1,0,1,7,13,5,0,"https://fbref.com/en/players/0ed063d6/Yasser-Larouci"
2022,"Troyes","Ligue 1","Levi Lumeka","ENG","MF,FW","22",1998,0.7,0,0,0,0,0,0,2,0,2,0,0,0,0,0,2,0,"https://fbref.com/en/players/199ff86e/Levi-Lumeka"
2022,"Troyes","Ligue 1","Derek Mazou-Sacko","FRA","FW,DF","16",2004,0,1,0,0,0,1,1,1,100,0,0,0,0,0,1,1,0,"https://fbref.com/en/players/810edef9/Derek-Mazou-Sacko"
2022,"Troyes","Ligue 1","Lebo Mothiba","RSA","FW,MF","25",1996,5.8,8,4,4,3,1,2,5,40,3,3,0,3,2,10,0,0,"https://fbref.com/en/players/3eaf8817/Lebo-Mothiba"
2022,"Troyes","Ligue 1","Jessy Moulin","FRA","GK","35",1986,7,0,0,0,0,0,0,0,NA,0,0,0,0,1,1,7,0,"https://fbref.com/en/players/28a65a2c/Jessy-Moulin"
2022,"Troyes","Ligue 1","Eric N'Jo","FRA","DF","17",2004,1.1,0,0,0,0,0,0,1,0,1,1,1,0,2,2,1,0,"https://fbref.com/en/players/b85e57bb/Eric-NJo"
2022,"Troyes","Ligue 1","Erik Palmer-Brown","USA","DF","24",1997,19.3,37,22,29,8,0,20,26,76.9,6,26,18,8,34,71,87,1,"https://fbref.com/en/players/e5c1e0ca/Erik-Palmer-Brown"
2022,"Troyes","Ligue 1","Adil Rami","FRA","DF","35",1985,13,10,9,6,4,0,7,8,87.5,1,17,9,8,16,26,43,0,"https://fbref.com/en/players/8dbff17c/Adil-Rami"
2022,"Troyes","Ligue 1","Renaud Ripart","FRA","MF,FW","28",1993,21,38,21,18,15,5,18,50,36,32,21,1,20,19,57,21,1,"https://fbref.com/en/players/beae3a73/Renaud-Ripart"
2022,"Troyes","Ligue 1","Patrick Roberts","ENG","MF","24",1997,0.2,0,0,0,0,0,0,0,NA,0,0,0,0,0,0,0,0,"https://fbref.com/en/players/59d93937/Patrick-Roberts"
2022,"Troyes","Ligue 1","Gerson Rodrigues","LUX","FW,MF","26",1995,9.4,12,9,2,6,4,1,17,5.9,16,8,1,7,0,12,2,0,"https://fbref.com/en/players/3814b753/Gerson-Rodrigues"
2022,"Troyes","Ligue 1","Yoann Salmier","GUF","DF","28",1992,29.6,58,33,44,11,3,26,34,76.5,8,30,14,16,40,98,94,0,"https://fbref.com/en/players/c3725db2/Yoann-Salmier"
2022,"Troyes","Ligue 1","Mama Samba Baldé","GNB","MF,FW","25",1995,19.1,40,28,16,14,10,8,26,30.8,18,32,1,31,5,45,9,0,"https://fbref.com/en/players/fb14aa28/Mama-Samba-Balde"
2022,"Troyes","Ligue 1","Philippe Sandler","NED","DF","24",1997,0.8,0,0,0,0,0,0,0,NA,0,1,1,0,3,3,6,0,"https://fbref.com/en/players/60740e70/Philippe-Sandler"
2022,"Troyes","Ligue 1","Florian Tardieu","FRA","MF","29",1992,29.2,58,25,31,21,6,31,71,43.7,40,31,9,22,42,100,38,0,"https://fbref.com/en/players/ed39121c/Florian-Tardieu"
2022,"Troyes","Ligue 1","Yoann Touzghar","TUN","FW","34",1986,16.2,5,2,1,3,1,1,3,33.3,2,3,1,2,3,8,8,0,"https://fbref.com/en/players/4e47507a/Yoann-Touzghar"
2022,"Troyes","Ligue 1","Ike Ugbo","CAN","FW","22",1998,9,3,1,0,1,2,0,1,0,1,4,1,3,2,5,1,0,"https://fbref.com/en/players/8a53d24b/Ike-Ugbo"
2022,"Troyes","Ligue 1","Banhie Zoukrou","FRA","DF","18",2003,0.9,1,0,1,0,0,1,2,50,1,0,0,0,0,1,2,0,"https://fbref.com/en/players/aefa3050/Banhie-Zoukrou"
2022,"Udinese","Serie A","Tolgay Arslan","GER","MF","30",1990,18.4,35,20,15,16,4,19,50,38,31,17,4,13,13,48,23,1,"https://fbref.com/en/players/963a328b/Tolgay-Arslan"
2022,"Udinese","Serie A","Rodrigo Becão","BRA","DF","25",1996,34.8,81,46,49,30,2,34,60,56.7,26,45,20,25,42,123,89,3,"https://fbref.com/en/players/19e4eab9/Rodrigo-Becao"
2022,"Udinese","Serie A","Filip Benković","CRO","DF,FW","24",1997,0.1,0,0,0,0,0,0,0,NA,0,0,0,0,0,0,0,0,"https://fbref.com/en/players/305a3820/Filip-Benkovic"
2022,"Udinese","Serie A","Beto","GNB","FW","23",1998,24.1,21,6,2,14,5,9,19,47.4,10,16,1,15,5,26,25,1,"https://fbref.com/en/players/ed5c0319/Beto"
2022,"Udinese","Serie A","Sebastien De Maio","FRA","DF","34",1987,2,5,1,4,1,0,1,9,11.1,8,6,5,1,1,6,9,0,"https://fbref.com/en/players/952a03fe/Sebastien-De-Maio"
2022,"Udinese","Serie A","Gerard Deulofeu","ESP","FW,MF","27",1994,29.1,11,6,2,3,6,7,29,24.1,22,14,0,14,9,20,4,0,"https://fbref.com/en/players/39583cfd/Gerard-Deulofeu"
2022,"Udinese","Serie A","Fernando Forestieri","ITA","FW,MF","31",1990,0.6,0,0,0,0,0,0,1,0,1,1,0,1,0,0,1,0,"https://fbref.com/en/players/d60c26fc/Fernando-Forestieri"
2022,"Udinese","Serie A","Mato Jajalo","BIH","MF","33",1988,7,24,14,14,7,3,11,23,47.8,12,7,0,7,11,35,5,0,"https://fbref.com/en/players/8c65eb5f/Mato-Jajalo"
2022,"Udinese","Serie A","Jean-Victor Makengo","FRA","MF","23",1998,26.1,30,21,7,17,6,15,29,51.7,14,26,6,20,19,49,17,0,"https://fbref.com/en/players/22bfb57e/Jean-Victor-Makengo"
2022,"Udinese","Serie A","Pablo Marí","ESP","DF","27",1993,14.9,16,8,8,6,2,8,16,50,8,18,12,6,21,37,72,0,"https://fbref.com/en/players/aa54ec6f/Pablo-Mari"
2022,"Udinese","Serie A","Nahuel Molina","ARG","DF","23",1998,29.3,41,24,17,21,3,16,48,33.3,32,24,3,21,22,63,44,2,"https://fbref.com/en/players/23610943/Nahuel-Molina"
2022,"Udinese","Serie A","Ilija Nestorovski","MKD","FW","31",1990,2.1,0,0,0,0,0,0,3,0,3,0,0,0,0,0,4,0,"https://fbref.com/en/players/b1236c63/Ilija-Nestorovski"
2022,"Udinese","Serie A","Bram Nuytinck","NED","DF","31",1990,22.6,38,24,24,13,1,15,34,44.1,19,42,31,11,22,60,101,0,"https://fbref.com/en/players/e33f36d5/Bram-Nuytinck"
2022,"Udinese","Serie A","Stefano Okaka","ITA","FW","31",1989,0.2,0,0,0,0,0,0,0,NA,0,2,0,2,0,0,1,0,"https://fbref.com/en/players/601ef102/Stefano-Okaka"
2022,"Udinese","Serie A","Daniele Padelli","ITA","GK","35",1985,3,0,0,0,0,0,0,0,NA,0,0,0,0,0,0,2,1,"https://fbref.com/en/players/cf1c23d8/Daniele-Padelli"
2022,"Udinese","Serie A","Simone Pafundi","ITA","FW","15",2006,0.3,0,0,0,0,0,0,1,0,1,0,0,0,0,0,0,0,"https://fbref.com/en/players/8daee720/Simone-Pafundi"
2022,"Udinese","Serie A","Roberto Pereyra","ARG","MF,FW","30",1991,19.9,18,12,7,6,5,7,23,30.4,16,26,5,21,12,30,11,0,"https://fbref.com/en/players/75f2c59f/Roberto-Pereyra"
2022,"Udinese","Serie A","Nehuén Pérez","ARG","DF","21",2000,18.8,44,21,21,21,2,16,25,64,9,27,9,18,21,65,47,0,"https://fbref.com/en/players/f7c491f1/Nehuen-Perez"
2022,"Udinese","Serie A","Riccardo Pinzi","ITA","FW","17",2003,0,0,0,0,0,0,0,0,NA,0,0,0,0,0,0,0,0,"https://fbref.com/en/players/5dafcdce/Riccardo-Pinzi"
2022,"Udinese","Serie A","Ignacio Pussetto","ARG","FW,MF","25",1995,13.4,17,9,2,9,6,2,10,20,8,18,2,16,4,21,13,0,"https://fbref.com/en/players/62437b4f/Ignacio-Pussetto"
2022,"Udinese","Serie A","Lazar Samardzic","GER","MF,FW","19",2002,5.4,13,9,4,7,2,7,26,26.9,19,6,0,6,2,15,2,0,"https://fbref.com/en/players/217c93a1/Lazar-Samardzic"
2022,"Udinese","Serie A","Samir Santos","BRA","DF","26",1994,15.8,36,16,22,13,1,15,25,60,10,21,7,14,42,78,62,0,"https://fbref.com/en/players/92b4758e/Samir-Santos"
2022,"Udinese","Serie A","Marco Silvestri","ITA","GK","30",1991,35,0,0,0,0,0,0,1,0,1,0,0,0,1,1,11,1,"https://fbref.com/en/players/0d422df7/Marco-Silvestri"
2022,"Udinese","Serie A","Brandon Soppy","FRA","DF,MF","19",2002,8.6,20,9,8,10,2,11,16,68.8,5,10,2,8,5,25,9,1,"https://fbref.com/en/players/28f66c2e/Brandon-Soppy"
2022,"Udinese","Serie A","Jens Stryger Larsen","DEN","DF","30",1991,7.6,5,2,3,1,1,2,3,66.7,1,2,0,2,4,9,17,0,"https://fbref.com/en/players/f91e81c9/Jens-Stryger-Larsen"
2022,"Udinese","Serie A","Isaac Success","NGA","FW,MF","25",1996,10.1,5,2,0,3,2,1,5,20,4,2,0,2,2,7,6,0,"https://fbref.com/en/players/f573a8bf/Isaac-Success"
2022,"Udinese","Serie A","Iyenoma Udogie","ITA","DF","18",2002,27.5,64,40,30,27,7,33,60,55,27,39,6,33,27,91,42,0,"https://fbref.com/en/players/7cd520e8/Iyenoma-Udogie"
2022,"Udinese","Serie A","Walace","BRA","MF","26",1995,33,83,49,37,38,8,50,113,44.2,63,51,5,46,54,137,32,1,"https://fbref.com/en/players/26db8853/Walace"
2022,"Udinese","Serie A","Marvin Zeegelaar","NED","DF","30",1990,7.1,15,11,6,8,1,5,14,35.7,9,12,4,8,12,27,22,1,"https://fbref.com/en/players/8abd0c03/Marvin-Zeegelaar"
2022,"Union Berlin","Bundesliga","Taiwo Awoniyi","NGA","FW","23",1997,24.2,11,7,3,6,2,1,9,11.1,8,11,2,9,2,13,29,0,"https://fbref.com/en/players/e5478b87/Taiwo-Awoniyi"
2022,"Union Berlin","Bundesliga","Timo Baumgartl","GER","DF","25",1996,24.1,59,28,34,21,4,31,47,66,16,27,11,16,37,96,58,0,"https://fbref.com/en/players/bd7d2e6d/Timo-Baumgartl"
2022,"Union Berlin","Bundesliga","Sheraldo Becker","SUR","FW,MF","26",1995,19.5,9,6,3,4,2,6,18,33.3,12,11,0,11,2,11,4,0,"https://fbref.com/en/players/8eb55dbb/Sheraldo-Becker"
2022,"Union Berlin","Bundesliga","Kevin Behrens","GER","FW","30",1991,5.5,3,2,1,1,1,0,4,0,4,3,0,3,3,6,7,0,"https://fbref.com/en/players/30ae134d/Kevin-Behrens"
2022,"Union Berlin","Bundesliga","Keita Endo","JPN","MF","23",1997,0.6,1,1,1,0,0,0,0,NA,0,1,0,1,0,1,0,0,"https://fbref.com/en/players/1a83027b/Keita-Endo"
2022,"Union Berlin","Bundesliga","Marvin Friedrich","GER","DF","25",1995,13,17,5,14,3,0,10,16,62.5,6,13,7,6,23,40,47,0,"https://fbref.com/en/players/b77f44a4/Marvin-Friedrich"
2022,"Union Berlin","Bundesliga","Niko Gießelmann","GER","DF,FW","29",1991,23.1,24,17,10,11,3,15,38,39.5,23,26,4,22,18,42,29,1,"https://fbref.com/en/players/7242b495/Niko-Giesselmann"
2022,"Union Berlin","Bundesliga","Sebastian Griesbeck","GER","MF","30",1990,0.1,1,1,0,1,0,1,1,100,0,0,0,0,0,1,0,0,"https://fbref.com/en/players/a8db7ebb/Sebastian-Griesbeck"
2022,"Union Berlin","Bundesliga","Genki Haraguchi","JPN","MF","30",1991,19.5,37,20,12,22,3,15,48,31.3,33,25,3,22,26,63,15,0,"https://fbref.com/en/players/f24ea523/Genki-Haraguchi"
2022,"Union Berlin","Bundesliga","Dominique Heintz","GER","DF","27",1993,5.2,8,5,5,3,0,3,6,50,3,7,4,3,7,15,14,0,"https://fbref.com/en/players/699fb8db/Dominique-Heintz"
2022,"Union Berlin","Bundesliga","Marcus Ingvartsen","DEN","MF","25",1996,1.4,0,0,0,0,0,0,2,0,2,0,0,0,2,2,1,0,"https://fbref.com/en/players/271b8617/Marcus-Ingvartsen"
2022,"Union Berlin","Bundesliga","Paul Jaeckel","GER","DF","23",1998,22.7,51,29,27,24,0,29,51,56.9,22,34,10,24,57,108,81,0,"https://fbref.com/en/players/a93b6f4e/Paul-Jaeckel"
2022,"Union Berlin","Bundesliga","Rani Khedira","GER","MF","27",1994,30.6,75,38,25,42,8,32,66,48.5,34,21,8,13,50,125,27,1,"https://fbref.com/en/players/59e4b92e/Rani-Khedira"
2022,"Union Berlin","Bundesliga","Robin Knoche","GER","DF","29",1992,33,50,24,38,12,0,30,53,56.6,23,45,26,19,49,99,151,1,"https://fbref.com/en/players/6bd5cd5d/Robin-Knoche"
2022,"Union Berlin","Bundesliga","Max Kruse","GER","FW,MF","33",1988,14.1,4,1,0,3,1,2,16,12.5,14,12,0,12,3,7,2,0,"https://fbref.com/en/players/f9446dcd/Max-Kruse"
2022,"Union Berlin","Bundesliga","Andreas Luthe","GER","GK","34",1987,27,0,0,0,0,0,0,1,0,1,0,0,0,0,0,11,4,"https://fbref.com/en/players/7fe12375/Andreas-Luthe"
2022,"Union Berlin","Bundesliga","Sven Michel","GER","FW","31",1990,3.8,10,6,5,3,2,2,8,25,6,3,0,3,1,11,1,0,"https://fbref.com/en/players/1e274a0a/Sven-Michel"
2022,"Union Berlin","Bundesliga","Kevin Möhwald","GER","MF","28",1993,3.9,7,1,3,3,1,1,7,14.3,6,3,0,3,3,10,6,0,"https://fbref.com/en/players/a5ce09f2/Kevin-Mohwald"
2022,"Union Berlin","Bundesliga","Bastian Oczipka","GER","DF","32",1989,10.4,24,15,15,7,2,10,13,76.9,3,10,2,8,12,36,21,0,"https://fbref.com/en/players/d1661819/Bastian-Oczipka"
2022,"Union Berlin","Bundesliga","Levin Öztunalı","GER","MF","25",1996,6.4,14,11,6,5,3,7,17,41.2,10,3,0,3,4,18,12,0,"https://fbref.com/en/players/66385c46/Levin-Oztunali"
2022,"Union Berlin","Bundesliga","Grischa Prömel","GER","MF","26",1995,26.9,36,22,14,17,5,22,52,42.3,30,18,3,15,23,59,22,0,"https://fbref.com/en/players/924f9191/Grischa-Promel"
2022,"Union Berlin","Bundesliga","Julian Ryerson","NOR","DF","23",1997,15.9,27,15,11,12,4,17,25,68,8,12,4,8,16,43,32,0,"https://fbref.com/en/players/009a4f60/Julian-Ryerson"
2022,"Union Berlin","Bundesliga","Frederik Rønnow","DEN","GK","28",1992,7,0,0,0,0,0,0,0,NA,0,0,0,0,0,0,1,0,"https://fbref.com/en/players/a70b8345/Frederik-Ronnow"
2022,"Union Berlin","Bundesliga","András Schäfer","HUN","MF","22",1999,2.7,4,1,3,1,0,0,5,0,5,7,1,6,2,6,4,0,"https://fbref.com/en/players/049751d7/Andras-Schafer"
2022,"Union Berlin","Bundesliga","Cedric Teuchert","GER","MF,FW","24",1997,1.2,3,2,3,0,0,2,6,33.3,4,1,0,1,0,3,0,0,"https://fbref.com/en/players/f956479d/Cedric-Teuchert"
2022,"Union Berlin","Bundesliga","Christopher Trimmel","AUT","DF,FW","34",1987,22.1,49,30,25,19,5,26,45,57.8,19,20,3,17,34,83,75,0,"https://fbref.com/en/players/056d2d95/Christopher-Trimmel"
2022,"Union Berlin","Bundesliga","Anthony Ujah","NGA","FW,MF","30",1990,0.4,0,0,0,0,0,0,0,NA,0,0,0,0,0,0,0,0,"https://fbref.com/en/players/99be8fb5/Anthony-Ujah"
2022,"Union Berlin","Bundesliga","Andreas Voglsammer","GER","FW,MF","29",1992,9.8,14,9,8,3,3,6,14,42.9,8,9,2,7,2,16,7,0,"https://fbref.com/en/players/daa78200/Andreas-Voglsammer"
2022,"Valencia","La Liga","Omar Alderete","PAR","DF","24",1996,26.7,53,34,34,17,2,34,53,64.2,19,30,18,12,35,88,153,0,"https://fbref.com/en/players/bb08bce9/Omar-Alderete"
2022,"Valencia","La Liga","Bryan","ESP","MF,FW","20",2001,8.4,13,8,6,3,4,2,13,15.4,11,13,0,13,1,14,4,0,"https://fbref.com/en/players/7b5ab7f2/Bryan"
2022,"Valencia","La Liga","Denis Cheryshev","RUS","MF,FW","30",1990,6.3,14,5,6,1,7,6,15,40,9,9,1,8,9,23,9,0,"https://fbref.com/en/players/0ac94a23/Denis-Cheryshev"
2022,"Valencia","La Liga","Jasper Cillessen","NED","GK","32",1989,16.2,0,0,0,0,0,0,1,0,1,0,0,0,1,1,6,0,"https://fbref.com/en/players/04ac8285/Jasper-Cillessen"
2022,"Valencia","La Liga","Eray Cömert","SUI","DF","23",1998,4.5,5,3,4,1,0,3,6,50,3,3,2,1,2,7,6,0,"https://fbref.com/en/players/15937e17/Eray-Comert"
2022,"Valencia","La Liga","Thierry Correia","POR","DF","22",1999,15.7,35,23,26,6,3,14,29,48.3,15,20,5,15,19,54,27,0,"https://fbref.com/en/players/c78b352d/Thierry-Correia"
2022,"Valencia","La Liga","Hélder Costa","ANG","MF,FW","27",1994,12.4,27,16,11,9,7,14,41,34.1,27,12,1,11,3,30,9,0,"https://fbref.com/en/players/f13d02a6/Helder-Costa"
2022,"Valencia","La Liga","Mouctar Diakhaby","GUI","DF","24",1996,21.6,35,24,18,15,2,13,23,56.5,10,29,17,12,30,65,87,3,"https://fbref.com/en/players/d2110326/Mouctar-Diakhaby"
2022,"Valencia","La Liga","Jaume Doménech","ESP","GK","30",1990,3.8,0,0,0,0,0,0,0,NA,0,0,0,0,0,0,3,1,"https://fbref.com/en/players/c9cb972b/Jaume-Domenech"
2022,"Valencia","La Liga","Mario Dominguez","ESP","FW","17",2004,0.3,0,0,0,0,0,0,0,NA,0,0,0,0,0,0,1,0,"https://fbref.com/en/players/d709cd5c/Mario-Dominguez"
2022,"Valencia","La Liga","Hugo Duro","ESP","FW,MF","21",1999,20.4,25,19,11,13,1,15,38,39.5,23,24,2,22,4,29,20,1,"https://fbref.com/en/players/37e103f8/Hugo-Duro"
2022,"Valencia","La Liga","Dimitri Foulquier","FRA","DF","28",1993,26,36,17,17,15,4,21,34,61.8,13,19,3,16,29,65,49,0,"https://fbref.com/en/players/45e17712/Dimitri-Foulquier"
2022,"Valencia","La Liga","Maxi Gómez","URU","FW","24",1996,21.7,5,3,1,2,2,5,8,62.5,3,5,1,4,3,8,22,0,"https://fbref.com/en/players/4c2e9442/Maxi-Gomez"
2022,"Valencia","La Liga","Gonçalo Guedes","POR","FW,MF","24",1996,29,21,14,6,7,8,2,22,9.1,20,14,0,14,9,30,1,0,"https://fbref.com/en/players/e6bc67d7/Goncalo-Guedes"
2022,"Valencia","La Liga","Hugo Guillamón","ESP","MF,DF","21",2000,26.2,43,27,20,16,7,18,44,40.9,26,26,10,16,30,73,53,1,"https://fbref.com/en/players/f7c12fbf/Hugo-Guillamon"
2022,"Valencia","La Liga","Jason","ESP","MF,DF","27",1994,0.8,4,1,2,1,1,0,1,0,1,2,0,2,1,5,1,0,"https://fbref.com/en/players/9038c2a1/Jason"
2022,"Valencia","La Liga","Koba Koindredi","FRA","MF","19",2001,2,4,3,2,1,1,2,6,33.3,4,3,0,3,4,8,5,0,"https://fbref.com/en/players/3a58d075/Koba-Koindredi"
2022,"Valencia","La Liga","Toni Lato","ESP","DF","23",1997,6.6,17,12,12,3,2,9,16,56.3,7,6,0,6,8,25,14,0,"https://fbref.com/en/players/8e088e04/Toni-Lato"
2022,"Valencia","La Liga","Ruben Lendinez","ESP","DF","18",2003,1.5,3,3,1,2,0,3,8,37.5,5,4,0,4,2,5,6,0,"https://fbref.com/en/players/755da865/Ruben-Lendinez"
2022,"Valencia","La Liga","José Luis Gayà","ESP","DF","26",1995,20.8,35,21,24,10,1,16,34,47.1,18,17,3,14,19,54,37,0,"https://fbref.com/en/players/b05e2dbd/Jose-Luis-Gaya"
2022,"Valencia","La Liga","Giorgi Mamardashvili","GEO","GK","20",2000,18,0,0,0,0,0,0,0,NA,0,0,0,0,0,0,6,1,"https://fbref.com/en/players/d4b73232/Giorgi-Mamardashvili"
2022,"Valencia","La Liga","Maranhão","BRA","FW,MF","24",1996,10.8,15,11,4,6,5,5,16,31.3,11,15,0,15,7,22,13,0,"https://fbref.com/en/players/ae86d473/Maranhao"
2022,"Valencia","La Liga","Ilaix Moriba","GUI","MF","18",2003,9.1,26,18,10,13,3,14,35,40,21,15,0,15,12,38,14,0,"https://fbref.com/en/players/f4c69aa6/Ilaix-Moriba"
2022,"Valencia","La Liga","Cristhian Mosquera","COL","DF","17",2004,2.4,4,2,3,0,1,3,6,50,3,1,0,1,3,7,1,1,"https://fbref.com/en/players/dc1ce4f5/Cristhian-Mosquera"
2022,"Valencia","La Liga","Yunus Musah","USA","MF,FW","18",2002,14,23,13,8,8,7,6,20,30,14,19,1,18,14,37,11,0,"https://fbref.com/en/players/b51b1b9c/Yunus-Musah"
2022,"Valencia","La Liga","Gabriel Paulista","BRA","DF","30",1990,17.7,21,12,16,5,0,14,20,70,6,18,12,6,39,60,88,0,"https://fbref.com/en/players/b7ca5c51/Gabriel-Paulista"
2022,"Valencia","La Liga","Cristiano Piccini","ITA","DF","28",1992,3.6,14,8,9,5,0,5,7,71.4,2,3,2,1,1,15,11,0,"https://fbref.com/en/players/32c0491f/Cristiano-Piccini"
2022,"Valencia","La Liga","Uroš Račić","SRB","MF","23",1998,13.4,32,18,9,19,4,12,33,36.4,21,16,6,10,16,48,21,0,"https://fbref.com/en/players/faed84db/Uros-Racic"
2022,"Valencia","La Liga","Jesús Santiago","ESP","MF","17",2004,0.9,2,2,1,1,0,0,2,0,2,1,0,1,0,2,1,0,"https://fbref.com/en/players/bc49fd34/Jesus-Santiago"
2022,"Valencia","La Liga","Rubén Sobrino","ESP","MF","29",1992,0.2,1,1,1,0,0,1,1,100,0,1,0,1,2,3,0,0,"https://fbref.com/en/players/19b776e9/Ruben-Sobrino"
2022,"Valencia","La Liga","Carlos Soler","ESP","MF","24",1997,27.5,29,19,10,15,4,11,37,29.7,26,19,4,15,14,43,28,0,"https://fbref.com/en/players/fed17f5a/Carlos-Soler"
2022,"Valencia","La Liga","Manu Vallejo","ESP","FW,MF","24",1997,1.1,2,1,1,1,0,0,1,0,1,0,0,0,0,2,1,0,"https://fbref.com/en/players/0bc4e720/Manu-Vallejo"
2022,"Valencia","La Liga","Jesus Vazquez","ESP","DF","18",2003,9,24,13,10,8,6,10,22,45.5,12,16,3,13,9,33,19,0,"https://fbref.com/en/players/106c142c/Jesus-Vazquez"
2022,"Valencia","La Liga","Daniel Wass","DEN","MF","32",1989,17.6,23,13,6,14,3,8,31,25.8,23,13,2,11,13,36,19,0,"https://fbref.com/en/players/d83bbc54/Daniel-Wass"
2022,"Venezia","Serie A","Ethan Ampadu","WAL","MF,DF","20",2000,25.4,67,43,37,27,3,24,58,41.4,34,49,19,30,51,118,76,0,"https://fbref.com/en/players/10b9fa99/Ethan-Ampadu"
2022,"Venezia","Serie A","Mattia Aramu","ITA","MF,FW","26",1995,23.3,20,15,5,9,6,8,33,24.2,25,20,2,18,8,28,19,0,"https://fbref.com/en/players/0847b5a5/Mattia-Aramu"
2022,"Venezia","Serie A","Issa Bah","LUX","FW","19",2002,0.1,0,0,0,0,0,0,0,NA,0,0,0,0,0,0,0,0,"https://fbref.com/en/players/956a78ea/Issa-Bah"
2022,"Venezia","Serie A","Bjarki Bjarkason","ISL","MF","21",2000,0,0,0,0,0,0,0,0,NA,0,0,0,0,0,0,0,0,"https://fbref.com/en/players/f1d25de7/Bjarki-Bjarkason"
2022,"Venezia","Serie A","Gianluca Busio","USA","MF","19",2002,21.7,53,28,27,20,6,28,63,44.4,35,45,13,32,21,74,30,1,"https://fbref.com/en/players/4a0b7f07/Gianluca-Busio"
2022,"Venezia","Serie A","Mattia Caldara","ITA","DF","27",1994,30,48,28,30,15,3,20,34,58.8,14,49,37,12,62,110,147,1,"https://fbref.com/en/players/ac7e640b/Mattia-Caldara"
2022,"Venezia","Serie A","Pietro Ceccaroni","ITA","DF","25",1995,34.7,55,31,33,18,4,25,36,69.4,11,45,32,13,30,85,143,0,"https://fbref.com/en/players/4d1efb48/Pietro-Ceccaroni"
2022,"Venezia","Serie A","Domen Črnigoj","SVN","MF","25",1995,20.9,21,13,7,11,3,11,29,37.9,18,27,8,19,24,45,42,0,"https://fbref.com/en/players/22cd43d2/Domen-Crnigoj"
2022,"Venezia","Serie A","Mickaël Cuisance","FRA","MF","21",1999,10.2,23,9,7,12,4,10,28,35.7,18,14,0,14,12,35,5,0,"https://fbref.com/en/players/5722eced/Mickael-Cuisance"
2022,"Venezia","Serie A","Jacopo Dezi","ITA","MF","29",1992,0.2,0,0,0,0,0,0,1,0,1,0,0,0,1,1,0,0,"https://fbref.com/en/players/e921b9db/Jacopo-Dezi"
2022,"Venezia","Serie A","Francesco Di Mariano","ITA","FW","25",1996,0.7,1,1,0,1,0,0,0,NA,0,2,1,1,0,1,0,0,"https://fbref.com/en/players/35a2557c/Francesco-Di-Mariano"
2022,"Venezia","Serie A","Tyronne Ebuehi","NGA","DF","25",1995,12.6,28,12,16,8,4,10,18,55.6,8,13,3,10,16,44,38,1,"https://fbref.com/en/players/6af30900/Tyronne-Ebuehi"
2022,"Venezia","Serie A","Luca Fiordilino","ITA","MF","25",1996,7.3,21,13,11,6,4,13,27,48.1,14,14,4,10,11,32,12,0,"https://fbref.com/en/players/9bb1ad91/Luca-Fiordilino"
2022,"Venezia","Serie A","Francesco Forte","ITA","FW","28",1993,4.7,3,2,0,2,1,2,5,40,3,1,0,1,0,3,2,0,"https://fbref.com/en/players/69e11a01/Francesco-Forte"
2022,"Venezia","Serie A","Nicolas Galazzi","ITA","MF","20",2000,0.2,2,1,1,0,1,0,1,0,1,0,0,0,0,2,0,0,"https://fbref.com/en/players/a796492f/Nicolas-Galazzi"
2022,"Venezia","Serie A","Ridgeciano Haps","SUR","DF","28",1993,22.8,36,20,26,4,6,11,21,52.4,10,34,12,22,29,65,57,1,"https://fbref.com/en/players/c8d7131c/Ridgeciano-Haps"
2022,"Venezia","Serie A","Thomas Henry","FRA","FW","26",1994,23.5,9,4,2,3,4,5,13,38.5,8,11,5,6,2,11,25,0,"https://fbref.com/en/players/9ef42479/Thomas-Henry"
2022,"Venezia","Serie A","Daan Heymans","BEL","MF,FW","22",1999,2.8,3,1,1,2,0,1,5,20,4,7,3,4,4,7,3,0,"https://fbref.com/en/players/6d70c771/Daan-Heymans"
2022,"Venezia","Serie A","Dennis Johnsen","NOR","FW,MF","23",1998,16.1,14,10,8,4,2,6,18,33.3,12,14,1,13,5,19,3,0,"https://fbref.com/en/players/66784dee/Dennis-Johnsen"
2022,"Venezia","Serie A","Sofian Kiyine","MAR","MF,FW","23",1997,13.8,24,14,9,11,4,12,32,37.5,20,15,1,14,10,34,9,0,"https://fbref.com/en/players/ce1806be/Sofian-Kiyine"
2022,"Venezia","Serie A","Patrick Leal","USA","FW","18",2003,0,0,0,0,0,0,0,1,0,1,0,0,0,0,0,0,0,"https://fbref.com/en/players/d97ec0d1/Patrick-Leal"
2022,"Venezia","Serie A","Luca Lezzerini","ITA","GK","26",1995,5.5,0,0,0,0,0,0,0,NA,0,1,0,1,0,0,0,0,"https://fbref.com/en/players/c9c32262/Luca-Lezzerini"
2022,"Venezia","Serie A","Niki Mäenpää","FIN","GK","36",1985,16.5,0,0,0,0,0,0,0,NA,0,0,0,0,0,0,8,2,"https://fbref.com/en/players/14a96e1c/Niki-Maenpaa"
2022,"Venezia","Serie A","Aleš Matějů","CZE","DF","25",1996,8.1,16,12,10,5,1,13,29,44.8,16,10,6,4,9,25,15,0,"https://fbref.com/en/players/deb748c9/Ales-Mateju"
2022,"Venezia","Serie A","Pasquale Mazzocchi","ITA","DF","26",1995,13.8,18,8,11,4,3,10,26,38.5,16,11,8,3,21,39,31,1,"https://fbref.com/en/players/eb0ec070/Pasquale-Mazzocchi"
2022,"Venezia","Serie A","Hilmir Mikaelsson","ISL","FW","17",2004,0.2,2,0,0,1,1,0,0,NA,0,0,0,0,0,2,0,0,"https://fbref.com/en/players/5add9b29/Hilmir-Mikaelsson"
2022,"Venezia","Serie A","Marco Modolo","ITA","DF","32",1989,4.4,6,3,4,2,0,2,5,40,3,6,6,0,4,10,26,0,"https://fbref.com/en/players/fdcdb521/Marco-Modolo"
2022,"Venezia","Serie A","Cristian Molinaro","ITA","DF","38",1983,6.1,12,9,10,2,0,5,7,71.4,2,7,2,5,6,18,20,0,"https://fbref.com/en/players/1c8c5aed/Cristian-Molinaro"
2022,"Venezia","Serie A","Nani","POR","MF,FW","34",1986,3.2,2,1,1,1,0,0,1,0,1,1,0,1,2,4,0,1,"https://fbref.com/en/players/15e9c7e6/Nani"
2022,"Venezia","Serie A","Jean-Pierre Nsame","CMR","FW","28",1993,2.7,1,1,0,0,1,0,0,NA,0,0,0,0,0,1,1,0,"https://fbref.com/en/players/12e6d21a/Jean-Pierre-Nsame"
2022,"Venezia","Serie A","David Okereke","NGA","FW,MF","23",1997,22.8,16,10,4,9,3,3,20,15,17,19,3,16,10,26,20,0,"https://fbref.com/en/players/d125f22f/David-Okereke"
2022,"Venezia","Serie A","Dor Peretz","ISR","MF","26",1995,6.5,27,18,8,16,3,13,25,52,12,8,4,4,8,35,11,0,"https://fbref.com/en/players/e2a302a8/Dor-Peretz"
2022,"Venezia","Serie A","Sergio Romero","ARG","GK","34",1987,16,2,2,2,0,0,2,2,100,0,0,0,0,1,3,10,0,"https://fbref.com/en/players/1e26e376/Sergio-Romero"
2022,"Venezia","Serie A","David Schnegg","AUT","DF","22",1998,1.6,2,0,1,1,0,1,3,33.3,2,4,0,4,3,5,6,0,"https://fbref.com/en/players/1c341b14/David-Schnegg"
2022,"Venezia","Serie A","Arnór Sigurðsson","ISL","FW,MF","22",1999,2,1,1,0,1,0,1,2,50,1,2,0,2,1,2,0,0,"https://fbref.com/en/players/f209b81e/Arnor-Sigurdsson"
2022,"Venezia","Serie A","Michael Svoboda","AUT","DF","22",1998,13.7,33,17,26,6,1,18,32,56.3,14,27,15,12,10,43,61,5,"https://fbref.com/en/players/8abd174d/Michael-Svoboda"
2022,"Venezia","Serie A","Tanner Tessmann","USA","MF","19",2001,7.6,11,5,4,6,1,5,14,35.7,9,19,9,10,5,16,22,0,"https://fbref.com/en/players/ac277993/Tanner-Tessmann"
2022,"Venezia","Serie A","Maximilian Ullmann","AUT","DF","25",1996,2.7,0,0,0,0,0,0,1,0,1,4,0,4,2,2,7,0,"https://fbref.com/en/players/caaf2ed1/Maximilian-Ullmann"
2022,"Venezia","Serie A","Antonio Vacca","ITA","MF","31",1990,11.8,36,20,24,10,2,14,36,38.9,22,16,8,8,20,56,16,0,"https://fbref.com/en/players/444c89d9/Antonio-Vacca"
2022,"Villarreal","La Liga","Raúl Albiol","ESP","DF","35",1985,27.4,26,15,20,5,1,14,18,77.8,4,24,15,9,21,47,126,1,"https://fbref.com/en/players/4bd414c1/Raul-Albiol"
2022,"Villarreal","La Liga","Paco Alcácer","ESP","FW","27",1993,8.7,9,3,2,4,3,1,5,20,4,7,0,7,6,15,1,0,"https://fbref.com/en/players/a7a9d95a/Paco-Alcacer"
2022,"Villarreal","La Liga","Sergio Asenjo","ESP","GK","32",1989,6,0,0,0,0,0,0,1,0,1,0,0,0,1,1,6,0,"https://fbref.com/en/players/9f0ea33f/Sergio-Asenjo"
2022,"Villarreal","La Liga","Serge Aurier","CIV","DF","28",1992,11.2,14,9,11,2,1,4,7,57.1,3,14,7,7,11,25,25,0,"https://fbref.com/en/players/5c2b4f07/Serge-Aurier"
2022,"Villarreal","La Liga","Étienne Capoue","FRA","MF","33",1988,25.4,44,26,18,23,3,15,28,53.6,13,17,5,12,35,79,51,0,"https://fbref.com/en/players/5acc4a10/Etienne-Capoue"
2022,"Villarreal","La Liga","Carlo","ESP","MF","20",2001,0.1,0,0,0,0,0,0,0,NA,0,0,0,0,0,0,0,0,"https://fbref.com/en/players/8249ff06/Carlo"
2022,"Villarreal","La Liga","Samuel Chukwueze","NGA","MF,FW","22",1999,14.8,13,9,6,5,2,3,6,50,3,7,0,7,5,18,4,0,"https://fbref.com/en/players/b8a642fc/Samuel-Chukwueze"
2022,"Villarreal","La Liga","Francis Coquelin","FRA","MF","30",1991,9.2,26,17,9,11,6,11,20,55,9,15,5,10,19,45,11,0,"https://fbref.com/en/players/a6951bf8/Francis-Coquelin"
2022,"Villarreal","La Liga","Arnaut Danjuma","NED","FW","24",1997,16.4,7,6,3,0,4,2,4,50,2,5,0,5,2,9,3,0,"https://fbref.com/en/players/f08490a6/Arnaut-Danjuma"
2022,"Villarreal","La Liga","Boulaye Dia","SEN","FW","24",1996,14.1,8,6,3,4,1,2,5,40,3,6,1,5,5,13,4,0,"https://fbref.com/en/players/244bc2c8/Boulaye-Dia"
2022,"Villarreal","La Liga","Pervis Estupiñán","ECU","DF","23",1998,17.5,36,22,20,11,5,17,24,70.8,7,13,5,8,25,61,29,2,"https://fbref.com/en/players/d38fdf53/Pervis-Estupinan"
2022,"Villarreal","La Liga","Juan Foyth","ARG","DF","23",1998,21.4,69,49,35,28,6,35,47,74.5,12,29,7,22,20,89,50,0,"https://fbref.com/en/players/6c7762c3/Juan-Foyth"
2022,"Villarreal","La Liga","Mario Gaspar","ESP","DF","30",1990,6.9,10,4,2,5,3,6,10,60,4,6,3,3,6,16,15,0,"https://fbref.com/en/players/fb5d47b3/Mario-Gaspar"
2022,"Villarreal","La Liga","Moi Gómez","ESP","MF,FW","27",1994,14.3,15,7,8,3,4,5,17,29.4,12,5,0,5,6,21,6,0,"https://fbref.com/en/players/5a626448/Moi-Gomez"
2022,"Villarreal","La Liga","Vicente Iborra","ESP","MF","33",1988,11.5,19,10,9,7,3,12,24,50,12,11,5,6,11,30,27,1,"https://fbref.com/en/players/ad1ffcfd/Vicente-Iborra"
2022,"Villarreal","La Liga","Nikita Iosifov","RUS","MF","20",2001,0,0,0,0,0,0,0,0,NA,0,0,0,0,0,0,0,0,"https://fbref.com/en/players/4c2fa917/Nikita-Iosifov"
2022,"Villarreal","La Liga","Nicolas Jackson","SEN","FW,MF","20",2001,1.8,2,0,1,0,1,0,0,NA,0,0,0,0,1,3,1,0,"https://fbref.com/en/players/9c36ed83/Nicolas-Jackson"
2022,"Villarreal","La Liga","Giovani Lo Celso","ARG","FW,MF","25",1996,11,22,12,8,10,4,9,22,40.9,13,4,0,4,5,27,3,0,"https://fbref.com/en/players/d7553721/Giovani-Lo-Celso"
2022,"Villarreal","La Liga","Aïssa Mandi","ALG","DF","29",1991,15.3,11,5,2,8,1,3,6,50,3,17,14,3,13,24,49,3,"https://fbref.com/en/players/fbd6378b/Aissa-Mandi"
2022,"Villarreal","La Liga","Alberto Moreno","ESP","MF,DF","29",1992,13.6,13,7,5,7,1,5,18,27.8,13,13,1,12,27,40,15,0,"https://fbref.com/en/players/11b9265b/Alberto-Moreno"
2022,"Villarreal","La Liga","Gerard Moreno","ESP","FW","29",1992,13.2,5,2,2,2,1,1,7,14.3,6,6,1,5,6,11,14,0,"https://fbref.com/en/players/81f0781e/Gerard-Moreno"
2022,"Villarreal","La Liga","Daniel Parejo","ESP","MF","32",1989,30,43,29,15,15,13,20,52,38.5,32,32,7,25,29,72,19,1,"https://fbref.com/en/players/7460ca0d/Daniel-Parejo"
2022,"Villarreal","La Liga","Alfonso Pedraza","ESP","DF","25",1996,18.9,34,16,17,12,5,10,28,35.7,18,12,3,9,31,65,32,0,"https://fbref.com/en/players/63f04c6c/Alfonso-Pedraza"
2022,"Villarreal","La Liga","Rubén Peña","ESP","MF,FW","30",1991,1.5,2,0,1,1,0,2,6,33.3,4,1,0,1,5,7,2,0,"https://fbref.com/en/players/1f079188/Ruben-Pena"
2022,"Villarreal","La Liga","Yeremi Pino","ESP","MF,FW","18",2002,18.6,32,14,14,8,10,10,24,41.7,14,33,4,29,6,38,12,1,"https://fbref.com/en/players/540ec57b/Yeremi-Pino"
2022,"Villarreal","La Liga","Dani Raba","ESP","MF,FW","25",1995,1,1,0,0,1,0,1,2,50,1,2,0,2,0,1,2,0,"https://fbref.com/en/players/ea6a7ab4/Dani-Raba"
2022,"Villarreal","La Liga","Gerónimo Rulli","ARG","GK","29",1992,32,0,0,0,0,0,0,4,0,4,0,0,0,1,1,15,5,"https://fbref.com/en/players/625c144a/Geronimo-Rulli"
2022,"Villarreal","La Liga","Pau Torres","ESP","DF","24",1997,31.7,32,19,23,7,2,18,25,72,7,32,23,9,19,51,105,2,"https://fbref.com/en/players/532e1e4f/Pau-Torres"
2022,"Villarreal","La Liga","Manu Trigueros","ESP","MF,FW","29",1991,24.2,45,25,16,18,11,23,66,34.8,43,19,3,16,13,58,17,0,"https://fbref.com/en/players/963829d0/Manu-Trigueros"
2022,"Watford","Premier League","Daniel Bachmann","AUT","GK","27",1994,12,0,0,0,0,0,0,0,NA,0,0,0,0,1,1,5,0,"https://fbref.com/en/players/1c0eea98/Daniel-Bachmann"
2022,"Watford","Premier League","Craig Cathcart","NIR","DF","32",1989,26.6,32,15,25,6,1,16,30,53.3,14,39,29,10,28,60,132,3,"https://fbref.com/en/players/89e4b358/Craig-Cathcart"
2022,"Watford","Premier League","Tom Cleverley","ENG","MF","31",1989,18,37,20,19,17,1,18,33,54.5,15,23,6,17,18,55,19,3,"https://fbref.com/en/players/6cdd8245/Tom-Cleverley"
2022,"Watford","Premier League","Cucho","COL","FW,MF","22",1999,12.7,13,5,5,5,3,5,27,18.5,22,13,1,12,5,18,9,0,"https://fbref.com/en/players/71b47ab9/Cucho"
2022,"Watford","Premier League","Troy Deeney","ENG","FW","33",1988,0.3,0,0,0,0,0,0,1,0,1,0,0,0,0,0,2,0,"https://fbref.com/en/players/82e34b69/Troy-Deeney"
2022,"Watford","Premier League","Emmanuel Dennis","NGA","FW,MF","23",1997,28.7,51,35,20,22,9,17,52,32.7,35,36,2,34,15,66,13,0,"https://fbref.com/en/players/2c44a35d/Emmanuel-Dennis"
2022,"Watford","Premier League","Oghenekaro Etebo","NGA","MF","25",1995,4.5,11,8,7,4,0,3,8,37.5,5,3,1,2,5,16,5,0,"https://fbref.com/en/players/b579e83d/Oghenekaro-Etebo"
2022,"Watford","Premier League","Kiko Femenía","ESP","DF","30",1991,23.8,35,22,23,10,2,21,37,56.8,16,24,8,16,37,72,51,0,"https://fbref.com/en/players/e5d01ecf/Kiko-Femenia"
2022,"Watford","Premier League","Ashley Fletcher","ENG","FW","25",1995,0.3,2,1,1,1,0,1,1,100,0,1,1,0,0,2,0,0,"https://fbref.com/en/players/eeb6551f/Ashley-Fletcher"
2022,"Watford","Premier League","Ben Foster","ENG","GK","38",1983,26,0,0,0,0,0,0,3,0,3,0,0,0,0,0,9,4,"https://fbref.com/en/players/d0b3ceb9/Ben-Foster"
2022,"Watford","Premier League","Dan Gosling","ENG","MF","31",1990,1.8,2,1,1,1,0,2,6,33.3,4,2,0,2,0,2,3,0,"https://fbref.com/en/players/7fec31a0/Dan-Gosling"
2022,"Watford","Premier League","João Pedro","BRA","FW,MF","19",2001,18.3,20,14,7,8,5,6,23,26.1,17,23,3,20,15,35,17,0,"https://fbref.com/en/players/e8832875/Joao-Pedro"
2022,"Watford","Premier League","Christian Kabasele","BEL","DF","30",1991,13.3,11,5,10,1,0,7,10,70,3,20,16,4,14,25,67,1,"https://fbref.com/en/players/914ab9a1/Christian-Kabasele"
2022,"Watford","Premier League","Samuel Kalu","NGA","FW","23",1997,2.5,2,2,0,2,0,1,1,100,0,2,0,2,3,5,3,0,"https://fbref.com/en/players/b8d22478/Samuel-Kalu"
2022,"Watford","Premier League","Hassane Kamara","CIV","DF","27",1994,18,53,34,31,16,6,27,43,62.8,16,20,4,16,69,122,67,0,"https://fbref.com/en/players/19a12bed/Hassane-Kamara"
2022,"Watford","Premier League","Edo Kayembe","COD","MF","23",1998,8.9,21,13,11,9,1,8,16,50,8,6,1,5,9,30,13,0,"https://fbref.com/en/players/f99b71de/Edo-Kayembe"
2022,"Watford","Premier League","Joshua King","NOR","FW","29",1992,25,19,15,7,6,6,4,17,23.5,13,15,4,11,8,27,31,0,"https://fbref.com/en/players/43458538/Joshua-King"
2022,"Watford","Premier League","Juraj Kucka","SVK","MF","34",1987,21.3,59,39,32,25,2,27,73,37,46,30,9,21,27,86,46,2,"https://fbref.com/en/players/5aaef9ef/Juraj-Kucka"
2022,"Watford","Premier League","Imran Louza","MAR","MF","22",1999,15.7,41,21,18,20,3,16,38,42.1,22,28,6,22,42,83,20,1,"https://fbref.com/en/players/e1df6989/Imran-Louza"
2022,"Watford","Premier League","Adam Masina","MAR","DF","27",1994,12,24,13,11,10,3,12,29,41.4,17,18,6,12,18,42,45,0,"https://fbref.com/en/players/de0f152c/Adam-Masina"
2022,"Watford","Premier League","Jeremy Ngakia","ENG","DF","20",2000,10,31,18,23,5,3,11,26,42.3,15,11,4,7,12,43,32,0,"https://fbref.com/en/players/3631ad41/Jeremy-Ngakia"
2022,"Watford","Premier League","Nicolas Nkoulou","CMR","DF","31",1990,1.9,1,0,0,1,0,0,0,NA,0,2,1,1,2,3,8,0,"https://fbref.com/en/players/93cf32a8/Nicolas-Nkoulou"
2022,"Watford","Premier League","Danny Rose","ENG","DF","31",1990,7.7,16,10,11,4,1,10,24,41.7,14,8,5,3,14,30,11,1,"https://fbref.com/en/players/89d10e53/Danny-Rose"
2022,"Watford","Premier League","Samir Santos","BRA","DF","26",1994,18.6,24,11,18,6,0,8,19,42.1,11,21,11,10,43,67,85,3,"https://fbref.com/en/players/92b4758e/Samir-Santos"
2022,"Watford","Premier League","Ismaila Sarr","SEN","FW,MF","23",1998,20.7,12,7,4,3,5,5,19,26.3,14,10,1,9,9,21,10,0,"https://fbref.com/en/players/bfdb33aa/Ismaila-Sarr"
2022,"Watford","Premier League","Ken Sema","SWE","MF,FW","27",1993,9.5,16,6,11,4,1,9,20,45,11,10,0,10,5,21,11,0,"https://fbref.com/en/players/1770bd68/Ken-Sema"
2022,"Watford","Premier League","Francisco Sierralta","CHI","DF","24",1997,4.7,7,3,7,0,0,5,8,62.5,3,7,2,5,6,13,35,0,"https://fbref.com/en/players/0f933743/Francisco-Sierralta"
2022,"Watford","Premier League","Moussa Sissoko","FRA","MF","31",1989,35.8,53,27,27,20,6,28,42,66.7,14,42,13,29,30,83,64,0,"https://fbref.com/en/players/2acd49b9/Moussa-Sissoko"
2022,"Watford","Premier League","William Troost-Ekong","NGA","DF","27",1993,15.4,18,9,11,6,1,10,15,66.7,5,24,14,10,7,25,82,1,"https://fbref.com/en/players/7ed4921e/William-Troost-Ekong"
2022,"Watford","Premier League","Ozan Tufan","TUR","MF","26",1995,3.7,3,2,1,1,1,1,5,20,4,2,0,2,2,5,4,0,"https://fbref.com/en/players/17d45fb2/Ozan-Tufan"
2022,"West Ham","Premier League","Michail Antonio","JAM","FW","31",1990,33,23,17,5,9,9,7,18,38.9,11,19,1,18,3,26,13,0,"https://fbref.com/en/players/ac05f970/Michail-Antonio"
2022,"West Ham","Premier League","Alphonse Areola","FRA","GK","28",1993,1,0,0,0,0,0,0,0,NA,0,0,0,0,0,0,1,0,"https://fbref.com/en/players/2f965a72/Alphonse-Areola"
2022,"West Ham","Premier League","Harrison Ashby","SCO","DF","19",2001,0.1,0,0,0,0,0,0,0,NA,0,1,0,1,1,1,1,0,"https://fbref.com/en/players/b391383a/Harrison-Ashby"
2022,"West Ham","Premier League","Saïd Benrahma","ALG","FW,MF","25",1995,24.1,28,17,16,9,3,15,38,39.5,23,17,1,16,9,37,8,0,"https://fbref.com/en/players/5a04fd92/Said-Benrahma"
2022,"West Ham","Premier League","Jarrod Bowen","ENG","FW","24",1996,33.1,36,20,20,11,5,17,44,38.6,27,29,2,27,21,57,14,0,"https://fbref.com/en/players/79c84d1c/Jarrod-Bowen"
2022,"West Ham","Premier League","Daniel Chesters","ENG","MF","19",2002,0,0,0,0,0,0,0,0,NA,0,0,0,0,0,0,0,0,"https://fbref.com/en/players/240c8ab6/Daniel-Chesters"
2022,"West Ham","Premier League","Vladimír Coufal","CZE","DF","28",1992,24.5,45,25,24,14,7,18,36,50,18,31,9,22,22,67,64,1,"https://fbref.com/en/players/fdf3cb77/Vladimir-Coufal"
2022,"West Ham","Premier League","Aaron Cresswell","ENG","DF","31",1989,30.3,28,18,18,6,4,13,25,52,12,31,18,13,35,63,66,0,"https://fbref.com/en/players/4f974391/Aaron-Cresswell"
2022,"West Ham","Premier League","Craig Dawson","ENG","DF","31",1990,30.6,29,17,20,8,1,14,25,56,11,59,52,7,29,58,139,0,"https://fbref.com/en/players/3e9e06cb/Craig-Dawson"
2022,"West Ham","Premier League","Issa Diop","FRA","DF","24",1997,10.7,10,8,5,5,0,4,11,36.4,7,14,13,1,7,17,44,0,"https://fbref.com/en/players/a712ca2b/Issa-Diop"
2022,"West Ham","Premier League","Łukasz Fabiański","POL","GK","36",1985,37,0,0,0,0,0,0,0,NA,0,0,0,0,0,0,11,0,"https://fbref.com/en/players/9328b835/Lukasz-Fabianski"
2022,"West Ham","Premier League","Pablo Fornals","ESP","FW,MF","25",1996,31.1,54,28,21,21,12,22,84,26.2,62,49,2,47,27,81,16,1,"https://fbref.com/en/players/82927de4/Pablo-Fornals"
2022,"West Ham","Premier League","Ryan Fredericks","ENG","DF","28",1992,3.4,2,2,2,0,0,0,1,0,1,2,1,1,4,6,6,0,"https://fbref.com/en/players/c067631c/Ryan-Fredericks"
2022,"West Ham","Premier League","Ben Johnson","ENG","DF","21",2000,15.5,33,16,15,15,3,21,28,75,7,16,8,8,22,55,55,0,"https://fbref.com/en/players/9319781b/Ben-Johnson"
2022,"West Ham","Premier League","Alex Král","CZE","MF","23",1998,0,0,0,0,0,0,0,0,NA,0,0,0,0,0,0,0,0,"https://fbref.com/en/players/e717705a/Alex-Kral"
2022,"West Ham","Premier League","Manuel Lanzini","ARG","MF,FW","28",1993,19.8,28,15,10,11,7,10,35,28.6,25,16,0,16,19,47,10,0,"https://fbref.com/en/players/26f6dca8/Manuel-Lanzini"
2022,"West Ham","Premier League","Arthur Masuaku","COD","DF,FW","27",1993,7.2,31,23,19,11,1,14,23,60.9,9,9,1,8,9,40,17,0,"https://fbref.com/en/players/57df7a11/Arthur-Masuaku"
2022,"West Ham","Premier League","Mark Noble","ENG","MF","34",1987,3.7,8,2,7,1,0,5,11,45.5,6,4,1,3,4,12,2,1,"https://fbref.com/en/players/ff527768/Mark-Noble"
2022,"West Ham","Premier League","Angelo Ogbonna","ITA","DF","33",1988,10.2,7,4,5,2,0,3,7,42.9,4,5,4,1,11,18,29,0,"https://fbref.com/en/players/74b2cd7e/Angelo-Ogbonna"
2022,"West Ham","Premier League","Sonny Perkins","ENG","FW","17",2004,0,NA,0,NA,NA,NA,NA,NA,NA,NA,NA,NA,NA,0,NA,NA,NA,"https://fbref.com/en/players/87f12e30/Sonny-Perkins"
2022,"West Ham","Premier League","Declan Rice","ENG","MF","22",1999,35.3,80,42,45,32,3,38,71,53.5,33,45,21,24,63,143,52,1,"https://fbref.com/en/players/1c7012b8/Declan-Rice"
2022,"West Ham","Premier League","Tomáš Souček","CZE","MF","26",1995,34,66,32,27,33,6,28,65,43.1,37,34,13,21,52,118,98,1,"https://fbref.com/en/players/6613c819/Tomas-Soucek"
2022,"West Ham","Premier League","Nikola Vlašić","CRO","FW,MF","23",1997,6.2,11,7,4,6,1,5,20,25,15,4,0,4,2,13,1,0,"https://fbref.com/en/players/aa8e289e/Nikola-Vlasic"
2022,"West Ham","Premier League","Andriy Yarmolenko","UKR","FW,MF","31",1989,3.5,4,2,2,2,0,2,8,25,6,4,2,2,0,4,2,0,"https://fbref.com/en/players/849c826a/Andriy-Yarmolenko"
2022,"West Ham","Premier League","Kurt Zouma","FRA","DF","26",1994,23.1,11,6,8,3,0,4,7,57.1,3,31,26,5,34,45,132,0,"https://fbref.com/en/players/ce4246f5/Kurt-Zouma"
2022,"Wolfsburg","Bundesliga","Maximilian Arnold","GER","MF","27",1994,33.3,37,20,19,16,2,20,50,40,30,43,15,28,37,74,55,0,"https://fbref.com/en/players/86e119e0/Maximilian-Arnold"
2022,"Wolfsburg","Bundesliga","Ridle Baku","GER","DF,FW","23",1998,27.2,62,37,30,24,8,25,65,38.5,40,43,1,42,21,83,52,1,"https://fbref.com/en/players/442b56fa/Ridle-Baku"
2022,"Wolfsburg","Bundesliga","Bartosz Bialek","POL","FW,DF","19",2001,2,0,0,0,0,0,0,1,0,1,1,0,1,0,0,2,0,"https://fbref.com/en/players/763b8b37/Bartosz-Bialek"
2022,"Wolfsburg","Bundesliga","Sebastiaan Bornauw","BEL","DF","22",1999,22.3,30,19,23,5,2,16,25,64,9,29,8,21,42,72,97,1,"https://fbref.com/en/players/01834aa0/Sebastiaan-Bornauw"
2022,"Wolfsburg","Bundesliga","Josip Brekalo","CRO","FW","23",1998,0.2,0,0,0,0,0,0,0,NA,0,0,0,0,0,0,0,0,"https://fbref.com/en/players/d4a2533d/Josip-Brekalo"
2022,"Wolfsburg","Bundesliga","John Brooks","USA","DF","28",1993,29.1,47,25,25,18,4,36,60,60,24,33,19,14,41,88,125,1,"https://fbref.com/en/players/e27da244/John-Brooks"
2022,"Wolfsburg","Bundesliga","Koen Casteels","BEL","GK","29",1992,28,0,0,0,0,0,0,1,0,1,0,0,0,0,0,9,2,"https://fbref.com/en/players/db401046/Koen-Casteels"
2022,"Wolfsburg","Bundesliga","Yannick Gerhardt","GER","MF,DF","27",1994,17.5,42,20,18,17,7,22,36,61.1,14,24,1,23,25,67,25,1,"https://fbref.com/en/players/62ab9184/Yannick-Gerhardt"
2022,"Wolfsburg","Bundesliga","Daniel Ginczek","GER","MF,FW","30",1991,0.1,0,0,0,0,0,0,0,NA,0,0,0,0,0,0,0,0,"https://fbref.com/en/players/e5f63987/Daniel-Ginczek"
2022,"Wolfsburg","Bundesliga","Josuha Guilavogui","FRA","MF,DF","30",1990,10.5,23,14,13,9,1,7,18,38.9,11,11,6,5,25,48,42,0,"https://fbref.com/en/players/e6c43eec/Josuha-Guilavogui"
2022,"Wolfsburg","Bundesliga","Felix Kalu Nmecha","GER","MF,FW","20",2000,3.6,3,1,1,1,1,0,2,0,2,2,0,2,7,10,6,0,"https://fbref.com/en/players/091c86e2/Felix-Kalu-Nmecha"
2022,"Wolfsburg","Bundesliga","Max Kruse","GER","MF,FW","33",1988,12.5,9,3,4,4,1,5,12,41.7,7,2,0,2,3,12,4,0,"https://fbref.com/en/players/f9446dcd/Max-Kruse"
2022,"Wolfsburg","Bundesliga","Maxence Lacroix","FRA","DF","21",2000,27.7,59,33,41,16,2,29,40,72.5,11,35,16,19,60,119,144,0,"https://fbref.com/en/players/277c49ed/Maxence-Lacroix"
2022,"Wolfsburg","Bundesliga","Dodi Lukebakio","BEL","FW,MF","23",1997,9.8,7,4,3,2,2,1,10,10,9,5,0,5,13,20,4,0,"https://fbref.com/en/players/0c61c77c/Dodi-Lukebakio"
2022,"Wolfsburg","Bundesliga","Omar Marmoush","EGY","FW","22",1999,0.3,0,0,0,0,0,0,0,NA,0,0,0,0,0,0,0,0,"https://fbref.com/en/players/0e0102eb/Omar-Marmoush"
2022,"Wolfsburg","Bundesliga","Kevin Mbabu","SUI","DF","26",1995,15.5,31,20,21,5,5,12,23,52.2,11,25,8,17,35,66,35,0,"https://fbref.com/en/players/493924a7/Kevin-Mbabu"
2022,"Wolfsburg","Bundesliga","Admir Mehmedi","SUI","DF","30",1991,0,0,0,0,0,0,0,0,NA,0,0,0,0,0,0,0,0,"https://fbref.com/en/players/b500b384/Admir-Mehmedi"
2022,"Wolfsburg","Bundesliga","Lukas Nmecha","GER","FW,MF","22",1998,18.1,12,5,5,5,2,5,19,26.3,14,9,1,8,4,16,10,0,"https://fbref.com/en/players/0cc5f4a5/Lukas-Nmecha"
2022,"Wolfsburg","Bundesliga","Paulo Otávio","BRA","DF,MF","26",1994,4,14,10,7,4,3,8,15,53.3,7,11,6,5,4,18,9,0,"https://fbref.com/en/players/1cbe4984/Paulo-Otavio"
2022,"Wolfsburg","Bundesliga","Kevin Paredes","USA","FW,DF","18",2003,0.2,1,0,0,0,1,0,0,NA,0,1,0,1,0,1,0,0,"https://fbref.com/en/players/5c50fdbc/Kevin-Paredes"
2022,"Wolfsburg","Bundesliga","Pavao Pervan","AUT","GK","33",1987,6,0,0,0,0,0,0,0,NA,0,0,0,0,0,0,3,0,"https://fbref.com/en/players/c89e8aae/Pavao-Pervan"
2022,"Wolfsburg","Bundesliga","Maximilian Philipp","GER","MF","27",1994,10.7,15,11,6,7,2,5,21,23.8,16,12,1,11,4,19,5,0,"https://fbref.com/en/players/061e8e23/Maximilian-Philipp"
2022,"Wolfsburg","Bundesliga","Jérôme Roussillon","FRA","DF","28",1993,19.7,14,9,8,6,0,10,16,62.5,6,24,5,19,14,28,34,2,"https://fbref.com/en/players/13203c45/Jerome-Roussillon"
2022,"Wolfsburg","Bundesliga","Xaver Schlager","AUT","MF","23",1997,11.6,43,20,20,20,3,20,49,40.8,29,25,2,23,9,52,14,0,"https://fbref.com/en/players/8f056768/Xaver-Schlager"
2022,"Wolfsburg","Bundesliga","Renato Steffen","SUI","FW,MF","29",1991,10.7,20,16,10,10,0,9,16,56.3,7,7,0,7,13,33,14,0,"https://fbref.com/en/players/dd669209/Renato-Steffen"
2022,"Wolfsburg","Bundesliga","Mickey van de Ven","NED","DF","20",2001,2.1,4,4,3,1,0,0,1,0,1,4,1,3,2,6,8,0,"https://fbref.com/en/players/8fe2a392/Mickey-van-de-Ven"
2022,"Wolfsburg","Bundesliga","Aster Vranckx","BEL","MF","18",2002,12.7,34,13,14,16,4,14,26,53.8,12,19,7,12,13,47,16,0,"https://fbref.com/en/players/f86cd5df/Aster-Vranckx"
2022,"Wolfsburg","Bundesliga","Luca Waldschmidt","GER","MF,FW","25",1996,8,9,1,3,5,1,5,13,38.5,8,5,0,5,8,17,3,0,"https://fbref.com/en/players/e5a35ae9/Luca-Waldschmidt"
2022,"Wolfsburg","Bundesliga","Wout Weghorst","NED","FW","28",1992,17.3,13,7,3,3,7,7,17,41.2,10,10,3,7,2,15,11,1,"https://fbref.com/en/players/c4e87b8b/Wout-Weghorst"
2022,"Wolfsburg","Bundesliga","Jonas Wind","DEN","FW,MF","22",1999,13.1,10,6,1,7,2,1,4,25,3,8,3,5,6,16,13,0,"https://fbref.com/en/players/2077ae86/Jonas-Wind"
2022,"Wolves","Premier League","Rayan Aït Nouri","FRA","DF,MF","20",2001,20.3,64,36,46,15,3,22,44,50,22,24,2,22,22,86,39,1,"https://fbref.com/en/players/9b398aea/Rayan-Ait-Nouri"
2022,"Wolves","Premier League","Willy Boly","CIV","DF","30",1991,10,25,19,18,7,0,8,15,53.3,7,14,6,8,14,39,35,0,"https://fbref.com/en/players/a4ac4b8f/Willy-Boly"
2022,"Wolves","Premier League","Chem Campbell","WAL","MF","18",2002,0.1,1,1,0,1,0,0,0,NA,0,0,0,0,0,1,0,0,"https://fbref.com/en/players/6f711f67/Chem-Campbell"
2022,"Wolves","Premier League","Jonny Castro","ESP","DF","27",1994,11.4,25,15,13,11,1,11,20,55,9,14,3,11,13,38,11,0,"https://fbref.com/en/players/e28868f3/Jonny-Castro"
2022,"Wolves","Premier League","Chiquinho","POR","DF,FW","21",2000,2.3,9,6,4,5,0,4,5,80,1,5,0,5,2,11,1,0,"https://fbref.com/en/players/dc6c2f02/Chiquinho"
2022,"Wolves","Premier League","Conor Coady","ENG","DF","28",1993,37.3,31,14,23,7,1,16,28,57.1,12,46,40,6,28,59,140,0,"https://fbref.com/en/players/2928dca2/Conor-Coady"
2022,"Wolves","Premier League","Luke Cundle","ENG","MF","19",2002,2,4,3,0,4,0,1,1,100,0,0,0,0,1,5,1,0,"https://fbref.com/en/players/cc3b8e78/Luke-Cundle"
2022,"Wolves","Premier League","Leander Dendoncker","BEL","MF","26",1995,21.7,42,17,25,14,3,22,50,44,28,37,10,27,9,51,38,1,"https://fbref.com/en/players/5a7301ae/Leander-Dendoncker"
2022,"Wolves","Premier League","Morgan Gibbs-White","ENG","DF,FW","21",2000,0.1,0,0,0,0,0,0,0,NA,0,1,0,1,0,0,0,0,"https://fbref.com/en/players/32f60ed8/Morgan-Gibbs-White"
2022,"Wolves","Premier League","Toti Gomes","POR","DF","22",1999,4,11,7,10,1,0,7,9,77.8,2,6,3,3,8,19,15,0,"https://fbref.com/en/players/f0caab96/Toti-Gomes"
2022,"Wolves","Premier League","Hwang Hee-chan","KOR","FW,MF","25",1996,20.2,27,13,9,16,2,14,44,31.8,30,10,0,10,13,40,7,1,"https://fbref.com/en/players/169fd162/Hwang-Hee-chan"
2022,"Wolves","Premier League","Ki-Jana Hoever","NED","DF,MF","19",2002,3.4,10,6,5,5,0,7,12,58.3,5,6,0,6,6,16,8,0,"https://fbref.com/en/players/9a71e978/Ki-Jana-Hoever"
2022,"Wolves","Premier League","Raúl Jiménez","MEX","FW","30",1991,29.2,29,14,6,16,7,6,30,20,24,31,5,26,13,42,26,0,"https://fbref.com/en/players/b561db50/Raul-Jimenez"
2022,"Wolves","Premier League","Max Kilman","ENG","DF","24",1997,29.9,50,26,38,10,2,24,37,64.9,13,36,21,15,45,95,113,3,"https://fbref.com/en/players/d0f72bf1/Max-Kilman"
2022,"Wolves","Premier League","Fernando Marçal","BRA","MF,DF","32",1989,16.1,42,22,27,14,1,21,37,56.8,16,25,4,21,28,70,52,0,"https://fbref.com/en/players/9ae9eaea/Fernando-Marcal"
2022,"Wolves","Premier League","João Moutinho","POR","MF","34",1986,33,74,39,34,27,13,30,106,28.3,76,48,8,40,34,108,36,2,"https://fbref.com/en/players/f5a00fa4/Joao-Moutinho"
2022,"Wolves","Premier League","Pedro Neto","POR","FW,MF","21",2000,5.2,4,4,2,0,2,0,9,0,9,0,0,0,6,10,1,0,"https://fbref.com/en/players/7ba2eaa9/Pedro-Neto"
2022,"Wolves","Premier League","Rúben Neves","POR","MF","24",1997,29.6,68,37,23,41,4,24,87,27.6,63,39,5,34,41,109,49,3,"https://fbref.com/en/players/44bfb6c5/Ruben-Neves"
2022,"Wolves","Premier League","Daniel Podence","POR","FW,MF","25",1995,16.5,18,11,10,5,3,4,17,23.5,13,8,1,7,10,28,1,0,"https://fbref.com/en/players/7fcc71d8/Daniel-Podence"
2022,"Wolves","Premier League","John Ruddy","ENG","GK","34",1986,1.5,0,0,0,0,0,0,0,NA,0,0,0,0,0,0,3,0,"https://fbref.com/en/players/da8b19e2/John-Ruddy"
2022,"Wolves","Premier League","José Sá","POR","GK","28",1993,36.5,2,1,2,0,0,2,4,50,2,0,0,0,2,4,19,5,"https://fbref.com/en/players/903b6e8b/Jose-Sa"
2022,"Wolves","Premier League","Romain Saïss","MAR","DF","31",1990,30.1,40,27,28,11,1,19,33,57.6,14,41,21,20,58,98,158,2,"https://fbref.com/en/players/9fbbcf39/Romain-Saiss"
2022,"Wolves","Premier League","Nélson Semedo","POR","MF,DF","27",1993,23.7,58,39,39,17,2,25,49,51,24,23,4,19,21,79,64,1,"https://fbref.com/en/players/d04b94db/Nelson-Semedo"
2022,"Wolves","Premier League","Fábio Silva","POR","FW","19",2002,6.4,3,2,0,2,1,0,8,0,8,2,0,2,1,4,1,0,"https://fbref.com/en/players/e7aa9d7c/Fabio-Silva"
2022,"Wolves","Premier League","Adama Traoré","ESP","FW,MF","25",1996,11.9,8,3,6,0,2,3,7,42.9,4,4,1,3,2,10,1,0,"https://fbref.com/en/players/9a28eba4/Adama-Traore"
2022,"Wolves","Premier League","Francisco Trincão","POR","FW,MF","21",1999,14.8,28,15,9,13,6,3,19,15.8,16,17,1,16,12,40,1,1,"https://fbref.com/en/players/77e39b04/Francisco-Trincao"
2023,"Ajaccio","Ligue 1","Mickaël Alphonse","GLP","DF","33",1989,15.1,35,23,20,11,4,20,33,60.6,13,17,5,12,35,70,44,1,"https://fbref.com/en/players/0a63446f/Mickael-Alphonse"
2023,"Ajaccio","Ligue 1","Cédric Avinel","GLP","DF","35",1986,19.9,13,7,8,5,0,8,12,66.7,4,20,13,7,15,28,91,1,"https://fbref.com/en/players/a94d93be/Cedric-Avinel"
2023,"Ajaccio","Ligue 1","Mickaël Barreto","FRA","MF","31",1991,14.7,32,20,12,17,3,8,45,17.8,37,17,0,17,18,50,11,0,"https://fbref.com/en/players/e3844ecb/Mickael-Barreto"
2023,"Ajaccio","Ligue 1","Cyrille Bayala","BFA","MF","26",1996,22.3,53,37,16,20,17,23,47,48.9,24,20,3,17,25,78,21,0,"https://fbref.com/en/players/20e0dd86/Cyrille-Bayala"
2023,"Ajaccio","Ligue 1","Youcef Belaïli","ALG","MF,FW","30",1992,12.8,18,10,3,9,6,8,20,40,12,10,1,9,5,23,4,0,"https://fbref.com/en/players/1a248246/Youcef-Belaili"
2023,"Ajaccio","Ligue 1","Kouamé Botué","BFA","FW,MF","19",2002,2.5,4,2,2,1,1,0,2,0,2,1,0,1,0,4,1,0,"https://fbref.com/en/players/65fcf987/Kouame-Botue"
2023,"Ajaccio","Ligue 1","Florian Chabrolle","FRA","MF","24",1998,3.7,6,4,1,5,0,2,4,50,2,3,0,3,7,13,2,0,"https://fbref.com/en/players/5d9577aa/Florian-Chabrolle"
2023,"Ajaccio","Ligue 1","Ivane Chegra","FRA","MF,FW","18",2004,2.1,8,3,6,1,1,4,11,36.4,7,0,0,0,1,9,0,0,"https://fbref.com/en/players/1237c049/Ivane-Chegra"
2023,"Ajaccio","Ligue 1","Yanis Cimignani","FRA","MF,DF","20",2002,3.1,11,5,3,7,1,4,5,80,1,5,1,4,2,13,2,0,"https://fbref.com/en/players/7495aba7/Yanis-Cimignani"
2023,"Ajaccio","Ligue 1","Mathieu Coutadeur","FRA","MF","36",1986,21.6,23,13,13,10,0,8,28,28.6,20,19,3,16,19,42,21,0,"https://fbref.com/en/players/ef8ae23b/Mathieu-Coutadeur"
2023,"Ajaccio","Ligue 1","Ismael Diallo","CIV","DF","25",1997,24.2,46,33,35,9,2,35,63,55.6,28,26,12,14,30,76,46,1,"https://fbref.com/en/players/b3244eeb/Ismael-Diallo"
2023,"Ajaccio","Ligue 1","Moussa Djitte","SEN","FW","22",1999,1.5,1,0,0,0,1,1,2,50,1,0,0,0,0,1,1,0,"https://fbref.com/en/players/627b570a/Moussa-Djitte"
2023,"Ajaccio","Ligue 1","Oumar Gonzalez","CMR","DF","24",1998,28.6,51,28,34,13,4,23,37,62.2,14,32,11,21,52,103,82,0,"https://fbref.com/en/players/a9d4c241/Oumar-Gonzalez"
2023,"Ajaccio","Ligue 1","Ben Hamed Touré","CIV","FW","18",2003,2.3,4,4,2,2,0,1,5,20,4,2,0,2,1,5,4,0,"https://fbref.com/en/players/c7eebddf/Ben-Hamed-Toure"
2023,"Ajaccio","Ligue 1","Romain Hamouma","FRA","FW,MF","35",1987,12,8,3,3,3,2,3,6,50,3,8,0,8,2,10,2,0,"https://fbref.com/en/players/0b4d8274/Romain-Hamouma"
2023,"Ajaccio","Ligue 1","Mounaim El Idrissy","FRA","FW","23",1999,27.7,32,19,5,20,7,10,36,27.8,26,22,0,22,13,45,20,0,"https://fbref.com/en/players/fb0ee44e/Mounaim-El-Idrissy"
2023,"Ajaccio","Ligue 1","Anthony Khelifa","FRA","DF","16",2005,0.1,0,0,0,0,0,0,0,NA,0,0,0,0,0,0,0,0,"https://fbref.com/en/players/3670aa71/Anthony-Khelifa"
2023,"Ajaccio","Ligue 1","Youssouf Koné","MLI","DF","27",1995,10.2,28,19,24,4,0,18,25,72,7,9,2,7,12,40,32,1,"https://fbref.com/en/players/e6eadfb8/Youssouf-Kone"
2023,"Ajaccio","Ligue 1","Qazim Laçi","ALB","MF","26",1996,2.4,6,3,2,3,1,4,9,44.4,5,5,0,5,2,8,3,0,"https://fbref.com/en/players/eb0db257/Qazim-Laci"
2023,"Ajaccio","Ligue 1","Paolo Lebas","POR","MF","19",2003,0.6,0,0,0,0,0,0,0,NA,0,0,0,0,0,0,0,0,"https://fbref.com/en/players/5bf26efc/Paolo-Lebas"
2023,"Ajaccio","Ligue 1","Benjamin Leroy","FRA","GK","33",1989,31.1,0,0,0,0,0,0,2,0,2,0,0,0,1,1,16,2,"https://fbref.com/en/players/1e7aea56/Benjamin-Leroy"
2023,"Ajaccio","Ligue 1","Ruan Levine","BRA","MF,FW","23",1999,0.3,2,2,1,1,0,0,0,NA,0,1,0,1,2,4,0,0,"https://fbref.com/en/players/17e25e72/Ruan-Levine"
2023,"Ajaccio","Ligue 1","Thomas Mangani","FRA","MF","35",1987,14.8,32,17,14,15,3,18,47,38.3,29,22,3,19,24,56,22,1,"https://fbref.com/en/players/c801616a/Thomas-Mangani"
2023,"Ajaccio","Ligue 1","Vincent Marchetti","FRA","MF","25",1997,27.2,55,26,29,19,7,25,68,36.8,43,23,3,20,19,74,31,0,"https://fbref.com/en/players/740f00ac/Vincent-Marchetti"
2023,"Ajaccio","Ligue 1","Fernand Mayembo","CGO","DF","26",1996,7.9,8,5,6,2,0,4,9,44.4,5,2,0,2,11,19,36,0,"https://fbref.com/en/players/b20cc590/Fernand-Mayembo"
2023,"Ajaccio","Ligue 1","Bevic Moussiti-Oko","CGO","FW","27",1995,7.8,3,1,1,1,1,1,2,50,1,5,3,2,2,5,8,0,"https://fbref.com/en/players/71d10572/Bevic-Moussiti-Oko"
2023,"Ajaccio","Ligue 1","Riad Nouri","FRA","MF,FW","37",1985,18.8,21,12,7,10,4,12,29,41.4,17,8,1,7,15,36,11,0,"https://fbref.com/en/players/374fbf7d/Riad-Nouri"
2023,"Ajaccio","Ligue 1","Mehdi Puch Herrantz","FRA","MF","18",2004,0.5,2,2,0,1,1,1,2,50,1,1,0,1,3,5,0,0,"https://fbref.com/en/players/7be7c08b/Mehdi-Puch-Herrantz"
2023,"Ajaccio","Ligue 1","Ghjuvanni Quilichini","FRA","GK","19",2002,0.9,0,0,0,0,0,0,0,NA,0,0,0,0,0,0,1,0,"https://fbref.com/en/players/1b729a98/Ghjuvanni-Quilichini"
2023,"Ajaccio","Ligue 1","François-Joseph Sollacaro","FRA","GK","28",1994,6,0,0,0,0,0,0,0,NA,0,0,0,0,0,0,2,2,"https://fbref.com/en/players/f19f32b1/Francois-Joseph-Sollacaro"
2023,"Ajaccio","Ligue 1","Moussa Soumano","FRA","FW","17",2005,5.5,2,2,0,1,1,0,6,0,6,2,0,2,0,2,0,0,"https://fbref.com/en/players/86a49468/Moussa-Soumano"
2023,"Ajaccio","Ligue 1","Kevin Spadanuda","SUI","MF,FW","25",1997,11.8,29,18,15,9,5,12,33,36.4,21,18,0,18,11,40,5,0,"https://fbref.com/en/players/a45a5d95/Kevin-Spadanuda"
2023,"Ajaccio","Ligue 1","Tony Strata","FRA","MF,DF","17",2004,1.5,4,3,4,0,0,4,5,80,1,2,0,2,1,5,7,0,"https://fbref.com/en/players/4ca4f263/Tony-Strata"
2023,"Ajaccio","Ligue 1","Yoann Touzghar","TUN","FW","35",1986,5,3,2,0,2,1,0,1,0,1,0,0,0,0,3,1,0,"https://fbref.com/en/players/4e47507a/Yoann-Touzghar"
2023,"Ajaccio","Ligue 1","Clément Vidal","FRA","DF,MF","22",2000,21.1,25,15,14,11,0,18,38,47.4,20,27,16,11,27,52,73,1,"https://fbref.com/en/players/b2791a55/Clement-Vidal"
2023,"Ajaccio","Ligue 1","Mohamed Youssouf","COM","DF","34",1988,27.3,72,44,41,24,7,38,61,62.3,23,32,8,24,65,137,70,0,"https://fbref.com/en/players/1a85bcdb/Mohamed-Youssouf"
2023,"Almería","La Liga","Sergio Akieme","ESP","DF","24",1997,25.5,27,16,19,6,2,12,22,54.5,10,22,6,16,14,41,41,0,"https://fbref.com/en/players/06efa9dc/Sergio-Akieme"
2023,"Almería","La Liga","Srđan Babić","SRB","DF","26",1996,33.3,28,18,20,8,0,15,32,46.9,17,34,22,12,29,57,124,1,"https://fbref.com/en/players/075fe5a3/Srdjan-Babic"
2023,"Almería","La Liga","Léo Baptistão","BRA","FW,MF","29",1992,19.2,32,20,13,16,3,13,33,39.4,20,17,2,15,19,51,12,0,"https://fbref.com/en/players/35f6db55/Leo-Baptistao"
2023,"Almería","La Liga","El Bilal Touré","MLI","FW","20",2001,14,4,3,2,1,1,0,3,0,3,6,1,5,1,5,23,0,"https://fbref.com/en/players/47c609d5/El-Bilal-Toure"
2023,"Almería","La Liga","Juan Brandáriz","ESP","DF","23",1999,16.5,29,16,18,9,2,14,23,60.9,9,20,7,13,15,44,53,0,"https://fbref.com/en/players/2475cf9b/Juan-Brandariz"
2023,"Almería","La Liga","José Carlos Lazo","ESP","MF,FW","26",1996,0.2,0,0,0,0,0,0,0,NA,0,0,0,0,0,0,0,0,"https://fbref.com/en/players/5b93209a/Jose-Carlos-Lazo"
2023,"Almería","La Liga","Álex Centelles","ESP","DF","24",1997,12.5,22,14,16,3,3,16,22,72.7,6,13,2,11,11,33,40,0,"https://fbref.com/en/players/ae852b7d/Alex-Centelles"
2023,"Almería","La Liga","Samu Costa","POR","MF","21",2000,22.1,61,31,35,20,6,29,61,47.5,32,29,7,22,37,98,64,4,"https://fbref.com/en/players/76c2a023/Samu-Costa"
2023,"Almería","La Liga","Curro","ESP","MF","26",1996,0.5,2,0,1,1,0,1,2,50,1,0,0,0,0,2,0,0,"https://fbref.com/en/players/f9a225f5/Curro"
2023,"Almería","La Liga","Íñigo Eguaras","ESP","MF","30",1992,10.7,11,8,4,6,1,5,18,27.8,13,9,3,6,6,17,15,0,"https://fbref.com/en/players/3e93f8cf/Inigo-Eguaras"
2023,"Almería","La Liga","Rodrigo Ely","BRA","DF","28",1993,35.1,30,21,26,4,0,18,25,72,7,46,33,13,31,61,203,1,"https://fbref.com/en/players/fd47b4f2/Rodrigo-Ely"
2023,"Almería","La Liga","Adri Embarba","ESP","FW,MF","30",1992,16.4,50,27,21,26,3,22,46,47.8,24,23,0,23,9,59,9,0,"https://fbref.com/en/players/db8f0eba/Adri-Embarba"
2023,"Almería","La Liga","Fernando","ESP","GK","32",1990,36.5,0,0,0,0,0,0,2,0,2,2,0,2,1,1,20,3,"https://fbref.com/en/players/dabb2827/Fernando"
2023,"Almería","La Liga","Luis Javier Suárez","COL","FW","24",1997,16.6,17,11,5,6,6,6,26,23.1,20,13,3,10,3,20,10,0,"https://fbref.com/en/players/eeba07f8/Luis-Javier-Suarez"
2023,"Almería","La Liga","Kaiky","BRA","DF","18",2004,6.5,5,5,5,0,0,3,7,42.9,4,18,10,8,11,16,28,0,"https://fbref.com/en/players/55634fb8/Kaiky"
2023,"Almería","La Liga","César de la Hoz","ESP","MF","30",1992,18.6,37,20,17,18,2,19,37,51.4,18,26,6,20,13,50,37,0,"https://fbref.com/en/players/60abea75/Cesar-de-la-Hoz"
2023,"Almería","La Liga","Lázaro","BRA","FW,MF","20",2002,8,4,3,3,0,1,3,15,20,12,16,1,15,2,6,1,0,"https://fbref.com/en/players/86ff856b/Lazaro"
2023,"Almería","La Liga","Diego Mariño","ESP","GK","32",1990,0.5,0,0,0,0,0,0,0,NA,0,0,0,0,0,0,0,0,"https://fbref.com/en/players/d9235a45/Diego-Marino"
2023,"Almería","La Liga","Gonzalo Melero","ESP","MF","28",1994,20.6,32,16,9,18,5,11,39,28.2,28,23,2,21,7,39,19,1,"https://fbref.com/en/players/3902e91b/Gonzalo-Melero"
2023,"Almería","La Liga","Houboulang Mendes","FRA","DF","24",1998,9.8,19,11,16,3,0,11,27,40.7,16,12,2,10,7,26,23,1,"https://fbref.com/en/players/1545cf15/Houboulang-Mendes"
2023,"Almería","La Liga","Marko Milovanović","SRB","FW","18",2003,0.2,0,0,0,0,0,0,0,NA,0,0,0,0,0,0,0,0,"https://fbref.com/en/players/1fda2b14/Marko-Milovanovic"
2023,"Almería","La Liga","Fernando Pacheco","ESP","GK","30",1992,1,0,0,0,0,0,0,0,NA,0,0,0,0,0,0,1,0,"https://fbref.com/en/players/97852360/Fernando-Pacheco"
2023,"Almería","La Liga","Francisco Portillo","ESP","MF,FW","32",1990,8,13,6,4,5,4,3,16,18.8,13,7,1,6,7,20,8,0,"https://fbref.com/en/players/8e010ff4/Francisco-Portillo"
2023,"Almería","La Liga","Alejandro Pozo Pozo","ESP","DF","23",1999,20.9,37,19,17,17,3,27,53,50.9,26,30,5,25,26,63,45,1,"https://fbref.com/en/players/3c16d927/Alejandro-Pozo-Pozo"
2023,"Almería","La Liga","Arnau Puigmal","ESP","MF,FW","21",2001,8.5,22,14,10,7,5,12,17,70.6,5,7,0,7,11,33,6,0,"https://fbref.com/en/players/39352da2/Arnau-Puigmal"
2023,"Almería","La Liga","Largie Ramazani","BEL","FW,MF","21",2001,15.6,15,9,6,3,6,8,27,29.6,19,11,0,11,15,30,10,0,"https://fbref.com/en/players/cc9256ef/Largie-Ramazani"
2023,"Almería","La Liga","Lucas Robertone","ARG","MF","25",1997,31.6,50,28,20,21,9,28,64,43.8,36,45,7,38,46,96,46,1,"https://fbref.com/en/players/a8981944/Lucas-Robertone"
2023,"Almería","La Liga","Umar Sadiq","NGA","FW","25",1997,2.7,0,0,0,0,0,0,1,0,1,2,0,2,0,0,3,0,"https://fbref.com/en/players/686cbe7d/Umar-Sadiq"
2023,"Almería","La Liga","Dyego Sousa","POR","FW","32",1989,5.9,10,6,5,4,1,4,5,80,1,4,2,2,1,11,14,0,"https://fbref.com/en/players/e4738e91/Dyego-Sousa"
2023,"Angers","Ligue 1","Himad Abdelli","ALG","MF,FW","22",1999,23.7,64,38,22,32,10,31,67,46.3,36,30,1,29,28,92,15,0,"https://fbref.com/en/players/7978cbf0/Himad-Abdelli"
2023,"Angers","Ligue 1","Ibrahim Amadou","FRA","DF,MF","29",1993,4.7,10,7,6,3,1,7,11,63.6,4,7,3,4,10,20,20,0,"https://fbref.com/en/players/9260926b/Ibrahim-Amadou"
2023,"Angers","Ligue 1","Abdoulaye Bamba","CIV","DF","32",1990,15.2,22,12,15,5,2,16,19,84.2,3,7,3,4,18,40,38,0,"https://fbref.com/en/players/7fecbcdb/Abdoulaye-Bamba"
2023,"Angers","Ligue 1","Nabil Bentaleb","ALG","MF","27",1994,27.7,74,40,31,35,8,36,61,59,25,33,11,22,44,118,29,3,"https://fbref.com/en/players/3189f61a/Nabil-Bentaleb"
2023,"Angers","Ligue 1","Paul Bernardoni","FRA","GK","25",1997,27,2,0,2,0,0,2,3,66.7,1,1,0,1,1,3,12,1,"https://fbref.com/en/players/28dabd43/Paul-Bernardoni"
2023,"Angers","Ligue 1","Miha Blažič","SVN","DF","29",1993,22,8,6,8,0,0,7,15,46.7,8,25,19,6,22,30,80,1,"https://fbref.com/en/players/3cdfc63e/Miha-Blazic"
2023,"Angers","Ligue 1","Antonin Bobichon","FRA","MF","26",1995,0.2,0,0,0,0,0,0,0,NA,0,1,0,1,0,0,0,0,"https://fbref.com/en/players/7d937aa1/Antonin-Bobichon"
2023,"Angers","Ligue 1","Sofiane Boufal","MAR","FW,MF","28",1993,9.3,14,9,7,4,3,3,14,21.4,11,6,0,6,5,19,1,0,"https://fbref.com/en/players/b0c71810/Sofiane-Boufal"
2023,"Angers","Ligue 1","Ousmane Camara","FRA","DF","19",2003,5.8,10,6,5,5,0,5,12,41.7,7,4,2,2,11,21,15,0,"https://fbref.com/en/players/7d3dfdfd/Ousmane-Camara"
2023,"Angers","Ligue 1","Pierrick Capelle","FRA","MF,DF","35",1987,15.9,36,21,17,15,4,22,55,40,33,24,3,21,15,51,24,0,"https://fbref.com/en/players/79b2399c/Pierrick-Capelle"
2023,"Angers","Ligue 1","Ilyes Cheti","ALG","DF","27",1995,2.3,6,4,4,0,2,5,8,62.5,3,5,1,4,4,10,7,0,"https://fbref.com/en/players/9d498560/Ilyes-Cheti"
2023,"Angers","Ligue 1","Lois Diony","FRA","FW","29",1992,5.6,1,0,0,1,0,1,3,33.3,2,2,0,2,0,1,1,0,"https://fbref.com/en/players/4be0b467/Lois-Diony"
2023,"Angers","Ligue 1","Souleyman Doumbia","CIV","DF,FW","25",1996,19.9,45,31,31,13,1,17,31,54.8,14,20,3,17,27,72,27,1,"https://fbref.com/en/players/9daeac61/Souleyman-Doumbia"
2023,"Angers","Ligue 1","Yahia Fofana","FRA","GK","21",2000,11,0,0,0,0,0,0,0,NA,0,0,0,0,1,1,4,1,"https://fbref.com/en/players/9d420dad/Yahia-Fofana"
2023,"Angers","Ligue 1","Faouzi Ghoulam","ALG","DF","31",1991,5.3,3,3,1,1,1,3,5,60,2,4,2,2,4,7,12,1,"https://fbref.com/en/players/c5adc293/Faouzi-Ghoulam"
2023,"Angers","Ligue 1","Cédric Hountondji","BEN","DF","28",1994,34.4,50,36,31,17,2,19,29,65.5,10,44,22,22,59,109,132,1,"https://fbref.com/en/players/00891164/Cedric-Hountondji"
2023,"Angers","Ligue 1","Adrien Hunou","FRA","MF,FW","28",1994,24.8,39,20,17,16,6,16,45,35.6,29,35,0,35,7,46,7,0,"https://fbref.com/en/players/d14229f3/Adrien-Hunou"
2023,"Angers","Ligue 1","Marin Jakoliš","CRO","FW","25",1996,0.3,1,1,0,0,1,0,0,NA,0,0,0,0,0,1,0,0,"https://fbref.com/en/players/96f4ebc0/Marin-Jakolis"
2023,"Angers","Ligue 1","Justin-Noël Kalumba","FRA","DF","17",2004,6.1,9,5,5,2,2,5,16,31.3,11,4,1,3,4,13,5,0,"https://fbref.com/en/players/32e2163d/Justin-Noel-Kalumba"
2023,"Angers","Ligue 1","Jean Mattéo Bahoya","FRA","FW,MF","17",2005,3,7,3,1,3,3,4,7,57.1,3,4,0,4,0,7,0,0,"https://fbref.com/en/players/70d4c949/Jean-Matteo-Bahoya"
2023,"Angers","Ligue 1","Jason Mbock","FRA","MF,FW","22",1999,0.3,0,0,0,0,0,0,0,NA,0,0,0,0,0,0,0,0,"https://fbref.com/en/players/890bc029/Jason-Mbock"
2023,"Angers","Ligue 1","Farid El Melali","ALG","DF,FW","25",1997,9,21,12,7,12,2,11,22,50,11,16,0,16,8,29,7,0,"https://fbref.com/en/players/d21e361a/Farid-El-Melali"
2023,"Angers","Ligue 1","Batista Mendy","FRA","MF,DF","22",2000,31.8,70,30,34,28,8,37,53,69.8,16,38,6,32,21,91,29,2,"https://fbref.com/en/players/e472a6f6/Batista-Mendy"
2023,"Angers","Ligue 1","Ibrahima Niane","SEN","FW","23",1999,12.6,6,2,1,4,1,1,6,16.7,5,8,2,6,1,7,9,0,"https://fbref.com/en/players/46faabfa/Ibrahima-Niane"
2023,"Angers","Ligue 1","Zinédine Ould Khaled","FRA","MF,FW","22",2000,0.6,1,1,0,1,0,0,1,0,1,0,0,0,2,3,0,0,"https://fbref.com/en/players/6b4436ba/Zinedine-Ould-Khaled"
2023,"Angers","Ligue 1","Azzedine Ounahi","MAR","MF,FW","22",2000,12.5,19,8,5,13,1,10,20,50,10,8,0,8,15,34,4,1,"https://fbref.com/en/players/83299cc0/Azzedine-Ounahi"
2023,"Angers","Ligue 1","Lilian Raolisoa","FRA","DF,MF","22",2000,1.9,11,9,6,3,2,7,10,70,3,3,1,2,3,14,5,0,"https://fbref.com/en/players/79a793b7/Lilian-Raolisoa"
2023,"Angers","Ligue 1","Halid Šabanović","BIH","DF","22",1999,7.1,8,6,7,1,0,6,8,75,2,8,2,6,8,16,12,0,"https://fbref.com/en/players/8299e363/Halid-Sabanovic"
2023,"Angers","Ligue 1","Amine Salama","FRA","FW,MF","22",2000,13.9,11,9,3,7,1,2,12,16.7,10,8,2,6,10,21,2,0,"https://fbref.com/en/players/bc7cc472/Amine-Salama"
2023,"Angers","Ligue 1","Abdallah Sima","SEN","FW","21",2001,20.4,22,13,4,15,3,7,19,36.8,12,8,0,8,4,26,19,0,"https://fbref.com/en/players/fdbde523/Abdallah-Sima"
2023,"Angers","Ligue 1","Waniss Taibi","FRA","MF","20",2002,2.1,9,5,4,4,1,2,4,50,2,1,0,1,2,11,2,0,"https://fbref.com/en/players/95192fe4/Waniss-Taibi"
2023,"Angers","Ligue 1","Sada Thioub","SEN","DF,FW","27",1995,11.8,19,10,9,8,2,8,17,47.1,9,13,0,13,7,26,5,1,"https://fbref.com/en/players/f4bc42b1/Sada-Thioub"
2023,"Angers","Ligue 1","Valery","ESP","DF,MF","22",1999,27.7,NA,40,NA,NA,NA,NA,NA,NA,NA,NA,NA,NA,33,NA,NA,NA,"https://fbref.com/en/players/4acd733a/Valery"
2023,"Arsenal","Premier League","Gabriel Dos Santos","BRA","DF","24",1997,37.9,48,30,29,15,4,18,27,66.7,9,49,26,23,32,80,125,2,"https://fbref.com/en/players/67ac5bb8/Gabriel-Dos-Santos"
2023,"Arsenal","Premier League","Mohamed Elneny","EGY","MF","30",1992,1.3,1,1,1,0,0,1,1,100,0,0,0,0,0,1,0,0,"https://fbref.com/en/players/47a34c4f/Mohamed-Elneny"
2023,"Arsenal","Premier League","Rob Holding","ENG","DF","26",1995,6.3,8,5,4,4,0,3,6,50,3,6,5,1,3,11,27,1,"https://fbref.com/en/players/d79a8c87/Rob-Holding"
2023,"Arsenal","Premier League","Gabriel Jesus","BRA","FW","25",1997,22.9,33,25,16,8,9,15,31,48.4,16,27,3,24,11,44,15,1,"https://fbref.com/en/players/b66315ae/Gabriel-Jesus"
2023,"Arsenal","Premier League","Jorginho","ITA","MF","30",1991,9.5,18,13,6,10,2,5,24,20.8,19,7,2,5,9,27,8,0,"https://fbref.com/en/players/45db685d/Jorginho"
2023,"Arsenal","Premier League","Jakub Kiwior","POL","DF","22",2000,4.7,7,5,6,1,0,5,8,62.5,3,5,3,2,6,13,10,0,"https://fbref.com/en/players/dc3e663e/Jakub-Kiwior"
2023,"Arsenal","Premier League","Marquinhos","BRA","MF","19",2003,0,0,0,0,0,0,0,0,NA,0,0,0,0,0,0,0,0,"https://fbref.com/en/players/59878425/Marquinhos"
2023,"Arsenal","Premier League","Martinelli","BRA","FW","21",2001,31,31,18,13,12,6,9,22,40.9,13,24,1,23,9,40,14,0,"https://fbref.com/en/players/48a5a5d6/Martinelli"
2023,"Arsenal","Premier League","Reiss Nelson","ENG","FW","22",1999,2.4,4,1,2,1,1,2,4,50,2,3,0,3,0,4,4,0,"https://fbref.com/en/players/c5bdb6e3/Reiss-Nelson"
2023,"Arsenal","Premier League","Eddie Nketiah","ENG","FW","23",1999,12.1,13,9,6,2,5,2,8,25,6,7,1,6,1,14,7,0,"https://fbref.com/en/players/a53649b7/Eddie-Nketiah"
2023,"Arsenal","Premier League","Ethan Nwaneri","ENG","FW","15",2007,0,0,0,0,0,0,0,0,NA,0,1,0,1,0,0,0,0,"https://fbref.com/en/players/7f94982c/Ethan-Nwaneri"
2023,"Arsenal","Premier League","Thomas Partey","GHA","MF","29",1993,27.6,70,40,20,35,15,25,52,48.1,27,26,5,21,28,98,41,1,"https://fbref.com/en/players/529f49ab/Thomas-Partey"
2023,"Arsenal","Premier League","Aaron Ramsdale","ENG","GK","24",1998,38,1,1,1,0,0,1,1,100,0,0,0,0,0,1,20,6,"https://fbref.com/en/players/466fb2c5/Aaron-Ramsdale"
2023,"Arsenal","Premier League","Bukayo Saka","ENG","FW","20",2001,35.3,63,34,22,15,26,20,44,45.5,24,38,0,38,14,77,19,0,"https://fbref.com/en/players/bc7dc64d/Bukayo-Saka"
2023,"Arsenal","Premier League","William Saliba","FRA","DF","21",2001,26.8,34,20,23,9,2,15,18,83.3,3,13,10,3,19,53,85,4,"https://fbref.com/en/players/972aeb2a/William-Saliba"
2023,"Arsenal","Premier League","Albert Sambi Lokonga","BEL","MF","22",1999,2.2,1,1,0,0,1,0,2,0,2,1,0,1,5,6,2,0,"https://fbref.com/en/players/1b4f1169/Albert-Sambi-Lokonga"
2023,"Arsenal","Premier League","Emile Smith Rowe","ENG","MF,FW","22",2000,1.9,1,1,1,0,0,1,3,33.3,2,1,0,1,0,1,2,0,"https://fbref.com/en/players/17695062/Emile-Smith-Rowe"
2023,"Arsenal","Premier League","Cédric Soares","POR","DF","30",1991,0.3,0,0,0,0,0,0,1,0,1,1,0,1,0,0,1,0,"https://fbref.com/en/players/839c14e1/Cedric-Soares"
2023,"Arsenal","Premier League","Kieran Tierney","SCO","DF","25",1997,8.8,20,11,9,9,2,12,16,75,4,8,2,6,11,31,25,0,"https://fbref.com/en/players/fce2302c/Kieran-Tierney"
2023,"Arsenal","Premier League","Takehiro Tomiyasu","JPN","DF","23",1998,7.4,27,18,12,10,5,13,18,72.2,5,7,0,7,14,41,15,1,"https://fbref.com/en/players/b3af9be1/Takehiro-Tomiyasu"
2023,"Arsenal","Premier League","Leandro Trossard","BEL","FW","27",1994,10.3,12,7,4,2,6,6,18,33.3,12,18,0,18,6,18,3,1,"https://fbref.com/en/players/38ceb24a/Leandro-Trossard"
2023,"Arsenal","Premier League","Fabio Vieira","POR","MF,FW","22",2000,5.7,6,4,3,0,3,3,5,60,2,5,0,5,4,10,2,0,"https://fbref.com/en/players/6412cc03/Fabio-Vieira"
2023,"Arsenal","Premier League","Ben White","ENG","DF","24",1997,33.9,60,31,23,30,7,42,70,60,28,47,11,36,22,82,79,1,"https://fbref.com/en/players/35e413f1/Ben-White"
2023,"Arsenal","Premier League","Granit Xhaka","SUI","MF","29",1992,33.3,34,27,11,18,5,16,41,39,25,28,10,18,15,49,45,1,"https://fbref.com/en/players/e61b8aee/Granit-Xhaka"
2023,"Arsenal","Premier League","Oleksandr Zinchenko","UKR","DF","25",1996,23.5,40,18,14,17,9,21,39,53.8,18,20,2,18,22,62,38,2,"https://fbref.com/en/players/51cf8561/Oleksandr-Zinchenko"
2023,"Arsenal","Premier League","Martin Ødegaard","NOR","MF","23",1998,34.7,36,23,12,14,10,14,47,29.8,33,20,5,15,6,42,12,1,"https://fbref.com/en/players/79300479/Martin-Odegaard"
2023,"Aston Villa","Premier League","Cameron Archer","ENG","FW,MF","21",2001,0.5,0,0,0,0,0,0,0,NA,0,0,0,0,0,0,0,0,"https://fbref.com/en/players/05e8ca6d/Cameron-Archer"
2023,"Aston Villa","Premier League","Ludwig Augustinsson","SWE","DF","28",1994,0.9,1,1,1,0,0,0,0,NA,0,0,0,0,0,1,1,0,"https://fbref.com/en/players/9fec8860/Ludwig-Augustinsson"
2023,"Aston Villa","Premier League","Leon Bailey","JAM","FW,MF","24",1997,21.9,14,6,6,7,1,5,20,25,15,13,0,13,6,20,12,0,"https://fbref.com/en/players/3a233281/Leon-Bailey"
2023,"Aston Villa","Premier League","Jan Bednarek","POL","DF","26",1996,1.1,3,3,0,3,0,1,1,100,0,3,1,2,2,5,5,0,"https://fbref.com/en/players/4115ce4e/Jan-Bednarek"
2023,"Aston Villa","Premier League","Emi Buendía","ARG","MF,FW","25",1996,26.8,52,23,20,20,12,21,74,28.4,53,20,2,18,20,72,17,0,"https://fbref.com/en/players/66b76d44/Emi-Buendia"
2023,"Aston Villa","Premier League","Diego Carlos","BRA","DF","29",1993,2.3,1,0,0,1,0,0,1,0,1,2,2,0,1,2,2,0,"https://fbref.com/en/players/b4a014b1/Diego-Carlos"
2023,"Aston Villa","Premier League","Matty Cash","POL","DF","24",1997,20.2,55,32,36,15,4,26,37,70.3,11,20,5,15,26,81,43,0,"https://fbref.com/en/players/2389cdc2/Matty-Cash"
2023,"Aston Villa","Premier League","Calum Chambers","ENG","DF,MF","27",1995,3.9,9,6,7,2,0,6,8,75,2,5,4,1,7,16,10,1,"https://fbref.com/en/players/dc6f5bdd/Calum-Chambers"
2023,"Aston Villa","Premier League","Philippe Coutinho","BRA","MF,FW","30",1992,8.8,19,14,8,8,3,9,15,60,6,11,1,10,4,23,2,0,"https://fbref.com/en/players/0ef89a37/Philippe-Coutinho"
2023,"Aston Villa","Premier League","Leander Dendoncker","BEL","MF","27",1995,7.7,19,9,11,6,2,11,21,52.4,10,19,4,15,10,29,12,0,"https://fbref.com/en/players/5a7301ae/Leander-Dendoncker"
2023,"Aston Villa","Premier League","Lucas Digne","FRA","DF","29",1993,16.7,30,12,20,9,1,20,33,60.6,13,18,5,13,18,48,45,0,"https://fbref.com/en/players/1b84dbe1/Lucas-Digne"
2023,"Aston Villa","Premier League","Jhon Durán","COL","FW,MF","18",2003,1.5,2,2,0,1,1,1,4,25,3,0,0,0,2,4,2,0,"https://fbref.com/en/players/414184f7/Jhon-Duran"
2023,"Aston Villa","Premier League","Danny Ings","ENG","FW","30",1992,9.2,10,5,1,6,3,1,6,16.7,5,12,1,11,1,11,11,0,"https://fbref.com/en/players/07802f7f/Danny-Ings"
2023,"Aston Villa","Premier League","Boubacar Kamara","FRA","MF","22",1999,19.7,58,25,25,23,10,27,56,48.2,29,38,12,26,19,77,24,2,"https://fbref.com/en/players/cc77354e/Boubacar-Kamara"
2023,"Aston Villa","Premier League","Ezri Konsa","ENG","DF","24",1997,36.9,42,20,25,15,2,18,26,69.2,8,41,23,18,26,68,120,3,"https://fbref.com/en/players/0313a347/Ezri-Konsa"
2023,"Aston Villa","Premier League","Douglas Luiz","BRA","MF","24",1998,32.5,73,42,31,32,10,30,63,47.6,33,36,7,29,40,113,27,2,"https://fbref.com/en/players/6f7d826d/Douglas-Luiz"
2023,"Aston Villa","Premier League","Emiliano Martínez","ARG","GK","29",1992,34.9,0,0,0,0,0,0,2,0,2,0,0,0,1,1,23,1,"https://fbref.com/en/players/7956236f/Emiliano-Martinez"
2023,"Aston Villa","Premier League","John McGinn","SCO","MF,FW","27",1994,29.9,66,36,27,29,10,34,71,47.9,37,43,4,39,24,90,19,0,"https://fbref.com/en/players/90f91999/John-McGinn"
2023,"Aston Villa","Premier League","Tyrone Mings","ENG","DF","29",1993,35,15,7,10,5,0,9,20,45,11,40,21,19,54,69,163,2,"https://fbref.com/en/players/8397a50c/Tyrone-Mings"
2023,"Aston Villa","Premier League","Álex Moreno","ESP","DF","29",1993,14.8,23,14,15,5,3,13,36,36.1,23,18,3,15,7,30,37,2,"https://fbref.com/en/players/16e9d0ea/Alex-Moreno"
2023,"Aston Villa","Premier League","Robin Olsen","SWE","GK","32",1990,3.1,0,0,0,0,0,0,2,0,2,0,0,0,0,0,1,0,"https://fbref.com/en/players/e7ee38c3/Robin-Olsen"
2023,"Aston Villa","Premier League","Jacob Ramsey","ENG","MF,FW","21",2001,29.3,69,39,23,35,11,32,69,46.4,37,48,8,40,23,92,34,0,"https://fbref.com/en/players/1544f145/Jacob-Ramsey"
2023,"Aston Villa","Premier League","Morgan Sanson","FRA","MF","27",1994,0.1,2,1,1,1,0,1,1,100,0,0,0,0,0,2,0,0,"https://fbref.com/en/players/6e7f1353/Morgan-Sanson"
2023,"Aston Villa","Premier League","Bertrand Traoré","BFA","FW,MF","26",1995,2.6,1,1,1,0,0,1,4,25,3,5,0,5,2,3,0,0,"https://fbref.com/en/players/c47541e0/Bertrand-Traore"
2023,"Aston Villa","Premier League","Ollie Watkins","ENG","FW","26",1995,34.7,19,13,3,13,3,10,27,37,17,21,4,17,10,29,39,0,"https://fbref.com/en/players/aed3a70f/Ollie-Watkins"
2023,"Aston Villa","Premier League","Ashley Young","ENG","DF","37",1985,22.6,50,27,34,15,1,37,49,75.5,12,25,11,14,21,71,65,0,"https://fbref.com/en/players/be927d03/Ashley-Young"
2023,"Atalanta","Serie A","Jeremie Boga","CIV","MF,FW","25",1997,8.7,9,5,3,2,4,2,5,40,3,6,0,6,1,10,1,0,"https://fbref.com/en/players/fe012aca/Jeremie-Boga"
2023,"Atalanta","Serie A","Tommaso De Nipoti","ITA","MF","19",2003,0,1,0,0,1,0,0,0,NA,0,0,0,0,0,1,0,0,"https://fbref.com/en/players/7f9d956a/Tommaso-De-Nipoti"
2023,"Atalanta","Serie A","Merih Demiral","TUR","DF","24",1998,17.1,41,29,30,11,0,26,36,72.2,10,24,7,17,24,65,57,1,"https://fbref.com/en/players/e3cceee6/Merih-Demiral"
2023,"Atalanta","Serie A","Berat Djimsiti","ALB","DF","29",1993,20,34,19,21,13,0,17,25,68,8,17,7,10,36,70,74,1,"https://fbref.com/en/players/6eee05f1/Berat-Djimsiti"
2023,"Atalanta","Serie A","Éderson","BRA","MF","23",1999,24.6,67,34,18,42,7,29,66,43.9,37,56,7,49,36,103,31,0,"https://fbref.com/en/players/a9202def/Ederson"
2023,"Atalanta","Serie A","Hans Hateboer","NED","DF","28",1994,15.5,21,13,11,8,2,11,27,40.7,16,23,4,19,12,33,25,0,"https://fbref.com/en/players/3b333ac3/Hans-Hateboer"
2023,"Atalanta","Serie A","Rasmus Højlund","DEN","FW","19",2003,20.4,4,3,0,2,2,1,6,16.7,5,9,1,8,1,5,5,0,"https://fbref.com/en/players/491a433d/Rasmus-Hojlund"
2023,"Atalanta","Serie A","Teun Koopmeiners","NED","MF","24",1998,31.8,46,26,15,24,7,28,55,50.9,27,41,5,36,19,65,36,2,"https://fbref.com/en/players/a26fb8aa/Teun-Koopmeiners"
2023,"Atalanta","Serie A","Ademola Lookman","NGA","FW,MF","24",1997,19.2,13,5,2,6,5,3,15,20,12,18,0,18,4,17,1,0,"https://fbref.com/en/players/7c104bb7/Ademola-Lookman"
2023,"Atalanta","Serie A","José Luis Palomino","ARG","DF","32",1990,8.4,23,14,16,7,0,11,19,57.9,8,11,4,7,28,51,20,0,"https://fbref.com/en/players/921f6058/Jose-Luis-Palomino"
2023,"Atalanta","Serie A","Ruslan Malinovskyi","UKR","MF,FW","29",1993,6.1,14,8,5,6,3,6,17,35.3,11,8,1,7,5,19,2,0,"https://fbref.com/en/players/48d5bd33/Ruslan-Malinovskyi"
2023,"Atalanta","Serie A","Luis Muriel","COL","FW,MF","31",1991,11.9,9,6,2,3,4,5,16,31.3,11,9,0,9,2,11,2,0,"https://fbref.com/en/players/eb2fe5b6/Luis-Muriel"
2023,"Atalanta","Serie A","Juan Musso","ARG","GK","28",1994,23.1,1,1,1,0,0,1,1,100,0,0,0,0,0,1,11,1,"https://fbref.com/en/players/a111cf41/Juan-Musso"
2023,"Atalanta","Serie A","Joakim Mæhle","DEN","DF,MF","25",1997,24.5,32,18,12,7,13,22,39,56.4,17,29,6,23,24,56,26,0,"https://fbref.com/en/players/c459a650/Joakim-Maehle"
2023,"Atalanta","Serie A","Caleb Okoli","ITA","DF","21",2001,10.7,21,17,14,6,1,10,25,40,15,10,5,5,30,51,44,3,"https://fbref.com/en/players/8ec109e6/Caleb-Okoli"
2023,"Atalanta","Serie A","Mario Pašalić","CRO","MF,FW","27",1995,19.7,22,10,6,14,2,6,23,26.1,17,22,4,18,21,43,13,0,"https://fbref.com/en/players/e599253a/Mario-Pasalic"
2023,"Atalanta","Serie A","Marten de Roon","NED","MF","31",1991,32.9,77,39,37,35,5,37,81,45.7,44,37,4,33,36,113,58,0,"https://fbref.com/en/players/2a1beb34/Marten-de-Roon"
2023,"Atalanta","Serie A","Francesco Rossi","ITA","GK","31",1991,0,0,0,0,0,0,0,0,NA,0,0,0,0,0,0,0,0,"https://fbref.com/en/players/7b5f516f/Francesco-Rossi"
2023,"Atalanta","Serie A","Matteo Ruggeri","ITA","DF,MF","20",2002,9.2,17,12,5,9,3,8,16,50,8,14,3,11,12,29,16,0,"https://fbref.com/en/players/ae9898c5/Matteo-Ruggeri"
2023,"Atalanta","Serie A","Giorgio Scalvini","ITA","DF","18",2003,25.9,54,29,30,18,6,29,55,52.7,26,36,13,23,56,110,57,2,"https://fbref.com/en/players/1e9aa637/Giorgio-Scalvini"
2023,"Atalanta","Serie A","Brandon Soppy","FRA","DF","20",2002,7.1,8,5,4,4,0,3,9,33.3,6,10,0,10,3,11,7,0,"https://fbref.com/en/players/28f66c2e/Brandon-Soppy"
2023,"Atalanta","Serie A","Marco Sportiello","ITA","GK","30",1992,14.9,1,0,1,0,0,1,3,33.3,2,0,0,0,0,1,2,0,"https://fbref.com/en/players/ac4003af/Marco-Sportiello"
2023,"Atalanta","Serie A","Rafael Tolói","ITA","DF","31",1990,30.9,69,44,37,32,0,35,64,54.7,29,42,18,24,57,126,88,1,"https://fbref.com/en/players/c56dc39e/Rafael-Toloi"
2023,"Atalanta","Serie A","Lukáš Vorlický","CZE","MF,FW","20",2002,0.3,0,0,0,0,0,0,0,NA,0,0,0,0,1,1,0,0,"https://fbref.com/en/players/f052fb01/Lukas-Vorlicky"
2023,"Atalanta","Serie A","Duván Zapata","COL","FW","31",1991,15.4,8,4,1,3,4,3,5,60,2,6,2,4,4,12,17,1,"https://fbref.com/en/players/d3de9af0/Duvan-Zapata"
2023,"Atalanta","Serie A","Davide Zappacosta","ITA","DF","30",1992,16.3,34,18,17,12,5,15,22,68.2,7,23,2,21,9,43,16,0,"https://fbref.com/en/players/7fe90ccd/Davide-Zappacosta"
2023,"Atalanta","Serie A","Nadir Zortea","ITA","DF,MF","23",1999,2.5,10,5,3,7,0,3,4,75,1,4,0,4,0,10,4,0,"https://fbref.com/en/players/82598b71/Nadir-Zortea"
2023,"Athletic Club","La Liga","Julen Agirrezabala","ESP","GK","21",2000,7.5,0,0,0,0,0,0,0,NA,0,0,0,0,0,0,2,0,"https://fbref.com/en/players/a2c1a8d3/Julen-Agirrezabala"
2023,"Athletic Club","La Liga","Yeray Álvarez","ESP","DF","27",1995,25.9,34,23,26,7,1,24,31,77.4,7,23,13,10,48,82,101,0,"https://fbref.com/en/players/3ecc11d8/Yeray-Alvarez"
2023,"Athletic Club","La Liga","Mikel Balenziaga","ESP","DF","34",1988,1.3,4,4,1,2,1,4,4,100,0,0,0,0,1,5,2,0,"https://fbref.com/en/players/1fe67e86/Mikel-Balenziaga"
2023,"Athletic Club","La Liga","Yuri Berchiche","ESP","DF","32",1990,26.7,56,32,28,20,8,35,59,59.3,24,37,12,25,40,96,59,1,"https://fbref.com/en/players/b6e50615/Yuri-Berchiche"
2023,"Athletic Club","La Liga","Álex Berenguer","ESP","FW","27",1995,25.5,58,37,17,25,16,23,60,38.3,37,37,4,33,10,68,6,0,"https://fbref.com/en/players/dc1c2fce/Alex-Berenguer"
2023,"Athletic Club","La Liga","Ander Capa","ESP","DF","30",1992,1.2,1,1,1,0,0,1,5,20,4,5,0,5,0,1,2,0,"https://fbref.com/en/players/37f1cf47/Ander-Capa"
2023,"Athletic Club","La Liga","Malcom Abdulai Ares Djalo","ESP","FW,MF","20",2001,0.9,4,2,2,1,1,4,4,100,0,1,0,1,2,6,1,0,"https://fbref.com/en/players/a461f098/Malcom-Abdulai-Ares-Djalo"
2023,"Athletic Club","La Liga","Dani García","ESP","MF","32",1990,16.5,46,27,17,25,4,29,47,61.7,18,21,6,15,19,65,21,1,"https://fbref.com/en/players/240d3a0b/Dani-Garcia"
2023,"Athletic Club","La Liga","Raúl García","ESP","FW,MF","36",1986,10.7,12,8,3,4,5,5,15,33.3,10,13,1,12,6,18,9,0,"https://fbref.com/en/players/b418dbd4/Raul-Garcia"
2023,"Athletic Club","La Liga","Gorka Guruzeta","ESP","FW","25",1996,15.8,24,20,6,12,6,11,24,45.8,13,23,2,21,4,28,8,0,"https://fbref.com/en/players/6b5ea2f4/Gorka-Guruzeta"
2023,"Athletic Club","La Liga","Ander Herrera","ESP","MF","32",1989,7.7,18,10,8,7,3,6,18,33.3,12,12,3,9,11,29,12,0,"https://fbref.com/en/players/436a9dd0/Ander-Herrera"
2023,"Athletic Club","La Liga","Iñigo Lekue","ESP","DF","29",1993,14.7,24,17,20,4,0,12,19,63.2,7,16,2,14,13,37,31,1,"https://fbref.com/en/players/59b7d823/Inigo-Lekue"
2023,"Athletic Club","La Liga","Óscar de Marcos","ESP","DF","33",1989,31.3,67,33,34,22,11,40,76,52.6,36,42,6,36,29,96,59,0,"https://fbref.com/en/players/9f323c71/Oscar-de-Marcos"
2023,"Athletic Club","La Liga","Iñigo Martínez","ESP","DF","31",1991,14.9,18,8,11,7,0,6,9,66.7,3,17,11,6,18,36,55,0,"https://fbref.com/en/players/3fc45c73/Inigo-Martinez"
2023,"Athletic Club","La Liga","Jon Morcillo","ESP","FW,MF","23",1998,0.8,1,0,1,0,0,0,1,0,1,0,0,0,1,2,0,0,"https://fbref.com/en/players/b7d7f3bf/Jon-Morcillo"
2023,"Athletic Club","La Liga","Iker Muniain","ESP","MF,FW","29",1992,18.8,21,16,7,11,3,6,17,35.3,11,10,1,9,4,25,2,0,"https://fbref.com/en/players/c05dfb74/Iker-Muniain"
2023,"Athletic Club","La Liga","Aitor Paredes","ESP","DF","22",2000,9.5,7,6,4,2,1,6,11,54.5,5,11,7,4,14,21,26,0,"https://fbref.com/en/players/b906757a/Aitor-Paredes"
2023,"Athletic Club","La Liga","Oihan Sancet","ESP","MF","22",2000,28.1,27,16,2,19,6,11,37,29.7,26,10,0,10,4,31,9,1,"https://fbref.com/en/players/bdb624a3/Oihan-Sancet"
2023,"Athletic Club","La Liga","Unai Simón","ESP","GK","25",1997,30.5,2,0,2,0,0,1,1,100,0,1,0,1,0,2,9,3,"https://fbref.com/en/players/5dcf3e90/Unai-Simon"
2023,"Athletic Club","La Liga","Unai Vencedor Paris","ESP","MF","21",2000,2.1,3,1,0,3,0,1,6,16.7,5,5,0,5,1,4,1,0,"https://fbref.com/en/players/4112ace5/Unai-Vencedor-Paris"
2023,"Athletic Club","La Liga","Mikel Vesga","ESP","MF","29",1993,28.6,57,35,21,31,5,25,68,36.8,43,39,8,31,36,93,39,3,"https://fbref.com/en/players/b0fce72c/Mikel-Vesga"
2023,"Athletic Club","La Liga","Asier Villalibre","ESP","FW","24",1997,1.1,0,0,0,0,0,0,0,NA,0,0,0,0,0,0,1,0,"https://fbref.com/en/players/57be54ec/Asier-Villalibre"
2023,"Athletic Club","La Liga","Daniel Vivian","ESP","DF","23",1999,26.4,57,32,36,16,5,36,45,80,9,27,14,13,24,81,90,3,"https://fbref.com/en/players/ab7bf91d/Daniel-Vivian"
2023,"Athletic Club","La Liga","Iñaki Williams","GHA","FW","28",1994,31.5,22,16,5,14,3,9,24,37.5,15,18,3,15,7,29,34,0,"https://fbref.com/en/players/6a99e0b1/Inaki-Williams"
2023,"Athletic Club","La Liga","Nico Williams","ESP","FW","20",2002,29.5,31,16,10,15,6,19,41,46.3,22,40,2,38,8,39,14,1,"https://fbref.com/en/players/afdc14d7/Nico-Williams"
2023,"Athletic Club","La Liga","Oier Zarraga","ESP","MF","23",1999,9.5,14,9,5,7,2,8,20,40,12,7,0,7,10,24,5,0,"https://fbref.com/en/players/968a1c2f/Oier-Zarraga"
2023,"Atlético Madrid","La Liga","Pablo Barrios","ESP","MF","19",2003,8,19,10,3,10,6,8,15,53.3,7,12,2,10,9,28,6,1,"https://fbref.com/en/players/45736cec/Pablo-Barrios"
2023,"Atlético Madrid","La Liga","Yannick Carrasco","BEL","DF,MF","28",1993,25.7,35,14,21,10,4,23,54,42.6,31,23,1,22,12,47,19,0,"https://fbref.com/en/players/de39485a/Yannick-Carrasco"
2023,"Atlético Madrid","La Liga","Ángel Correa","ARG","FW,MF","27",1995,16.2,12,6,6,3,3,5,16,31.3,11,17,0,17,10,22,6,1,"https://fbref.com/en/players/01eb744d/Angel-Correa"
2023,"Atlético Madrid","La Liga","Matheus Cunha","BRA","FW,MF","23",1999,4.2,4,1,1,3,0,0,3,0,3,4,1,3,2,6,3,0,"https://fbref.com/en/players/dc62b55d/Matheus-Cunha"
2023,"Atlético Madrid","La Liga","Rodrigo De Paul","ARG","MF","28",1994,21.4,35,21,11,18,6,18,35,51.4,17,20,3,17,8,43,7,0,"https://fbref.com/en/players/162efffd/Rodrigo-De-Paul"
2023,"Atlético Madrid","La Liga","Matt Doherty","IRL","DF","30",1992,0.2,0,0,0,0,0,0,0,NA,0,2,0,2,0,0,0,0,"https://fbref.com/en/players/d557d734/Matt-Doherty"
2023,"Atlético Madrid","La Liga","Felipe","BRA","DF","33",1989,2.2,3,2,1,2,0,2,4,50,2,2,2,0,0,3,7,0,"https://fbref.com/en/players/51a3c4c8/Felipe"
2023,"Atlético Madrid","La Liga","João Félix","POR","FW,MF","22",1999,7.2,10,7,2,3,5,1,6,16.7,5,1,0,1,3,13,2,0,"https://fbref.com/en/players/8aafd64f/Joao-Felix"
2023,"Atlético Madrid","La Liga","Antonio Gomis","ESP","GK","19",2003,0.1,0,0,0,0,0,0,0,NA,0,0,0,0,0,0,0,0,"https://fbref.com/en/players/f0f4671c/Antonio-Gomis"
2023,"Atlético Madrid","La Liga","Ivo Grbić","CRO","GK","26",1996,10.2,0,0,0,0,0,0,0,NA,0,0,0,0,0,0,9,1,"https://fbref.com/en/players/3f034750/Ivo-Grbic"
2023,"Atlético Madrid","La Liga","Antoine Griezmann","FRA","FW,MF","31",1991,31.8,49,34,15,23,11,20,66,30.3,46,34,3,31,24,73,31,0,"https://fbref.com/en/players/df69b544/Antoine-Griezmann"
2023,"Atlético Madrid","La Liga","Mario Hermoso","ESP","DF","27",1995,23.4,22,15,14,6,2,9,30,30,21,19,9,10,19,41,85,1,"https://fbref.com/en/players/555f3a0b/Mario-Hermoso"
2023,"Atlético Madrid","La Liga","Koke","ESP","MF","30",1992,28.3,55,38,23,25,7,28,72,38.9,44,35,13,22,20,75,19,0,"https://fbref.com/en/players/55126f3b/Koke"
2023,"Atlético Madrid","La Liga","Geoffrey Kondogbia","CTA","MF","29",1993,11.2,40,23,19,20,1,17,25,68,8,9,1,8,26,66,12,1,"https://fbref.com/en/players/cce181df/Geoffrey-Kondogbia"
2023,"Atlético Madrid","La Liga","Thomas Lemar","FRA","MF","26",1995,13.9,30,18,10,13,7,10,28,35.7,18,12,3,9,7,37,12,0,"https://fbref.com/en/players/4dbd0916/Thomas-Lemar"
2023,"Atlético Madrid","La Liga","Marcos Llorente","ESP","MF,DF","27",1995,18.9,32,15,16,10,6,17,30,56.7,13,26,2,24,17,49,19,0,"https://fbref.com/en/players/02c15616/Marcos-Llorente"
2023,"Atlético Madrid","La Liga","Reinildo Mandava","MOZ","DF","28",1994,20.6,66,43,46,19,1,38,49,77.6,11,27,12,15,30,96,59,0,"https://fbref.com/en/players/c20bdcd7/Reinildo-Mandava"
2023,"Atlético Madrid","La Liga","José María Giménez","URU","DF","27",1995,26.9,43,25,28,14,1,24,35,68.6,11,37,17,20,24,67,138,1,"https://fbref.com/en/players/f0da930c/Jose-Maria-Gimenez"
2023,"Atlético Madrid","La Liga","Carlos Martín","ESP","FW,MF","20",2002,0.3,2,2,0,2,0,2,3,66.7,1,0,0,0,1,3,0,0,"https://fbref.com/en/players/64035864/Carlos-Martin"
2023,"Atlético Madrid","La Liga","Memphis","NED","FW","28",1994,3,1,0,0,0,1,0,1,0,1,0,0,0,0,1,0,0,"https://fbref.com/en/players/8f696594/Memphis"
2023,"Atlético Madrid","La Liga","Nahuel Molina","ARG","DF","24",1998,31.9,69,43,38,18,13,39,91,42.9,52,38,7,31,18,87,63,1,"https://fbref.com/en/players/23610943/Nahuel-Molina"
2023,"Atlético Madrid","La Liga","Álvaro Morata","ESP","FW","29",1992,21.1,16,11,4,8,4,3,8,37.5,5,11,3,8,0,16,23,0,"https://fbref.com/en/players/129af0db/Alvaro-Morata"
2023,"Atlético Madrid","La Liga","Saúl Ñíguez","ESP","MF,DF","27",1994,12.2,42,27,18,18,6,22,37,59.5,15,27,5,22,15,57,29,0,"https://fbref.com/en/players/c14bc029/Saul-Niguez"
2023,"Atlético Madrid","La Liga","Jan Oblak","SVN","GK","29",1993,27.7,0,0,0,0,0,0,0,NA,0,0,0,0,1,1,8,0,"https://fbref.com/en/players/ee8508c0/Jan-Oblak"
2023,"Atlético Madrid","La Liga","Sergio Reguilón","ESP","DF","25",1996,3.4,7,5,5,2,0,5,7,71.4,2,3,0,3,2,9,4,0,"https://fbref.com/en/players/3353737a/Sergio-Reguilon"
2023,"Atlético Madrid","La Liga","Stefan Savić","MNE","DF","31",1991,21.6,39,26,29,7,3,26,39,66.7,13,17,8,9,33,72,67,2,"https://fbref.com/en/players/f6ac68c1/Stefan-Savic"
2023,"Atlético Madrid","La Liga","Axel Witsel","BEL","DF,MF","33",1989,25.1,36,22,22,11,3,17,31,54.8,14,20,11,9,23,59,76,0,"https://fbref.com/en/players/5dfc6ad5/Axel-Witsel"
2023,"Augsburg","Bundesliga","Maximilian Bauer","GER","DF","22",2000,20.5,31,17,18,12,1,17,34,50,17,25,9,16,23,54,79,1,"https://fbref.com/en/players/44a20f0c/Maximilian-Bauer"
2023,"Augsburg","Bundesliga","Julian Baumgartlinger","AUT","MF","34",1988,6.2,15,4,5,6,4,6,19,31.6,13,4,2,2,4,19,15,0,"https://fbref.com/en/players/69374ff5/Julian-Baumgartlinger"
2023,"Augsburg","Bundesliga","Noah Joel Sarenren Bazee","NGA","MF,FW","25",1996,0.2,0,0,0,0,0,0,1,0,1,1,0,1,0,0,0,0,"https://fbref.com/en/players/fbbc8e15/Noah-Joel-Sarenren-Bazee"
2023,"Augsburg","Bundesliga","Mergim Berisha","GER","FW","24",1998,18.7,11,6,4,3,4,4,14,28.6,10,16,1,15,0,11,19,0,"https://fbref.com/en/players/eb6e14be/Mergim-Berisha"
2023,"Augsburg","Bundesliga","Daniel Caligiuri","ITA","DF,MF","34",1988,3.2,8,5,5,3,0,4,5,80,1,3,2,1,3,11,2,0,"https://fbref.com/en/players/d1273f09/Daniel-Caligiuri"
2023,"Augsburg","Bundesliga","Irvin Cardona","FRA","MF,FW","24",1997,3.5,1,1,1,0,0,1,5,20,4,3,0,3,4,5,8,0,"https://fbref.com/en/players/5e080f73/Irvin-Cardona"
2023,"Augsburg","Bundesliga","David Čolina","CRO","DF,FW","22",2000,1.8,4,1,1,1,2,2,2,100,0,8,0,8,4,8,3,0,"https://fbref.com/en/players/dd5bbe0d/David-Colina"
2023,"Augsburg","Bundesliga","Ermedin Demirović","BIH","FW,MF","24",1998,26.3,31,14,9,12,10,9,22,40.9,13,31,4,27,14,45,37,0,"https://fbref.com/en/players/ed79b7d3/Ermedin-Demirovic"
2023,"Augsburg","Bundesliga","Niklas Dorsch","GER","MF","24",1998,5.4,21,12,8,11,2,9,16,56.3,7,9,3,6,6,27,9,0,"https://fbref.com/en/players/7f73bdf4/Niklas-Dorsch"
2023,"Augsburg","Bundesliga","Dion Drena Beljo","CRO","FW","20",2002,12.5,7,6,3,2,2,2,13,15.4,11,15,2,13,1,8,14,0,"https://fbref.com/en/players/9a2e3a23/Dion-Drena-Beljo"
2023,"Augsburg","Bundesliga","Arne Engels","BEL","MF","18",2003,16,20,9,9,10,1,8,19,42.1,11,17,5,12,15,35,12,1,"https://fbref.com/en/players/554bcc91/Arne-Engels"
2023,"Augsburg","Bundesliga","Ohis Felix Uduokhai","GER","DF","24",1997,16.1,30,20,14,13,3,15,29,51.7,14,27,14,13,29,59,61,1,"https://fbref.com/en/players/677da306/Ohis-Felix-Uduokhai"
2023,"Augsburg","Bundesliga","Raphael Framberger","GER","DF,FW","26",1995,2,10,6,6,4,0,3,5,60,2,2,1,1,2,12,5,0,"https://fbref.com/en/players/626fab5f/Raphael-Framberger"
2023,"Augsburg","Bundesliga","Rafał Gikiewicz","POL","GK","34",1987,23,2,2,2,0,0,2,3,66.7,1,0,0,0,0,2,15,5,"https://fbref.com/en/players/17376543/Rafal-Gikiewicz"
2023,"Augsburg","Bundesliga","Jeffrey Gouweleeuw","NED","DF","31",1991,31.1,42,27,19,17,6,24,49,49,25,41,23,18,50,92,141,2,"https://fbref.com/en/players/1025db8e/Jeffrey-Gouweleeuw"
2023,"Augsburg","Bundesliga","Carlos Gruezo","ECU","MF","27",1995,10.7,21,12,12,9,0,9,16,56.3,7,13,4,9,10,31,15,0,"https://fbref.com/en/players/f2dd9a21/Carlos-Gruezo"
2023,"Augsburg","Bundesliga","Robert Gumny","POL","DF","24",1998,22.4,34,24,13,15,6,11,27,40.7,16,21,7,14,26,60,62,1,"https://fbref.com/en/players/1df0c0b9/Robert-Gumny"
2023,"Augsburg","Bundesliga","André Hahn","GER","FW,MF","31",1990,4.3,9,5,4,4,1,8,12,66.7,4,9,2,7,4,13,14,0,"https://fbref.com/en/players/cd82452e/Andre-Hahn"
2023,"Augsburg","Bundesliga","Iago","BRA","DF,MF","25",1997,17.8,34,16,20,10,4,11,29,37.9,18,18,5,13,17,51,53,0,"https://fbref.com/en/players/054849d2/Iago"
2023,"Augsburg","Bundesliga","Fredrik Jensen","FIN","FW,MF","24",1997,10.3,15,10,8,3,4,5,10,50,5,12,5,7,4,19,12,0,"https://fbref.com/en/players/3eeb80e0/Fredrik-Jensen"
2023,"Augsburg","Bundesliga","Tomáš Koubek","CZE","GK","29",1992,11,0,0,0,0,0,0,0,NA,0,0,0,0,0,0,7,0,"https://fbref.com/en/players/dc366c36/Tomas-Koubek"
2023,"Augsburg","Bundesliga","Arne Maier","GER","MF","23",1999,21.8,31,22,17,11,3,10,18,55.6,8,21,0,21,15,46,22,0,"https://fbref.com/en/players/ab700320/Arne-Maier"
2023,"Augsburg","Bundesliga","Nathanael Mbuku","FRA","MF,FW","20",2002,0.4,1,0,0,1,0,0,0,NA,0,0,0,0,0,1,0,0,"https://fbref.com/en/players/46750e9c/Nathanael-Mbuku"
2023,"Augsburg","Bundesliga","Florian Niederlechner","GER","FW,MF","31",1990,10.1,10,5,5,4,1,4,7,57.1,3,16,2,14,1,11,9,0,"https://fbref.com/en/players/d6862409/Florian-Niederlechner"
2023,"Augsburg","Bundesliga","Reece Oxford","ENG","DF","23",1998,1,1,1,1,0,0,0,0,NA,0,4,3,1,1,2,5,0,"https://fbref.com/en/players/8b6e0db2/Reece-Oxford"
2023,"Augsburg","Bundesliga","Mads Pedersen","DEN","DF,MF","25",1996,20.4,44,23,31,11,2,22,33,66.7,11,32,9,23,20,64,41,1,"https://fbref.com/en/players/582a5247/Mads-Pedersen"
2023,"Augsburg","Bundesliga","Ricardo Pepi","USA","FW","19",2003,1.1,1,1,1,0,0,1,1,100,0,1,0,1,0,1,1,0,"https://fbref.com/en/players/a2b1ed42/Ricardo-Pepi"
2023,"Augsburg","Bundesliga","Lukas Petkov","GER","MF,FW","21",2000,1.6,5,1,4,1,0,2,3,66.7,1,4,1,3,1,6,0,0,"https://fbref.com/en/players/f503ef6e/Lukas-Petkov"
2023,"Augsburg","Bundesliga","Elvis Rexhbeçaj","GER","MF","24",1997,28,51,30,18,24,9,29,59,49.2,30,40,13,27,17,68,40,0,"https://fbref.com/en/players/1ae836b1/Elvis-Rexhbecaj"
2023,"Augsburg","Bundesliga","Ruben Vargas","SUI","MF,FW","23",1998,12.6,15,7,6,7,2,5,11,45.5,6,8,2,6,6,21,16,1,"https://fbref.com/en/players/6ecbddf6/Ruben-Vargas"
2023,"Augsburg","Bundesliga","Renato Veiga","POR","DF","19",2003,7.1,9,6,4,3,2,7,9,77.8,2,20,6,14,7,16,29,1,"https://fbref.com/en/players/fc8fcbd1/Renato-Veiga"
2023,"Augsburg","Bundesliga","Frederik Winther","DEN","DF","21",2001,1,2,2,1,1,0,0,2,0,2,1,1,0,0,2,7,0,"https://fbref.com/en/players/a1257b5e/Frederik-Winther"
2023,"Augsburg","Bundesliga","Kelvin Yeboah","ITA","FW,MF","22",2000,3.9,6,4,2,4,0,2,5,40,3,7,0,7,1,7,2,0,"https://fbref.com/en/players/ea0893d6/Kelvin-Yeboah"
2023,"Augsburg","Bundesliga","Aaron Zehnter","GER","DF","17",2004,0,0,0,0,0,0,0,1,0,1,0,0,0,1,1,0,0,"https://fbref.com/en/players/65bf7e2b/Aaron-Zehnter"
2023,"Auxerre","Ligue 1","Matthis Abline","FRA","FW,MF","19",2003,9,4,2,0,3,1,0,5,0,5,6,1,5,1,5,1,0,"https://fbref.com/en/players/0e46fa2f/Matthis-Abline"
2023,"Auxerre","Ligue 1","Mathias Autret","FRA","MF,FW","31",1991,14.3,22,10,10,10,2,7,16,43.8,9,14,2,12,12,34,13,0,"https://fbref.com/en/players/7dfbba27/Mathias-Autret"
2023,"Auxerre","Ligue 1","Dénys Bain","FRA","DF","29",1993,1.4,4,3,3,1,0,1,2,50,1,2,1,1,2,6,4,0,"https://fbref.com/en/players/5065d67d/Denys-Bain"
2023,"Auxerre","Ligue 1","Quentin Bernard","FRA","DF","33",1989,7,9,7,4,2,3,7,15,46.7,8,9,1,8,15,24,17,0,"https://fbref.com/en/players/3916b09c/Quentin-Bernard"
2023,"Auxerre","Ligue 1","Kenji-Van Boto","MAD","DF","26",1996,2,3,2,2,0,1,2,4,50,2,0,0,0,1,4,3,0,"https://fbref.com/en/players/c03b7266/Kenji-Van-Boto"
2023,"Auxerre","Ligue 1","Ousmane Camara","GUI","FW,MF","20",2001,0.3,1,1,0,0,1,0,0,NA,0,0,0,0,0,1,0,0,"https://fbref.com/en/players/5a6b06cd/Ousmane-Camara"
2023,"Auxerre","Ligue 1","Gaëtan Charbonnier","FRA","FW,MF","33",1988,2.8,2,1,0,2,0,0,4,0,4,2,0,2,0,2,5,0,"https://fbref.com/en/players/18ebca4b/Gaetan-Charbonnier"
2023,"Auxerre","Ligue 1","Alexandre Coeff","FRA","DF","30",1992,6.5,10,5,6,4,0,4,9,44.4,5,9,4,5,8,18,35,1,"https://fbref.com/en/players/c4065f40/Alexandre-Coeff"
2023,"Auxerre","Ligue 1","Nuno da Costa","CPV","FW,MF","31",1991,22.3,45,23,14,23,8,11,46,23.9,35,21,1,20,20,65,15,0,"https://fbref.com/en/players/909222de/Nuno-da-Costa"
2023,"Auxerre","Ligue 1","Benoît Costil","FRA","GK","35",1987,19,2,0,2,0,0,2,4,50,2,0,0,0,0,2,5,0,"https://fbref.com/en/players/2434f24a/Benoit-Costil"
2023,"Auxerre","Ligue 1","Kévin Danois","FRA","MF","18",2004,0,1,1,0,1,0,0,0,NA,0,0,0,0,1,2,0,0,"https://fbref.com/en/players/e76f6fbe/Kevin-Danois"
2023,"Auxerre","Ligue 1","Siriki Dembélé","CIV","MF,FW","25",1996,4.1,10,6,4,3,3,4,12,33.3,8,2,0,2,1,11,2,0,"https://fbref.com/en/players/11f54bd5/Siriki-Dembele"
2023,"Auxerre","Ligue 1","Rémy Dugimont","FRA","FW,MF","36",1986,1.3,2,1,0,1,1,1,2,50,1,3,0,3,0,2,5,0,"https://fbref.com/en/players/6d7ede84/Remy-Dugimont"
2023,"Auxerre","Ligue 1","Gauthier Hein","FRA","MF,FW","25",1996,20.8,27,20,13,11,3,18,48,37.5,30,10,0,10,6,33,10,0,"https://fbref.com/en/players/563fcd6b/Gauthier-Hein"
2023,"Auxerre","Ligue 1","Julian Jeanvier","GUI","DF","30",1992,19.6,32,17,24,8,0,13,22,59.1,9,24,17,7,27,59,96,1,"https://fbref.com/en/players/5cb215fc/Julian-Jeanvier"
2023,"Auxerre","Ligue 1","Paul Joly","FRA","DF","22",2000,9.6,33,21,21,10,2,19,35,54.3,16,13,2,11,24,57,29,2,"https://fbref.com/en/players/5b4bc323/Paul-Joly"
2023,"Auxerre","Ligue 1","Jubal","BRA","DF","28",1993,35.7,41,26,29,11,1,19,38,50,19,57,34,23,53,94,193,0,"https://fbref.com/en/players/56ae428b/Jubal"
2023,"Auxerre","Ligue 1","Donovan Léon","GUF","GK","29",1992,2,0,0,0,0,0,0,0,NA,0,0,0,0,0,0,1,0,"https://fbref.com/en/players/51c83a90/Donovan-Leon"
2023,"Auxerre","Ligue 1","Youssouf M'Changama","COM","MF","31",1990,12,22,11,7,12,3,7,13,53.8,6,6,0,6,15,37,6,1,"https://fbref.com/en/players/e05082d1/Youssouf-MChangama"
2023,"Auxerre","Ligue 1","Han-Noah Massengo","FRA","MF","21",2001,12.4,27,15,10,15,2,7,16,43.8,9,12,3,9,14,41,7,0,"https://fbref.com/en/players/eba1e557/Han-Noah-Massengo"
2023,"Auxerre","Ligue 1","Gideon Mensah","GHA","DF","24",1998,25.1,80,44,43,32,5,44,77,57.1,33,33,10,23,38,118,41,0,"https://fbref.com/en/players/9bdd8118/Gideon-Mensah"
2023,"Auxerre","Ligue 1","M'Baye Niang","SEN","FW","27",1994,16.5,13,7,1,8,4,3,13,23.1,10,22,1,21,1,14,20,0,"https://fbref.com/en/players/2054d037/MBaye-Niang"
2023,"Auxerre","Ligue 1","Théo Pellenard","FRA","DF","28",1994,1.1,1,0,1,0,0,1,1,100,0,3,1,2,2,3,2,0,"https://fbref.com/en/players/97fb4608/Theo-Pellenard"
2023,"Auxerre","Ligue 1","Brayann Pereira","FRA","DF","19",2003,2,6,5,5,1,0,1,5,20,4,2,2,0,2,8,8,1,"https://fbref.com/en/players/5c42e7ce/Brayann-Pereira"
2023,"Auxerre","Ligue 1","Gaëtan Perrin","FRA","MF,FW","26",1996,15.5,17,8,5,6,6,8,30,26.7,22,15,0,15,10,27,9,0,"https://fbref.com/en/players/10dd88f9/Gaetan-Perrin"
2023,"Auxerre","Ligue 1","Ionuț Radu","ROU","GK","25",1997,17,0,0,0,0,0,0,0,NA,0,0,0,0,0,0,3,2,"https://fbref.com/en/players/67f649be/Ionut-Radu"
2023,"Auxerre","Ligue 1","Rayan Raveloson","MAD","DF,MF","25",1997,27,38,23,21,16,1,23,33,69.7,10,43,12,31,39,77,70,0,"https://fbref.com/en/players/fb3236a7/Rayan-Raveloson"
2023,"Auxerre","Ligue 1","Kays Ruiz","MAR","MF","19",2002,0.7,1,1,1,0,0,0,1,0,1,2,1,1,3,4,0,0,"https://fbref.com/en/players/90a9cc01/Kays-Ruiz"
2023,"Auxerre","Ligue 1","Hamza Sakhi","MAR","MF","26",1996,18.4,44,22,22,17,5,22,42,52.4,20,16,1,15,25,69,9,0,"https://fbref.com/en/players/c9151d66/Hamza-Sakhi"
2023,"Auxerre","Ligue 1","Lassine Sinayoko","MLI","MF,FW","22",1999,17.4,33,15,14,12,7,21,40,52.5,19,12,0,12,18,51,17,0,"https://fbref.com/en/players/5e5249c8/Lassine-Sinayoko"
2023,"Auxerre","Ligue 1","Birama Touré","MLI","MF","30",1992,37.8,80,47,35,35,10,34,93,36.6,59,54,9,45,67,147,49,0,"https://fbref.com/en/players/a4b798a9/Birama-Toure"
2023,"Auxerre","Ligue 1","Souleymane Touré","FRA","DF","19",2003,17.6,29,13,19,9,1,16,20,80,4,32,12,20,26,55,56,1,"https://fbref.com/en/players/01fd01e8/Souleymane-Toure"
2023,"Auxerre","Ligue 1","Akim Zedadka","ALG","DF","27",1995,17.8,35,21,21,10,4,18,32,56.3,14,17,3,14,23,58,51,1,"https://fbref.com/en/players/0ff630d0/Akim-Zedadka"
2023,"Barcelona","La Liga","Ángel Alarcón","ESP","FW","18",2004,0.3,NA,0,NA,NA,NA,NA,NA,NA,NA,NA,NA,NA,0,NA,NA,NA,"https://fbref.com/en/players/455c26a4/Angel-Alarcon"
2023,"Barcelona","La Liga","Jordi Alba","ESP","DF","33",1989,15.8,25,18,13,11,1,12,28,42.9,16,12,5,7,11,36,23,0,"https://fbref.com/en/players/4601e194/Jordi-Alba"
2023,"Barcelona","La Liga","Marcos Alonso","ESP","DF","31",1990,13,15,10,10,5,0,9,12,75,3,14,10,4,11,26,32,0,"https://fbref.com/en/players/f4290206/Marcos-Alonso"
2023,"Barcelona","La Liga","Ronald Araújo","URU","DF","23",1999,20,26,18,12,13,1,6,9,66.7,3,15,7,8,12,38,41,1,"https://fbref.com/en/players/2bef2bca/Ronald-Araujo"
2023,"Barcelona","La Liga","Pierre-Emerick Aubameyang","GAB","FW","33",1989,0.1,0,0,0,0,0,0,0,NA,0,0,0,0,0,0,0,0,"https://fbref.com/en/players/d5dd5f1f/Pierre-Emerick-Aubameyang"
2023,"Barcelona","La Liga","Alejandro Balde","ESP","DF","18",2003,27.5,42,30,22,16,4,24,41,58.5,17,25,3,22,12,54,17,1,"https://fbref.com/en/players/5ccc9672/Alejandro-Balde"
2023,"Barcelona","La Liga","Héctor Bellerín","ESP","DF","27",1995,1.6,2,0,0,2,0,2,3,66.7,1,2,0,2,3,5,2,0,"https://fbref.com/en/players/f874dd44/Hector-Bellerin"
2023,"Barcelona","La Liga","Sergio Busquets","ESP","MF","34",1988,26,58,26,24,26,8,29,51,56.9,22,32,6,26,27,85,36,2,"https://fbref.com/en/players/5ab0ea87/Sergio-Busquets"
2023,"Barcelona","La Liga","Andreas Christensen","DEN","DF","26",1996,19.6,20,15,9,11,0,10,16,62.5,6,14,12,2,21,41,47,0,"https://fbref.com/en/players/1cb49278/Andreas-Christensen"
2023,"Barcelona","La Liga","Ousmane Dembélé","FRA","FW","25",1997,15.7,19,12,4,8,7,4,15,26.7,11,10,1,9,0,19,2,0,"https://fbref.com/en/players/b19db005/Ousmane-Dembele"
2023,"Barcelona","La Liga","Ansu Fati","ESP","FW","19",2002,15.5,16,9,8,4,4,5,18,27.8,13,19,0,19,5,21,6,0,"https://fbref.com/en/players/0ba976e4/Ansu-Fati"
2023,"Barcelona","La Liga","Eric García","ESP","DF,MF","21",2001,15.7,24,16,16,5,3,9,20,45,11,23,10,13,19,43,36,1,"https://fbref.com/en/players/2bed3eab/Eric-Garcia"
2023,"Barcelona","La Liga","Aleix Garrido","ESP","FW","18",2004,0.1,2,1,1,0,1,1,1,100,0,1,0,1,0,2,0,0,"https://fbref.com/en/players/5757adc3/Aleix-Garrido"
2023,"Barcelona","La Liga","Gavi","ESP","MF,FW","17",2004,28.1,47,31,7,30,10,21,55,38.2,34,32,5,27,18,65,22,0,"https://fbref.com/en/players/19cae58d/Gavi"
2023,"Barcelona","La Liga","Frenkie de Jong","NED","MF","25",1997,28.2,46,26,16,21,9,17,41,41.5,24,11,1,10,35,81,22,1,"https://fbref.com/en/players/1bacc518/Frenkie-de-Jong"
2023,"Barcelona","La Liga","Franck Kessié","CIV","MF","25",1996,11,15,9,6,6,3,8,18,44.4,10,10,2,8,12,27,11,2,"https://fbref.com/en/players/05e19d6a/Franck-Kessie"
2023,"Barcelona","La Liga","Jules Koundé","FRA","DF","23",1998,27,37,23,18,13,6,21,31,67.7,10,24,9,15,19,56,61,3,"https://fbref.com/en/players/4d1666ff/Jules-Kounde"
2023,"Barcelona","La Liga","Robert Lewandowski","POL","FW","33",1988,31.6,17,11,2,5,10,7,14,50,7,20,0,20,2,19,14,0,"https://fbref.com/en/players/8d78e732/Robert-Lewandowski"
2023,"Barcelona","La Liga","Memphis","NED","FW","28",1994,1.3,1,1,1,0,0,0,1,0,1,0,0,0,0,1,0,0,"https://fbref.com/en/players/8f696594/Memphis"
2023,"Barcelona","La Liga","Pedri","ESP","MF","19",2002,22,39,22,15,17,7,13,45,28.9,32,27,0,27,13,52,8,1,"https://fbref.com/en/players/0d9b2d31/Pedri"
2023,"Barcelona","La Liga","Iñaki Peña","ESP","GK","23",1999,0.8,0,0,0,0,0,0,0,NA,0,0,0,0,0,0,0,1,"https://fbref.com/en/players/cc1c5035/Inaki-Pena"
2023,"Barcelona","La Liga","Gerard Piqué","ESP","DF","35",1987,4.3,5,4,1,4,0,4,4,100,0,2,1,1,2,7,19,0,"https://fbref.com/en/players/adfc9123/Gerard-Pique"
2023,"Barcelona","La Liga","Raphinha","BRA","FW","25",1996,23,29,19,10,7,12,11,31,35.5,20,33,1,32,14,43,11,1,"https://fbref.com/en/players/3423f250/Raphinha"
2023,"Barcelona","La Liga","Chadi Riad","MAR","MF","19",2003,0,0,0,0,0,0,0,0,NA,0,0,0,0,0,0,0,0,"https://fbref.com/en/players/b3b9b8b8/Chadi-Riad"
2023,"Barcelona","La Liga","Sergi Roberto","ESP","DF,MF","30",1992,14.5,22,15,12,6,4,7,18,38.9,11,15,7,8,11,33,16,0,"https://fbref.com/en/players/335fa267/Sergi-Roberto"
2023,"Barcelona","La Liga","Marc-André ter Stegen","GER","GK","30",1992,37.2,0,0,0,0,0,0,0,NA,0,0,0,0,1,1,7,3,"https://fbref.com/en/players/6f51e382/Marc-Andre-ter-Stegen"
2023,"Barcelona","La Liga","Pablo Torre","ESP","FW,MF","19",2003,1.6,2,1,0,1,1,2,4,50,2,1,0,1,2,4,1,0,"https://fbref.com/en/players/04e531b6/Pablo-Torre"
2023,"Barcelona","La Liga","Ferrán Torres","ESP","FW,MF","22",2000,15.5,13,7,4,5,4,5,20,25,15,11,2,9,3,16,5,0,"https://fbref.com/en/players/9e1035f8/Ferran-Torres"
2023,"Barcelona","La Liga","Lamine Yamal","ESP","FW","15",2007,0.1,0,0,0,0,0,0,0,NA,0,0,0,0,0,0,0,0,"https://fbref.com/en/players/82ec26c1/Lamine-Yamal"
2023,"Bayern Munich","Bundesliga","Daley Blind","NED","DF,MF","32",1990,1.5,2,0,2,0,0,0,1,0,1,4,2,2,2,4,6,0,"https://fbref.com/en/players/691bef82/Daley-Blind"
2023,"Bayern Munich","Bundesliga","João Cancelo","POR","DF,FW","28",1994,11.2,23,14,9,10,4,10,23,43.5,13,14,2,12,15,38,22,0,"https://fbref.com/en/players/bd6351cd/Joao-Cancelo"
2023,"Bayern Munich","Bundesliga","Kingsley Coman","FRA","FW,MF","26",1996,15.7,11,8,3,5,3,7,17,41.2,10,19,1,18,2,13,7,0,"https://fbref.com/en/players/042e8a49/Kingsley-Coman"
2023,"Bayern Munich","Bundesliga","Alphonso Davies","CAN","DF","21",2000,22.7,45,28,25,13,7,18,39,46.2,21,28,4,24,24,69,24,4,"https://fbref.com/en/players/d781d855/Alphonso-Davies"
2023,"Bayern Munich","Bundesliga","Serge Gnabry","GER","FW,MF","27",1995,21.6,35,23,11,14,10,17,43,39.5,26,24,1,23,11,46,5,1,"https://fbref.com/en/players/88e357ef/Serge-Gnabry"
2023,"Bayern Munich","Bundesliga","Leon Goretzka","GER","MF","27",1995,19.2,43,24,21,16,6,27,48,56.3,21,40,3,37,30,73,32,0,"https://fbref.com/en/players/cc86b9a3/Leon-Goretzka"
2023,"Bayern Munich","Bundesliga","Ryan Gravenberch","NED","MF","20",2002,6.4,17,8,4,10,3,7,13,53.8,6,9,1,8,9,26,10,0,"https://fbref.com/en/players/b8e740fb/Ryan-Gravenberch"
2023,"Bayern Munich","Bundesliga","Lucas Hernández","FRA","DF","26",1996,5.3,6,4,3,3,0,5,6,83.3,1,2,1,1,5,11,7,0,"https://fbref.com/en/players/c3ee18ef/Lucas-Hernandez"
2023,"Bayern Munich","Bundesliga","Arijon Ibrahimović","GER","MF","16",2005,0.2,1,1,1,0,0,0,0,NA,0,0,0,0,0,1,0,0,"https://fbref.com/en/players/f5c4fd91/Arijon-Ibrahimovic"
2023,"Bayern Munich","Bundesliga","Joshua Kimmich","GER","MF","27",1995,31.2,78,49,24,46,8,38,72,52.8,34,36,7,29,41,119,39,2,"https://fbref.com/en/players/49296448/Joshua-Kimmich"
2023,"Bayern Munich","Bundesliga","Matthijs de Ligt","NED","DF","22",1999,26.7,32,23,15,16,1,15,24,62.5,9,31,20,11,23,55,85,0,"https://fbref.com/en/players/d6e53a3a/Matthijs-de-Ligt"
2023,"Bayern Munich","Bundesliga","Sadio Mané","SEN","FW,MF","30",1992,15.8,11,5,3,3,5,1,9,11.1,8,15,2,13,0,11,4,0,"https://fbref.com/en/players/c691bfe2/Sadio-Mane"
2023,"Bayern Munich","Bundesliga","Eric Maxim Choupo-Moting","CMR","FW","33",1989,12.4,10,7,2,6,2,1,2,50,1,8,0,8,0,10,5,0,"https://fbref.com/en/players/0e6bc38c/Eric-Maxim-Choupo-Moting"
2023,"Bayern Munich","Bundesliga","Noussair Mazraoui","MAR","DF","24",1997,11.9,29,21,9,9,11,15,24,62.5,9,13,2,11,10,39,25,0,"https://fbref.com/en/players/b74277a0/Noussair-Mazraoui"
2023,"Bayern Munich","Bundesliga","Thomas Müller","GER","FW,MF","32",1989,18.5,21,12,5,9,7,6,16,37.5,10,19,3,16,4,25,16,0,"https://fbref.com/en/players/3c6089ab/Thomas-Muller"
2023,"Bayern Munich","Bundesliga","Jamal Musiala","GER","MF,FW","19",2003,24.4,34,23,9,16,9,13,35,37.1,22,30,3,27,19,53,3,0,"https://fbref.com/en/players/2c0558b8/Jamal-Musiala"
2023,"Bayern Munich","Bundesliga","Manuel Neuer","GER","GK","36",1986,12,0,0,0,0,0,0,0,NA,0,0,0,0,0,0,4,1,"https://fbref.com/en/players/8778c910/Manuel-Neuer"
2023,"Bayern Munich","Bundesliga","Benjamin Pavard","FRA","DF","26",1996,27,70,41,36,26,8,36,48,75,12,35,16,19,44,114,83,0,"https://fbref.com/en/players/45a03961/Benjamin-Pavard"
2023,"Bayern Munich","Bundesliga","Marcel Sabitzer","AUT","MF","28",1994,7,27,14,11,10,6,10,17,58.8,7,3,0,3,10,37,9,0,"https://fbref.com/en/players/e280527c/Marcel-Sabitzer"
2023,"Bayern Munich","Bundesliga","Leroy Sané","GER","MF,FW","26",1996,22.3,38,30,11,19,8,18,36,50,18,11,1,10,3,41,1,2,"https://fbref.com/en/players/2b114be3/Leroy-Sane"
2023,"Bayern Munich","Bundesliga","Bouna Sarr","SEN","FW","30",1992,0,0,0,0,0,0,0,0,NA,0,0,0,0,0,0,0,0,"https://fbref.com/en/players/1a4b9094/Bouna-Sarr"
2023,"Bayern Munich","Bundesliga","Yann Sommer","SUI","GK","33",1988,19,0,0,0,0,0,0,0,NA,0,0,0,0,1,1,5,1,"https://fbref.com/en/players/420c18a1/Yann-Sommer"
2023,"Bayern Munich","Bundesliga","Josip Stanišić","CRO","DF","22",2000,6.4,19,11,14,2,3,12,17,70.6,5,9,1,8,7,26,11,3,"https://fbref.com/en/players/7ed08d5c/Josip-Stanisic"
2023,"Bayern Munich","Bundesliga","Mathys Tel","FRA","FW","17",2005,4.6,2,2,0,1,1,1,1,100,0,5,1,4,0,2,2,0,"https://fbref.com/en/players/829aa60c/Mathys-Tel"
2023,"Bayern Munich","Bundesliga","Sven Ulreich","GER","GK","33",1988,3,1,1,1,0,0,1,1,100,0,0,0,0,0,1,0,1,"https://fbref.com/en/players/7d3e7da6/Sven-Ulreich"
2023,"Bayern Munich","Bundesliga","Dayot Upamecano","FRA","DF","23",1998,26.1,65,37,43,22,0,28,45,62.2,17,26,6,20,27,92,71,4,"https://fbref.com/en/players/d248cd8f/Dayot-Upamecano"
2023,"Bayern Munich","Bundesliga","Gabriel Vidovic","CRO","FW","18",2003,0.2,0,0,0,0,0,0,0,NA,0,0,0,0,0,0,0,0,"https://fbref.com/en/players/5360a956/Gabriel-Vidovic"
2023,"Bayern Munich","Bundesliga","Paul Wanner","GER","MF","16",2005,0.3,3,1,1,2,0,1,1,100,0,0,0,0,0,3,1,0,"https://fbref.com/en/players/cb64672e/Paul-Wanner"
2023,"Betis","La Liga","Abner","BRA","DF","22",2000,6.7,12,9,9,2,1,7,16,43.8,9,8,2,6,8,20,24,0,"https://fbref.com/en/players/7f9c5d2d/Abner"
2023,"Betis","La Liga","Paul Akouokou","CIV","MF,DF","24",1997,5,16,9,13,3,0,13,20,65,7,2,2,0,12,28,17,1,"https://fbref.com/en/players/31f5b89b/Paul-Akouokou"
2023,"Betis","La Liga","Claudio Bravo","CHI","GK","39",1983,12,0,0,0,0,0,0,0,NA,0,0,0,0,2,2,1,1,"https://fbref.com/en/players/10072610/Claudio-Bravo"
2023,"Betis","La Liga","Sergio Canales","ESP","FW,MF","31",1991,26.7,25,14,10,8,7,14,33,42.4,19,18,0,18,14,39,8,0,"https://fbref.com/en/players/a6de370d/Sergio-Canales"
2023,"Betis","La Liga","William Carvalho","POR","MF","30",1992,27.1,43,27,18,23,2,17,44,38.6,27,27,6,21,16,59,22,0,"https://fbref.com/en/players/dee86451/William-Carvalho"
2023,"Betis","La Liga","Juan Cruz","ESP","FW","22",2000,2,1,0,0,1,0,1,3,33.3,2,1,0,1,0,1,0,0,"https://fbref.com/en/players/cc2dd8a5/Juan-Cruz"
2023,"Betis","La Liga","Fran Delgado","ESP","DF","21",2001,0.1,0,0,0,0,0,0,0,NA,0,0,0,0,0,0,0,0,"https://fbref.com/en/players/e7d2a50b/Fran-Delgado"
2023,"Betis","La Liga","Nabil Fekir","FRA","MF","29",1993,10.7,11,5,3,3,5,2,9,22.2,7,6,2,4,1,12,0,0,"https://fbref.com/en/players/bece776f/Nabil-Fekir"
2023,"Betis","La Liga","Luiz Felipe","ITA","DF","25",1997,19.6,34,23,23,11,0,18,34,52.9,16,43,24,19,28,62,106,0,"https://fbref.com/en/players/15d0c248/Luiz-Felipe"
2023,"Betis","La Liga","Felix Garreta","ESP","DF","18",2004,1,1,0,0,1,0,0,0,NA,0,1,1,0,1,2,4,0,"https://fbref.com/en/players/9a26fa06/Felix-Garreta"
2023,"Betis","La Liga","Édgar González","ESP","DF","25",1997,19.7,28,19,18,7,3,14,27,51.9,13,12,9,3,21,49,120,0,"https://fbref.com/en/players/49d028db/Edgar-Gonzalez"
2023,"Betis","La Liga","Roberto González","ESP","FW,MF","21",2001,0.6,0,0,0,0,0,0,1,0,1,0,0,0,1,1,0,0,"https://fbref.com/en/players/56545648/Roberto-Gonzalez"
2023,"Betis","La Liga","Andrés Guardado","MEX","MF","35",1986,15.3,41,25,17,20,4,18,43,41.9,25,14,5,9,23,64,29,0,"https://fbref.com/en/players/ef322658/Andres-Guardado"
2023,"Betis","La Liga","Luiz Henrique","BRA","FW","21",2001,20.1,48,34,27,15,6,20,44,45.5,24,22,0,22,14,62,17,0,"https://fbref.com/en/players/8059806f/Luiz-Henrique"
2023,"Betis","La Liga","Borja Iglesias","ESP","FW","29",1993,26.3,8,4,3,3,2,2,13,15.4,11,9,1,8,1,9,17,0,"https://fbref.com/en/players/75645f0e/Borja-Iglesias"
2023,"Betis","La Liga","Joaquín","ESP","MF,FW","41",1981,5.5,3,3,2,1,0,1,3,33.3,2,7,2,5,4,7,5,0,"https://fbref.com/en/players/4c5b14d2/Joaquin"
2023,"Betis","La Liga","Willian José","BRA","FW","30",1991,8.1,9,6,6,3,0,4,9,44.4,5,4,0,4,1,10,15,0,"https://fbref.com/en/players/d87e2cae/Willian-Jose"
2023,"Betis","La Liga","Juanmi","ESP","FW","29",1993,10.3,14,10,4,7,3,7,31,22.6,24,10,0,10,4,18,4,0,"https://fbref.com/en/players/84399660/Juanmi"
2023,"Betis","La Liga","Juan Miranda","ESP","DF","22",2000,16.4,23,16,16,6,1,14,29,48.3,15,20,7,13,20,43,63,0,"https://fbref.com/en/players/ead61f73/Juan-Miranda"
2023,"Betis","La Liga","Martín Montoya","ESP","DF","31",1991,5,13,8,9,4,0,10,12,83.3,2,6,1,5,9,22,14,1,"https://fbref.com/en/players/5cec2487/Martin-Montoya"
2023,"Betis","La Liga","Álex Moreno","ESP","DF","29",1993,15,29,22,19,10,0,18,36,50,18,17,4,13,17,46,39,0,"https://fbref.com/en/players/16e9d0ea/Alex-Moreno"
2023,"Betis","La Liga","Loren Morón","ESP","FW","28",1993,0.2,2,2,0,1,1,0,0,NA,0,0,0,0,0,2,1,0,"https://fbref.com/en/players/3aa4a3be/Loren-Moron"
2023,"Betis","La Liga","Ayoze Pérez","ESP","FW,MF","29",1993,15.4,31,15,9,16,6,10,40,25,30,22,0,22,13,44,5,0,"https://fbref.com/en/players/819aa8e7/Ayoze-Perez"
2023,"Betis","La Liga","Germán Pezzella","ARG","DF","31",1991,27.9,41,28,32,9,0,26,38,68.4,12,32,15,17,50,91,129,1,"https://fbref.com/en/players/8c725b43/German-Pezzella"
2023,"Betis","La Liga","Rodri","ESP","FW,MF","22",2000,17.8,16,11,5,9,2,8,17,47.1,9,10,0,10,13,29,2,0,"https://fbref.com/en/players/85bed4ee/Rodri"
2023,"Betis","La Liga","Guido Rodríguez","ARG","MF","28",1994,31.9,115,75,59,50,6,54,101,53.5,47,58,14,44,42,157,76,1,"https://fbref.com/en/players/34e393f2/Guido-Rodriguez"
2023,"Betis","La Liga","Aitor Ruibal","ESP","DF,FW","26",1996,16.2,47,29,35,9,3,31,58,53.4,27,17,2,15,24,71,41,0,"https://fbref.com/en/players/a55d8df5/Aitor-Ruibal"
2023,"Betis","La Liga","Víctor Ruiz","ESP","DF","33",1989,6.2,5,3,3,2,0,3,3,100,0,10,7,3,6,11,34,0,"https://fbref.com/en/players/b3dc6eca/Victor-Ruiz"
2023,"Betis","La Liga","Youssouf Sabaly","SEN","DF","29",1993,18.7,45,23,29,14,2,22,33,66.7,11,35,8,27,19,64,52,1,"https://fbref.com/en/players/fbbb9269/Youssouf-Sabaly"
2023,"Betis","La Liga","Rui Silva","POR","GK","28",1994,26,4,1,4,0,0,4,4,100,0,0,0,0,0,4,12,1,"https://fbref.com/en/players/ea83bfa6/Rui-Silva"
2023,"Bochum","Bundesliga","Christopher Antwi-Adjei","GHA","FW,MF","28",1994,22,23,15,7,8,8,10,29,34.5,19,17,0,17,5,28,16,0,"https://fbref.com/en/players/0a3f6cde/Christopher-Antwi-Adjei"
2023,"Bochum","Bundesliga","Takuma Asano","JPN","FW,MF","27",1994,19,14,9,4,4,6,7,16,43.8,9,17,1,16,8,22,8,0,"https://fbref.com/en/players/13ddc856/Takuma-Asano"
2023,"Bochum","Bundesliga","Moritz Broschinski","GER","FW,MF","21",2000,2.4,0,0,0,0,0,0,5,0,5,1,0,1,0,0,6,0,"https://fbref.com/en/players/bbd79358/Moritz-Broschinski"
2023,"Bochum","Bundesliga","Philipp Förster","GER","MF","27",1995,14.5,31,19,11,15,5,12,40,30,28,22,0,22,6,37,6,0,"https://fbref.com/en/players/76fa965f/Philipp-Forster"
2023,"Bochum","Bundesliga","Cristian Gamboa","CRC","DF","32",1989,16.4,42,24,27,14,1,21,31,67.7,10,20,7,13,16,58,34,1,"https://fbref.com/en/players/f27680d9/Cristian-Gamboa"
2023,"Bochum","Bundesliga","Silvère Ganvoula M'Boussy","CGO","FW,MF","26",1996,2.7,2,2,0,1,1,0,0,NA,0,0,0,0,0,2,3,0,"https://fbref.com/en/players/6c731625/Silvere-Ganvoula-MBoussy"
2023,"Bochum","Bundesliga","Jacek Góralski","POL","MF","29",1992,1.6,6,3,3,3,0,4,6,66.7,2,4,0,4,3,9,5,0,"https://fbref.com/en/players/83b9c48f/Jacek-Goralski"
2023,"Bochum","Bundesliga","Dominique Heintz","GER","DF","28",1993,8.8,13,9,5,7,1,6,17,35.3,11,11,7,4,12,25,34,0,"https://fbref.com/en/players/699fb8db/Dominique-Heintz"
2023,"Bochum","Bundesliga","Philipp Hofmann","GER","FW","29",1993,29.2,18,11,0,13,5,5,12,41.7,7,20,8,12,6,24,48,0,"https://fbref.com/en/players/877bc844/Philipp-Hofmann"
2023,"Bochum","Bundesliga","Gerrit Holtmann","PHI","FW,MF","27",1995,10.5,14,7,6,7,1,12,21,57.1,9,15,1,14,2,16,4,0,"https://fbref.com/en/players/2979c05a/Gerrit-Holtmann"
2023,"Bochum","Bundesliga","Jannes Horn","GER","DF,FW","25",1997,0.7,2,1,1,1,0,1,1,100,0,1,0,1,3,5,2,0,"https://fbref.com/en/players/2b83fa49/Jannes-Horn"
2023,"Bochum","Bundesliga","Saidy Janko","GAM","DF","26",1995,12.6,23,15,13,8,2,12,20,60,8,24,10,14,11,34,33,1,"https://fbref.com/en/players/689c9cf4/Saidy-Janko"
2023,"Bochum","Bundesliga","Pierre Kunde","CMR","MF,FW","27",1995,4.2,12,6,3,8,1,6,14,42.9,8,7,1,6,7,19,9,0,"https://fbref.com/en/players/9ceb7642/Pierre-Kunde"
2023,"Bochum","Bundesliga","Vassilis Lambropoulos","GRE","DF","32",1990,7,10,8,7,3,0,6,9,66.7,3,5,3,2,13,23,41,0,"https://fbref.com/en/players/591477c9/Vassilis-Lambropoulos"
2023,"Bochum","Bundesliga","Anthony Losilla","FRA","MF","36",1986,30.2,76,49,32,34,10,38,77,49.4,39,39,12,27,37,113,67,0,"https://fbref.com/en/players/07c7eb0c/Anthony-Losilla"
2023,"Bochum","Bundesliga","Erhan Mašović","SRB","DF,MF","23",1998,24.2,50,31,28,21,1,30,51,58.8,21,30,14,16,27,77,79,0,"https://fbref.com/en/players/a396fb61/Erhan-Masovic"
2023,"Bochum","Bundesliga","Tim Oermann","GER","DF","18",2003,2.2,2,1,2,0,0,1,1,100,0,3,2,1,1,3,8,1,"https://fbref.com/en/players/57ec75bf/Tim-Oermann"
2023,"Bochum","Bundesliga","Ivan Ordets","UKR","DF","30",1992,27.2,31,19,21,9,1,16,28,57.1,12,34,17,17,57,88,139,0,"https://fbref.com/en/players/86c75897/Ivan-Ordets"
2023,"Bochum","Bundesliga","Jordi Osei-Tutu","ENG","DF,FW","23",1998,8.3,23,18,13,5,5,12,23,52.2,11,12,5,7,10,33,8,0,"https://fbref.com/en/players/0a16eb36/Jordi-Osei-Tutu"
2023,"Bochum","Bundesliga","Patrick Osterhage","GER","MF","22",2000,11.4,20,17,8,10,2,11,16,68.8,5,17,6,11,12,32,25,0,"https://fbref.com/en/players/9662c9ec/Patrick-Osterhage"
2023,"Bochum","Bundesliga","Manuel Riemann","GER","GK","33",1988,34,3,2,3,0,0,3,5,60,2,1,0,1,5,8,23,7,"https://fbref.com/en/players/9f941969/Manuel-Riemann"
2023,"Bochum","Bundesliga","Keven Schlotterbeck","GER","DF","25",1997,8.2,17,9,12,5,0,9,11,81.8,2,11,5,6,14,31,49,0,"https://fbref.com/en/players/f6bdc830/Keven-Schlotterbeck"
2023,"Bochum","Bundesliga","Danilo Soares","BRA","DF","30",1991,19.6,72,46,42,23,7,43,72,59.7,29,29,6,23,30,102,56,1,"https://fbref.com/en/players/c05f2f8c/Danilo-Soares"
2023,"Bochum","Bundesliga","Kostas Stafylidis","GRE","DF,MF","28",1993,11.6,27,16,13,8,6,10,24,41.7,14,21,8,13,20,47,31,1,"https://fbref.com/en/players/861e0116/Kostas-Stafylidis"
2023,"Bochum","Bundesliga","Kevin Stöger","AUT","MF","28",1993,28.9,84,45,38,32,14,31,94,33,63,27,4,23,26,110,21,1,"https://fbref.com/en/players/e5649a78/Kevin-Stoger"
2023,"Bochum","Bundesliga","Simon Zoller","GER","FW","31",1991,16.2,11,4,2,8,1,4,12,33.3,8,14,1,13,6,17,21,0,"https://fbref.com/en/players/29f7cfd9/Simon-Zoller"
2023,"Bologna","Serie A","Michel Aebischer","SUI","FW,MF","25",1997,17.1,12,6,3,6,3,2,18,11.1,16,14,2,12,7,19,9,0,"https://fbref.com/en/players/f9c927de/Michel-Aebischer"
2023,"Bologna","Serie A","Marko Arnautović","AUT","FW","33",1989,17,9,6,2,5,2,1,6,16.7,5,11,1,10,2,11,10,0,"https://fbref.com/en/players/00459419/Marko-Arnautovic"
2023,"Bologna","Serie A","Francesco Bardi","ITA","GK","30",1992,1,0,0,0,0,0,0,0,NA,0,0,0,0,0,0,0,0,"https://fbref.com/en/players/0acda699/Francesco-Bardi"
2023,"Bologna","Serie A","Musa Barrow","GAM","FW,MF","23",1998,21.8,21,4,10,6,5,8,14,57.1,6,25,1,24,1,22,7,0,"https://fbref.com/en/players/e5bf73f3/Musa-Barrow"
2023,"Bologna","Serie A","Kevin Bonifazi","ITA","DF","26",1996,10,13,8,7,6,0,6,12,50,6,11,8,3,12,25,39,0,"https://fbref.com/en/players/fb77bfef/Kevin-Bonifazi"
2023,"Bologna","Serie A","Andrea Cambiaso","ITA","DF","22",2000,24.1,57,34,34,20,3,28,65,43.1,37,26,2,24,26,83,33,1,"https://fbref.com/en/players/247ed022/Andrea-Cambiaso"
2023,"Bologna","Serie A","Lorenzo De Silvestri","ITA","DF","34",1988,7.5,3,2,2,0,1,3,7,42.9,4,6,5,1,3,6,20,0,"https://fbref.com/en/players/e74f0e59/Lorenzo-De-Silvestri"
2023,"Bologna","Serie A","Nicolás Domínguez","ARG","MF","24",1998,25.6,79,49,34,33,12,39,76,51.3,37,29,3,26,21,100,29,1,"https://fbref.com/en/players/20b3a502/Nicolas-Dominguez"
2023,"Bologna","Serie A","Lewis Ferguson","SCO","MF,FW","22",1999,25.7,44,25,16,20,8,20,40,50,20,22,7,15,19,63,25,0,"https://fbref.com/en/players/ee64a822/Lewis-Ferguson"
2023,"Bologna","Serie A","Denso Kasius","NED","DF","19",2002,3.8,12,6,7,4,1,8,10,80,2,6,3,3,3,15,6,0,"https://fbref.com/en/players/7ae36711/Denso-Kasius"
2023,"Bologna","Serie A","Giorgos Kyriakopoulos","GRE","DF,FW","26",1996,7.8,13,6,4,5,4,10,23,43.5,13,14,2,12,4,17,10,0,"https://fbref.com/en/players/0a483542/Giorgos-Kyriakopoulos"
2023,"Bologna","Serie A","Jhon Lucumí","COL","DF","24",1998,32.2,53,37,39,13,1,24,43,55.8,19,43,26,17,35,88,100,1,"https://fbref.com/en/players/80490d7f/Jhon-Lucumi"
2023,"Bologna","Serie A","Charalambos Lykogiannis","GRE","DF","28",1993,12.3,16,8,5,6,5,5,13,38.5,8,9,4,5,15,31,30,0,"https://fbref.com/en/players/5efc5389/Charalambos-Lykogiannis"
2023,"Bologna","Serie A","Gary Medel","CHI","MF,DF","34",1987,16.4,25,15,16,7,2,9,16,56.3,7,17,10,7,28,53,34,0,"https://fbref.com/en/players/563a68ad/Gary-Medel"
2023,"Bologna","Serie A","Nikola Moro","CRO","MF","24",1998,13.6,32,21,11,15,6,14,36,38.9,22,15,2,13,8,40,18,0,"https://fbref.com/en/players/ff579c7e/Nikola-Moro"
2023,"Bologna","Serie A","Riccardo Orsolini","ITA","FW","25",1997,23.6,30,19,15,10,5,17,41,41.5,24,29,3,26,8,38,18,0,"https://fbref.com/en/players/e14ec482/Riccardo-Orsolini"
2023,"Bologna","Serie A","Stefan Posch","AUT","DF","25",1997,28.1,81,43,41,29,11,44,75,58.7,31,44,15,29,35,116,69,0,"https://fbref.com/en/players/7f609bfc/Stefan-Posch"
2023,"Bologna","Serie A","Niklas Pyyhtiä","FIN","MF","18",2003,1.2,1,0,0,1,0,0,1,0,1,1,1,0,1,2,4,0,"https://fbref.com/en/players/88f53b75/Niklas-Pyyhtia"
2023,"Bologna","Serie A","Antonio Raimondo","ITA","FW","18",2004,0.2,0,0,0,0,0,0,0,NA,0,0,0,0,0,0,1,0,"https://fbref.com/en/players/ce1a6c7e/Antonio-Raimondo"
2023,"Bologna","Serie A","Nicola Sansone","ITA","FW","30",1991,8.2,12,4,6,4,2,5,10,50,5,0,0,0,0,12,4,0,"https://fbref.com/en/players/7eb97a8e/Nicola-Sansone"
2023,"Bologna","Serie A","Jerdy Schouten","NED","MF","25",1997,27.9,63,38,28,33,2,27,49,55.1,22,40,17,23,40,103,43,1,"https://fbref.com/en/players/2cfae697/Jerdy-Schouten"
2023,"Bologna","Serie A","Łukasz Skorupski","POL","GK","31",1991,37,2,1,2,0,0,1,2,50,1,0,0,0,0,2,19,2,"https://fbref.com/en/players/ab4449d6/Lukasz-Skorupski"
2023,"Bologna","Serie A","Roberto Soriano","ITA","FW,MF","31",1991,14.7,31,16,9,16,6,13,25,52,12,23,2,21,6,37,14,0,"https://fbref.com/en/players/9d4c45d6/Roberto-Soriano"
2023,"Bologna","Serie A","Joaquin Sosa","URU","DF","20",2002,7.6,6,2,5,1,0,4,18,22.2,14,5,3,2,6,12,31,0,"https://fbref.com/en/players/50841bef/Joaquin-Sosa"
2023,"Bologna","Serie A","Adama Soumaoro","FRA","DF","30",1992,20.7,25,17,11,12,2,5,7,71.4,2,18,13,5,15,40,75,1,"https://fbref.com/en/players/7b075c75/Adama-Soumaoro"
2023,"Bologna","Serie A","Emanuel Vignato","ITA","MF,FW","21",2000,2.7,4,4,2,2,0,2,4,50,2,2,0,2,3,7,0,0,"https://fbref.com/en/players/ec5dae45/Emanuel-Vignato"
2023,"Bologna","Serie A","Joshua Zirkzee","NED","FW","21",2001,9.1,4,2,1,1,2,2,7,28.6,5,4,1,3,4,8,4,0,"https://fbref.com/en/players/028e70b9/Joshua-Zirkzee"
2023,"Bournemouth","Premier League","Jaidon Anthony","ENG","MF,FW","22",1999,14,30,17,15,9,6,8,24,33.3,16,30,3,27,10,40,19,0,"https://fbref.com/en/players/e4238fb1/Jaidon-Anthony"
2023,"Bournemouth","Premier League","Owen Bevan","WAL","DF","18",2003,0.1,0,0,0,0,0,0,0,NA,0,0,0,0,0,0,0,0,"https://fbref.com/en/players/87966294/Owen-Bevan"
2023,"Bournemouth","Premier League","Philip Billing","DEN","MF,FW","26",1996,30.7,63,36,21,33,9,11,40,27.5,29,48,8,40,31,94,58,1,"https://fbref.com/en/players/d328a254/Philip-Billing"
2023,"Bournemouth","Premier League","David Brooks","WAL","FW,MF","25",1997,1.9,1,0,1,0,0,0,1,0,1,2,0,2,2,3,5,0,"https://fbref.com/en/players/dc4cae05/David-Brooks"
2023,"Bournemouth","Premier League","Ryan Christie","SCO","MF,FW","27",1995,20.4,34,22,10,23,1,14,49,28.6,35,16,4,12,26,60,20,0,"https://fbref.com/en/players/26ce2263/Ryan-Christie"
2023,"Bournemouth","Premier League","Lewis Cook","ENG","MF","25",1997,19.1,37,22,10,22,5,18,42,42.9,24,29,10,19,23,60,31,0,"https://fbref.com/en/players/2afc7272/Lewis-Cook"
2023,"Bournemouth","Premier League","Siriki Dembélé","CIV","FW,MF","25",1996,1.2,3,1,2,1,0,0,1,0,1,1,0,1,1,4,1,0,"https://fbref.com/en/players/11f54bd5/Siriki-Dembele"
2023,"Bournemouth","Premier League","Ryan Fredericks","ENG","DF","29",1992,5.9,3,2,2,0,1,1,4,25,3,7,2,5,1,4,27,0,"https://fbref.com/en/players/c067631c/Ryan-Fredericks"
2023,"Bournemouth","Premier League","Hamed Junior Traorè","CIV","FW,MF","22",2000,4.7,17,11,5,9,3,6,18,33.3,12,9,0,9,2,19,1,0,"https://fbref.com/en/players/570bb4b9/Hamed-Junior-Traore"
2023,"Bournemouth","Premier League","Lloyd Kelly","ENG","DF","23",1998,22.7,33,18,23,9,1,13,19,68.4,6,26,15,11,26,59,101,1,"https://fbref.com/en/players/f31def1e/Lloyd-Kelly"
2023,"Bournemouth","Premier League","Jefferson Lerma","COL","MF","27",1994,36.1,50,30,23,23,4,20,45,44.4,25,32,15,17,47,97,91,1,"https://fbref.com/en/players/9b5ce51a/Jefferson-Lerma"
2023,"Bournemouth","Premier League","Jamal Lowe","JAM","MF,FW","28",1994,0.1,0,0,0,0,0,0,0,NA,0,0,0,0,0,0,0,0,"https://fbref.com/en/players/b2856bc0/Jamal-Lowe"
2023,"Bournemouth","Premier League","Emiliano Marcondes","DEN","MF","27",1995,0.1,0,0,0,0,0,0,0,NA,0,0,0,0,0,0,1,0,"https://fbref.com/en/players/4d960fc3/Emiliano-Marcondes"
2023,"Bournemouth","Premier League","Chris Mepham","WAL","DF","24",1997,24.4,45,22,37,8,0,19,30,63.3,11,40,27,13,30,75,152,0,"https://fbref.com/en/players/fed96827/Chris-Mepham"
2023,"Bournemouth","Premier League","Kieffer Moore","WAL","FW","29",1992,14.2,14,11,2,9,3,5,16,31.3,11,12,5,7,1,15,26,0,"https://fbref.com/en/players/01ce9e70/Kieffer-Moore"
2023,"Bournemouth","Premier League","Neto","BRA","GK","33",1989,26.5,3,1,3,0,0,3,3,100,0,0,0,0,0,3,10,3,"https://fbref.com/en/players/a9dc785c/Neto"
2023,"Bournemouth","Premier League","Dango Ouattara","BFA","MF,FW","20",2002,13.8,28,15,20,6,2,13,32,40.6,19,20,3,17,13,41,29,1,"https://fbref.com/en/players/2f9e4435/Dango-Ouattara"
2023,"Bournemouth","Premier League","Ben Pearson","ENG","MF","27",1995,3.2,7,3,3,3,1,1,3,33.3,2,4,0,4,2,9,6,0,"https://fbref.com/en/players/a6b461e7/Ben-Pearson"
2023,"Bournemouth","Premier League","Joe Rothwell","ENG","MF","27",1995,11.3,20,13,7,12,1,7,21,33.3,14,14,3,11,9,29,7,0,"https://fbref.com/en/players/10a10454/Joe-Rothwell"
2023,"Bournemouth","Premier League","Antoine Semenyo","GHA","FW,MF","22",2000,2.9,1,0,0,0,1,1,6,16.7,5,10,1,9,2,3,4,0,"https://fbref.com/en/players/efd2ec23/Antoine-Semenyo"
2023,"Bournemouth","Premier League","Marcos Senesi","ARG","DF","25",1997,27.7,50,35,28,22,0,23,43,53.5,20,38,20,18,43,93,146,2,"https://fbref.com/en/players/35141f4c/Marcos-Senesi"
2023,"Bournemouth","Premier League","Adam Smith","ENG","DF","31",1991,32.7,49,29,27,19,3,29,60,48.3,31,30,13,17,25,74,81,1,"https://fbref.com/en/players/20b104bc/Adam-Smith"
2023,"Bournemouth","Premier League","Dominic Solanke","ENG","FW,MF","24",1997,31.8,15,9,8,3,4,5,22,22.7,17,26,7,19,6,21,46,0,"https://fbref.com/en/players/e77dc3b2/Dominic-Solanke"
2023,"Bournemouth","Premier League","Jack Stacey","ENG","DF","26",1996,3.3,5,4,3,1,1,2,5,40,3,3,1,2,5,10,15,0,"https://fbref.com/en/players/558807c0/Jack-Stacey"
2023,"Bournemouth","Premier League","Junior Stanislas","ENG","MF","32",1989,0.7,0,0,0,0,0,0,0,NA,0,2,1,1,0,0,0,0,"https://fbref.com/en/players/6992791d/Junior-Stanislas"
2023,"Bournemouth","Premier League","Jack Stephens","ENG","DF","28",1994,13,15,11,10,4,1,6,10,60,4,23,16,7,16,31,53,0,"https://fbref.com/en/players/6adbc307/Jack-Stephens"
2023,"Bournemouth","Premier League","Marcus Tavernier","ENG","MF,FW","23",1999,19.4,33,22,19,11,3,11,32,34.4,21,25,4,21,9,42,23,0,"https://fbref.com/en/players/5c0da4a4/Marcus-Tavernier"
2023,"Bournemouth","Premier League","Mark Travers","IRL","GK","23",1999,11.5,0,0,0,0,0,0,0,NA,0,1,0,1,0,0,6,0,"https://fbref.com/en/players/fe558029/Mark-Travers"
2023,"Bournemouth","Premier League","Matías Viña","URU","DF","24",1997,5.1,19,11,9,8,2,14,30,46.7,16,13,1,12,4,23,22,0,"https://fbref.com/en/players/08eb3b58/Matias-Vina"
2023,"Bournemouth","Premier League","Illia Zabarnyi","UKR","DF","19",2002,3.3,4,2,4,0,0,3,7,42.9,4,7,2,5,3,7,14,0,"https://fbref.com/en/players/88968486/Illia-Zabarnyi"
2023,"Bournemouth","Premier League","Jordan Zemura","ZIM","DF","22",1999,16.2,39,24,24,14,1,23,43,53.5,20,31,9,22,16,55,32,0,"https://fbref.com/en/players/e8271ad9/Jordan-Zemura"
2023,"Brentford","Premier League","Kristoffer Ajer","NOR","DF","24",1998,8.5,11,8,5,4,2,9,16,56.3,7,6,5,1,7,18,22,0,"https://fbref.com/en/players/a8c0acb7/Kristoffer-Ajer"
2023,"Brentford","Premier League","Shandon Baptiste","GRN","MF","24",1998,6.9,15,9,6,6,3,7,17,41.2,10,10,2,8,7,22,10,0,"https://fbref.com/en/players/2886c9b5/Shandon-Baptiste"
2023,"Brentford","Premier League","Mads Bech Sørensen","DEN","DF,MF","23",1999,0.2,0,0,0,0,0,0,0,NA,0,0,0,0,1,1,1,0,"https://fbref.com/en/players/30db8574/Mads-Bech-Sorensen"
2023,"Brentford","Premier League","Sergi Canós","ESP","FW,DF","25",1997,0.9,0,0,0,0,0,0,2,0,2,3,1,2,0,0,1,0,"https://fbref.com/en/players/1137759d/Sergi-Canos"
2023,"Brentford","Premier League","Mikkel Damsgaard","DEN","MF,FW","22",2000,11,31,21,13,13,5,15,42,35.7,27,20,2,18,10,41,14,0,"https://fbref.com/en/players/215f3907/Mikkel-Damsgaard"
2023,"Brentford","Premier League","Josh Dasilva","ENG","MF","23",1998,15.4,18,9,6,6,6,6,16,37.5,10,22,6,16,5,23,7,1,"https://fbref.com/en/players/60344e4f/Josh-Dasilva"
2023,"Brentford","Premier League","Halil Dervişoğlu","TUR","MF","22",1999,0.1,0,0,0,0,0,0,1,0,1,0,0,0,0,0,0,0,"https://fbref.com/en/players/9d8cf204/Halil-Dervisoglu"
2023,"Brentford","Premier League","Saman Ghoddos","IRN","MF,FW","28",1993,1.5,2,1,0,1,1,1,3,33.3,2,5,1,4,4,6,2,0,"https://fbref.com/en/players/f7b1d4e0/Saman-Ghoddos"
2023,"Brentford","Premier League","Rico Henry","ENG","DF","25",1997,36,57,31,20,28,9,22,41,53.7,19,29,8,21,30,87,84,1,"https://fbref.com/en/players/8a3c1dc7/Rico-Henry"
2023,"Brentford","Premier League","Aaron Hickey","SCO","DF","20",2002,21.3,38,26,27,11,0,18,32,56.3,14,18,7,11,17,55,32,1,"https://fbref.com/en/players/1780bb4a/Aaron-Hickey"
2023,"Brentford","Premier League","Vitaly Janelt","GER","MF,DF","24",1998,24.5,54,27,20,24,10,21,49,42.9,28,29,9,20,29,83,26,0,"https://fbref.com/en/players/8449d35e/Vitaly-Janelt"
2023,"Brentford","Premier League","Pontus Jansson","SWE","DF","31",1991,8,5,3,4,1,0,3,5,60,2,13,9,4,9,14,38,0,"https://fbref.com/en/players/172e52d8/Pontus-Jansson"
2023,"Brentford","Premier League","Mathias Jensen","DEN","MF","26",1996,31.1,70,35,28,30,12,34,97,35.1,63,54,5,49,32,102,24,1,"https://fbref.com/en/players/0f134faf/Mathias-Jensen"
2023,"Brentford","Premier League","Mathias Jørgensen","DEN","DF","32",1990,12.3,17,8,9,8,0,9,21,42.9,12,19,12,7,16,33,39,1,"https://fbref.com/en/players/0db5d2c8/Mathias-Jorgensen"
2023,"Brentford","Premier League","Keane Lewis-Potter","ENG","FW,MF","21",2001,3.6,1,0,0,1,0,0,0,NA,0,5,1,4,0,1,2,0,"https://fbref.com/en/players/41f08ac8/Keane-Lewis-Potter"
2023,"Brentford","Premier League","Bryan Mbeumo","CMR","FW","22",1999,32.3,26,18,5,13,8,8,42,19,34,24,1,23,13,39,21,0,"https://fbref.com/en/players/6afaebf2/Bryan-Mbeumo"
2023,"Brentford","Premier League","Ben Mee","ENG","DF","32",1989,36.3,45,24,28,13,4,20,37,54.1,17,54,42,12,48,93,122,1,"https://fbref.com/en/players/8df7a2fb/Ben-Mee"
2023,"Brentford","Premier League","Christian Nørgaard","DEN","MF","28",1994,19.6,52,30,21,29,2,18,48,37.5,30,32,9,23,34,86,41,2,"https://fbref.com/en/players/df0a4c90/Christian-Norgaard"
2023,"Brentford","Premier League","Frank Onyeka","NGA","MF","24",1998,9.4,19,14,11,7,1,10,25,40,15,16,3,13,10,29,16,0,"https://fbref.com/en/players/2944f86f/Frank-Onyeka"
2023,"Brentford","Premier League","Ethan Pinnock","JAM","DF","29",1993,30,52,28,33,12,7,18,24,75,6,41,31,10,35,87,215,2,"https://fbref.com/en/players/e541326e/Ethan-Pinnock"
2023,"Brentford","Premier League","David Raya","ESP","GK","26",1995,38,0,0,0,0,0,0,2,0,2,1,0,1,1,1,10,2,"https://fbref.com/en/players/98ea5115/David-Raya"
2023,"Brentford","Premier League","Mads Roerslev","DEN","DF","23",1999,12.3,22,12,19,3,0,16,33,48.5,17,14,5,9,9,31,38,0,"https://fbref.com/en/players/57c94db2/Mads-Roerslev"
2023,"Brentford","Premier League","Kevin Schade","GER","FW","20",2001,8.1,12,8,7,2,3,5,10,50,5,7,0,7,4,16,6,0,"https://fbref.com/en/players/52afb588/Kevin-Schade"
2023,"Brentford","Premier League","Ivan Toney","ENG","FW","26",1996,32.8,23,13,4,9,10,7,23,30.4,16,24,9,15,14,37,36,0,"https://fbref.com/en/players/e09f279b/Ivan-Toney"
2023,"Brentford","Premier League","Yoane Wissa","COD","FW","25",1996,17.8,17,12,4,7,6,6,13,46.2,7,10,0,10,6,23,15,0,"https://fbref.com/en/players/2500cef9/Yoane-Wissa"
2023,"Brest","Ligue 1","Taïryk Arconte","FRA","FW","18",2003,1.4,1,1,0,0,1,0,3,0,3,1,0,1,0,1,2,0,"https://fbref.com/en/players/c5e6c017/Tairyk-Arconte"
2023,"Brest","Ligue 1","Youcef Belaïli","ALG","FW,MF","30",1992,4,5,2,3,2,0,2,7,28.6,5,2,0,2,1,6,1,0,"https://fbref.com/en/players/1a248246/Youcef-Belaili"
2023,"Brest","Ligue 1","Haris Belkebla","ALG","MF","28",1994,29.5,80,48,35,40,5,44,85,51.8,41,32,6,26,52,132,21,3,"https://fbref.com/en/players/2b1bed19/Haris-Belkebla"
2023,"Brest","Ligue 1","Marco Bizot","NED","GK","31",1991,37,0,0,0,0,0,0,1,0,1,1,0,1,0,0,24,4,"https://fbref.com/en/players/3d214e5f/Marco-Bizot"
2023,"Brest","Ligue 1","Joaquín Blázquez","ARG","GK","21",2001,1,0,0,0,0,0,0,0,NA,0,0,0,0,0,0,2,0,"https://fbref.com/en/players/6a9e4913/Joaquin-Blazquez"
2023,"Brest","Ligue 1","Lilian Brassier","FRA","DF","22",1999,34.4,42,30,31,8,3,23,32,71.9,9,42,19,23,53,95,132,1,"https://fbref.com/en/players/5b146df3/Lilian-Brassier"
2023,"Brest","Ligue 1","Mahdi Camara","FRA","MF","24",1998,20.2,63,36,18,38,7,25,43,58.1,18,35,4,31,40,103,16,0,"https://fbref.com/en/players/8577e60a/Mahdi-Camara"
2023,"Brest","Ligue 1","Axel Camblan","FRA","FW,MF","18",2003,0.8,2,2,1,1,0,0,1,0,1,0,0,0,0,2,0,0,"https://fbref.com/en/players/9f4a940f/Axel-Camblan"
2023,"Brest","Ligue 1","Irvin Cardona","FRA","FW,MF","24",1997,2.6,2,0,1,1,0,0,3,0,3,3,0,3,2,4,2,0,"https://fbref.com/en/players/5e080f73/Irvin-Cardona"
2023,"Brest","Ligue 1","Brendan Chardonnet","FRA","DF","27",1994,27.7,45,27,27,18,0,20,38,52.6,18,40,19,21,63,108,86,1,"https://fbref.com/en/players/16aa7d4c/Brendan-Chardonnet"
2023,"Brest","Ligue 1","Achraf Dari","MAR","DF","23",1999,14.6,21,14,15,5,1,14,20,70,6,16,10,6,19,40,65,2,"https://fbref.com/en/players/5069b796/Achraf-Dari"
2023,"Brest","Ligue 1","Romain Del Castillo","FRA","MF,FW","26",1996,15.8,39,24,13,17,9,16,36,44.4,20,14,1,13,11,50,5,0,"https://fbref.com/en/players/0be95d34/Romain-Del-Castillo"
2023,"Brest","Ligue 1","Karamoko Dembele","SCO","FW,MF","19",2003,2,2,0,1,1,0,2,2,100,0,1,0,1,1,3,0,0,"https://fbref.com/en/players/7304f3b1/Karamoko-Dembele"
2023,"Brest","Ligue 1","Jean-Kevin Duverne","FRA","DF","25",1997,27.9,72,38,44,24,4,42,73,57.5,31,33,5,28,28,100,65,1,"https://fbref.com/en/players/0cbc8baa/Jean-Kevin-Duverne"
2023,"Brest","Ligue 1","Alberth Elis","HON","MF,FW","26",1996,2.9,4,3,1,2,1,1,7,14.3,6,1,0,1,1,5,2,0,"https://fbref.com/en/players/104b4ad3/Alberth-Elis"
2023,"Brest","Ligue 1","Noah Fadiga","SEN","DF","22",1999,14.5,30,21,18,9,3,14,26,53.8,12,17,7,10,26,56,18,0,"https://fbref.com/en/players/83f03b07/Noah-Fadiga"
2023,"Brest","Ligue 1","Christophe Hérelle","MTQ","DF","29",1992,11.8,10,4,7,2,1,4,13,30.8,9,16,11,5,20,30,48,0,"https://fbref.com/en/players/3681cfff/Christophe-Herelle"
2023,"Brest","Ligue 1","Franck Honorat","FRA","FW,MF","25",1996,28.2,41,29,20,8,13,19,34,55.9,15,22,2,20,21,62,18,0,"https://fbref.com/en/players/db7849ca/Franck-Honorat"
2023,"Brest","Ligue 1","Kenny Lala","FRA","DF","30",1991,15.7,36,19,19,15,2,22,38,57.9,16,15,5,10,21,57,28,0,"https://fbref.com/en/players/770d7eb8/Kenny-Lala"
2023,"Brest","Ligue 1","Jérémy Le Douaron","FRA","MF,FW","24",1998,23,15,9,5,9,1,3,27,11.1,24,29,2,27,11,26,30,0,"https://fbref.com/en/players/88c4d190/Jeremy-Le-Douaron"
2023,"Brest","Ligue 1","Pierre Lees-Melou","FRA","MF","29",1993,30.7,97,55,55,37,5,57,123,46.3,66,48,13,35,52,149,46,1,"https://fbref.com/en/players/f5044e54/Pierre-Lees-Melou"
2023,"Brest","Ligue 1","Félix Lemaréchal","CIV","MF","18",2003,3.2,5,5,2,1,2,0,3,0,3,6,0,6,1,6,2,0,"https://fbref.com/en/players/8ca9415f/Felix-Lemarechal"
2023,"Brest","Ligue 1","Bradley Locko","FRA","DF","20",2002,3,4,3,2,1,1,2,3,66.7,1,4,0,4,2,6,13,0,"https://fbref.com/en/players/40221fa7/Bradley-Locko"
2023,"Brest","Ligue 1","Hugo Magnetti","FRA","MF","24",1998,18.8,43,27,18,23,2,23,63,36.5,40,21,1,20,25,68,12,0,"https://fbref.com/en/players/d4d35152/Hugo-Magnetti"
2023,"Brest","Ligue 1","Hianga Mananga Mbock","FRA","MF","22",1999,0.2,0,0,0,0,0,0,1,0,1,0,0,0,0,0,0,0,"https://fbref.com/en/players/0f86995c/Hianga-Mananga-Mbock"
2023,"Brest","Ligue 1","Steve Mounié","BEN","FW","27",1994,18.4,13,5,1,7,5,5,14,35.7,9,18,7,11,3,16,20,0,"https://fbref.com/en/players/19ba6c6d/Steve-Mounie"
2023,"Brest","Ligue 1","Mathias Pereira Lage","POR","MF,FW","25",1996,14,20,7,5,14,1,11,29,37.9,18,10,1,9,14,34,12,0,"https://fbref.com/en/players/8846a40f/Mathias-Pereira-Lage"
2023,"Brest","Ligue 1","Islam Slimani","ALG","FW","34",1988,11,5,3,2,2,1,0,3,0,3,2,0,2,1,6,11,0,"https://fbref.com/en/players/ffec9769/Islam-Slimani"
2023,"Brest","Ligue 1","Jere Uronen","FIN","DF","28",1994,3.3,8,5,4,4,0,7,12,58.3,5,6,2,4,7,15,5,0,"https://fbref.com/en/players/d75f3980/Jere-Uronen"
2023,"Brighton","Premier League","Yasin Ayari","SWE","MF","18",2003,0.7,2,2,1,1,0,0,4,0,4,1,0,1,0,2,0,0,"https://fbref.com/en/players/f173303a/Yasin-Ayari"
2023,"Brighton","Premier League","Facundo Buonanotte","ARG","FW,MF","17",2004,6.3,2,1,1,1,0,1,22,4.5,21,5,2,3,4,6,3,0,"https://fbref.com/en/players/468a7a91/Facundo-Buonanotte"
2023,"Brighton","Premier League","Moisés Caicedo","ECU","MF","20",2001,34.9,100,50,41,47,12,40,68,58.8,28,43,7,36,56,156,31,3,"https://fbref.com/en/players/16264a81/Moises-Caicedo"
2023,"Brighton","Premier League","Julio César Enciso","PAR","FW,MF","18",2004,9,13,4,3,6,4,8,13,61.5,5,9,0,9,4,17,2,0,"https://fbref.com/en/players/9cfbad36/Julio-Cesar-Enciso"
2023,"Brighton","Premier League","Levi Colwill","ENG","DF","19",2003,13.6,8,7,4,4,0,4,9,44.4,5,5,3,2,15,23,37,1,"https://fbref.com/en/players/700783e7/Levi-Colwill"
2023,"Brighton","Premier League","Lewis Dunk","ENG","DF","30",1991,36,30,19,19,9,2,18,41,43.9,23,37,27,10,34,64,81,1,"https://fbref.com/en/players/282f75f3/Lewis-Dunk"
2023,"Brighton","Premier League","Pervis Estupiñán","ECU","DF","24",1998,29.7,61,31,36,19,6,35,60,58.3,25,30,8,22,37,98,37,1,"https://fbref.com/en/players/d38fdf53/Pervis-Estupinan"
2023,"Brighton","Premier League","Evan Ferguson","IRL","FW","17",2004,10.6,6,3,1,3,2,1,7,14.3,6,11,1,10,2,8,6,0,"https://fbref.com/en/players/4596da74/Evan-Ferguson"
2023,"Brighton","Premier League","Billy Gilmour","SCO","MF","21",2001,5.6,5,2,2,2,1,2,8,25,6,5,2,3,6,11,5,0,"https://fbref.com/en/players/df10e27c/Billy-Gilmour"
2023,"Brighton","Premier League","Pascal Groß","GER","MF,DF","31",1991,36,59,38,23,27,9,25,55,45.5,30,32,10,22,13,72,21,1,"https://fbref.com/en/players/8aec0537/Pascal-Gross"
2023,"Brighton","Premier League","Jan Paul van Hecke","NED","DF","22",2000,3.3,8,6,3,4,1,5,5,100,0,8,5,3,6,14,9,0,"https://fbref.com/en/players/4fd08daa/Jan-Paul-van-Hecke"
2023,"Brighton","Premier League","Jack Hinshelwood","ENG","FW","17",2005,0,1,0,1,0,0,0,0,NA,0,0,0,0,0,1,0,0,"https://fbref.com/en/players/e98211e7/Jack-Hinshelwood"
2023,"Brighton","Premier League","Adam Lallana","ENG","MF,FW","34",1988,8,9,4,6,2,1,0,7,0,7,6,0,6,2,11,1,0,"https://fbref.com/en/players/99813635/Adam-Lallana"
2023,"Brighton","Premier League","Tariq Lamptey","GHA","DF","21",2000,5,11,6,6,4,1,5,7,71.4,2,7,3,4,7,18,2,0,"https://fbref.com/en/players/f4e433d4/Tariq-Lamptey"
2023,"Brighton","Premier League","Alexis Mac Allister","ARG","MF","23",1998,32.1,70,39,22,40,8,34,70,48.6,36,26,2,24,22,92,10,1,"https://fbref.com/en/players/83d074ff/Alexis-Mac-Allister"
2023,"Brighton","Premier League","Solly March","ENG","FW,DF","28",1994,30.2,53,31,16,17,20,8,28,28.6,20,34,3,31,24,77,32,0,"https://fbref.com/en/players/bb5fbd2b/Solly-March"
2023,"Brighton","Premier League","Kaoru Mitoma","JPN","FW,MF","25",1997,25.8,44,27,15,16,13,20,41,48.8,21,25,0,25,17,61,10,0,"https://fbref.com/en/players/74618572/Kaoru-Mitoma"
2023,"Brighton","Premier League","Andrew Moran","IRL","FW","18",2003,0.1,0,0,0,0,0,0,0,NA,0,1,0,1,0,0,0,0,"https://fbref.com/en/players/c4720845/Andrew-Moran"
2023,"Brighton","Premier League","Enock Mwepu","ZAM","FW,MF","24",1998,2.4,10,5,1,6,3,3,4,75,1,3,1,2,1,11,1,0,"https://fbref.com/en/players/1d5cab82/Enock-Mwepu"
2023,"Brighton","Premier League","Odeluga Offiah","ENG","DF","19",2002,0.3,1,1,1,0,0,0,2,0,2,0,0,0,0,1,1,0,"https://fbref.com/en/players/65c3efa2/Odeluga-Offiah"
2023,"Brighton","Premier League","Cameron Peupion","AUS","MF","19",2002,0.1,0,0,0,0,0,0,0,NA,0,0,0,0,0,0,0,0,"https://fbref.com/en/players/0bdeb013/Cameron-Peupion"
2023,"Brighton","Premier League","Robert Sanchez","ESP","GK","24",1997,23,NA,0,NA,NA,NA,NA,NA,NA,NA,NA,NA,NA,3,NA,NA,NA,"https://fbref.com/en/players/cce694d4/Robert-Sanchez"
2023,"Brighton","Premier League","Jeremy Sarmiento","ECU","MF","20",2002,2,6,3,4,1,1,2,5,40,3,2,0,2,1,7,0,0,"https://fbref.com/en/players/ac0d576d/Jeremy-Sarmiento"
2023,"Brighton","Premier League","Jason Steele","ENG","GK","31",1990,15,0,0,0,0,0,0,1,0,1,0,0,0,0,0,6,1,"https://fbref.com/en/players/28300a16/Jason-Steele"
2023,"Brighton","Premier League","Leandro Trossard","BEL","FW,MF","27",1994,14.6,10,6,7,1,2,1,8,12.5,7,17,0,17,6,16,1,0,"https://fbref.com/en/players/38ceb24a/Leandro-Trossard"
2023,"Brighton","Premier League","Deniz Undav","GER","FW,MF","26",1996,7,7,4,2,2,3,2,8,25,6,4,1,3,0,7,1,0,"https://fbref.com/en/players/dd549382/Deniz-Undav"
2023,"Brighton","Premier League","Joël Veltman","NED","DF","30",1992,24.3,62,32,44,14,4,37,57,64.9,20,27,8,19,19,81,51,0,"https://fbref.com/en/players/dad4b285/Joel-Veltman"
2023,"Brighton","Premier League","Adam Webster","ENG","DF","27",1995,22.1,22,12,10,9,3,11,19,57.9,8,30,19,11,19,41,55,4,"https://fbref.com/en/players/c40b6180/Adam-Webster"
2023,"Brighton","Premier League","Danny Welbeck","ENG","FW","31",1990,20.6,15,7,0,7,8,4,11,36.4,7,24,2,22,5,20,20,0,"https://fbref.com/en/players/ce5143da/Danny-Welbeck"
2023,"Celta Vigo","La Liga","Joseph Aidoo","GHA","DF","26",1995,34.7,51,36,33,17,1,16,28,57.1,12,26,14,12,31,82,150,0,"https://fbref.com/en/players/18abe173/Joseph-Aidoo"
2023,"Celta Vigo","La Liga","Iago Aspas","ESP","FW","34",1987,31.9,8,4,0,4,4,3,22,13.6,19,10,1,9,7,15,23,0,"https://fbref.com/en/players/7dcf86f6/Iago-Aspas"
2023,"Celta Vigo","La Liga","Fran Beltrán","ESP","MF","23",1999,31.7,34,22,15,14,5,14,55,25.5,41,29,5,24,53,87,35,2,"https://fbref.com/en/players/ed5c5fa3/Fran-Beltran"
2023,"Celta Vigo","La Liga","Franco Cervi","ARG","MF,DF","28",1994,21,76,46,29,36,11,33,66,50,33,33,1,32,36,112,16,0,"https://fbref.com/en/players/5e1028e5/Franco-Cervi"
2023,"Celta Vigo","La Liga","Carlos Dominguez","ESP","DF","21",2001,1.2,1,1,0,1,0,1,2,50,1,1,1,0,0,1,7,0,"https://fbref.com/en/players/3521abfe/Carlos-Dominguez"
2023,"Celta Vigo","La Liga","Pablo Durán","ESP","MF,DF","21",2001,0.4,0,0,0,0,0,0,0,NA,0,2,1,1,1,1,2,0,"https://fbref.com/en/players/6db116ec/Pablo-Duran"
2023,"Celta Vigo","La Liga","Javi Galán","ESP","DF","27",1994,35.1,104,72,60,40,4,48,98,49,50,54,5,49,41,145,63,1,"https://fbref.com/en/players/a4b00319/Javi-Galan"
2023,"Celta Vigo","La Liga","Luca de la Torre","USA","MF","24",1998,16.5,28,19,11,14,3,12,32,37.5,20,22,1,21,9,37,6,0,"https://fbref.com/en/players/e9241b40/Luca-de-la-Torre"
2023,"Celta Vigo","La Liga","Hugo Mallo","ESP","DF","31",1991,24,53,29,34,14,5,28,42,66.7,14,28,7,21,24,77,73,0,"https://fbref.com/en/players/cb574619/Hugo-Mallo"
2023,"Celta Vigo","La Liga","Agustín Marchesín","ARG","GK","34",1988,19,0,0,0,0,0,0,1,0,1,0,0,0,0,0,7,0,"https://fbref.com/en/players/853b7c48/Agustin-Marchesin"
2023,"Celta Vigo","La Liga","Fernando Medrano","ESP","DF","22",2000,0.1,2,1,2,0,0,1,1,100,0,0,0,0,1,3,1,0,"https://fbref.com/en/players/d854c9d0/Fernando-Medrano"
2023,"Celta Vigo","La Liga","Óscar Mingueza","ESP","DF","23",1999,14.3,37,21,27,9,1,25,32,78.1,7,10,4,6,12,49,25,0,"https://fbref.com/en/players/056269d7/Oscar-Mingueza"
2023,"Celta Vigo","La Liga","Unai Núñez","ESP","DF","25",1997,35,47,35,29,15,3,18,34,52.9,16,27,17,10,72,119,135,1,"https://fbref.com/en/players/be170419/Unai-Nunez"
2023,"Celta Vigo","La Liga","Gonçalo Paciência","POR","FW,MF","27",1994,7.4,8,5,0,5,3,2,7,28.6,5,9,1,8,0,8,4,0,"https://fbref.com/en/players/962e54cb/Goncalo-Paciencia"
2023,"Celta Vigo","La Liga","Carles Pérez","ESP","MF,FW","24",1998,23.8,39,23,12,17,10,22,66,33.3,44,29,3,26,6,45,9,0,"https://fbref.com/en/players/a8f21b9f/Carles-Perez"
2023,"Celta Vigo","La Liga","Óscar Rodríguez Arnaiz","ESP","MF","24",1998,19.7,32,25,12,15,5,13,28,46.4,15,16,2,14,24,56,15,0,"https://fbref.com/en/players/19709006/Oscar-Rodriguez-Arnaiz"
2023,"Celta Vigo","La Liga","Miguel Rodríguez","ESP","MF,FW","19",2003,2.8,7,5,4,3,0,4,11,36.4,7,6,0,6,1,8,3,0,"https://fbref.com/en/players/958d67bb/Miguel-Rodriguez"
2023,"Celta Vigo","La Liga","Haris Seferović","SUI","FW","30",1992,9.9,6,3,1,4,1,3,8,37.5,5,7,1,6,1,7,6,1,"https://fbref.com/en/players/a45eac1f/Haris-Seferovic"
2023,"Celta Vigo","La Liga","Augusto Solari","ARG","MF","30",1992,2.9,10,6,6,3,1,3,11,27.3,8,5,0,5,4,14,3,0,"https://fbref.com/en/players/3ca6106c/Augusto-Solari"
2023,"Celta Vigo","La Liga","Hugo Sotelo","ESP","MF","18",2003,0.2,0,0,0,0,0,0,0,NA,0,0,0,0,0,0,0,0,"https://fbref.com/en/players/3aa74860/Hugo-Sotelo"
2023,"Celta Vigo","La Liga","Jørgen Strand Larsen","NOR","FW","22",2000,18.9,15,7,3,5,7,7,30,23.3,23,14,5,9,3,18,24,0,"https://fbref.com/en/players/f553b2b3/Jorgen-Strand-Larsen"
2023,"Celta Vigo","La Liga","Williot Swedberg","SWE","MF","18",2004,0.6,3,1,1,0,2,0,0,NA,0,2,0,2,0,3,1,0,"https://fbref.com/en/players/184fe4b2/Williot-Swedberg"
2023,"Celta Vigo","La Liga","Renato Tapia","PER","MF,DF","27",1995,16.1,47,25,21,21,5,18,37,48.6,19,29,11,18,19,66,37,0,"https://fbref.com/en/players/34269bdf/Renato-Tapia"
2023,"Celta Vigo","La Liga","Kevin Vázquez","ESP","DF,MF","29",1993,4.9,13,8,5,7,1,8,12,66.7,4,4,1,3,2,15,8,0,"https://fbref.com/en/players/ee923664/Kevin-Vazquez"
2023,"Celta Vigo","La Liga","Gabriel Veiga","ESP","MF","20",2002,25.5,43,19,14,25,4,16,52,30.8,36,30,3,27,21,64,6,0,"https://fbref.com/en/players/35a6e5c7/Gabriel-Veiga"
2023,"Celta Vigo","La Liga","Iván Villar","ESP","GK","25",1997,19,0,0,0,0,0,0,1,0,1,0,0,0,0,0,7,0,"https://fbref.com/en/players/cde52ef5/Ivan-Villar"
2023,"Chelsea","Premier League","Kepa Arrizabalaga","ESP","GK","27",1994,28.5,2,2,2,0,0,2,3,66.7,1,0,0,0,1,3,16,2,"https://fbref.com/en/players/28d596a0/Kepa-Arrizabalaga"
2023,"Chelsea","Premier League","Pierre-Emerick Aubameyang","GAB","FW","33",1989,6.2,1,0,1,0,0,0,1,0,1,2,0,2,2,3,4,2,"https://fbref.com/en/players/d5dd5f1f/Pierre-Emerick-Aubameyang"
2023,"Chelsea","Premier League","César Azpilicueta","ESP","DF","32",1989,17,43,25,23,15,5,22,37,59.5,15,26,5,21,19,62,54,1,"https://fbref.com/en/players/53cad200/Cesar-Azpilicueta"
2023,"Chelsea","Premier League","Benoît Badiashile","FRA","DF","21",2001,10.1,14,8,10,4,0,9,14,64.3,5,5,2,3,16,30,34,1,"https://fbref.com/en/players/06df8256/Benoit-Badiashile"
2023,"Chelsea","Premier League","Armando Broja","ALB","FW","20",2001,3.3,4,1,0,3,1,1,1,100,0,10,1,9,1,5,1,0,"https://fbref.com/en/players/97220da2/Armando-Broja"
2023,"Chelsea","Premier League","Trevoh Chalobah","ENG","DF","23",1999,17.9,31,20,22,6,3,24,34,70.6,10,17,7,10,24,55,56,1,"https://fbref.com/en/players/5515376c/Trevoh-Chalobah"
2023,"Chelsea","Premier League","Ben Chilwell","ENG","DF,MF","25",1996,15.6,21,17,12,8,1,13,25,52,12,21,2,19,18,39,26,0,"https://fbref.com/en/players/d2424d1b/Ben-Chilwell"
2023,"Chelsea","Premier League","Carney Chukwuemeka","ENG","MF,FW","18",2003,3.9,13,7,7,6,0,3,5,60,2,7,0,7,6,19,1,0,"https://fbref.com/en/players/b2f9c73e/Carney-Chukwuemeka"
2023,"Chelsea","Premier League","Marc Cucurella","ESP","DF","24",1998,18.6,66,33,40,15,11,30,60,50,30,28,8,20,16,82,48,1,"https://fbref.com/en/players/1daec722/Marc-Cucurella"
2023,"Chelsea","Premier League","David Datro Fofana","CIV","FW","19",2002,0.8,3,1,1,1,1,1,1,100,0,1,0,1,0,3,0,0,"https://fbref.com/en/players/e82900ef/David-Datro-Fofana"
2023,"Chelsea","Premier League","João Félix","POR","FW,MF","22",1999,10.5,14,7,5,6,3,4,12,33.3,8,3,0,3,1,15,1,1,"https://fbref.com/en/players/8aafd64f/Joao-Felix"
2023,"Chelsea","Premier League","Enzo Fernández","ARG","MF","21",2001,17.2,45,27,25,17,3,21,56,37.5,35,32,2,30,16,61,12,1,"https://fbref.com/en/players/5ff4ab71/Enzo-Fernandez"
2023,"Chelsea","Premier League","Wesley Fofana","FRA","DF","21",2000,13.1,30,18,19,7,4,13,26,50,13,17,10,7,20,50,33,2,"https://fbref.com/en/players/132a82f1/Wesley-Fofana"
2023,"Chelsea","Premier League","Conor Gallagher","ENG","MF","22",2000,18,46,33,17,19,10,10,37,27,27,41,10,31,23,69,18,1,"https://fbref.com/en/players/c2731c10/Conor-Gallagher"
2023,"Chelsea","Premier League","Lewis Hall","ENG","DF","17",2004,7.3,23,12,19,4,0,15,22,68.2,7,8,0,8,11,34,11,1,"https://fbref.com/en/players/da011f18/Lewis-Hall"
2023,"Chelsea","Premier League","Kai Havertz","GER","FW,MF","23",1999,28.5,34,16,4,20,10,10,30,33.3,20,28,0,28,7,41,41,0,"https://fbref.com/en/players/fed7cb61/Kai-Havertz"
2023,"Chelsea","Premier League","Omari Hutchinson","ENG","FW","18",2003,0.3,0,0,0,0,0,0,0,NA,0,0,0,0,1,1,0,0,"https://fbref.com/en/players/bd9553e6/Omari-Hutchinson"
2023,"Chelsea","Premier League","Reece James","ENG","DF,MF","22",1999,13.8,31,20,10,18,3,15,19,78.9,4,17,2,15,12,43,23,0,"https://fbref.com/en/players/1265a93a/Reece-James"
2023,"Chelsea","Premier League","Jorginho","ITA","MF","30",1991,14.2,42,23,22,14,6,22,46,47.8,24,18,3,15,21,63,7,0,"https://fbref.com/en/players/45db685d/Jorginho"
2023,"Chelsea","Premier League","N'Golo Kanté","FRA","MF","31",1991,5.8,16,10,4,10,2,4,8,50,4,11,0,11,6,22,2,0,"https://fbref.com/en/players/b9fbae28/NGolo-Kante"
2023,"Chelsea","Premier League","Kalidou Koulibaly","SEN","DF","31",1991,20,45,31,34,8,3,26,40,65,14,30,13,17,29,74,77,0,"https://fbref.com/en/players/da974c7b/Kalidou-Koulibaly"
2023,"Chelsea","Premier League","Mateo Kovačić","CRO","MF","28",1994,19,36,24,16,14,6,14,36,38.9,22,10,1,9,19,55,16,0,"https://fbref.com/en/players/79c0821a/Mateo-Kovacic"
2023,"Chelsea","Premier League","Ruben Loftus-Cheek","ENG","MF,DF","26",1996,17.1,25,14,8,14,3,12,21,57.1,9,15,2,13,12,37,23,0,"https://fbref.com/en/players/e97fd090/Ruben-Loftus-Cheek"
2023,"Chelsea","Premier League","Noni Madueke","ENG","FW","20",2002,7.1,12,8,5,4,3,6,13,46.2,7,13,2,11,4,16,7,0,"https://fbref.com/en/players/bf34eebd/Noni-Madueke"
2023,"Chelsea","Premier League","Edouard Mendy","SEN","GK","30",1992,9.5,0,0,0,0,0,0,0,NA,0,0,0,0,0,0,3,3,"https://fbref.com/en/players/33887998/Edouard-Mendy"
2023,"Chelsea","Premier League","Mason Mount","ENG","MF,FW","23",1999,18.3,33,19,6,16,11,14,27,51.9,13,24,6,18,8,41,9,0,"https://fbref.com/en/players/9674002f/Mason-Mount"
2023,"Chelsea","Premier League","Mykhailo Mudryk","UKR","FW,MF","21",2001,7.3,11,9,2,4,5,4,13,30.8,9,7,1,6,0,11,3,0,"https://fbref.com/en/players/049a888d/Mykhailo-Mudryk"
2023,"Chelsea","Premier League","Christian Pulisic","USA","FW,DF","23",1998,9.1,11,6,3,6,2,3,5,60,2,8,1,7,4,15,4,0,"https://fbref.com/en/players/1bf33a9a/Christian-Pulisic"
2023,"Chelsea","Premier League","Thiago Silva","BRA","DF","37",1984,26.1,41,27,24,17,0,21,31,67.7,10,38,29,9,34,75,111,2,"https://fbref.com/en/players/86e7deaf/Thiago-Silva"
2023,"Chelsea","Premier League","Raheem Sterling","ENG","FW,MF","27",1994,21,18,10,5,4,9,8,14,57.1,6,17,0,17,2,20,5,0,"https://fbref.com/en/players/b400bde0/Raheem-Sterling"
2023,"Chelsea","Premier League","Denis Zakaria","SUI","MF","25",1996,4.6,9,5,5,2,2,2,8,25,6,4,1,3,3,12,10,0,"https://fbref.com/en/players/384d58d9/Denis-Zakaria"
2023,"Chelsea","Premier League","Hakim Ziyech","MAR","FW,MF","29",1993,7.3,20,12,12,5,3,4,9,44.4,5,8,0,8,5,25,5,1,"https://fbref.com/en/players/6622454d/Hakim-Ziyech"
2023,"Clermont Foot","Ligue 1","Jim Allevinah","GAB","DF,FW","27",1995,24.9,39,24,24,11,4,19,62,30.6,43,24,2,22,24,63,26,1,"https://fbref.com/en/players/1956b948/Jim-Allevinah"
2023,"Clermont Foot","Ligue 1","Komnen Andrić","SRB","FW","27",1995,16.1,13,5,2,7,4,2,15,13.3,13,8,1,7,8,21,13,0,"https://fbref.com/en/players/af3ddb2e/Komnen-Andric"
2023,"Clermont Foot","Ligue 1","Brandon Baiye","BEL","MF","21",2000,0.6,3,2,2,1,0,2,3,66.7,1,1,0,1,1,4,3,0,"https://fbref.com/en/players/7e3e825e/Brandon-Baiye"
2023,"Clermont Foot","Ligue 1","Jérémie Bela","ANG","DF,MF","29",1993,8.3,6,4,2,1,3,3,4,75,1,10,1,9,9,15,8,0,"https://fbref.com/en/players/5680bf3f/Jeremie-Bela"
2023,"Clermont Foot","Ligue 1","Jason Berthomier","FRA","MF","32",1990,0.3,0,0,0,0,0,0,0,NA,0,0,0,0,0,0,0,0,"https://fbref.com/en/players/03e91055/Jason-Berthomier"
2023,"Clermont Foot","Ligue 1","Jean-Claude Billong","CMR","MF","28",1993,0.3,0,0,0,0,0,0,0,NA,0,1,1,0,1,1,0,0,"https://fbref.com/en/players/a3e1d20d/Jean-Claude-Billong"
2023,"Clermont Foot","Ligue 1","Neto Borges","BRA","DF","25",1996,31.5,75,45,45,20,10,46,75,61.3,29,45,11,34,41,116,62,1,"https://fbref.com/en/players/9f936061/Neto-Borges"
2023,"Clermont Foot","Ligue 1","Maximiliano Caufriez","BEL","DF","25",1997,24.7,40,24,31,8,1,20,28,71.4,8,33,18,15,34,74,70,0,"https://fbref.com/en/players/c92c24f0/Maximiliano-Caufriez"
2023,"Clermont Foot","Ligue 1","Souleymane Cissé","FRA","DF","19",2002,0.4,1,1,1,0,0,1,1,100,0,1,1,0,1,2,2,0,"https://fbref.com/en/players/ff4d0258/Souleymane-Cisse"
2023,"Clermont Foot","Ligue 1","Baila Diallo","FRA","DF,MF","21",2001,1,1,0,1,0,0,0,0,NA,0,1,1,0,0,1,1,0,"https://fbref.com/en/players/fb55f63a/Baila-Diallo"
2023,"Clermont Foot","Ligue 1","Mory Diaw","SEN","GK","29",1993,37,0,0,0,0,0,0,4,0,4,0,0,0,2,2,13,5,"https://fbref.com/en/players/f41a69e6/Mory-Diaw"
2023,"Clermont Foot","Ligue 1","Ouparine Djoco","SEN","GK","24",1998,1,0,0,0,0,0,0,0,NA,0,0,0,0,0,0,1,0,"https://fbref.com/en/players/62124972/Ouparine-Djoco"
2023,"Clermont Foot","Ligue 1","Jodel Dossou","BEN","MF,DF","30",1992,2.9,7,4,3,2,2,4,4,100,0,2,1,1,1,8,0,0,"https://fbref.com/en/players/a1dbfcb1/Jodel-Dossou"
2023,"Clermont Foot","Ligue 1","Johan Gastien","FRA","MF","34",1988,28.9,62,34,30,23,9,38,111,34.2,73,37,7,30,36,98,25,1,"https://fbref.com/en/players/868eaba0/Johan-Gastien"
2023,"Clermont Foot","Ligue 1","Maxime Gonalons","FRA","MF","33",1989,16.1,52,32,25,21,6,25,53,47.2,28,21,1,20,20,72,7,1,"https://fbref.com/en/players/b8c1de25/Maxime-Gonalons"
2023,"Clermont Foot","Ligue 1","Saîf-Eddine Khaoui","TUN","MF","27",1995,22.5,47,28,14,25,8,15,47,31.9,32,17,2,15,33,80,8,0,"https://fbref.com/en/players/796b1c41/Saif-Eddine-Khaoui"
2023,"Clermont Foot","Ligue 1","Cheick Konaté","CIV","DF","18",2004,6.4,19,12,10,7,2,13,22,59.1,9,7,1,6,13,32,8,1,"https://fbref.com/en/players/1361e5bc/Cheick-Konate"
2023,"Clermont Foot","Ligue 1","Grejohn Kyei","FRA","FW","26",1995,24.8,16,7,2,9,5,4,13,30.8,9,14,3,11,6,22,22,0,"https://fbref.com/en/players/397ba086/Grejohn-Kyei"
2023,"Clermont Foot","Ligue 1","Yohann Magnin","FRA","MF","25",1997,26.7,89,54,37,45,7,54,106,50.9,52,50,12,38,25,114,46,0,"https://fbref.com/en/players/caa7aaea/Yohann-Magnin"
2023,"Clermont Foot","Ligue 1","Yanis Massolin","FRA","MF","19",2002,0.7,2,1,1,0,1,0,1,0,1,1,0,1,2,4,0,0,"https://fbref.com/en/players/6ea05ca7/Yanis-Massolin"
2023,"Clermont Foot","Ligue 1","Aïman Maurer","MAR","MF","17",2004,5.6,2,1,1,1,0,1,10,10,9,1,0,1,3,5,5,0,"https://fbref.com/en/players/87d31635/Aiman-Maurer"
2023,"Clermont Foot","Ligue 1","Arial Mendy","SEN","DF","27",1994,2.5,4,2,3,0,1,2,2,100,0,2,0,2,4,8,4,0,"https://fbref.com/en/players/9f0f4b49/Arial-Mendy"
2023,"Clermont Foot","Ligue 1","Florent Ogier","FRA","DF","33",1989,18.9,33,16,20,12,1,22,39,56.4,17,22,13,9,18,51,64,1,"https://fbref.com/en/players/6993927b/Florent-Ogier"
2023,"Clermont Foot","Ligue 1","Elba Rashani","KVX","MF,FW","29",1993,24,39,26,13,19,7,13,39,33.3,26,27,2,25,21,60,19,0,"https://fbref.com/en/players/25749008/Elba-Rashani"
2023,"Clermont Foot","Ligue 1","Muhammed Saracevic Cham","AUT","MF","21",2000,21.9,30,15,15,4,11,13,35,37.1,22,13,0,13,7,37,5,0,"https://fbref.com/en/players/f527a32c/Muhammed-Saracevic-Cham"
2023,"Clermont Foot","Ligue 1","Alidu Seidu","GHA","DF","22",2000,27.3,52,31,35,14,3,31,51,60.8,20,28,14,14,52,104,50,2,"https://fbref.com/en/players/cea59f02/Alidu-Seidu"
2023,"Clermont Foot","Ligue 1","Mateusz Wieteska","POL","DF","25",1997,34.6,41,23,28,13,0,19,33,57.6,14,44,28,16,56,97,97,4,"https://fbref.com/en/players/3ecc8c5f/Mateusz-Wieteska"
2023,"Clermont Foot","Ligue 1","Mehdi Zeffane","ALG","DF,MF","30",1992,7.3,12,7,5,7,0,4,21,19,17,14,6,8,22,34,12,0,"https://fbref.com/en/players/c8c02ac7/Mehdi-Zeffane"
2023,"Cremonese","Serie A","Christian Acella","ITA","MF","20",2002,0.2,1,0,1,0,0,0,2,0,2,0,0,0,0,1,0,0,"https://fbref.com/en/players/771a2cfe/Christian-Acella"
2023,"Cremonese","Serie A","Felix Afena-Gyan","GHA","FW,MF","19",2003,9.1,7,3,4,1,2,2,10,20,8,5,1,4,1,8,6,0,"https://fbref.com/en/players/0154d290/Felix-Afena-Gyan"
2023,"Cremonese","Serie A","Emanuel Aiwum","AUT","DF","21",2000,18.4,55,34,36,17,2,33,47,70.2,14,28,16,12,25,80,52,3,"https://fbref.com/en/players/d810c13b/Emanuel-Aiwum"
2023,"Cremonese","Serie A","Santiago Ascacíbar","ARG","MF","25",1997,8.1,29,14,17,10,2,14,35,40,21,14,2,12,13,42,11,0,"https://fbref.com/en/players/e26fcca3/Santiago-Ascacibar"
2023,"Cremonese","Serie A","Jaime Báez","URU","DF","27",1995,1.1,4,2,3,0,1,3,6,50,3,0,0,0,0,4,2,1,"https://fbref.com/en/players/dfd24c07/Jaime-Baez"
2023,"Cremonese","Serie A","Alberto Basso","ITA","MF","18",2004,0.2,0,0,0,0,0,0,0,NA,0,0,0,0,0,0,0,0,"https://fbref.com/en/players/2ce215f2/Alberto-Basso"
2023,"Cremonese","Serie A","Marco Benassi","ITA","MF","27",1994,11.1,26,15,9,11,6,15,24,62.5,9,13,1,12,12,38,19,0,"https://fbref.com/en/players/0000acda/Marco-Benassi"
2023,"Cremonese","Serie A","Matteo Bianchetti","ITA","DF","29",1993,23.7,32,19,21,9,2,20,32,62.5,12,31,17,14,20,52,111,0,"https://fbref.com/en/players/b3a20f18/Matteo-Bianchetti"
2023,"Cremonese","Serie A","Cristian Buonaiuto","ITA","MF,FW","29",1992,10.9,25,16,8,11,6,12,26,46.2,14,11,0,11,14,39,7,0,"https://fbref.com/en/players/f3a9fa26/Cristian-Buonaiuto"
2023,"Cremonese","Serie A","Marco Carnesecchi","ITA","GK","22",2000,27,1,1,1,0,0,1,2,50,1,0,0,0,0,1,11,2,"https://fbref.com/en/players/8ec56e62/Marco-Carnesecchi"
2023,"Cremonese","Serie A","Michele Castagnetti","ITA","MF","32",1989,15.7,46,21,20,24,2,18,54,33.3,36,14,4,10,15,61,22,0,"https://fbref.com/en/players/ad92526f/Michele-Castagnetti"
2023,"Cremonese","Serie A","Vlad Chiricheș","ROU","DF","32",1989,10.9,35,20,27,7,1,16,24,66.7,8,36,23,13,22,57,44,0,"https://fbref.com/en/players/c316607a/Vlad-Chiriches"
2023,"Cremonese","Serie A","Daniel Ciofani","ITA","FW","37",1985,11.8,6,3,1,2,3,4,7,57.1,3,7,1,6,2,8,10,0,"https://fbref.com/en/players/b09a3ecc/Daniel-Ciofani"
2023,"Cremonese","Serie A","Cyriel Dessers","NGA","FW","27",1994,17.6,11,4,4,4,3,2,6,33.3,4,14,2,12,3,14,5,0,"https://fbref.com/en/players/dcb38abe/Cyriel-Dessers"
2023,"Cremonese","Serie A","Samuel Di Carmine","ITA","FW,MF","33",1988,0.3,0,0,0,0,0,0,0,NA,0,0,0,0,0,0,0,0,"https://fbref.com/en/players/ef94dc2f/Samuel-Di-Carmine"
2023,"Cremonese","Serie A","Gonzalo Escalante","ARG","MF","29",1993,6.2,16,8,8,8,0,10,13,76.9,3,7,1,6,10,26,4,0,"https://fbref.com/en/players/3f79a1c8/Gonzalo-Escalante"
2023,"Cremonese","Serie A","Alex Ferrari","ITA","DF","28",1994,11.2,40,23,32,7,1,28,42,66.7,14,19,4,15,25,65,45,1,"https://fbref.com/en/players/d0dbca9f/Alex-Ferrari"
2023,"Cremonese","Serie A","Pablo Galdames Millán","CHI","MF","25",1996,8.2,14,10,8,3,3,5,33,15.2,28,13,2,11,10,24,13,0,"https://fbref.com/en/players/dd403465/Pablo-Galdames-Millan"
2023,"Cremonese","Serie A","Paolo Ghiglione","ITA","DF","25",1997,7.9,16,11,10,3,3,10,23,43.5,13,9,4,5,4,20,12,0,"https://fbref.com/en/players/71dc23da/Paolo-Ghiglione"
2023,"Cremonese","Serie A","Jack Hendry","SCO","DF","27",1995,2.4,0,0,0,0,0,0,1,0,1,2,1,1,1,1,7,0,"https://fbref.com/en/players/ffed43e3/Jack-Hendry"
2023,"Cremonese","Serie A","Luka Lochoshvili","GEO","DF","24",1998,20.4,45,19,30,11,4,22,31,71,9,31,10,21,22,67,89,0,"https://fbref.com/en/players/c8ad0857/Luka-Lochoshvili"
2023,"Cremonese","Serie A","Soualiho Meïté","FRA","MF","28",1994,26.3,47,31,25,15,7,22,46,47.8,24,27,6,21,27,74,36,0,"https://fbref.com/en/players/5cec2c74/Soualiho-Meite"
2023,"Cremonese","Serie A","Tommaso Milanese","ITA","MF","20",2002,0.3,0,0,0,0,0,0,0,NA,0,1,1,0,0,0,0,0,"https://fbref.com/en/players/b2561711/Tommaso-Milanese"
2023,"Cremonese","Serie A","David Okereke","NGA","FW,MF","24",1997,25.2,12,8,4,5,3,3,16,18.8,13,23,3,20,10,22,12,0,"https://fbref.com/en/players/d125f22f/David-Okereke"
2023,"Cremonese","Serie A","Charles Pickel","SUI","MF","25",1997,27.6,55,23,25,26,4,32,57,56.1,25,37,5,32,24,79,36,1,"https://fbref.com/en/players/f71ad8cb/Charles-Pickel"
2023,"Cremonese","Serie A","Giacomo Quagliata","ITA","DF","22",2000,7.8,10,8,7,1,2,5,11,45.5,6,7,2,5,11,21,8,0,"https://fbref.com/en/players/1b9c7401/Giacomo-Quagliata"
2023,"Cremonese","Serie A","Ionuț Radu","ROU","GK","25",1997,9,0,0,0,0,0,0,0,NA,0,0,0,0,0,0,1,3,"https://fbref.com/en/players/67f649be/Ionut-Radu"
2023,"Cremonese","Serie A","Mouhamadou Sarr","SEN","GK","25",1997,2,0,0,0,0,0,0,0,NA,0,0,0,0,0,0,2,0,"https://fbref.com/en/players/b959a0d1/Mouhamadou-Sarr"
2023,"Cremonese","Serie A","Leonardo Sernicola","ITA","DF","25",1997,25.7,45,33,25,13,7,29,43,67.4,14,23,6,17,38,83,55,0,"https://fbref.com/en/players/dd7febd8/Leonardo-Sernicola"
2023,"Cremonese","Serie A","Frank Tsadjout","ITA","FW","23",1999,11.7,10,8,3,6,1,3,9,33.3,6,7,1,6,8,18,9,0,"https://fbref.com/en/players/0588a092/Frank-Tsadjout"
2023,"Cremonese","Serie A","Emanuele Valeri","ITA","DF","23",1998,30.9,54,27,29,21,4,29,69,42,40,17,3,14,22,76,44,1,"https://fbref.com/en/players/ec52b661/Emanuele-Valeri"
2023,"Cremonese","Serie A","Johan Vásquez","MEX","DF","23",1998,20.1,41,26,34,7,0,18,39,46.2,21,27,20,7,45,86,93,1,"https://fbref.com/en/players/5eaed77a/Johan-Vasquez"
2023,"Cremonese","Serie A","Luca Zanimacchia","ITA","MF,FW","24",1998,8.3,21,13,11,6,4,8,21,38.1,13,9,0,9,9,30,5,0,"https://fbref.com/en/players/5e834dce/Luca-Zanimacchia"
2023,"Crystal Palace","Premier League","Naouirou Ahamada","FRA","MF,FW","20",2002,1,3,2,3,0,0,1,3,33.3,2,2,0,2,0,3,0,0,"https://fbref.com/en/players/a6c58494/Naouirou-Ahamada"
2023,"Crystal Palace","Premier League","Joachim Andersen","DEN","DF","26",1996,30.9,42,22,30,12,0,16,32,50,16,28,13,15,24,66,188,0,"https://fbref.com/en/players/e34fc66d/Joachim-Andersen"
2023,"Crystal Palace","Premier League","Jordan Ayew","GHA","FW,MF","30",1991,30.2,66,41,23,20,23,21,53,39.6,32,35,4,31,15,81,31,0,"https://fbref.com/en/players/da052c14/Jordan-Ayew"
2023,"Crystal Palace","Premier League","Nathaniel Clyne","ENG","DF","31",1991,18.2,27,16,13,9,5,14,23,60.9,9,22,4,18,19,46,34,0,"https://fbref.com/en/players/0442183b/Nathaniel-Clyne"
2023,"Crystal Palace","Premier League","Cheick Doucouré","MLI","MF","22",2000,30.8,77,46,40,33,4,29,52,55.8,23,47,13,34,56,133,48,0,"https://fbref.com/en/players/ce4f40c7/Cheick-Doucoure"
2023,"Crystal Palace","Premier League","Malcolm Ebiowei","ENG","MF,FW","18",2003,0.4,1,1,1,0,0,0,1,0,1,2,0,2,0,1,0,0,"https://fbref.com/en/players/fa9fa773/Malcolm-Ebiowei"
2023,"Crystal Palace","Premier League","Odsonne Édouard","FRA","FW","24",1998,20,25,13,7,12,6,7,13,53.8,6,17,5,12,3,28,22,0,"https://fbref.com/en/players/0562b7f1/Odsonne-Edouard"
2023,"Crystal Palace","Premier League","Eberechi Eze","ENG","MF,FW","24",1998,29.3,42,24,17,18,7,18,38,47.4,20,22,0,22,13,55,10,0,"https://fbref.com/en/players/ae4fc6a4/Eberechi-Eze"
2023,"Crystal Palace","Premier League","Vicente Guaita","ESP","GK","35",1987,27,0,0,0,0,0,0,0,NA,0,0,0,0,0,0,9,1,"https://fbref.com/en/players/ab13a5aa/Vicente-Guaita"
2023,"Crystal Palace","Premier League","Marc Guéhi","ENG","DF","22",2000,37,52,27,39,11,2,26,42,61.9,16,45,24,21,45,97,134,3,"https://fbref.com/en/players/d0706b27/Marc-Guehi"
2023,"Crystal Palace","Premier League","Will Hughes","ENG","MF","27",1995,9.4,29,16,11,16,2,11,20,55,9,16,7,9,16,45,9,0,"https://fbref.com/en/players/a0666d3e/Will-Hughes"
2023,"Crystal Palace","Premier League","Sam Johnstone","ENG","GK","29",1993,9,0,0,0,0,0,0,0,NA,0,0,0,0,0,0,5,0,"https://fbref.com/en/players/9e5708be/Sam-Johnstone"
2023,"Crystal Palace","Premier League","Jean-Philippe Mateta","FRA","FW","25",1997,8.6,7,1,2,4,1,1,3,33.3,2,3,1,2,3,10,18,0,"https://fbref.com/en/players/50e6dc35/Jean-Philippe-Mateta"
2023,"Crystal Palace","Premier League","James McArthur","SCO","MF","34",1987,0.6,1,1,1,0,0,1,1,100,0,2,1,1,1,2,2,0,"https://fbref.com/en/players/cee31595/James-McArthur"
2023,"Crystal Palace","Premier League","Luka Milivojević","SRB","MF","31",1991,5.7,13,7,7,4,2,7,10,70,3,13,4,9,12,25,10,0,"https://fbref.com/en/players/2ce2508a/Luka-Milivojevic"
2023,"Crystal Palace","Premier League","Tyrick Mitchell","ENG","DF","22",1999,32.1,71,49,43,23,5,30,53,56.6,23,48,11,37,42,113,78,0,"https://fbref.com/en/players/5cbd1eb0/Tyrick-Mitchell"
2023,"Crystal Palace","Premier League","Michael Olise","FRA","FW,MF","20",2001,30.5,58,34,28,26,4,25,60,41.7,35,46,1,45,26,84,17,0,"https://fbref.com/en/players/c4486bac/Michael-Olise"
2023,"Crystal Palace","Premier League","David Ozoh","","FW","17",2005,0,0,0,0,0,0,0,0,NA,0,0,0,0,0,0,0,0,"https://fbref.com/en/players/d00d45ab/David-Ozoh"
2023,"Crystal Palace","Premier League","Chris Richards","USA","DF","22",2000,5,9,6,8,1,0,5,7,71.4,2,10,1,9,8,17,31,0,"https://fbref.com/en/players/0a3d6d2b/Chris-Richards"
2023,"Crystal Palace","Premier League","Jaïro Riedewald","NED","DF,MF","25",1996,0.7,2,1,2,0,0,0,1,0,1,2,0,2,0,2,4,0,"https://fbref.com/en/players/7a1f2c08/Jairo-Riedewald"
2023,"Crystal Palace","Premier League","Albert Sambi Lokonga","BEL","MF","22",1999,6,13,10,7,4,2,8,12,66.7,4,8,3,5,7,20,10,0,"https://fbref.com/en/players/1b4f1169/Albert-Sambi-Lokonga"
2023,"Crystal Palace","Premier League","Jeffrey Schlupp","GHA","MF,FW","29",1992,28.1,66,46,28,29,9,22,43,51.2,21,39,8,31,23,89,38,0,"https://fbref.com/en/players/3312f911/Jeffrey-Schlupp"
2023,"Crystal Palace","Premier League","James Tomkins","ENG","DF","33",1989,3.8,4,2,2,1,1,1,3,33.3,2,3,2,1,5,9,19,0,"https://fbref.com/en/players/e7ca0439/James-Tomkins"
2023,"Crystal Palace","Premier League","Joel Ward","ENG","DF","32",1989,25.1,50,36,30,11,9,30,41,73.2,11,32,16,16,25,75,80,1,"https://fbref.com/en/players/8a7ff278/Joel-Ward"
2023,"Crystal Palace","Premier League","Joseph Whitworth","ENG","GK","18",2004,2,0,0,0,0,0,0,0,NA,0,0,0,0,0,0,1,0,"https://fbref.com/en/players/3f847d95/Joseph-Whitworth"
2023,"Crystal Palace","Premier League","Wilfried Zaha","CIV","FW,MF","29",1992,25.4,32,20,12,12,8,8,21,38.1,13,21,1,20,16,48,9,0,"https://fbref.com/en/players/b2bc3b1f/Wilfried-Zaha"
2023,"Cádiz","La Liga","Tomás Alarcón","CHI","MF","23",1999,2.5,3,2,0,2,1,1,2,50,1,1,0,1,2,5,2,0,"https://fbref.com/en/players/99ea2ddd/Tomas-Alarcon"
2023,"Cádiz","La Liga","Rubén Alcaraz","ESP","MF","31",1991,22.7,43,31,24,18,1,19,54,35.2,35,23,8,15,19,62,37,0,"https://fbref.com/en/players/036bba5f/Ruben-Alcaraz"
2023,"Cádiz","La Liga","Iván Alejo","ESP","MF,FW","27",1995,14.6,32,21,19,9,4,17,37,45.9,20,18,3,15,5,37,12,1,"https://fbref.com/en/players/3d7e48ce/Ivan-Alejo"
2023,"Cádiz","La Liga","José Antonio","ESP","MF,DF","18",2004,0.5,2,1,0,0,2,0,0,NA,0,0,0,0,0,2,0,0,"https://fbref.com/en/players/62a583ee/Jose-Antonio"
2023,"Cádiz","La Liga","Santiago Arzamendia","PAR","DF,MF","24",1998,5.4,9,8,7,1,1,6,21,28.6,15,11,1,10,2,11,15,1,"https://fbref.com/en/players/759d8dd7/Santiago-Arzamendia"
2023,"Cádiz","La Liga","Theo Bongonda","COD","MF,FW","26",1995,21.5,28,20,11,14,3,17,40,42.5,23,21,2,19,6,34,14,0,"https://fbref.com/en/players/0da6a13e/Theo-Bongonda"
2023,"Cádiz","La Liga","Cala","ESP","DF","32",1989,1.5,2,1,1,1,0,1,2,50,1,2,1,1,1,3,12,0,"https://fbref.com/en/players/fe05804b/Cala"
2023,"Cádiz","La Liga","Isaac Carcelen","ESP","DF","29",1993,24.4,69,51,41,22,6,41,63,65.1,22,35,11,24,19,88,80,1,"https://fbref.com/en/players/c4b888df/Isaac-Carcelen"
2023,"Cádiz","La Liga","Víctor Chust","ESP","DF","22",2000,10.7,9,6,7,2,0,4,7,57.1,3,8,3,5,10,19,53,0,"https://fbref.com/en/players/ec1a731e/Victor-Chust"
2023,"Cádiz","La Liga","Mamady Diarra","MLI","MF,DF","22",2000,0.7,2,1,2,0,0,1,2,50,1,2,0,2,0,2,0,0,"https://fbref.com/en/players/80211dc5/Mamady-Diarra"
2023,"Cádiz","La Liga","Youba Diarra","MLI","MF","24",1998,1.1,3,0,2,1,0,1,5,20,4,7,1,6,2,5,3,0,"https://fbref.com/en/players/d61759ec/Youba-Diarra"
2023,"Cádiz","La Liga","Gonzalo Escalante","ARG","MF","29",1993,12.5,36,24,15,20,1,15,29,51.7,14,18,4,14,17,53,26,1,"https://fbref.com/en/players/3f79a1c8/Gonzalo-Escalante"
2023,"Cádiz","La Liga","Alfonso Espino","URU","DF","30",1992,34.7,87,56,55,20,12,48,96,50,48,52,11,41,48,135,99,3,"https://fbref.com/en/players/db001fa9/Alfonso-Espino"
2023,"Cádiz","La Liga","Fali","ESP","DF,MF","28",1993,19,27,19,19,8,0,18,29,62.1,11,24,15,9,13,40,70,1,"https://fbref.com/en/players/72a84002/Fali"
2023,"Cádiz","La Liga","Álex Fernández","ESP","MF,FW","29",1992,17.5,13,7,6,4,3,4,14,28.6,10,14,1,13,8,21,19,0,"https://fbref.com/en/players/aa677a35/Alex-Fernandez"
2023,"Cádiz","La Liga","Carlos García","ESP","DF","22",2000,0.3,0,0,0,0,0,0,0,NA,0,0,0,0,0,0,2,0,"https://fbref.com/en/players/661e2822/Carlos-Garcia"
2023,"Cádiz","La Liga","David Gil","ESP","GK","28",1994,4,0,0,0,0,0,0,0,NA,0,0,0,0,0,0,3,0,"https://fbref.com/en/players/fea23125/David-Gil"
2023,"Cádiz","La Liga","Álvaro Giménez","ESP","FW","31",1991,0.2,0,0,0,0,0,0,1,0,1,0,0,0,0,0,0,0,"https://fbref.com/en/players/18017beb/Alvaro-Gimenez"
2023,"Cádiz","La Liga","Sergi Guardiola","ESP","FW","31",1991,12.9,9,7,0,6,3,3,12,25,9,5,0,5,3,12,7,0,"https://fbref.com/en/players/32974271/Sergi-Guardiola"
2023,"Cádiz","La Liga","Luis Hernández","ESP","DF","33",1989,35,33,21,25,7,1,22,36,61.1,14,31,24,7,31,64,145,0,"https://fbref.com/en/players/02d2c436/Luis-Hernandez"
2023,"Cádiz","La Liga","Jeremías Ledesma","ARG","GK","29",1993,34,3,2,3,0,0,3,7,42.9,4,1,0,1,2,5,23,3,"https://fbref.com/en/players/6c4776b1/Jeremias-Ledesma"
2023,"Cádiz","La Liga","Anthony Lozano","HON","FW","29",1993,16,6,4,1,4,1,1,7,14.3,6,12,1,11,3,9,17,0,"https://fbref.com/en/players/38699c72/Anthony-Lozano"
2023,"Cádiz","La Liga","Awer Mabil","AUS","MF,FW","26",1995,1.8,2,0,0,1,1,1,3,33.3,2,1,1,0,0,2,1,0,"https://fbref.com/en/players/922da988/Awer-Mabil"
2023,"Cádiz","La Liga","José Mari","ESP","MF","34",1987,4.4,16,7,12,3,1,10,16,62.5,6,3,1,2,5,21,9,0,"https://fbref.com/en/players/6f4c734d/Jose-Mari"
2023,"Cádiz","La Liga","Roger Martí","ESP","FW","31",1991,7.1,6,4,2,3,1,1,8,12.5,7,7,0,7,2,8,7,0,"https://fbref.com/en/players/0ae4e09a/Roger-Marti"
2023,"Cádiz","La Liga","Mamadou Mbaye","SEN","DF","24",1998,8.4,10,7,7,3,0,6,8,75,2,10,8,2,7,17,50,1,"https://fbref.com/en/players/8aae94b9/Mamadou-Mbaye"
2023,"Cádiz","La Liga","Jorge Meré","ESP","DF","25",1997,6.7,11,7,9,2,0,5,8,62.5,3,9,6,3,6,17,32,0,"https://fbref.com/en/players/9f979eb2/Jorge-Mere"
2023,"Cádiz","La Liga","Francisco Mwepu","ZAM","FW","22",2000,0.2,1,0,0,1,0,0,0,NA,0,0,0,0,0,1,0,0,"https://fbref.com/en/players/dfe5caa2/Francisco-Mwepu"
2023,"Cádiz","La Liga","Álvaro Negredo","ESP","FW","36",1985,8.4,5,4,1,2,2,2,2,100,0,4,1,3,0,5,8,0,"https://fbref.com/en/players/63b0ca6b/Alvaro-Negredo"
2023,"Cádiz","La Liga","Brian Ocampo","URU","MF,FW","23",1999,12.4,18,15,12,5,1,8,21,38.1,13,13,0,13,3,21,3,0,"https://fbref.com/en/players/2e3995cd/Brian-Ocampo"
2023,"Cádiz","La Liga","Raúl Parra","ESP","DF","22",1999,3.4,4,2,4,0,0,4,9,44.4,5,5,3,2,1,5,9,0,"https://fbref.com/en/players/647d39d2/Raul-Parra"
2023,"Cádiz","La Liga","Alberto Perea","ESP","MF","31",1990,0.5,2,0,2,0,0,0,0,NA,0,2,0,2,0,2,0,0,"https://fbref.com/en/players/5496cc91/Alberto-Perea"
2023,"Cádiz","La Liga","Lucas Pérez","ESP","FW","33",1988,7,3,2,2,1,0,1,3,33.3,2,2,0,2,1,4,3,0,"https://fbref.com/en/players/a300ac7e/Lucas-Perez"
2023,"Cádiz","La Liga","Chris Ramos","ESP","FW","25",1997,7.9,12,9,2,7,3,4,11,36.4,7,8,3,5,1,13,19,0,"https://fbref.com/en/players/44e07fac/Chris-Ramos"
2023,"Cádiz","La Liga","Fede San Emeterio","ESP","MF","25",1997,20.5,41,22,23,16,2,22,46,47.8,24,34,14,20,17,58,28,0,"https://fbref.com/en/players/efecd633/Fede-San-Emeterio"
2023,"Cádiz","La Liga","Rubén Sobrino","ESP","MF,FW","30",1992,27.4,55,37,29,17,9,23,56,41.1,33,33,3,30,24,79,20,1,"https://fbref.com/en/players/19b776e9/Ruben-Sobrino"
2023,"Cádiz","La Liga","Joseba Zaldúa","ESP","DF","30",1992,7.1,15,8,10,4,1,7,10,70,3,4,2,2,11,26,22,0,"https://fbref.com/en/players/5ca20b7a/Joseba-Zaldua"
2023,"Cádiz","La Liga","Blanco","","MF","22",2000,1.8,NA,4,NA,NA,NA,NA,NA,NA,NA,NA,NA,NA,1,NA,NA,NA,"https://fbref.com/en/players/e8deefd6/Blanco"
2023,"Dortmund","Bundesliga","Karim Adeyemi","GER","FW,MF","20",2002,15.4,16,11,6,6,4,8,30,26.7,22,18,1,17,7,23,3,0,"https://fbref.com/en/players/501055d8/Karim-Adeyemi"
2023,"Dortmund","Bundesliga","Jude Bellingham","ENG","MF","19",2003,29.9,76,42,28,34,14,34,51,66.7,17,51,4,47,35,111,30,0,"https://fbref.com/en/players/57d88cf9/Jude-Bellingham"
2023,"Dortmund","Bundesliga","Julian Brandt","GER","MF,FW","26",1996,26.6,29,20,6,14,9,12,43,27.9,31,23,0,23,15,44,9,1,"https://fbref.com/en/players/a167537f/Julian-Brandt"
2023,"Dortmund","Bundesliga","Jamie Bynoe-Gittens","ENG","FW,MF","17",2004,5.9,8,4,2,5,1,2,7,28.6,5,1,0,1,1,9,2,0,"https://fbref.com/en/players/10745192/Jamie-Bynoe-Gittens"
2023,"Dortmund","Bundesliga","Emre Can","GER","MF","28",1994,21.1,57,28,25,27,5,22,43,51.2,21,16,6,10,25,82,39,1,"https://fbref.com/en/players/a65ce836/Emre-Can"
2023,"Dortmund","Bundesliga","Soumaïla Coulibaly","FRA","DF","18",2003,0.5,0,0,0,0,0,0,0,NA,0,0,0,0,0,0,0,1,"https://fbref.com/en/players/9dff291c/Soumaila-Coulibaly"
2023,"Dortmund","Bundesliga","Mahmoud Dahoud","GER","MF","26",1996,3.7,11,9,3,4,4,7,7,100,0,6,2,4,7,18,3,0,"https://fbref.com/en/players/db4ed67b/Mahmoud-Dahoud"
2023,"Dortmund","Bundesliga","Julien Duranville","BEL","MF","16",2006,0.3,1,1,0,1,0,1,1,100,0,0,0,0,0,1,0,0,"https://fbref.com/en/players/b06a7ae9/Julien-Duranville"
2023,"Dortmund","Bundesliga","Raphaël Guerreiro","POR","DF,MF","28",1993,25.4,36,20,13,15,8,21,34,61.8,13,21,2,19,36,72,23,0,"https://fbref.com/en/players/048a1cbc/Raphael-Guerreiro"
2023,"Dortmund","Bundesliga","Sébastien Haller","CIV","FW","28",1994,13.6,5,4,2,1,2,0,4,0,4,8,0,8,1,6,10,0,"https://fbref.com/en/players/ba115a40/Sebastien-Haller"
2023,"Dortmund","Bundesliga","Thorgan Hazard","BEL","FW,DF","29",1993,5.2,17,6,5,11,1,12,17,70.6,5,6,0,6,5,22,5,0,"https://fbref.com/en/players/50871bcc/Thorgan-Hazard"
2023,"Dortmund","Bundesliga","Mats Hummels","GER","DF","33",1988,22.4,62,34,38,22,2,32,55,58.2,23,30,16,14,33,95,100,1,"https://fbref.com/en/players/05d548d8/Mats-Hummels"
2023,"Dortmund","Bundesliga","Gregor Kobel","SUI","GK","24",1997,27,0,0,0,0,0,0,1,0,1,1,0,1,0,0,7,2,"https://fbref.com/en/players/cd59b9df/Gregor-Kobel"
2023,"Dortmund","Bundesliga","Donyell Malen","NED","FW","23",1999,19,13,5,3,4,6,5,12,41.7,7,14,1,13,4,17,11,0,"https://fbref.com/en/players/116c35df/Donyell-Malen"
2023,"Dortmund","Bundesliga","Thomas Meunier","BEL","DF","30",1991,6.5,16,7,8,5,3,10,17,58.8,7,7,2,5,9,25,16,0,"https://fbref.com/en/players/e162b013/Thomas-Meunier"
2023,"Dortmund","Bundesliga","Alexander Meyer","GER","GK","31",1991,7,0,0,0,0,0,0,1,0,1,0,0,0,0,0,1,0,"https://fbref.com/en/players/b56dd813/Alexander-Meyer"
2023,"Dortmund","Bundesliga","Anthony Modeste","FRA","FW","34",1988,9,4,4,2,0,2,2,5,40,3,7,0,7,2,6,22,0,"https://fbref.com/en/players/34e4343c/Anthony-Modeste"
2023,"Dortmund","Bundesliga","Youssoufa Moukoko","GER","FW","17",2004,12.7,13,7,3,6,4,3,6,50,3,9,0,9,2,15,1,0,"https://fbref.com/en/players/6ce43701/Youssoufa-Moukoko"
2023,"Dortmund","Bundesliga","Justin Njinmah","GER","FW","21",2000,0.2,0,0,0,0,0,0,0,NA,0,0,0,0,0,0,0,0,"https://fbref.com/en/players/a45241d5/Justin-Njinmah"
2023,"Dortmund","Bundesliga","Salih Özcan","TUR","MF","24",1998,17.5,31,18,10,16,5,16,39,41,23,24,2,22,28,59,19,1,"https://fbref.com/en/players/15413fa5/Salih-Ozcan"
2023,"Dortmund","Bundesliga","Antonios Papadopoulos","GER","DF","22",1999,0.1,0,0,0,0,0,0,0,NA,0,0,0,0,1,1,0,0,"https://fbref.com/en/players/13d23b29/Antonios-Papadopoulos"
2023,"Dortmund","Bundesliga","Marco Pašalić","CRO","MF","21",2000,0.1,0,0,0,0,0,0,0,NA,0,0,0,0,0,0,0,0,"https://fbref.com/en/players/1866b0f1/Marco-Pasalic"
2023,"Dortmund","Bundesliga","Felix Passlack","GER","DF","24",1998,0.7,4,3,0,4,0,1,1,100,0,1,1,0,0,4,1,0,"https://fbref.com/en/players/5c899683/Felix-Passlack"
2023,"Dortmund","Bundesliga","Marco Reus","GER","MF,FW","33",1989,15,30,17,12,14,4,7,24,29.2,17,12,4,8,8,38,8,0,"https://fbref.com/en/players/36a3ff67/Marco-Reus"
2023,"Dortmund","Bundesliga","Gio Reyna","USA","FW,MF","19",2002,6.9,14,7,2,5,7,5,10,50,5,8,2,6,3,17,5,0,"https://fbref.com/en/players/7fa4e703/Gio-Reyna"
2023,"Dortmund","Bundesliga","Tom Rothe","GER","DF","17",2004,0.3,1,1,0,1,0,1,1,100,0,0,0,0,1,2,2,0,"https://fbref.com/en/players/90c1f9a4/Tom-Rothe"
2023,"Dortmund","Bundesliga","Julian Ryerson","NOR","DF","24",1997,15.7,27,15,17,7,3,19,37,51.4,18,13,2,11,8,35,28,0,"https://fbref.com/en/players/009a4f60/Julian-Ryerson"
2023,"Dortmund","Bundesliga","Nico Schlotterbeck","GER","DF","22",1999,25,59,34,34,24,1,37,53,69.8,16,38,21,17,32,91,71,1,"https://fbref.com/en/players/34e12499/Nico-Schlotterbeck"
2023,"Dortmund","Bundesliga","Niklas Süle","GER","DF","26",1995,23.5,25,19,18,3,4,14,23,60.9,9,28,19,9,17,42,53,0,"https://fbref.com/en/players/e33c06cf/Niklas-Sule"
2023,"Dortmund","Bundesliga","Marius Wolf","GER","DF","27",1995,17.4,25,18,9,12,4,16,29,55.2,13,40,10,30,18,43,22,1,"https://fbref.com/en/players/fa661778/Marius-Wolf"
2023,"Eint Frankfurt","Bundesliga","Paxten Aaronson","USA","MF,DF","18",2003,1.9,6,5,2,2,2,2,3,66.7,1,2,1,1,0,6,2,0,"https://fbref.com/en/players/4cd41883/Paxten-Aaronson"
2023,"Eint Frankfurt","Bundesliga","Lucas Alario","ARG","FW,MF","29",1992,3.7,3,2,1,0,2,0,1,0,1,0,0,0,2,5,13,0,"https://fbref.com/en/players/834d0be5/Lucas-Alario"
2023,"Eint Frankfurt","Bundesliga","Faride Alidou","GER","DF,MF","21",2001,2,8,5,3,4,1,3,9,33.3,6,3,0,3,1,9,3,0,"https://fbref.com/en/players/00f518d8/Faride-Alidou"
2023,"Eint Frankfurt","Bundesliga","Rafael Borré","COL","MF,FW","26",1995,12,25,15,4,13,8,4,17,23.5,13,10,2,8,2,27,9,0,"https://fbref.com/en/players/c68da769/Rafael-Borre"
2023,"Eint Frankfurt","Bundesliga","Aurélio Buta","POR","DF","25",1997,14.6,33,19,15,13,5,15,27,55.6,12,18,1,17,9,42,34,0,"https://fbref.com/en/players/b4705807/Aurelio-Buta"
2023,"Eint Frankfurt","Bundesliga","Timothy Chandler","USA","DF","32",1990,1,2,2,2,0,0,2,2,100,0,1,0,1,0,2,3,0,"https://fbref.com/en/players/b3b7f5a6/Timothy-Chandler"
2023,"Eint Frankfurt","Bundesliga","Junior Dina Ebimbe","FRA","DF,MF","21",2000,11.8,30,19,16,14,0,16,33,48.5,17,18,5,13,11,41,20,0,"https://fbref.com/en/players/95bb6ddc/Junior-Dina-Ebimbe"
2023,"Eint Frankfurt","Bundesliga","Dario Gebuhr","GER","DF","19",2003,0.2,0,0,0,0,0,0,1,0,1,0,0,0,0,0,0,0,"https://fbref.com/en/players/277be51d/Dario-Gebuhr"
2023,"Eint Frankfurt","Bundesliga","Mario Götze","GER","MF","30",1992,30.4,42,25,13,22,7,14,47,29.8,33,25,0,25,13,55,12,0,"https://fbref.com/en/players/9efa1d25/Mario-Gotze"
2023,"Eint Frankfurt","Bundesliga","Makoto Hasebe","JPN","DF","38",1984,14.5,18,12,16,2,0,7,22,31.8,15,22,9,13,17,35,45,0,"https://fbref.com/en/players/9ab16552/Makoto-Hasebe"
2023,"Eint Frankfurt","Bundesliga","Kristijan Jakić","CRO","DF,MF","25",1997,16.2,33,21,19,12,2,22,41,53.7,19,32,10,22,14,47,49,1,"https://fbref.com/en/players/a8ee54ad/Kristijan-Jakic"
2023,"Eint Frankfurt","Bundesliga","Daichi Kamada","JPN","MF","25",1996,25.2,51,31,10,37,4,31,57,54.4,26,31,2,29,16,67,17,1,"https://fbref.com/en/players/15b287da/Daichi-Kamada"
2023,"Eint Frankfurt","Bundesliga","Ansgar Knauff","GER","DF","20",2002,14.3,36,25,22,11,3,15,34,44.1,19,19,1,18,15,51,26,0,"https://fbref.com/en/players/19a967ab/Ansgar-Knauff"
2023,"Eint Frankfurt","Bundesliga","Randal Kolo Muani","FRA","FW","23",1998,29.2,14,10,3,3,8,1,9,11.1,8,19,2,17,3,17,13,0,"https://fbref.com/en/players/c0b3669f/Randal-Kolo-Muani"
2023,"Eint Frankfurt","Bundesliga","Filip Kostić","SRB","DF,MF","29",1992,0.8,2,0,1,1,0,0,0,NA,0,0,0,0,1,3,0,0,"https://fbref.com/en/players/b1cd37e6/Filip-Kostic"
2023,"Eint Frankfurt","Bundesliga","Christopher Lenz","GER","DF","27",1994,14.3,29,21,17,7,5,16,37,43.2,21,16,3,13,21,50,34,0,"https://fbref.com/en/players/bbd86530/Christopher-Lenz"
2023,"Eint Frankfurt","Bundesliga","Jesper Lindstrøm","DEN","MF,FW","22",2000,18.7,26,11,15,7,4,7,22,31.8,15,25,3,22,9,35,9,0,"https://fbref.com/en/players/37dc1a48/Jesper-Lindstrom"
2023,"Eint Frankfurt","Bundesliga","Philipp Max","GER","DF","28",1993,7.7,12,9,4,7,1,5,16,31.3,11,10,2,8,3,15,11,0,"https://fbref.com/en/players/826e8b63/Philipp-Max"
2023,"Eint Frankfurt","Bundesliga","Obite N'Dicka","FRA","DF","22",1999,29.9,25,18,10,11,4,18,32,56.3,14,47,19,28,31,56,150,0,"https://fbref.com/en/players/441197b8/Obite-NDicka"
2023,"Eint Frankfurt","Bundesliga","Luca Pellegrini","ITA","DF","23",1999,6.2,13,8,10,3,0,8,8,100,0,8,2,6,7,20,11,1,"https://fbref.com/en/players/3b61c9ec/Luca-Pellegrini"
2023,"Eint Frankfurt","Bundesliga","Diant Ramaj","GER","GK","20",2001,1,0,0,0,0,0,0,0,NA,0,0,0,0,0,0,1,0,"https://fbref.com/en/players/b90c4a43/Diant-Ramaj"
2023,"Eint Frankfurt","Bundesliga","Sebastian Rode","GER","MF","31",1990,15.7,38,24,7,28,3,14,45,31.1,31,18,2,16,16,54,12,0,"https://fbref.com/en/players/e12b0b5b/Sebastian-Rode"
2023,"Eint Frankfurt","Bundesliga","Hrvoje Smolčić","CRO","DF","21",2000,5.2,8,7,6,2,0,5,10,50,5,11,4,7,6,14,38,0,"https://fbref.com/en/players/c967f6b8/Hrvoje-Smolcic"
2023,"Eint Frankfurt","Bundesliga","Djibril Sow","SUI","MF","25",1997,29.4,41,25,13,25,3,22,44,50,22,22,4,18,28,69,23,0,"https://fbref.com/en/players/4c6facae/Djibril-Sow"
2023,"Eint Frankfurt","Bundesliga","Almamy Touré","MLI","DF","26",1996,4.4,13,7,7,5,1,5,9,55.6,4,9,2,7,10,23,8,0,"https://fbref.com/en/players/c8c60119/Almamy-Toure"
2023,"Eint Frankfurt","Bundesliga","Kevin Trapp","GER","GK","32",1990,33,1,1,1,0,0,0,2,0,2,2,0,2,0,1,10,0,"https://fbref.com/en/players/ce17b5eb/Kevin-Trapp"
2023,"Eint Frankfurt","Bundesliga","Tuta","BRA","DF","23",1999,30.2,53,35,27,19,7,33,57,57.9,24,47,14,33,49,102,134,2,"https://fbref.com/en/players/35d64857/Tuta"
2023,"Eint Frankfurt","Bundesliga","Marcel Wenig","GER","MF","18",2004,0,0,0,0,0,0,0,0,NA,0,0,0,0,0,0,0,0,"https://fbref.com/en/players/1c86aa16/Marcel-Wenig"
2023,"Elche","La Liga","Alejandro Alfaro","ESP","MF","20",2002,0.2,0,0,0,0,0,0,0,NA,0,0,0,0,0,0,0,0,"https://fbref.com/en/players/b907d169/Alejandro-Alfaro"
2023,"Elche","La Liga","Édgar Badía","ESP","GK","30",1992,36,1,0,1,0,0,1,2,50,1,0,0,0,0,1,19,3,"https://fbref.com/en/players/e4346678/Edgar-Badia"
2023,"Elche","La Liga","Pedro Bigas","ESP","DF","31",1990,22.4,37,20,30,7,0,18,29,62.1,11,25,14,11,33,70,95,0,"https://fbref.com/en/players/697295b1/Pedro-Bigas"
2023,"Elche","La Liga","Lautaro Blanco","ARG","DF,MF","23",1999,9.7,16,9,10,4,2,9,26,34.6,17,8,1,7,2,18,10,1,"https://fbref.com/en/players/1657f448/Lautaro-Blanco"
2023,"Elche","La Liga","Lucas Boyé","ARG","FW","26",1996,27.4,36,16,12,16,8,17,35,48.6,18,33,5,28,15,51,46,0,"https://fbref.com/en/players/d49f3e6b/Lucas-Boye"
2023,"Elche","La Liga","Carmona","ESP","MF,DF","20",2002,6.5,16,9,7,6,3,6,16,37.5,10,14,2,12,8,24,9,0,"https://fbref.com/en/players/2dce876a/Carmona"
2023,"Elche","La Liga","Pape Cheikh Diop","SEN","MF","24",1997,0.4,0,0,0,0,0,0,1,0,1,0,0,0,0,0,0,0,"https://fbref.com/en/players/873ce3a2/Pape-Cheikh-Diop"
2023,"Elche","La Liga","Carlos Clerc","ESP","DF,MF","30",1992,29.3,75,51,55,16,4,31,50,62,19,29,7,22,28,103,94,1,"https://fbref.com/en/players/33a61a52/Carlos-Clerc"
2023,"Elche","La Liga","Álex Collado","ESP","MF","23",1999,8.1,26,14,13,11,2,8,13,61.5,5,12,1,11,2,28,4,0,"https://fbref.com/en/players/85dace26/Alex-Collado"
2023,"Elche","La Liga","John Donald","ESP","MF,DF","21",2000,12.1,20,11,9,9,2,7,14,50,7,14,7,7,14,34,23,1,"https://fbref.com/en/players/5e95c000/John-Donald"
2023,"Elche","La Liga","Nicolás Ezequiel Fernández","ARG","MF,DF","22",2000,5.7,23,12,10,7,6,9,17,52.9,8,7,0,7,5,28,2,1,"https://fbref.com/en/players/3409de86/Nicolas-Ezequiel-Fernandez"
2023,"Elche","La Liga","Federico Fernández","ARG","DF","33",1989,1,1,1,1,0,0,1,1,100,0,0,0,0,2,3,12,0,"https://fbref.com/en/players/f25b010f/Federico-Fernandez"
2023,"Elche","La Liga","Fidel","ESP","MF,FW","32",1989,19,15,10,8,5,2,4,38,10.5,34,9,0,9,5,20,8,0,"https://fbref.com/en/players/eb82b6f1/Fidel"
2023,"Elche","La Liga","Diego González","ESP","DF","27",1995,10.6,12,7,9,3,0,7,11,63.6,4,14,12,2,7,19,50,1,"https://fbref.com/en/players/4ac7608e/Diego-Gonzalez"
2023,"Elche","La Liga","Gerard Gumbau","ESP","MF","27",1994,30.4,44,25,17,23,4,18,51,35.3,33,32,8,24,28,72,40,0,"https://fbref.com/en/players/ac454a4f/Gerard-Gumbau"
2023,"Elche","La Liga","Raúl Guti","ESP","MF","25",1996,12.4,18,12,8,9,1,8,18,44.4,10,10,3,7,8,26,6,0,"https://fbref.com/en/players/0b2c8585/Raul-Guti"
2023,"Elche","La Liga","Josan","ESP","DF,MF","32",1989,12,25,20,20,5,0,14,27,51.9,13,8,0,8,7,32,15,1,"https://fbref.com/en/players/5b28b2f6/Josan"
2023,"Elche","La Liga","Pol Lirola","ESP","DF","24",1997,7,13,6,9,3,1,8,13,61.5,5,3,2,1,7,20,16,0,"https://fbref.com/en/players/ff800ed8/Pol-Lirola"
2023,"Elche","La Liga","Lisandro Magallán","ARG","DF","28",1993,10,19,11,11,5,3,10,12,83.3,2,14,5,9,13,32,30,1,"https://fbref.com/en/players/01a49bd2/Lisandro-Magallan"
2023,"Elche","La Liga","Roger Martí","ESP","FW","31",1991,7.3,5,2,3,2,0,1,5,20,4,4,0,4,1,6,7,0,"https://fbref.com/en/players/0ae4e09a/Roger-Marti"
2023,"Elche","La Liga","Omar Mascarell","ESP","MF,DF","29",1993,27.2,53,26,32,19,2,31,64,48.4,33,51,19,32,45,98,54,1,"https://fbref.com/en/players/11fd2b75/Omar-Mascarell"
2023,"Elche","La Liga","Pere Milla","ESP","FW,MF","29",1992,20.5,31,20,18,8,5,14,41,34.1,27,18,3,15,9,40,19,1,"https://fbref.com/en/players/335039a2/Pere-Milla"
2023,"Elche","La Liga","Johan Mojica","COL","DF,MF","29",1992,3,6,3,5,1,0,2,3,66.7,1,3,2,1,4,10,5,0,"https://fbref.com/en/players/608f2092/Johan-Mojica"
2023,"Elche","La Liga","Tete Morente","ESP","MF,DF","25",1996,23,33,21,18,13,2,15,36,41.7,21,23,3,20,25,58,28,0,"https://fbref.com/en/players/004d185e/Tete-Morente"
2023,"Elche","La Liga","Randy Ntekja","FRA","FW,MF","24",1997,8.1,15,10,7,6,2,2,11,18.2,9,15,3,12,4,19,9,0,"https://fbref.com/en/players/a6103274/Randy-Ntekja"
2023,"Elche","La Liga","Helibelton Palacios","COL","DF","29",1993,21.3,38,20,21,15,2,19,26,73.1,7,26,12,14,20,58,55,0,"https://fbref.com/en/players/ac8b2421/Helibelton-Palacios"
2023,"Elche","La Liga","Javier Pastore","ARG","MF","33",1989,0.1,0,0,0,0,0,0,0,NA,0,0,0,0,0,0,0,0,"https://fbref.com/en/players/881ef58c/Javier-Pastore"
2023,"Elche","La Liga","Ezequiel Ponce","ARG","FW,MF","25",1997,12.5,9,7,0,6,3,0,7,0,7,6,1,5,1,10,13,0,"https://fbref.com/en/players/ccbbe661/Ezequiel-Ponce"
2023,"Elche","La Liga","Domingos Quina","POR","MF","22",1999,3.1,3,2,2,1,0,1,3,33.3,2,5,0,5,3,6,1,0,"https://fbref.com/en/players/41fb0f4e/Domingos-Quina"
2023,"Elche","La Liga","Enzo Roco","CHI","DF","29",1992,18.4,33,13,23,10,0,15,24,62.5,9,22,15,7,17,50,63,1,"https://fbref.com/en/players/37f827ec/Enzo-Roco"
2023,"Elche","La Liga","Gonzalo Verdú","ESP","DF","33",1988,7.8,10,5,8,2,0,4,8,50,4,8,6,2,10,20,33,0,"https://fbref.com/en/players/1c2c55fc/Gonzalo-Verdu"
2023,"Elche","La Liga","Axel Werner","ARG","GK","26",1996,2,0,0,0,0,0,0,1,0,1,0,0,0,0,0,0,0,"https://fbref.com/en/players/c0b1a6da/Axel-Werner"
2023,"Empoli","Serie A","Jean-Daniel Akpa-Akpro","CIV","MF,FW","29",1992,15.1,53,37,25,19,9,23,42,54.8,19,35,4,31,13,66,27,0,"https://fbref.com/en/players/fdf4b948/Jean-Daniel-Akpa-Akpro"
2023,"Empoli","Serie A","Nedim Bajrami","ALB","MF,FW","23",1999,10.4,8,4,3,3,2,4,6,66.7,2,5,0,5,7,15,4,0,"https://fbref.com/en/players/f42d6c13/Nedim-Bajrami"
2023,"Empoli","Serie A","Tommaso Baldanzi","ITA","MF","19",2003,19.7,25,12,9,13,3,7,32,21.9,25,21,1,20,2,27,5,0,"https://fbref.com/en/players/102e2599/Tommaso-Baldanzi"
2023,"Empoli","Serie A","Filippo Bandinelli","ITA","MF","27",1995,25.1,55,34,19,26,10,17,45,37.8,28,20,7,13,18,73,40,0,"https://fbref.com/en/players/d44360be/Filippo-Bandinelli"
2023,"Empoli","Serie A","Liberato Cacace","NZL","DF","21",2000,6.5,25,10,12,8,5,9,15,60,6,15,7,8,4,29,16,0,"https://fbref.com/en/players/dd86e8e4/Liberato-Cacace"
2023,"Empoli","Serie A","Nicolò Cambiaghi","ITA","FW,MF","21",2000,14.3,30,22,11,12,7,8,27,29.6,19,19,1,18,9,39,8,0,"https://fbref.com/en/players/91ff775f/Nicolo-Cambiaghi"
2023,"Empoli","Serie A","Francesco Caputo","ITA","FW","34",1987,19,2,2,0,1,1,0,1,0,1,7,2,5,2,4,8,0,"https://fbref.com/en/players/5bd72174/Francesco-Caputo"
2023,"Empoli","Serie A","Koni De Winter","BEL","DF","20",2002,11.4,14,9,11,3,0,5,13,38.5,8,14,12,2,6,20,65,0,"https://fbref.com/en/players/f4797849/Koni-De-Winter"
2023,"Empoli","Serie A","Duccio Degl'Innocenti","ITA","MF","19",2003,0,0,0,0,0,0,0,0,NA,0,0,0,0,1,1,0,0,"https://fbref.com/en/players/0e0d6c53/Duccio-DeglInnocenti"
2023,"Empoli","Serie A","Mattia Destro","ITA","FW,MF","31",1991,6.4,1,1,0,1,0,0,0,NA,0,2,0,2,1,2,5,0,"https://fbref.com/en/players/d7d32194/Mattia-Destro"
2023,"Empoli","Serie A","Tyronne Ebuehi","NGA","DF","26",1995,21.4,22,14,11,7,4,9,13,69.2,4,23,12,11,12,34,79,1,"https://fbref.com/en/players/6af30900/Tyronne-Ebuehi"
2023,"Empoli","Serie A","Emmanuel Ekong","SWE","FW,MF","20",2002,0.2,0,0,0,0,0,0,0,NA,0,0,0,0,0,0,0,0,"https://fbref.com/en/players/c20892ee/Emmanuel-Ekong"
2023,"Empoli","Serie A","Jacopo Fazzini","ITA","MF","19",2003,9.2,31,17,20,8,3,18,34,52.9,16,15,3,12,7,38,19,0,"https://fbref.com/en/players/06b08c45/Jacopo-Fazzini"
2023,"Empoli","Serie A","Alberto Grassi","ITA","MF","27",1995,13.3,26,21,13,13,0,15,24,62.5,9,23,12,11,27,53,45,0,"https://fbref.com/en/players/6cc97b6a/Alberto-Grassi"
2023,"Empoli","Serie A","Nicolas Haas","SUI","MF","26",1996,12.8,27,13,16,6,5,12,24,50,12,16,4,12,8,35,27,0,"https://fbref.com/en/players/fa449bba/Nicolas-Haas"
2023,"Empoli","Serie A","Liam Henderson","SCO","MF","26",1996,11.2,13,10,6,5,2,4,21,19,17,10,2,8,10,23,10,0,"https://fbref.com/en/players/d7918b13/Liam-Henderson"
2023,"Empoli","Serie A","Ardian Ismajli","ALB","DF","25",1996,23.3,40,32,25,15,0,18,24,75,6,47,31,16,27,67,120,0,"https://fbref.com/en/players/6b635f5c/Ardian-Ismajli"
2023,"Empoli","Serie A","Sam Lammers","NED","FW","25",1997,9.8,20,10,5,9,6,7,11,63.6,4,4,1,3,3,23,8,0,"https://fbref.com/en/players/c283ddef/Sam-Lammers"
2023,"Empoli","Serie A","Sebastiano Luperto","ITA","DF","25",1996,34.8,33,18,24,8,1,9,20,45,11,54,42,12,43,76,163,1,"https://fbref.com/en/players/997fff07/Sebastiano-Luperto"
2023,"Empoli","Serie A","Răzvan Marin","ROU","MF","26",1996,28.2,44,22,22,21,1,19,40,47.5,21,29,11,18,14,58,33,0,"https://fbref.com/en/players/7fac99d4/Razvan-Marin"
2023,"Empoli","Serie A","Herculano Nabian","POR","MF","18",2004,0,0,0,0,0,0,0,0,NA,0,0,0,0,0,0,0,0,"https://fbref.com/en/players/c39babc1/Herculano-Nabian"
2023,"Empoli","Serie A","Fabiano Parisi","ITA","DF","21",2000,31.4,65,35,37,21,7,30,72,41.7,42,51,16,35,41,106,91,0,"https://fbref.com/en/players/0967845b/Fabiano-Parisi"
2023,"Empoli","Serie A","Samuele Perisan","ITA","GK","24",1997,7,0,0,0,0,0,0,0,NA,0,0,0,0,0,0,2,0,"https://fbref.com/en/players/00a17eba/Samuele-Perisan"
2023,"Empoli","Serie A","Roberto Piccoli","ITA","FW","21",2001,5.7,1,1,1,0,0,0,3,0,3,4,1,3,1,2,9,0,"https://fbref.com/en/players/1cadaf34/Roberto-Piccoli"
2023,"Empoli","Serie A","Marko Pjaca","CRO","MF,FW","27",1995,5.8,4,3,3,1,0,3,5,60,2,3,0,3,3,7,3,0,"https://fbref.com/en/players/2c38b327/Marko-Pjaca"
2023,"Empoli","Serie A","Martin Satriano","URU","FW","21",2001,18.9,13,8,5,6,2,6,14,42.9,8,5,0,5,3,16,22,0,"https://fbref.com/en/players/86383d0e/Martin-Satriano"
2023,"Empoli","Serie A","Petar Stojanović","SVN","DF","26",1995,17,42,22,28,10,4,26,43,60.5,17,17,5,12,11,53,55,0,"https://fbref.com/en/players/13b44b02/Petar-Stojanovic"
2023,"Empoli","Serie A","Lorenzo Tonelli","ITA","DF","32",1990,0.2,0,0,0,0,0,0,1,0,1,0,0,0,0,0,0,0,"https://fbref.com/en/players/8cc29864/Lorenzo-Tonelli"
2023,"Empoli","Serie A","Samir Ujkani","KVX","GK","34",1988,0.1,0,0,0,0,0,0,0,NA,0,0,0,0,0,0,0,0,"https://fbref.com/en/players/96640846/Samir-Ujkani"
2023,"Empoli","Serie A","Guglielmo Vicario","ITA","GK","25",1996,30.9,1,1,1,0,0,1,2,50,1,0,0,0,0,1,15,2,"https://fbref.com/en/players/77d6fd4d/Guglielmo-Vicario"
2023,"Empoli","Serie A","Emanuel Vignato","ITA","MF,FW","21",2000,0.6,2,0,2,0,0,0,0,NA,0,0,0,0,0,2,1,0,"https://fbref.com/en/players/ec5dae45/Emanuel-Vignato"
2023,"Empoli","Serie A","Sebastian Walukiewicz","POL","DF","22",2000,6.7,9,6,7,2,0,4,6,66.7,2,10,9,1,7,16,30,0,"https://fbref.com/en/players/217875a4/Sebastian-Walukiewicz"
2023,"Espanyol","La Liga","Keidi Bare","ALB","MF","24",1997,5.6,15,8,7,5,3,7,13,53.8,6,8,2,6,11,26,8,0,"https://fbref.com/en/players/03049c8c/Keidi-Bare"
2023,"Espanyol","La Liga","Wassim Boullif","ESP","DF","17",2005,1.6,3,1,3,0,0,2,3,66.7,1,5,4,1,0,3,3,0,"https://fbref.com/en/players/7f271d74/Wassim-Boullif"
2023,"Espanyol","La Liga","Martin Braithwaite","DEN","FW,MF","31",1991,27.3,12,2,2,4,6,5,14,35.7,9,10,0,10,5,17,11,0,"https://fbref.com/en/players/fd771f95/Martin-Braithwaite"
2023,"Espanyol","La Liga","Leandro Cabrera","URU","DF","31",1991,29.7,46,24,34,12,0,28,43,65.1,15,37,23,14,43,89,114,2,"https://fbref.com/en/players/69cbc8b6/Leandro-Cabrera"
2023,"Espanyol","La Liga","Fernando Calero","ESP","DF,MF","26",1995,17.9,46,29,27,15,4,21,34,61.8,13,31,13,18,13,59,52,0,"https://fbref.com/en/players/41b3069f/Fernando-Calero"
2023,"Espanyol","La Liga","José Carlos Lazo","ESP","MF,FW","26",1996,1.8,5,3,2,2,1,3,3,100,0,2,0,2,3,8,5,0,"https://fbref.com/en/players/5b93209a/Jose-Carlos-Lazo"
2023,"Espanyol","La Liga","Sergi Darder","ESP","MF","28",1993,36.9,69,38,12,43,14,29,73,39.7,44,34,2,32,24,93,23,0,"https://fbref.com/en/players/070a3904/Sergi-Darder"
2023,"Espanyol","La Liga","Adri Embarba","ESP","FW","30",1992,0.4,1,0,0,1,0,1,1,100,0,1,0,1,0,1,0,0,"https://fbref.com/en/players/db8f0eba/Adri-Embarba"
2023,"Espanyol","La Liga","Edu Expósito","ESP","MF","25",1996,12.9,34,20,16,15,3,13,23,56.5,10,7,0,7,12,46,20,0,"https://fbref.com/en/players/283c7121/Edu-Exposito"
2023,"Espanyol","La Liga","Álvaro Fernández","ESP","GK","24",1998,11,0,0,0,0,0,0,0,NA,0,0,0,0,0,0,7,2,"https://fbref.com/en/players/f127d782/Alvaro-Fernandez"
2023,"Espanyol","La Liga","Joan García","ESP","GK","21",2001,1,0,0,0,0,0,0,0,NA,0,0,0,0,0,0,0,0,"https://fbref.com/en/players/87b498b0/Joan-Garcia"
2023,"Espanyol","La Liga","Óscar Gil","ESP","DF","25",1997,28.4,63,37,38,16,9,32,61,52.5,29,51,18,33,31,94,55,1,"https://fbref.com/en/players/6652cf96/Oscar-Gil"
2023,"Espanyol","La Liga","Dani Gómez","ESP","MF,FW","24",1998,1,2,1,1,1,0,1,2,50,1,0,0,0,1,3,0,0,"https://fbref.com/en/players/0e5ddc7c/Dani-Gomez"
2023,"Espanyol","La Liga","Sergi Gómez","ESP","DF","30",1992,26,29,16,20,9,0,18,22,81.8,4,33,19,14,27,56,125,1,"https://fbref.com/en/players/bc6f5f06/Sergi-Gomez"
2023,"Espanyol","La Liga","José Gragera","ESP","MF,DF","21",2000,5.1,19,9,11,6,2,6,11,54.5,5,10,4,6,7,26,18,0,"https://fbref.com/en/players/ee45d138/Jose-Gragera"
2023,"Espanyol","La Liga","Omar El Hilali","MAR","DF,MF","18",2003,1,3,2,3,0,0,1,2,50,1,1,0,1,1,4,6,0,"https://fbref.com/en/players/139560df/Omar-El-Hilali"
2023,"Espanyol","La Liga","Joselu","ESP","FW","32",1990,33.2,13,11,3,4,6,4,17,23.5,13,25,4,21,8,21,43,0,"https://fbref.com/en/players/6265208f/Joselu"
2023,"Espanyol","La Liga","Luca Koleosho","ITA","FW,DF","17",2004,0.7,2,2,0,0,2,1,2,50,1,1,0,1,0,2,0,0,"https://fbref.com/en/players/fc076f78/Luca-Koleosho"
2023,"Espanyol","La Liga","Benjamin Lecomte","FRA","GK","31",1991,10,0,0,0,0,0,0,0,NA,0,0,0,0,0,0,3,2,"https://fbref.com/en/players/2fa2a875/Benjamin-Lecomte"
2023,"Espanyol","La Liga","Pol Lozano","ESP","MF","22",1999,0.2,0,0,0,0,0,0,0,NA,0,1,0,1,0,0,1,0,"https://fbref.com/en/players/ea610f00/Pol-Lozano"
2023,"Espanyol","La Liga","Roger Martínez","ESP","DF","18",2004,0.1,0,0,0,0,0,0,0,NA,0,0,0,0,0,0,0,0,"https://fbref.com/en/players/937c6ae6/Roger-Martinez"
2023,"Espanyol","La Liga","César Montes","MEX","DF","25",1997,17.7,17,9,10,7,0,10,18,55.6,8,19,12,7,14,31,101,0,"https://fbref.com/en/players/28e957d7/Cesar-Montes"
2023,"Espanyol","La Liga","Brian Oliván","ESP","DF","28",1994,26.7,47,27,30,12,5,17,26,65.4,9,26,6,20,22,69,67,0,"https://fbref.com/en/players/a3e4bf46/Brian-Olivan"
2023,"Espanyol","La Liga","Fernando Pacheco","ESP","GK","30",1992,16,0,0,0,0,0,0,1,0,1,0,0,0,1,1,11,0,"https://fbref.com/en/players/97852360/Fernando-Pacheco"
2023,"Espanyol","La Liga","Pedrosa","ESP","DF,MF","24",1998,2.5,5,1,5,0,0,4,7,57.1,3,1,1,0,5,10,3,0,"https://fbref.com/en/players/112521d1/Pedrosa"
2023,"Espanyol","La Liga","Ronaël Pierre-Gabriel","FRA","DF","24",1998,2.6,17,9,12,4,1,5,11,45.5,6,5,2,3,9,26,11,0,"https://fbref.com/en/players/64ba07c0/Ronael-Pierre-Gabriel"
2023,"Espanyol","La Liga","Javi Puado","ESP","FW,MF","24",1998,26,20,11,12,5,3,12,28,42.9,16,12,2,10,10,30,14,0,"https://fbref.com/en/players/2683eda7/Javi-Puado"
2023,"Espanyol","La Liga","Nico Ribaudo","ESP","MF,FW","21",2001,13.9,18,13,5,9,4,11,30,36.7,19,19,1,18,5,23,1,0,"https://fbref.com/en/players/ce8039aa/Nico-Ribaudo"
2023,"Espanyol","La Liga","Rubén","ESP","DF,MF","21",2001,9.9,30,15,18,9,3,20,29,69,9,14,4,10,18,48,18,0,"https://fbref.com/en/players/35d4f151/Ruben"
2023,"Espanyol","La Liga","Vinicius Souza","BRA","MF","23",1999,27,99,66,41,45,13,33,59,55.9,26,31,14,17,48,147,50,1,"https://fbref.com/en/players/6a8a7af8/Vinicius-Souza"
2023,"Espanyol","La Liga","Denis Suárez","ESP","MF,FW","28",1994,10.5,26,20,12,12,2,13,45,28.9,32,11,1,10,5,31,4,0,"https://fbref.com/en/players/12c50af5/Denis-Suarez"
2023,"Espanyol","La Liga","Nabil Touaizi","MAR","MF","21",2001,0,0,0,0,0,0,0,0,NA,0,0,0,0,0,0,0,0,"https://fbref.com/en/players/e96b2583/Nabil-Touaizi"
2023,"Espanyol","La Liga","Aleix Vidal","ESP","MF,FW","32",1989,11.4,11,5,6,3,2,4,22,18.2,18,21,2,19,15,26,14,0,"https://fbref.com/en/players/04965583/Aleix-Vidal"
2023,"Everton","Premier League","Dele Alli","ENG","MF","26",1996,0.4,0,0,0,0,0,0,0,NA,0,0,0,0,0,0,0,0,"https://fbref.com/en/players/cea4ee8f/Dele-Alli"
2023,"Everton","Premier League","Asmir Begović","BIH","GK","35",1987,1,0,0,0,0,0,0,0,NA,0,0,0,0,0,0,1,0,"https://fbref.com/en/players/7b4de647/Asmir-Begovic"
2023,"Everton","Premier League","Dominic Calvert-Lewin","ENG","FW","25",1997,12.9,4,2,1,0,3,1,5,20,4,5,1,4,3,7,18,0,"https://fbref.com/en/players/59e6e5bf/Dominic-Calvert-Lewin"
2023,"Everton","Premier League","Thomas Cannon","IRL","FW","19",2002,0.3,0,0,0,0,0,0,0,NA,0,0,0,0,0,0,0,0,"https://fbref.com/en/players/4506aec5/Thomas-Cannon"
2023,"Everton","Premier League","Conor Coady","ENG","DF","29",1993,23.3,14,9,8,6,0,7,15,46.7,8,21,17,4,14,28,88,3,"https://fbref.com/en/players/2928dca2/Conor-Coady"
2023,"Everton","Premier League","Séamus Coleman","IRL","DF","33",1988,18.4,35,26,21,10,4,19,29,65.5,10,14,7,7,22,57,58,2,"https://fbref.com/en/players/0420d84f/Seamus-Coleman"
2023,"Everton","Premier League","Tom Davies","ENG","MF","24",1998,6,15,9,5,9,1,7,14,50,7,10,1,9,4,19,7,1,"https://fbref.com/en/players/9228b07c/Tom-Davies"
2023,"Everton","Premier League","Abdoulaye Doucouré","MLI","MF","29",1993,17,31,20,9,15,7,12,37,32.4,25,26,3,23,13,44,11,0,"https://fbref.com/en/players/02b29014/Abdoulaye-Doucoure"
2023,"Everton","Premier League","Idrissa Gana Gueye","SEN","MF","32",1989,28.6,97,57,49,35,13,31,60,51.7,29,50,12,38,56,153,34,3,"https://fbref.com/en/players/72c812f3/Idrissa-Gana-Gueye"
2023,"Everton","Premier League","James Garner","ENG","MF,DF","21",2001,8.9,16,13,4,8,4,9,19,47.4,10,9,1,8,12,28,13,0,"https://fbref.com/en/players/4e015693/James-Garner"
2023,"Everton","Premier League","Ben Godfrey","ENG","DF","24",1998,8.9,20,11,13,5,2,11,29,37.9,18,12,6,6,8,28,33,1,"https://fbref.com/en/players/9f7c837d/Ben-Godfrey"
2023,"Everton","Premier League","Anthony Gordon","ENG","FW","21",2001,12.2,34,22,17,10,7,8,23,34.8,15,19,0,19,4,38,11,0,"https://fbref.com/en/players/2bd83368/Anthony-Gordon"
2023,"Everton","Premier League","Demarai Gray","JAM","FW,MF","26",1996,27.9,33,24,9,14,10,17,31,54.8,14,23,3,20,13,46,18,0,"https://fbref.com/en/players/4468ec10/Demarai-Gray"
2023,"Everton","Premier League","Mason Holgate","ENG","DF","25",1996,5.6,11,7,8,3,0,3,11,27.3,8,7,3,4,7,18,28,0,"https://fbref.com/en/players/d0042ab9/Mason-Holgate"
2023,"Everton","Premier League","Alex Iwobi","NGA","MF,FW","26",1996,37.5,69,37,37,28,4,33,65,50.8,32,41,2,39,25,94,29,0,"https://fbref.com/en/players/6ca5ec4b/Alex-Iwobi"
2023,"Everton","Premier League","Michael Keane","ENG","DF","29",1993,10.9,7,4,5,2,0,5,8,62.5,3,12,7,5,14,21,55,1,"https://fbref.com/en/players/c5b7c315/Michael-Keane"
2023,"Everton","Premier League","Neal Maupay","FRA","FW","25",1996,12.4,11,5,3,4,4,2,4,50,2,8,0,8,5,16,0,0,"https://fbref.com/en/players/4bcf39f6/Neal-Maupay"
2023,"Everton","Premier League","Dwight McNeil","ENG","FW,MF","22",1999,27.8,64,41,35,14,15,27,62,43.5,35,46,7,39,31,95,41,0,"https://fbref.com/en/players/fc15fb84/Dwight-McNeil"
2023,"Everton","Premier League","Yerry Mina","COL","DF","27",1994,6.6,15,8,9,6,0,9,11,81.8,2,7,4,3,6,21,28,0,"https://fbref.com/en/players/6d5701f2/Yerry-Mina"
2023,"Everton","Premier League","Vitaliy Mykolenko","UKR","DF","23",1999,29.5,58,34,36,19,3,28,51,54.9,23,50,16,34,46,104,99,0,"https://fbref.com/en/players/30d4a2e5/Vitaliy-Mykolenko"
2023,"Everton","Premier League","Amadou Onana","BEL","MF","20",2001,27.6,72,43,24,42,6,30,42,71.4,12,25,6,19,37,109,39,0,"https://fbref.com/en/players/828657ff/Amadou-Onana"
2023,"Everton","Premier League","Nathan Patterson","SCO","DF,MF","20",2001,14.2,49,24,32,13,4,29,53,54.7,24,24,4,20,15,64,45,0,"https://fbref.com/en/players/230f0471/Nathan-Patterson"
2023,"Everton","Premier League","Jordan Pickford","ENG","GK","28",1994,37,0,0,0,0,0,0,1,0,1,0,0,0,4,4,15,3,"https://fbref.com/en/players/4806ec67/Jordan-Pickford"
2023,"Everton","Premier League","Isaac Price","NIR","MF","18",2003,0.4,0,0,0,0,0,0,1,0,1,1,1,0,0,0,0,0,"https://fbref.com/en/players/b9403c99/Isaac-Price"
2023,"Everton","Premier League","Salomón Rondón","VEN","FW","32",1989,1.2,0,0,0,0,0,0,0,NA,0,1,1,0,0,0,0,0,"https://fbref.com/en/players/b318a643/Salomon-Rondon"
2023,"Everton","Premier League","Ellis Simms","ENG","FW","21",2001,2.5,0,0,0,0,0,0,0,NA,0,0,0,0,0,0,1,0,"https://fbref.com/en/players/26d3b5be/Ellis-Simms"
2023,"Everton","Premier League","James Tarkowski","ENG","DF","29",1992,38,51,26,36,13,2,20,38,52.6,18,99,78,21,51,102,201,3,"https://fbref.com/en/players/15ea812b/James-Tarkowski"
2023,"Everton","Premier League","Rúben Vinagre","POR","DF,MF","23",1999,0.3,2,2,1,1,0,1,2,50,1,0,0,0,0,2,1,0,"https://fbref.com/en/players/b937e490/Ruben-Vinagre"
2023,"Fiorentina","Serie A","Sofyan Amrabat","MAR","MF","25",1996,22.2,39,24,15,17,7,16,29,55.2,13,23,5,18,21,60,18,2,"https://fbref.com/en/players/5a2cb25d/Sofyan-Amrabat"
2023,"Fiorentina","Serie A","Arthur","BRA","FW","24",1998,15.9,9,2,1,4,4,4,8,50,4,10,1,9,1,10,12,0,"https://fbref.com/en/players/a820e429/Arthur"
2023,"Fiorentina","Serie A","Antonín Barák","CZE","MF","27",1994,20,21,9,5,7,9,6,16,37.5,10,16,2,14,3,24,13,0,"https://fbref.com/en/players/01efac19/Antonin-Barak"
2023,"Fiorentina","Serie A","Marco Benassi","ITA","DF","27",1994,1,3,3,2,0,1,3,4,75,1,0,0,0,1,4,1,0,"https://fbref.com/en/players/0000acda/Marco-Benassi"
2023,"Fiorentina","Serie A","Alessandro Bianco","ITA","MF","19",2002,1.7,5,2,2,3,0,2,3,66.7,1,1,0,1,0,5,0,0,"https://fbref.com/en/players/d65cf468/Alessandro-Bianco"
2023,"Fiorentina","Serie A","Cristiano Biraghi","ITA","DF","29",1992,28.3,65,38,29,29,7,32,65,49.2,33,32,7,25,14,79,42,1,"https://fbref.com/en/players/9e1577aa/Cristiano-Biraghi"
2023,"Fiorentina","Serie A","Giacomo Bonaventura","ITA","MF","32",1989,21.2,35,23,14,15,6,24,37,64.9,13,14,0,14,16,51,5,1,"https://fbref.com/en/players/d995ed27/Giacomo-Bonaventura"
2023,"Fiorentina","Serie A","Josip Brekalo","CRO","FW,MF","24",1998,2.5,2,1,0,1,1,1,4,25,3,1,0,1,1,3,1,0,"https://fbref.com/en/players/d4a2533d/Josip-Brekalo"
2023,"Fiorentina","Serie A","Gaetano Castrovilli","ITA","MF","25",1997,8,10,8,1,7,2,2,9,22.2,7,5,1,4,8,18,5,0,"https://fbref.com/en/players/0728bebe/Gaetano-Castrovilli"
2023,"Fiorentina","Serie A","Michele Cerofolini","ITA","GK","23",1999,5,0,0,0,0,0,0,0,NA,0,0,0,0,1,1,2,0,"https://fbref.com/en/players/efdeaff3/Michele-Cerofolini"
2023,"Fiorentina","Serie A","Dodô","BRA","DF","23",1998,25.9,40,22,20,14,6,22,46,47.8,24,26,2,24,25,65,37,0,"https://fbref.com/en/players/b5f7d10b/Dodo"
2023,"Fiorentina","Serie A","Alfred Duncan","GHA","MF","29",1993,12.3,18,10,0,17,1,10,21,47.6,11,9,0,9,8,26,6,0,"https://fbref.com/en/players/528492ea/Alfred-Duncan"
2023,"Fiorentina","Serie A","Pierluigi Gollini","ITA","GK","27",1995,3,1,0,1,0,0,1,1,100,0,0,0,0,0,1,2,0,"https://fbref.com/en/players/f0f7f62f/Pierluigi-Gollini"
2023,"Fiorentina","Serie A","Nicolás González","ARG","FW,MF","24",1998,15,17,10,3,10,4,5,16,31.3,11,14,0,14,4,21,6,0,"https://fbref.com/en/players/2374aaca/Nicolas-Gonzalez"
2023,"Fiorentina","Serie A","Igor","BRA","DF","24",1998,22.9,43,29,21,18,4,20,27,74.1,7,33,14,19,25,68,56,2,"https://fbref.com/en/players/a4e85758/Igor"
2023,"Fiorentina","Serie A","Jonathan Ikone","FRA","FW","24",1998,22.3,16,8,5,6,5,5,14,35.7,9,18,1,17,4,20,3,0,"https://fbref.com/en/players/42eaa028/Jonathan-Ikone"
2023,"Fiorentina","Serie A","Luka Jović","SRB","FW,MF","24",1997,17,6,3,1,4,1,2,8,25,6,7,2,5,2,8,10,0,"https://fbref.com/en/players/4d8cd038/Luka-Jovic"
2023,"Fiorentina","Serie A","Christian Kouamé","CIV","FW","24",1997,20.7,27,18,8,10,9,7,14,50,7,15,3,12,12,39,8,0,"https://fbref.com/en/players/58e933d2/Christian-Kouame"
2023,"Fiorentina","Serie A","Youssef Maleh","MAR","MF","23",1998,3.3,3,1,0,3,0,0,4,0,4,5,0,5,1,4,3,0,"https://fbref.com/en/players/4c8845f7/Youssef-Maleh"
2023,"Fiorentina","Serie A","Rolando Mandragora","ITA","MF","25",1997,21.7,42,24,12,22,8,23,52,44.2,29,25,3,22,16,58,21,0,"https://fbref.com/en/players/c7259b83/Rolando-Mandragora"
2023,"Fiorentina","Serie A","Lucas Martínez Quarta","ARG","DF","26",1996,24.1,80,48,44,32,4,42,61,68.9,19,41,19,22,48,128,78,1,"https://fbref.com/en/players/3ec3c1c9/Lucas-Martinez-Quarta"
2023,"Fiorentina","Serie A","Nikola Milenković","SRB","DF","24",1997,23.7,40,25,20,17,3,18,27,66.7,9,27,14,13,22,62,72,0,"https://fbref.com/en/players/bee704fc/Nikola-Milenkovic"
2023,"Fiorentina","Serie A","Luca Ranieri","ITA","DF","23",1999,5.6,9,4,6,3,0,6,9,66.7,3,5,3,2,11,20,15,1,"https://fbref.com/en/players/8c63fae5/Luca-Ranieri"
2023,"Fiorentina","Serie A","Riccardo Saponara","ITA","FW","30",1991,13.4,10,5,3,6,1,5,9,55.6,4,7,1,6,5,15,9,1,"https://fbref.com/en/players/3bb7af3b/Riccardo-Saponara"
2023,"Fiorentina","Serie A","Salvatore Sirigu","ITA","GK","35",1987,1,0,0,0,0,0,0,0,NA,0,0,0,0,0,0,1,0,"https://fbref.com/en/players/10dc46f0/Salvatore-Sirigu"
2023,"Fiorentina","Serie A","Riccardo Sottil","ITA","FW","23",1999,9.3,4,3,2,0,2,2,5,40,3,2,0,2,0,4,0,0,"https://fbref.com/en/players/94816803/Riccardo-Sottil"
2023,"Fiorentina","Serie A","Pietro Terracciano","ITA","GK","32",1990,29,2,1,2,0,0,2,3,66.7,1,0,0,0,1,3,14,0,"https://fbref.com/en/players/e1b0a70d/Pietro-Terracciano"
2023,"Fiorentina","Serie A","Aleksa Terzić","SRB","DF","22",1999,10.4,16,9,9,4,3,11,21,52.4,10,13,4,9,5,21,16,0,"https://fbref.com/en/players/3ef0a2d7/Aleksa-Terzic"
2023,"Fiorentina","Serie A","Lorenzo Venuti","ITA","DF","27",1995,10.3,18,7,6,11,1,11,18,61.1,7,7,2,5,5,23,17,2,"https://fbref.com/en/players/983ff2c7/Lorenzo-Venuti"
2023,"Fiorentina","Serie A","Szymon Żurkowski","POL","MF","24",1997,0.4,0,0,0,0,0,0,0,NA,0,0,0,0,0,0,0,0,"https://fbref.com/en/players/4e1d5e59/Szymon-Zurkowski"
2023,"Freiburg","Bundesliga","Ritsu Doan","JPN","MF,FW","24",1998,26.9,61,29,19,29,13,25,54,46.3,29,40,1,39,14,75,12,0,"https://fbref.com/en/players/d01bbb6f/Ritsu-Doan"
2023,"Freiburg","Bundesliga","Maximilian Eggestein","GER","MF","25",1996,27.2,51,29,21,24,6,17,35,48.6,18,37,8,29,36,87,27,0,"https://fbref.com/en/players/beb882a8/Maximilian-Eggestein"
2023,"Freiburg","Bundesliga","Kimberly Ezekwem","GER","DF","21",2001,0.1,0,0,0,0,0,0,0,NA,0,1,0,1,0,0,0,0,"https://fbref.com/en/players/56e6a1c9/Kimberly-Ezekwem"
2023,"Freiburg","Bundesliga","Mark Flekken","NED","GK","29",1993,34,0,0,0,0,0,0,1,0,1,1,0,1,0,0,9,5,"https://fbref.com/en/players/a92ab7be/Mark-Flekken"
2023,"Freiburg","Bundesliga","Matthias Ginter","GER","DF","28",1994,34,43,20,29,12,2,26,40,65,14,40,24,16,35,78,153,3,"https://fbref.com/en/players/f521b80a/Matthias-Ginter"
2023,"Freiburg","Bundesliga","Michael Gregoritsch","AUT","FW","28",1994,23.9,19,12,6,9,4,3,21,14.3,18,23,4,19,5,24,10,0,"https://fbref.com/en/players/8e235926/Michael-Gregoritsch"
2023,"Freiburg","Bundesliga","Vincenzo Grifo","ITA","MF,FW","29",1993,26.8,29,16,6,15,8,13,31,41.9,18,18,1,17,19,48,19,0,"https://fbref.com/en/players/54e4866f/Vincenzo-Grifo"
2023,"Freiburg","Bundesliga","Manuel Gulde","GER","DF","31",1991,7.1,14,8,10,4,0,2,4,50,2,5,1,4,19,33,25,0,"https://fbref.com/en/players/25ab9c9c/Manuel-Gulde"
2023,"Freiburg","Bundesliga","Christian Günter","GER","DF,MF","29",1993,30.5,29,21,18,9,2,13,43,30.2,30,22,4,18,16,45,41,0,"https://fbref.com/en/players/8593f88c/Christian-Gunter"
2023,"Freiburg","Bundesliga","Nicolas Höfler","GER","MF","32",1990,31.3,66,35,28,35,3,27,61,44.3,34,40,13,27,58,124,49,0,"https://fbref.com/en/players/5d8e331f/Nicolas-Hofler"
2023,"Freiburg","Bundesliga","Lucas Höler","GER","FW,MF","28",1994,16.7,19,14,5,7,7,6,22,27.3,16,22,5,17,10,29,17,0,"https://fbref.com/en/players/ca618d23/Lucas-Holer"
2023,"Freiburg","Bundesliga","Yannik Keitel","GER","MF","22",2000,7.6,11,7,4,6,1,3,5,60,2,6,3,3,13,24,8,0,"https://fbref.com/en/players/d2c580ce/Yannik-Keitel"
2023,"Freiburg","Bundesliga","Lukas Kübler","GER","DF","29",1992,18.2,37,25,24,9,4,18,30,60,12,25,11,14,29,66,50,0,"https://fbref.com/en/players/2a29eb9b/Lukas-Kubler"
2023,"Freiburg","Bundesliga","Daniel Kyereh","GHA","MF,FW","26",1996,6.2,6,4,2,4,0,3,6,50,3,4,0,4,2,8,6,0,"https://fbref.com/en/players/2770726a/Daniel-Kyereh"
2023,"Freiburg","Bundesliga","Philipp Lienhart","AUT","DF","26",1996,27.8,29,18,19,10,0,13,27,48.1,14,29,15,14,35,64,97,0,"https://fbref.com/en/players/302527b2/Philipp-Lienhart"
2023,"Freiburg","Bundesliga","Nils Petersen","GER","FW","33",1988,3.1,6,4,0,3,3,2,5,40,3,11,2,9,1,7,6,0,"https://fbref.com/en/players/f93e6e94/Nils-Petersen"
2023,"Freiburg","Bundesliga","Merlin Röhl","GER","MF,FW","20",2002,0.6,1,0,1,0,0,0,0,NA,0,0,0,0,0,1,1,0,"https://fbref.com/en/players/1f2c7b55/Merlin-Rohl"
2023,"Freiburg","Bundesliga","Roland Sallai","HUN","MF,FW","25",1997,11.1,11,8,4,3,4,4,10,40,6,7,1,6,2,13,11,0,"https://fbref.com/en/players/bf075f6b/Roland-Sallai"
2023,"Freiburg","Bundesliga","Kevin Schade","GER","FW,MF","20",2001,2,6,4,3,2,1,3,5,60,2,0,0,0,0,6,2,0,"https://fbref.com/en/players/52afb588/Kevin-Schade"
2023,"Freiburg","Bundesliga","Keven Schlotterbeck","GER","DF","25",1997,0.2,0,0,0,0,0,0,0,NA,0,1,1,0,2,2,2,0,"https://fbref.com/en/players/f6bdc830/Keven-Schlotterbeck"
2023,"Freiburg","Bundesliga","Jonathan Schmid","FRA","DF","32",1990,0.5,1,1,1,0,0,0,0,NA,0,1,0,1,1,2,1,1,"https://fbref.com/en/players/088ca1bd/Jonathan-Schmid"
2023,"Freiburg","Bundesliga","Kenneth Schmidt","GER","DF","20",2002,2.8,6,3,4,2,0,5,6,83.3,1,4,2,2,0,6,2,0,"https://fbref.com/en/players/7d31f1cb/Kenneth-Schmidt"
2023,"Freiburg","Bundesliga","Kiliann Sildillia","FRA","DF,MF","20",2002,22,33,20,10,19,4,18,30,60,12,24,9,15,21,54,47,1,"https://fbref.com/en/players/313254a3/Kiliann-Sildillia"
2023,"Freiburg","Bundesliga","Hugo Siquet","BEL","DF","20",2002,0.2,2,2,2,0,0,2,2,100,0,1,0,1,0,2,0,0,"https://fbref.com/en/players/c6cf860f/Hugo-Siquet"
2023,"Freiburg","Bundesliga","Robert Wagner","GER","MF","19",2003,0.4,0,0,0,0,0,0,0,NA,0,2,0,2,0,0,2,0,"https://fbref.com/en/players/e3d3fbeb/Robert-Wagner"
2023,"Freiburg","Bundesliga","Noah Weißhaupt","GER","MF,DF","20",2001,4.7,11,6,3,7,1,2,7,28.6,5,4,0,4,6,17,8,0,"https://fbref.com/en/players/dd676a97/Noah-Weisshaupt"
2023,"Freiburg","Bundesliga","Jeong Woo-yeong","KOR","MF,FW","22",1999,7.3,7,3,4,2,1,2,5,40,3,7,1,6,1,8,7,0,"https://fbref.com/en/players/6190474d/Jeong-Woo-yeong"
2023,"Fulham","Premier League","Tosin Adarabioyo","ENG","DF","24",1997,23.2,30,13,22,6,2,16,23,69.6,7,20,15,5,26,56,140,1,"https://fbref.com/en/players/c81d773d/Tosin-Adarabioyo"
2023,"Fulham","Premier League","Tom Cairney","SCO","MF","31",1991,11,17,6,4,8,5,7,10,70,3,18,3,15,5,22,3,0,"https://fbref.com/en/players/a8748947/Tom-Cairney"
2023,"Fulham","Premier League","Nathaniel Chalobah","ENG","MF","27",1994,0.1,1,1,1,0,0,1,1,100,0,0,0,0,0,1,2,0,"https://fbref.com/en/players/422862ea/Nathaniel-Chalobah"
2023,"Fulham","Premier League","Issa Diop","FRA","DF","25",1997,22.4,28,19,18,9,1,17,32,53.1,15,24,17,7,35,63,86,0,"https://fbref.com/en/players/a712ca2b/Issa-Diop"
2023,"Fulham","Premier League","Shane Duffy","IRL","DF,FW","30",1992,0.2,0,0,0,0,0,0,0,NA,0,0,0,0,0,0,0,1,"https://fbref.com/en/players/7314bba4/Shane-Duffy"
2023,"Fulham","Premier League","Tyrese Francois","AUS","FW","22",2000,0,0,0,0,0,0,0,0,NA,0,0,0,0,0,0,1,0,"https://fbref.com/en/players/6722d4f0/Tyrese-Francois"
2023,"Fulham","Premier League","Luke Harris","WAL","MF,FW","17",2005,0.1,0,0,0,0,0,0,0,NA,0,0,0,0,0,0,0,0,"https://fbref.com/en/players/8c3078cd/Luke-Harris"
2023,"Fulham","Premier League","Daniel James","WAL","FW","24",1997,6.9,9,5,4,4,1,4,8,50,4,5,1,4,1,10,5,0,"https://fbref.com/en/players/c931d9f9/Daniel-James"
2023,"Fulham","Premier League","Neeskens Kebano","COD","FW","30",1992,8.5,17,9,8,6,3,9,17,52.9,8,14,0,14,1,18,8,0,"https://fbref.com/en/players/18b999f4/Neeskens-Kebano"
2023,"Fulham","Premier League","Layvin Kurzawa","FRA","DF","29",1992,1.5,3,2,1,1,1,3,3,100,0,1,1,0,2,5,4,0,"https://fbref.com/en/players/41e7ef1c/Layvin-Kurzawa"
2023,"Fulham","Premier League","Bernd Leno","GER","GK","30",1992,36,0,0,0,0,0,0,2,0,2,0,0,0,0,0,18,0,"https://fbref.com/en/players/2628fd2b/Bernd-Leno"
2023,"Fulham","Premier League","Saša Lukić","SRB","MF","25",1996,4.6,8,3,1,4,3,3,7,42.9,4,6,2,4,5,13,3,0,"https://fbref.com/en/players/c6e8cf1f/Sasa-Lukic"
2023,"Fulham","Premier League","Kevin Mbabu","SUI","DF,FW","27",1995,1.6,3,2,2,1,0,1,3,33.3,2,2,0,2,3,6,3,0,"https://fbref.com/en/players/493924a7/Kevin-Mbabu"
2023,"Fulham","Premier League","Aleksandar Mitrović","SRB","FW","27",1994,22.3,14,7,8,4,2,5,12,41.7,7,22,5,17,3,17,20,1,"https://fbref.com/en/players/3925dbd6/Aleksandar-Mitrovic"
2023,"Fulham","Premier League","Josh Onomah","ENG","MF","25",1997,0.2,1,0,1,0,0,0,0,NA,0,1,0,1,0,1,0,0,"https://fbref.com/en/players/6612cd8c/Josh-Onomah"
2023,"Fulham","Premier League","João Palhinha","POR","MF","27",1995,34.5,147,83,58,65,24,71,134,53,63,48,5,43,46,193,61,2,"https://fbref.com/en/players/a78ff07f/Joao-Palhinha"
2023,"Fulham","Premier League","Andreas Pereira","BRA","MF","26",1996,29.9,18,9,3,6,9,8,33,24.2,25,21,3,18,6,24,8,0,"https://fbref.com/en/players/6639e500/Andreas-Pereira"
2023,"Fulham","Premier League","Tim Ream","USA","DF","34",1987,32.2,30,16,15,12,3,13,26,50,13,45,24,21,41,71,116,2,"https://fbref.com/en/players/28b40c9c/Tim-Ream"
2023,"Fulham","Premier League","Harrison Reed","ENG","MF","27",1995,31.8,44,27,17,21,6,16,50,32,34,54,12,42,19,63,36,0,"https://fbref.com/en/players/803ae100/Harrison-Reed"
2023,"Fulham","Premier League","Bobby Reid","JAM","FW,DF","29",1993,27.5,42,24,14,14,14,16,34,47.1,18,25,3,22,20,62,28,1,"https://fbref.com/en/players/0f7533cd/Bobby-Reid"
2023,"Fulham","Premier League","Antonee Robinson","USA","DF","24",1997,34.3,62,38,43,15,4,44,65,67.7,21,49,13,36,53,115,83,3,"https://fbref.com/en/players/289601e6/Antonee-Robinson"
2023,"Fulham","Premier League","Marek Rodák","SVK","GK","25",1996,2,0,0,0,0,0,0,0,NA,0,0,0,0,0,0,1,1,"https://fbref.com/en/players/17acc2ed/Marek-Rodak"
2023,"Fulham","Premier League","Cédric Soares","POR","DF","30",1991,2.2,8,5,4,3,1,3,3,100,0,3,1,2,1,9,5,0,"https://fbref.com/en/players/839c14e1/Cedric-Soares"
2023,"Fulham","Premier League","Manor Solomon","ISR","FW","23",1999,6.4,20,12,12,6,2,9,16,56.3,7,8,0,8,5,25,3,0,"https://fbref.com/en/players/886f9aac/Manor-Solomon"
2023,"Fulham","Premier League","Jay Stansfield","ENG","FW","19",2002,1,0,0,0,0,0,0,2,0,2,4,1,3,1,1,1,0,"https://fbref.com/en/players/b2626673/Jay-Stansfield"
2023,"Fulham","Premier League","Kenny Tete","NED","DF","26",1995,28.5,83,46,41,29,13,38,50,76,12,48,17,31,52,135,81,1,"https://fbref.com/en/players/77d7c96f/Kenny-Tete"
2023,"Fulham","Premier League","Carlos Vinícius","BRA","FW","27",1995,12.3,4,1,0,2,2,0,4,0,4,7,0,7,0,4,10,0,"https://fbref.com/en/players/8b529245/Carlos-Vinicius"
2023,"Fulham","Premier League","Willian","BRA","FW","33",1988,23.6,13,8,8,3,2,7,25,28,18,13,0,13,9,22,9,0,"https://fbref.com/en/players/8b9ebd03/Willian"
2023,"Fulham","Premier League","Harry Wilson","WAL","FW","25",1997,12.2,21,13,9,9,3,8,18,44.4,10,17,2,15,6,27,14,0,"https://fbref.com/en/players/c6dc9ecd/Harry-Wilson"
2023,"Getafe","La Liga","Omar Alderete","PAR","DF","25",1996,22.7,35,20,21,14,0,28,40,70,12,23,16,7,26,61,85,0,"https://fbref.com/en/players/bb08bce9/Omar-Alderete"
2023,"Getafe","La Liga","Carles Aleñá","ESP","MF,FW","24",1998,23.5,18,10,7,5,6,5,34,14.7,29,19,1,18,4,22,18,0,"https://fbref.com/en/players/6c811eb7/Carles-Alena"
2023,"Getafe","La Liga","Ángel Algobia","ESP","MF","23",1999,12.6,27,13,14,13,0,22,48,45.8,26,15,5,10,3,30,11,0,"https://fbref.com/en/players/acc1aefa/Angel-Algobia"
2023,"Getafe","La Liga","Gastón Álvarez","URU","DF","22",2000,16.7,38,30,24,9,5,23,42,54.8,19,15,5,10,15,53,35,0,"https://fbref.com/en/players/852ddfb8/Gaston-Alvarez"
2023,"Getafe","La Liga","Jordan Amavi","FRA","DF","28",1994,2.2,3,2,3,0,0,1,3,33.3,2,3,0,3,4,7,7,0,"https://fbref.com/en/players/22721b88/Jordan-Amavi"
2023,"Getafe","La Liga","Fabrizio Angileri","ARG","DF","28",1994,6.5,12,9,8,3,1,10,17,58.8,7,8,3,5,7,19,10,0,"https://fbref.com/en/players/fdd26d71/Fabrizio-Angileri"
2023,"Getafe","La Liga","Mauro Arambarri","URU","MF","26",1995,11,14,6,9,4,1,3,17,17.6,14,17,5,12,14,28,19,0,"https://fbref.com/en/players/58afe001/Mauro-Arambarri"
2023,"Getafe","La Liga","Djené","TOG","DF","30",1991,31.6,41,28,23,17,1,22,38,57.9,16,25,10,15,42,83,81,1,"https://fbref.com/en/players/a4971d84/Djene"
2023,"Getafe","La Liga","Domingos Duarte","POR","DF","27",1995,29.5,26,18,21,5,0,19,26,73.1,7,29,23,6,39,65,145,0,"https://fbref.com/en/players/93090f69/Domingos-Duarte"
2023,"Getafe","La Liga","Munir El Haddadi","MAR","MF,FW","26",1995,12.8,12,7,3,7,2,2,10,20,8,23,2,21,9,21,7,0,"https://fbref.com/en/players/8696bc90/Munir-El-Haddadi"
2023,"Getafe","La Liga","Iglesias","ESP","DF,MF","24",1998,23.8,61,35,40,18,3,33,65,50.8,32,40,5,35,21,82,91,1,"https://fbref.com/en/players/974322dc/Iglesias"
2023,"Getafe","La Liga","Latasa","ESP","FW","21",2001,5,5,4,2,0,3,1,1,100,0,3,1,2,1,6,8,0,"https://fbref.com/en/players/2bea832e/Latasa"
2023,"Getafe","La Liga","Nemanja Maksimović","SRB","MF","27",1995,22.8,41,30,17,18,6,19,32,59.4,13,36,14,22,34,75,27,0,"https://fbref.com/en/players/00b28772/Nemanja-Maksimovic"
2023,"Getafe","La Liga","Jaime Mata","ESP","FW,MF","33",1988,4.9,13,10,4,5,4,7,22,31.8,15,7,2,5,3,16,6,0,"https://fbref.com/en/players/02319ad7/Jaime-Mata"
2023,"Getafe","La Liga","Borja Mayoral","ESP","FW","25",1997,30.7,9,4,7,2,0,5,31,16.1,26,18,0,18,3,12,10,0,"https://fbref.com/en/players/64e8ed6d/Borja-Mayoral"
2023,"Getafe","La Liga","Luis Milla","ESP","MF","27",1994,20.6,48,30,21,18,9,19,44,43.2,25,13,1,12,32,80,25,1,"https://fbref.com/en/players/19c36442/Luis-Milla"
2023,"Getafe","La Liga","Stefan Mitrović","SRB","DF","32",1990,18.7,14,6,12,2,0,7,11,63.6,4,12,10,2,17,31,90,2,"https://fbref.com/en/players/e6777e6b/Stefan-Mitrovic"
2023,"Getafe","La Liga","Moises Parra Gutierrez","ESP","FW","20",2002,0.1,1,0,0,1,0,0,0,NA,0,0,0,0,0,1,0,0,"https://fbref.com/en/players/e2dcc60e/Moises-Parra-Gutierrez"
2023,"Getafe","La Liga","Portu","ESP","MF,DF","30",1992,19.7,28,21,14,10,4,18,42,42.9,24,23,3,20,17,45,20,1,"https://fbref.com/en/players/1bda5842/Portu"
2023,"Getafe","La Liga","Alejandro Revuelta Montero","ESP","DF","22",2000,0,0,0,0,0,0,0,0,NA,0,0,0,0,0,0,1,0,"https://fbref.com/en/players/14d5b7ac/Alejandro-Revuelta-Montero"
2023,"Getafe","La Liga","Jaime Seoane","ESP","MF,FW","25",1997,3.6,10,4,3,4,3,2,8,25,6,7,3,4,1,11,2,0,"https://fbref.com/en/players/a62b4888/Jaime-Seoane"
2023,"Getafe","La Liga","David Soria","ESP","GK","29",1993,38,0,0,0,0,0,0,1,0,1,0,0,0,1,1,20,4,"https://fbref.com/en/players/8f8c6934/David-Soria"
2023,"Getafe","La Liga","Damián Suárez","URU","DF,MF","34",1988,21.6,49,33,23,19,7,26,48,54.2,22,40,0,40,15,64,36,0,"https://fbref.com/en/players/ba5004e1/Damian-Suarez"
2023,"Getafe","La Liga","Enes Ünal","TUR","FW","25",1997,33,26,14,5,19,2,7,25,28,18,19,2,17,6,32,35,0,"https://fbref.com/en/players/f8eca1b6/Enes-Unal"
2023,"Getafe","La Liga","Gonzalo Villar","ESP","MF","24",1998,5.1,10,5,1,6,3,6,14,42.9,8,9,2,7,6,16,5,0,"https://fbref.com/en/players/bdc74a8f/Gonzalo-Villar"
2023,"Girona","La Liga","Ricard Artero","ESP","MF,FW","19",2003,1.5,3,3,2,1,0,1,1,100,0,2,0,2,1,4,3,0,"https://fbref.com/en/players/5d133e96/Ricard-Artero"
2023,"Girona","La Liga","Santiago Bueno","URU","DF","23",1998,33.4,63,38,43,19,1,24,36,66.7,12,34,22,12,31,94,105,2,"https://fbref.com/en/players/edc98fac/Santiago-Bueno"
2023,"Girona","La Liga","Alexander Callens","PER","DF","30",1992,1.3,3,3,2,1,0,3,4,75,1,3,1,2,1,4,9,0,"https://fbref.com/en/players/af34f10d/Alexander-Callens"
2023,"Girona","La Liga","Juan Carlos","ESP","GK","34",1988,10,0,0,0,0,0,0,0,NA,0,0,0,0,1,1,7,1,"https://fbref.com/en/players/688b96e3/Juan-Carlos"
2023,"Girona","La Liga","Casals","ESP","MF","17",2005,0.9,NA,2,NA,NA,NA,NA,NA,NA,NA,NA,NA,NA,0,NA,NA,NA,"https://fbref.com/en/players/ebeb2c4a/Casals"
2023,"Girona","La Liga","Valentín Castellanos","ARG","FW","23",1998,28.9,12,5,2,7,3,0,18,0,18,22,2,20,6,18,26,0,"https://fbref.com/en/players/da76bab4/Valentin-Castellanos"
2023,"Girona","La Liga","Yan Couto","BRA","DF,MF","20",2002,12.9,25,18,11,11,3,12,20,60,8,7,2,5,5,30,10,0,"https://fbref.com/en/players/1944818c/Yan-Couto"
2023,"Girona","La Liga","Bernardo Espinosa","COL","DF","33",1989,13.6,6,2,2,4,0,3,9,33.3,6,17,10,7,12,18,70,2,"https://fbref.com/en/players/4242011c/Bernardo-Espinosa"
2023,"Girona","La Liga","Aleix García","ESP","MF","25",1997,26,37,20,9,18,10,15,33,45.5,18,24,8,16,31,68,35,1,"https://fbref.com/en/players/a10361d2/Aleix-Garcia"
2023,"Girona","La Liga","Borja García","ESP","MF,FW","31",1990,7.5,10,4,7,2,1,2,9,22.2,7,3,1,2,5,15,6,1,"https://fbref.com/en/players/e7f4603c/Borja-Garcia"
2023,"Girona","La Liga","Paulo Gazzaniga","ARG","GK","30",1992,28,0,0,0,0,0,0,1,0,1,0,0,0,1,1,9,5,"https://fbref.com/en/players/63d17038/Paulo-Gazzaniga"
2023,"Girona","La Liga","Miguel Gutiérrez","ESP","DF","21",2001,26.6,41,23,23,13,5,23,37,62.2,14,23,5,18,18,59,42,1,"https://fbref.com/en/players/7e98cff1/Miguel-Gutierrez"
2023,"Girona","La Liga","Javi Hernández","ESP","DF","24",1998,12.4,21,12,12,7,2,13,21,61.9,8,10,5,5,7,28,38,0,"https://fbref.com/en/players/9a76c2e9/Javi-Hernandez"
2023,"Girona","La Liga","Yangel Herrera","VEN","MF,FW","24",1998,10.7,26,9,9,14,3,6,15,40,9,14,1,13,4,30,12,0,"https://fbref.com/en/players/5083a734/Yangel-Herrera"
2023,"Girona","La Liga","Juanpe","ESP","DF","31",1991,15.8,19,11,10,9,0,11,17,64.7,6,12,9,3,10,29,60,1,"https://fbref.com/en/players/1633fc8a/Juanpe"
2023,"Girona","La Liga","David López","ESP","DF","32",1989,18.4,31,18,17,13,1,19,27,70.4,8,29,19,10,14,45,64,1,"https://fbref.com/en/players/f03f284b/David-Lopez"
2023,"Girona","La Liga","Iván Martín","ESP","MF","23",1999,17.6,9,7,4,4,1,8,23,34.8,15,12,0,12,9,18,12,0,"https://fbref.com/en/players/ae48c5cb/Ivan-Martin"
2023,"Girona","La Liga","Arnau Martinez","ESP","DF","19",2003,30.4,69,45,41,19,9,38,85,44.7,47,44,10,34,25,94,54,2,"https://fbref.com/en/players/c3e66ffe/Arnau-Martinez"
2023,"Girona","La Liga","Reinier","BRA","MF,FW","20",2002,7.2,12,10,7,3,2,2,8,25,6,6,0,6,5,17,4,0,"https://fbref.com/en/players/6b21b7b5/Reinier"
2023,"Girona","La Liga","Rodrigo Riquelme","ESP","MF,FW","22",2000,24.2,20,8,8,8,4,9,35,25.7,26,16,0,16,11,31,5,0,"https://fbref.com/en/players/65154df0/Rodrigo-Riquelme"
2023,"Girona","La Liga","Oriol Romeu","ESP","MF","30",1991,32.8,70,38,36,26,8,26,51,51,25,48,10,38,37,107,54,0,"https://fbref.com/en/players/4b511457/Oriol-Romeu"
2023,"Girona","La Liga","Samuel Sáiz","ESP","MF","31",1991,2.7,2,2,0,2,0,1,2,50,1,3,0,3,0,2,1,1,"https://fbref.com/en/players/13e0eb29/Samuel-Saiz"
2023,"Girona","La Liga","Cristhian Stuani","URU","FW","35",1986,12.1,13,6,2,7,4,5,14,35.7,9,10,0,10,2,15,5,0,"https://fbref.com/en/players/220c11f1/Cristhian-Stuani"
2023,"Girona","La Liga","Ramón Terrats","ESP","MF","21",2000,2.4,4,2,1,3,0,2,6,33.3,4,6,2,4,3,7,3,1,"https://fbref.com/en/players/f36016a5/Ramon-Terrats"
2023,"Girona","La Liga","Viktor Tsyhankov","UKR","MF","24",1997,16.5,8,8,5,1,2,1,14,7.1,13,13,2,11,7,15,12,0,"https://fbref.com/en/players/f7e87032/Viktor-Tsyhankov"
2023,"Girona","La Liga","Oscar Ureña","ESP","MF","19",2003,1.1,4,2,2,2,0,2,3,66.7,1,2,0,2,1,5,0,0,"https://fbref.com/en/players/2dd7e29d/Oscar-Urena"
2023,"Girona","La Liga","Valery","ESP","MF,DF","22",1999,10.7,12,6,4,6,2,5,9,55.6,4,8,1,7,10,22,9,1,"https://fbref.com/en/players/4acd733a/Valery"
2023,"Girona","La Liga","Manu Vallejo","ESP","FW,MF","25",1997,2.3,4,1,1,2,1,1,6,16.7,5,2,0,2,1,5,3,0,"https://fbref.com/en/players/0bc4e720/Manu-Vallejo"
2023,"Girona","La Liga","Toni Villa","ESP","MF,FW","27",1995,9.9,25,18,9,11,5,10,23,43.5,13,8,0,8,8,33,3,0,"https://fbref.com/en/players/636eae97/Toni-Villa"
2023,"Hellas Verona","Serie A","Oliver Abildgaard","DEN","MF","26",1996,6.6,10,6,6,3,1,7,16,43.8,9,7,1,6,5,15,17,0,"https://fbref.com/en/players/8f5cdf66/Oliver-Abildgaard"
2023,"Hellas Verona","Serie A","Bruno Amione","ARG","DF","20",2002,0.6,1,1,1,0,0,1,2,50,1,1,0,1,0,1,4,0,"https://fbref.com/en/players/2df7cc43/Bruno-Amione"
2023,"Hellas Verona","Serie A","Antonín Barák","CZE","MF","27",1994,0.3,0,0,0,0,0,0,0,NA,0,0,0,0,0,0,0,0,"https://fbref.com/en/players/01efac19/Antonin-Barak"
2023,"Hellas Verona","Serie A","Jayden Braaf","NED","MF,FW","19",2002,3.2,5,3,2,3,0,0,0,NA,0,1,0,1,2,7,1,0,"https://fbref.com/en/players/c609e90e/Jayden-Braaf"
2023,"Hellas Verona","Serie A","Juan Cabal","COL","DF","21",2001,4.9,10,6,7,3,0,7,12,58.3,5,8,5,3,13,23,12,0,"https://fbref.com/en/players/ef6eef89/Juan-Cabal"
2023,"Hellas Verona","Serie A","Federico Ceccherini","ITA","DF","30",1992,15.7,25,19,15,9,1,13,23,56.5,10,17,10,7,19,44,55,0,"https://fbref.com/en/players/d9624b51/Federico-Ceccherini"
2023,"Hellas Verona","Serie A","Diego Coppola","ITA","DF","18",2003,13.1,25,17,15,10,0,11,24,45.8,13,20,6,14,14,39,38,0,"https://fbref.com/en/players/22ae86f9/Diego-Coppola"
2023,"Hellas Verona","Serie A","Alessandro Cortinovis","ITA","MF","21",2001,0.1,1,0,1,0,0,0,0,NA,0,1,0,1,0,1,0,0,"https://fbref.com/en/players/bfc359ed/Alessandro-Cortinovis"
2023,"Hellas Verona","Serie A","Paweł Dawidowicz","POL","DF","27",1995,18.1,48,31,28,17,3,22,31,71,9,14,9,5,23,71,71,0,"https://fbref.com/en/players/16bb656a/Pawel-Dawidowicz"
2023,"Hellas Verona","Serie A","Fabio Depaoli","ITA","DF","25",1997,24.1,48,28,25,16,7,25,44,56.8,19,32,6,26,18,66,33,3,"https://fbref.com/en/players/d97f2e8d/Fabio-Depaoli"
2023,"Hellas Verona","Serie A","Josh Doig","SCO","DF","20",2002,15,19,8,6,7,6,6,16,37.5,10,25,6,19,11,30,13,1,"https://fbref.com/en/players/2f69d881/Josh-Doig"
2023,"Hellas Verona","Serie A","Ondrej Duda","SVK","MF","27",1994,11.8,22,14,7,12,3,9,16,56.3,7,11,0,11,13,35,8,0,"https://fbref.com/en/players/79ca3e23/Ondrej-Duda"
2023,"Hellas Verona","Serie A","Davide Faraoni","ITA","DF","30",1991,16.5,34,24,19,13,2,16,41,39,25,30,11,19,15,49,37,0,"https://fbref.com/en/players/aae9d04a/Davide-Faraoni"
2023,"Hellas Verona","Serie A","Adolfo Gaich","ARG","FW","23",1999,8.1,5,3,0,3,2,1,6,16.7,5,7,2,5,3,8,7,1,"https://fbref.com/en/players/8dfed6e9/Adolfo-Gaich"
2023,"Hellas Verona","Serie A","Koray Günter","GER","DF","27",1994,11.1,10,6,1,8,1,4,7,57.1,3,24,15,9,30,40,46,0,"https://fbref.com/en/players/f1f1f238/Koray-Gunter"
2023,"Hellas Verona","Serie A","Thomas Henry","FRA","FW","27",1994,11.4,5,3,1,1,3,1,5,20,4,6,2,4,0,5,14,0,"https://fbref.com/en/players/9ef42479/Thomas-Henry"
2023,"Hellas Verona","Serie A","Isak Hien","SWE","DF","23",1999,29,73,36,54,19,0,38,61,62.3,23,40,17,23,31,104,92,1,"https://fbref.com/en/players/12806697/Isak-Hien"
2023,"Hellas Verona","Serie A","Martin Hongla","CMR","MF","24",1998,5.8,8,5,4,4,0,5,5,100,0,7,1,6,6,14,9,0,"https://fbref.com/en/players/b85bf253/Martin-Hongla"
2023,"Hellas Verona","Serie A","Ajdin Hrustic","AUS","MF","26",1996,2.5,2,1,1,1,0,1,2,50,1,2,0,2,0,2,2,1,"https://fbref.com/en/players/1f2d714c/Ajdin-Hrustic"
2023,"Hellas Verona","Serie A","Ivan Ilić","SRB","MF","21",2001,9.5,16,10,9,7,0,6,11,54.5,5,10,1,9,8,24,14,0,"https://fbref.com/en/players/bb376bed/Ivan-Ilic"
2023,"Hellas Verona","Serie A","Yayah Kallon","SLE","MF,FW","21",2001,9.6,14,10,5,4,5,7,12,58.3,5,10,0,10,8,22,5,0,"https://fbref.com/en/players/f95f49d2/Yayah-Kallon"
2023,"Hellas Verona","Serie A","Kevin Lasagna","ITA","FW,MF","29",1992,17.5,12,6,7,3,2,6,14,42.9,8,17,1,16,5,17,13,0,"https://fbref.com/en/players/09538fdb/Kevin-Lasagna"
2023,"Hellas Verona","Serie A","Darko Lazović","SRB","MF,DF","31",1990,24.9,24,13,9,12,3,13,29,44.8,16,14,3,11,16,40,19,0,"https://fbref.com/en/players/5128bde4/Darko-Lazovic"
2023,"Hellas Verona","Serie A","Giangiacomo Magnani","ITA","DF","26",1995,17,33,22,20,11,2,19,25,76,6,20,15,5,21,54,76,0,"https://fbref.com/en/players/cce9f582/Giangiacomo-Magnani"
2023,"Hellas Verona","Serie A","Lorenzo Montipò","ITA","GK","26",1996,37,1,0,1,0,0,0,3,0,3,1,0,1,0,1,26,3,"https://fbref.com/en/players/c1d95617/Lorenzo-Montipo"
2023,"Hellas Verona","Serie A","Cyril Ngonge","BEL","MF,FW","22",2000,8.3,7,3,2,2,3,3,11,27.3,8,7,0,7,6,13,4,0,"https://fbref.com/en/players/2b8360f1/Cyril-Ngonge"
2023,"Hellas Verona","Serie A","Simone Perilli","ITA","GK","27",1995,1,0,0,0,0,0,0,0,NA,0,0,0,0,0,0,0,0,"https://fbref.com/en/players/b9e11c1d/Simone-Perilli"
2023,"Hellas Verona","Serie A","Roberto Piccoli","ITA","FW","21",2001,2.1,1,0,1,0,0,0,2,0,2,2,0,2,0,1,2,0,"https://fbref.com/en/players/1cadaf34/Roberto-Piccoli"
2023,"Hellas Verona","Serie A","Panagiotis Retsos","GRE","DF","23",1998,1.4,5,4,2,2,1,3,3,100,0,4,1,3,2,7,3,0,"https://fbref.com/en/players/4bd00a50/Panagiotis-Retsos"
2023,"Hellas Verona","Serie A","Ibrahim Sulemana","GHA","MF","19",2003,7.2,19,13,10,7,2,6,12,50,6,8,2,6,14,33,15,0,"https://fbref.com/en/players/230c3f3a/Ibrahim-Sulemana"
2023,"Hellas Verona","Serie A","Adrien Tameze","CMR","MF","28",1994,33.7,51,30,21,26,4,28,63,44.4,35,51,14,37,37,88,55,2,"https://fbref.com/en/players/8da74c05/Adrien-Tameze"
2023,"Hellas Verona","Serie A","Filippo Terracciano","ITA","DF,MF","19",2003,9.1,20,13,11,7,2,15,20,75,5,7,4,3,10,30,14,0,"https://fbref.com/en/players/5cbb5ad6/Filippo-Terracciano"
2023,"Hellas Verona","Serie A","Miguel Veloso","POR","MF","36",1986,12.9,33,10,20,12,1,16,26,61.5,10,26,6,20,6,39,14,0,"https://fbref.com/en/players/ab1ca213/Miguel-Veloso"
2023,"Hellas Verona","Serie A","Simone Verdi","ITA","MF,FW","30",1992,12.2,15,10,7,5,3,6,17,35.3,11,8,1,7,0,15,2,0,"https://fbref.com/en/players/0375723e/Simone-Verdi"
2023,"Hellas Verona","Serie A","Deyovaisio Zeefuik","NED","DF","24",1998,0.1,1,1,0,1,0,0,0,NA,0,0,0,0,0,1,0,0,"https://fbref.com/en/players/58a2e9f6/Deyovaisio-Zeefuik"
2023,"Hellas Verona","Serie A","Milan Đurić","BIH","FW","32",1990,15.2,2,1,1,0,1,1,3,33.3,2,7,4,3,1,3,24,0,"https://fbref.com/en/players/405f6586/Milan-Djuric"
2023,"Hertha BSC","Bundesliga","Kevin-Prince Boateng","GHA","MF","35",1987,5.2,8,6,4,2,2,3,9,33.3,6,11,3,8,3,11,5,0,"https://fbref.com/en/players/f4ec4fd0/Kevin-Prince-Boateng"
2023,"Hertha BSC","Bundesliga","Jean-Paul Boëtius","NED","MF","28",1994,11.7,30,16,19,9,2,8,25,32,17,25,5,20,14,44,10,0,"https://fbref.com/en/players/635f2732/Jean-Paul-Boetius"
2023,"Hertha BSC","Bundesliga","Oliver Christensen","DEN","GK","23",1999,33,1,0,1,0,0,0,2,0,2,0,0,0,0,1,22,2,"https://fbref.com/en/players/af104654/Oliver-Christensen"
2023,"Hertha BSC","Bundesliga","Tolga Ciğerci","TUR","MF","30",1992,7.5,16,13,6,9,1,10,16,62.5,6,6,2,4,8,24,5,0,"https://fbref.com/en/players/6e17c802/Tolga-Cigerci"
2023,"Hertha BSC","Bundesliga","Márton Dárdai","GER","DF,MF","20",2002,10.5,17,8,9,8,0,9,18,50,9,14,9,5,11,28,45,1,"https://fbref.com/en/players/41bff4fa/Marton-Dardai"
2023,"Hertha BSC","Bundesliga","Vladimír Darida","CZE","MF","31",1990,0.3,1,1,0,1,0,0,0,NA,0,1,0,1,0,1,0,0,"https://fbref.com/en/players/3eb0f2df/Vladimir-Darida"
2023,"Hertha BSC","Bundesliga","Julian Eitschberger","GER","FW","18",2004,0,0,0,0,0,0,0,0,NA,0,0,0,0,0,0,0,0,"https://fbref.com/en/players/943b9602/Julian-Eitschberger"
2023,"Hertha BSC","Bundesliga","Chidera Ejuke","NGA","FW,MF","24",1998,9.9,5,4,1,4,0,1,5,20,4,4,0,4,4,9,1,0,"https://fbref.com/en/players/e7f3e8a7/Chidera-Ejuke"
2023,"Hertha BSC","Bundesliga","Tjark Ernst","GER","GK","19",2003,1,0,0,0,0,0,0,0,NA,0,0,0,0,0,0,1,0,"https://fbref.com/en/players/3f6c3ae0/Tjark-Ernst"
2023,"Hertha BSC","Bundesliga","Stevan Jovetić","MNE","FW,MF","32",1989,9.9,3,2,2,1,0,1,11,9.1,10,2,1,1,2,5,10,0,"https://fbref.com/en/players/f36c432f/Stevan-Jovetic"
2023,"Hertha BSC","Bundesliga","Wilfried Kanga","CIV","FW","24",1998,15.7,5,4,2,1,2,2,4,50,2,14,3,11,2,7,13,0,"https://fbref.com/en/players/b4c816a9/Wilfried-Kanga"
2023,"Hertha BSC","Bundesliga","Marc-Oliver Kempf","GER","DF","27",1995,30.1,44,27,29,14,1,16,22,72.7,6,42,32,10,51,95,143,0,"https://fbref.com/en/players/815c314f/Marc-Oliver-Kempf"
2023,"Hertha BSC","Bundesliga","Jonjoe Kenny","ENG","DF","25",1997,24.9,46,34,27,16,3,24,42,57.1,18,38,9,29,46,92,74,0,"https://fbref.com/en/players/099e666f/Jonjoe-Kenny"
2023,"Hertha BSC","Bundesliga","Pascal Klemens","GER","DF","17",2005,1,0,0,0,0,0,0,1,0,1,1,0,1,1,1,3,0,"https://fbref.com/en/players/90d88154/Pascal-Klemens"
2023,"Hertha BSC","Bundesliga","Dodi Lukebakio","BEL","FW,MF","24",1997,26.6,18,11,7,8,3,6,27,22.2,21,23,5,18,13,31,17,0,"https://fbref.com/en/players/0c61c77c/Dodi-Lukebakio"
2023,"Hertha BSC","Bundesliga","Myziane Maolida","FRA","FW,MF","23",1999,1.1,1,1,1,0,0,1,2,50,1,0,0,0,0,1,1,0,"https://fbref.com/en/players/706a60e1/Myziane-Maolida"
2023,"Hertha BSC","Bundesliga","Ibrahim Maza","GER","MF,FW","16",2005,0.8,1,1,1,0,0,0,1,0,1,2,0,2,0,1,1,0,"https://fbref.com/en/players/89b3bc5e/Ibrahim-Maza"
2023,"Hertha BSC","Bundesliga","Maximilian Mittelstädt","GER","DF,MF","25",1997,9.4,39,20,31,6,2,17,39,43.6,22,13,2,11,26,65,27,0,"https://fbref.com/en/players/88d4144a/Maximilian-Mittelstadt"
2023,"Hertha BSC","Bundesliga","Jessic Ngankam","GER","FW,MF","22",2000,9.2,14,9,7,4,3,6,14,42.9,8,6,1,5,1,15,4,0,"https://fbref.com/en/players/bc249af8/Jessic-Ngankam"
2023,"Hertha BSC","Bundesliga","Florian Niederlechner","GER","FW","31",1990,8.7,9,7,2,4,3,2,8,25,6,7,0,7,3,12,10,0,"https://fbref.com/en/players/d6862409/Florian-Niederlechner"
2023,"Hertha BSC","Bundesliga","Peter Pekarík","SVK","DF","35",1986,2.3,4,3,4,0,0,4,6,66.7,2,6,2,4,4,8,7,0,"https://fbref.com/en/players/c18d22f5/Peter-Pekarik"
2023,"Hertha BSC","Bundesliga","Marvin Plattenhardt","GER","DF","30",1992,26.7,43,33,24,15,4,29,47,61.7,18,25,11,14,15,58,82,0,"https://fbref.com/en/players/f7aa75bd/Marvin-Plattenhardt"
2023,"Hertha BSC","Bundesliga","Marco Richter","GER","MF,FW","24",1997,20.4,43,23,18,17,8,19,48,39.6,29,29,2,27,24,67,25,0,"https://fbref.com/en/players/f972644c/Marco-Richter"
2023,"Hertha BSC","Bundesliga","Agustín Rogel","URU","DF","24",1997,15.8,18,9,13,5,0,11,17,64.7,6,15,8,7,11,29,74,1,"https://fbref.com/en/players/ea42c03f/Agustin-Rogel"
2023,"Hertha BSC","Bundesliga","Tony Rölke","GER","FW","19",2003,0.2,0,0,0,0,0,0,0,NA,0,1,0,1,0,0,1,0,"https://fbref.com/en/players/779aa25c/Tony-Rolke"
2023,"Hertha BSC","Bundesliga","Derry Scherhant","GER","FW,MF","19",2002,3.2,7,6,3,3,1,4,8,50,4,3,0,3,0,7,5,0,"https://fbref.com/en/players/93cba339/Derry-Scherhant"
2023,"Hertha BSC","Bundesliga","Davie Selke","GER","FW","27",1995,3.1,2,1,1,1,0,0,1,0,1,3,1,2,1,3,5,0,"https://fbref.com/en/players/1238a3f9/Davie-Selke"
2023,"Hertha BSC","Bundesliga","Suat Serdar","GER","MF","25",1997,22.5,51,23,14,30,7,20,41,48.8,21,48,12,36,29,80,24,0,"https://fbref.com/en/players/b3325a30/Suat-Serdar"
2023,"Hertha BSC","Bundesliga","Veit Stange","GER","MF","18",2004,0.1,1,1,1,0,0,1,1,100,0,0,0,0,0,1,0,0,"https://fbref.com/en/players/e52d33d0/Veit-Stange"
2023,"Hertha BSC","Bundesliga","Ivan Šunjić","CRO","MF","25",1996,11,38,20,16,21,1,16,24,66.7,8,17,5,12,13,51,19,1,"https://fbref.com/en/players/e18098de/Ivan-Sunjic"
2023,"Hertha BSC","Bundesliga","Lucas Tousart","FRA","MF","25",1997,32.7,73,38,35,28,10,27,60,45,33,42,6,36,48,121,75,1,"https://fbref.com/en/players/71ec39ef/Lucas-Tousart"
2023,"Hertha BSC","Bundesliga","Filip Uremović","CRO","DF","25",1997,19.2,38,23,29,8,1,14,22,63.6,8,18,13,5,36,74,88,2,"https://fbref.com/en/players/af842091/Filip-Uremovic"
2023,"Hoffenheim","Bundesliga","Kevin Akpoguma","NGA","DF","27",1995,21.7,75,44,45,27,3,32,45,71.1,13,45,16,29,24,99,70,1,"https://fbref.com/en/players/6ec6fde0/Kevin-Akpoguma"
2023,"Hoffenheim","Bundesliga","Angeliño","ESP","DF","25",1997,29.1,40,24,19,18,3,23,37,62.2,14,32,6,26,25,65,67,0,"https://fbref.com/en/players/30941e96/Angelino"
2023,"Hoffenheim","Bundesliga","Fisnik Asllani","KVX","FW","19",2002,1.9,0,0,0,0,0,0,4,0,4,2,0,2,3,3,3,0,"https://fbref.com/en/players/35f67a30/Fisnik-Asllani"
2023,"Hoffenheim","Bundesliga","Oliver Baumann","GER","GK","32",1990,34,0,0,0,0,0,0,0,NA,0,0,0,0,0,0,15,1,"https://fbref.com/en/players/47064058/Oliver-Baumann"
2023,"Hoffenheim","Bundesliga","Christoph Baumgartner","AUT","MF,FW","22",1999,28.5,36,19,12,17,7,9,52,17.3,43,57,5,52,15,51,19,1,"https://fbref.com/en/players/437f2b00/Christoph-Baumgartner"
2023,"Hoffenheim","Bundesliga","Ihlas Bebou","TOG","FW,DF","28",1994,15.7,19,16,8,7,4,11,17,64.7,6,9,2,7,7,26,15,0,"https://fbref.com/en/players/a53b661f/Ihlas-Bebou"
2023,"Hoffenheim","Bundesliga","Ermin Bičakčić","BIH","DF","32",1990,2.9,8,4,6,1,1,2,6,33.3,4,4,3,1,5,13,14,0,"https://fbref.com/en/players/7aac47fe/Ermin-Bicakcic"
2023,"Hoffenheim","Bundesliga","Tom Bischof","GER","MF,FW","17",2005,3.5,15,10,8,3,4,7,10,70,3,5,1,4,1,16,1,0,"https://fbref.com/en/players/07d3bfec/Tom-Bischof"
2023,"Hoffenheim","Bundesliga","John Brooks","USA","DF","29",1993,15,18,12,10,8,0,13,18,72.2,5,17,12,5,10,28,105,0,"https://fbref.com/en/players/e27da244/John-Brooks"
2023,"Hoffenheim","Bundesliga","Jacob Bruun Larsen","DEN","FW","23",1998,3.6,4,3,0,1,3,3,4,75,1,3,1,2,1,5,0,0,"https://fbref.com/en/players/4e204552/Jacob-Bruun-Larsen"
2023,"Hoffenheim","Bundesliga","Moanes Dabbur","ISR","FW","30",1992,10.4,11,8,4,5,2,3,9,33.3,6,8,0,8,5,16,0,0,"https://fbref.com/en/players/eac044ad/Moanes-Dabbur"
2023,"Hoffenheim","Bundesliga","Muhammed Damar","GER","MF","18",2004,1.8,6,3,1,2,3,1,2,50,1,3,0,3,0,6,0,0,"https://fbref.com/en/players/d3d77413/Muhammed-Damar"
2023,"Hoffenheim","Bundesliga","Thomas Delaney","DEN","MF","30",1991,3.3,6,3,3,2,1,3,8,37.5,5,5,0,5,1,7,4,0,"https://fbref.com/en/players/fe641c1a/Thomas-Delaney"
2023,"Hoffenheim","Bundesliga","Kasper Dolberg","DEN","FW,MF","24",1997,4.5,7,5,1,4,2,4,6,66.7,2,6,2,4,0,7,5,0,"https://fbref.com/en/players/cc83b74d/Kasper-Dolberg"
2023,"Hoffenheim","Bundesliga","Dennis Geiger","GER","MF","24",1998,21.7,45,25,15,28,2,22,35,62.9,13,27,3,24,24,69,18,2,"https://fbref.com/en/players/37f606f0/Dennis-Geiger"
2023,"Hoffenheim","Bundesliga","Ozan Kabak","TUR","DF","22",2000,26.5,51,34,27,21,3,17,30,56.7,13,35,23,12,45,96,83,0,"https://fbref.com/en/players/2d61d13a/Ozan-Kabak"
2023,"Hoffenheim","Bundesliga","Pavel Kadeřábek","CZE","DF","30",1992,18.5,26,20,10,9,7,15,23,65.2,8,12,2,10,14,40,37,1,"https://fbref.com/en/players/79c90e45/Pavel-Kaderabek"
2023,"Hoffenheim","Bundesliga","Andrej Kramarić","CRO","MF,FW","31",1991,26.5,5,2,2,1,2,1,11,9.1,10,14,2,12,6,11,13,0,"https://fbref.com/en/players/603cb947/Andrej-Kramaric"
2023,"Hoffenheim","Bundesliga","Stanley N'Soki","FRA","DF","23",1999,14.3,22,13,14,7,1,12,22,54.5,10,22,5,17,24,46,34,0,"https://fbref.com/en/players/61590953/Stanley-NSoki"
2023,"Hoffenheim","Bundesliga","Finn Ole Becker","GER","MF","22",2000,5.7,10,2,4,6,0,4,7,57.1,3,4,0,4,5,15,8,0,"https://fbref.com/en/players/dd2e62da/Finn-Ole-Becker"
2023,"Hoffenheim","Bundesliga","Stefan Posch","AUT","DF","25",1997,0.2,0,0,0,0,0,0,0,NA,0,0,0,0,0,0,0,0,"https://fbref.com/en/players/7f609bfc/Stefan-Posch"
2023,"Hoffenheim","Bundesliga","Grischa Prömel","GER","MF","27",1995,16.2,27,19,14,11,2,9,25,36,16,22,4,18,8,35,23,0,"https://fbref.com/en/players/924f9191/Grischa-Promel"
2023,"Hoffenheim","Bundesliga","Eduardo Quaresma","POR","DF","20",2002,1,5,3,3,2,0,1,3,33.3,2,3,2,1,0,5,3,0,"https://fbref.com/en/players/7ec723b7/Eduardo-Quaresma"
2023,"Hoffenheim","Bundesliga","Joshua Quarshie","GER","MF","18",2004,0,0,0,0,0,0,0,0,NA,0,0,0,0,0,0,0,0,"https://fbref.com/en/players/3c200e05/Joshua-Quarshie"
2023,"Hoffenheim","Bundesliga","Sebastian Rudy","GER","MF","32",1990,8.8,26,12,10,16,0,13,27,48.1,14,27,7,20,11,37,13,0,"https://fbref.com/en/players/80f36c88/Sebastian-Rudy"
2023,"Hoffenheim","Bundesliga","Georginio Rutter","FRA","FW","20",2002,11.2,7,4,1,4,2,1,3,33.3,2,10,2,8,5,12,6,0,"https://fbref.com/en/players/c64c01fc/Georginio-Rutter"
2023,"Hoffenheim","Bundesliga","Diadie Samassékou","MLI","MF,FW","26",1996,0.4,1,0,0,1,0,0,1,0,1,0,0,0,0,1,0,0,"https://fbref.com/en/players/08593525/Diadie-Samassekou"
2023,"Hoffenheim","Bundesliga","Robert Skov","DEN","DF","26",1996,15,22,11,14,7,1,10,26,38.5,16,22,8,14,8,30,20,2,"https://fbref.com/en/players/ff98492b/Robert-Skov"
2023,"Hoffenheim","Bundesliga","Angelo Stiller","GER","MF","21",2001,7.8,26,12,9,13,4,8,12,66.7,4,12,2,10,10,36,14,0,"https://fbref.com/en/players/3b1ed320/Angelo-Stiller"
2023,"Hoffenheim","Bundesliga","Umut Tohumcu","GER","MF,DF","17",2004,3,10,5,4,5,1,3,9,33.3,6,4,0,4,2,12,8,0,"https://fbref.com/en/players/e547d3cf/Umut-Tohumcu"
2023,"Hoffenheim","Bundesliga","Kevin Vogt","GER","DF","30",1991,19.7,15,10,10,5,0,9,22,40.9,13,18,11,7,26,41,67,0,"https://fbref.com/en/players/1d8e9add/Kevin-Vogt"
2023,"Inter","Serie A","Francesco Acerbi","ITA","DF","34",1988,26.9,33,19,22,7,4,20,27,74.1,7,25,18,7,41,74,85,2,"https://fbref.com/en/players/b96b595c/Francesco-Acerbi"
2023,"Inter","Serie A","Kristjan Asllani","ALB","MF","20",2002,6.6,11,5,1,8,2,7,10,70,3,3,1,2,6,17,4,0,"https://fbref.com/en/players/0fdcef0e/Kristjan-Asllani"
2023,"Inter","Serie A","Nicolò Barella","ITA","MF","25",1997,29,49,25,17,26,6,28,53,52.8,25,29,5,24,12,61,12,0,"https://fbref.com/en/players/6928979a/Nicolo-Barella"
2023,"Inter","Serie A","Alessandro Bastoni","ITA","DF","23",1999,24,41,20,20,14,7,11,27,40.7,16,27,13,14,24,65,45,0,"https://fbref.com/en/players/75b86fb3/Alessandro-Bastoni"
2023,"Inter","Serie A","Raoul Bellanova","ITA","DF","22",2000,5.5,14,6,11,2,1,9,14,64.3,5,6,1,5,4,18,14,0,"https://fbref.com/en/players/e3756e72/Raoul-Bellanova"
2023,"Inter","Serie A","Marcelo Brozović","CRO","MF","29",1992,19.7,37,22,13,22,2,11,37,29.7,26,23,7,16,22,59,28,0,"https://fbref.com/en/players/33b8d077/Marcelo-Brozovic"
2023,"Inter","Serie A","Hakan Çalhanoğlu","TUR","MF","28",1994,26.3,48,27,17,26,5,16,43,37.2,27,30,5,25,25,73,13,1,"https://fbref.com/en/players/cd0fa27b/Hakan-Calhanoglu"
2023,"Inter","Serie A","Valentin Carboni","ARG","MF,DF","17",2005,0.3,1,1,0,1,0,1,3,33.3,2,1,0,1,0,1,0,0,"https://fbref.com/en/players/707b98f1/Valentin-Carboni"
2023,"Inter","Serie A","Alex Cordaz","ITA","GK","39",1983,0.3,0,0,0,0,0,0,0,NA,0,0,0,0,0,0,0,0,"https://fbref.com/en/players/e66ebabb/Alex-Cordaz"
2023,"Inter","Serie A","Joaquín Correa","ARG","FW","27",1994,10.6,12,7,3,6,3,4,15,26.7,11,4,1,3,3,15,0,0,"https://fbref.com/en/players/45b9b619/Joaquin-Correa"
2023,"Inter","Serie A","Danilo D'Ambrosio","ITA","DF","33",1988,8.1,25,17,17,7,1,15,27,55.6,12,12,4,8,10,35,17,0,"https://fbref.com/en/players/44eb9093/Danilo-DAmbrosio"
2023,"Inter","Serie A","Matteo Darmian","ITA","DF","32",1989,22.5,56,30,29,15,12,31,47,66,16,33,5,28,21,77,36,0,"https://fbref.com/en/players/96e0490d/Matteo-Darmian"
2023,"Inter","Serie A","Federico Dimarco","ITA","DF","24",1997,23,31,25,6,18,7,9,19,47.4,10,15,4,11,18,49,20,0,"https://fbref.com/en/players/970b8574/Federico-Dimarco"
2023,"Inter","Serie A","Denzel Dumfries","NED","DF","26",1996,24.6,35,18,17,13,5,22,34,64.7,12,33,9,24,12,47,26,0,"https://fbref.com/en/players/481c9ece/Denzel-Dumfries"
2023,"Inter","Serie A","Edin Džeko","BIH","FW","36",1986,19.2,3,2,0,3,0,0,4,0,4,15,1,14,3,6,25,0,"https://fbref.com/en/players/3bb7f478/Edin-Dzeko"
2023,"Inter","Serie A","Roberto Gagliardini","ITA","MF","28",1994,8.7,16,6,9,6,1,10,21,47.6,11,14,5,9,4,20,15,0,"https://fbref.com/en/players/ce30bfc8/Roberto-Gagliardini"
2023,"Inter","Serie A","Robin Gosens","GER","DF","28",1994,13.2,34,18,15,10,9,15,25,60,10,16,2,14,23,57,15,0,"https://fbref.com/en/players/2d970560/Robin-Gosens"
2023,"Inter","Serie A","Samir Handanović","SVN","GK","38",1984,13.7,0,0,0,0,0,0,0,NA,0,0,0,0,0,0,5,0,"https://fbref.com/en/players/74419746/Samir-Handanovic"
2023,"Inter","Serie A","Romelu Lukaku","BEL","FW","29",1993,18.4,3,1,1,0,2,2,5,40,3,3,1,2,0,3,16,0,"https://fbref.com/en/players/5eae500a/Romelu-Lukaku"
2023,"Inter","Serie A","Lautaro Martínez","ARG","FW","24",1997,28.6,25,14,3,15,7,7,23,30.4,16,31,1,30,13,38,16,1,"https://fbref.com/en/players/f7036e1c/Lautaro-Martinez"
2023,"Inter","Serie A","Henrikh Mkhitaryan","ARM","MF","33",1989,22.1,41,26,13,22,6,14,41,34.1,27,27,4,23,21,62,18,0,"https://fbref.com/en/players/dd0daf32/Henrikh-Mkhitaryan"
2023,"Inter","Serie A","André Onana","CMR","GK","26",1996,24,0,0,0,0,0,0,1,0,1,0,0,0,0,0,5,0,"https://fbref.com/en/players/e9c0c1b2/Andre-Onana"
2023,"Inter","Serie A","Milan Škriniar","SVK","DF","27",1995,19.7,29,18,14,11,4,18,32,56.3,14,18,13,5,13,42,46,3,"https://fbref.com/en/players/30f5ffa9/Milan-Skriniar"
2023,"Inter","Serie A","Stefan de Vrij","NED","DF","30",1992,21.6,28,18,19,9,0,8,14,57.1,6,18,10,8,40,68,80,0,"https://fbref.com/en/players/d0d8dd44/Stefan-de-Vrij"
2023,"Inter","Serie A","Mattia Zanotti","ITA","DF","19",2003,0.3,0,0,0,0,0,0,1,0,1,2,0,2,0,0,0,0,"https://fbref.com/en/players/875d65d1/Mattia-Zanotti"
2023,"Juventus","Serie A","Tommaso Barbieri","ITA","DF","19",2002,1.2,3,3,3,0,0,3,8,37.5,5,3,0,3,0,3,2,0,"https://fbref.com/en/players/6f1d7aa8/Tommaso-Barbieri"
2023,"Juventus","Serie A","Enzo Barrenechea","ARG","MF","21",2001,1.8,8,3,3,4,1,3,5,60,2,3,0,3,2,10,3,0,"https://fbref.com/en/players/6caffe81/Enzo-Barrenechea"
2023,"Juventus","Serie A","Leonardo Bonucci","ITA","DF","35",1987,9.8,5,4,1,4,0,2,4,50,2,12,8,4,13,18,29,0,"https://fbref.com/en/players/52ec54d0/Leonardo-Bonucci"
2023,"Juventus","Serie A","Gleison Bremer","BRA","DF","25",1997,29.3,29,20,23,5,1,19,26,73.1,7,44,22,22,42,71,120,2,"https://fbref.com/en/players/5fd5ed86/Gleison-Bremer"
2023,"Juventus","Serie A","Federico Chiesa","ITA","DF,MF","24",1997,9.5,22,11,6,6,10,5,14,35.7,9,13,1,12,0,22,1,0,"https://fbref.com/en/players/b0f7e36c/Federico-Chiesa"
2023,"Juventus","Serie A","Juan Cuadrado","COL","DF,FW","34",1988,23.1,50,34,34,13,3,27,65,41.5,38,15,2,13,24,74,32,0,"https://fbref.com/en/players/0ab1f153/Juan-Cuadrado"
2023,"Juventus","Serie A","Danilo","BRA","DF","31",1991,35.4,92,62,61,23,8,52,73,71.2,21,39,20,19,47,139,114,1,"https://fbref.com/en/players/94b2001f/Danilo"
2023,"Juventus","Serie A","Mattia De Sciglio","ITA","DF","29",1992,11.6,14,7,8,3,3,9,14,64.3,5,9,3,6,4,18,20,0,"https://fbref.com/en/players/ae4e2852/Mattia-De-Sciglio"
2023,"Juventus","Serie A","Ángel Di María","ARG","FW,MF","34",1988,15.1,10,5,3,5,2,3,19,15.8,16,15,0,15,7,17,0,0,"https://fbref.com/en/players/19cda00b/Angel-Di-Maria"
2023,"Juventus","Serie A","Nicolò Fagioli","ITA","MF","21",2001,16.9,29,19,12,15,2,8,27,29.6,19,16,2,14,8,37,7,1,"https://fbref.com/en/players/366be751/Nicolo-Fagioli"
2023,"Juventus","Serie A","Federico Gatti","ITA","DF","24",1998,16.1,15,11,9,4,2,9,15,60,6,20,14,6,21,36,54,2,"https://fbref.com/en/players/18dd3219/Federico-Gatti"
2023,"Juventus","Serie A","Samuel Iling-Junior","ENG","DF,FW","18",2003,3.5,7,2,3,1,3,4,9,44.4,5,5,1,4,2,9,6,0,"https://fbref.com/en/players/ba492306/Samuel-Iling-Junior"
2023,"Juventus","Serie A","Moise Kean","ITA","FW","22",2000,11.1,8,6,2,5,1,3,7,42.9,4,4,0,4,5,13,2,0,"https://fbref.com/en/players/3d50bcdb/Moise-Kean"
2023,"Juventus","Serie A","Filip Kostić","SRB","DF,FW","29",1992,28.5,41,26,17,20,4,21,47,44.7,26,30,4,26,16,57,32,0,"https://fbref.com/en/players/b1cd37e6/Filip-Kostic"
2023,"Juventus","Serie A","Manuel Locatelli","ITA","MF","24",1998,27.2,59,33,26,23,10,30,53,56.6,23,50,22,28,27,86,59,0,"https://fbref.com/en/players/a8a874f1/Manuel-Locatelli"
2023,"Juventus","Serie A","Weston McKennie","USA","MF,DF","23",1998,11.7,14,5,3,9,2,5,8,62.5,3,15,4,11,11,25,15,1,"https://fbref.com/en/players/01c3aff5/Weston-McKennie"
2023,"Juventus","Serie A","Arkadiusz Milik","POL","FW","28",1994,17.6,12,8,2,8,2,2,8,25,6,10,1,9,1,13,14,0,"https://fbref.com/en/players/85613cf0/Arkadiusz-Milik"
2023,"Juventus","Serie A","Fabio Miretti","ITA","MF,FW","18",2003,13.7,24,11,15,6,3,12,29,41.4,17,20,1,19,4,28,11,0,"https://fbref.com/en/players/34693494/Fabio-Miretti"
2023,"Juventus","Serie A","Leandro Paredes","ARG","MF","28",1994,10.9,19,13,7,11,1,10,22,45.5,12,8,0,8,17,36,22,0,"https://fbref.com/en/players/dff153a4/Leandro-Paredes"
2023,"Juventus","Serie A","Mattia Perin","ITA","GK","29",1992,10.5,0,0,0,0,0,0,0,NA,0,0,0,0,0,0,0,0,"https://fbref.com/en/players/4c62d0c8/Mattia-Perin"
2023,"Juventus","Serie A","Paul Pogba","FRA","MF,FW","29",1993,1.2,0,0,0,0,0,0,1,0,1,0,0,0,0,0,2,0,"https://fbref.com/en/players/867239d3/Paul-Pogba"
2023,"Juventus","Serie A","Adrien Rabiot","FRA","MF","27",1995,30.5,65,35,31,23,11,30,57,52.6,27,37,7,30,26,91,44,1,"https://fbref.com/en/players/8794e251/Adrien-Rabiot"
2023,"Juventus","Serie A","Nicolò Rovella","ITA","MF","20",2001,0.3,1,1,0,1,0,1,1,100,0,0,0,0,0,1,0,0,"https://fbref.com/en/players/e58cbfd5/Nicolo-Rovella"
2023,"Juventus","Serie A","Daniele Rugani","ITA","DF","28",1994,6.3,7,0,6,1,0,4,4,100,0,7,5,2,7,14,32,0,"https://fbref.com/en/players/14b8fcdf/Daniele-Rugani"
2023,"Juventus","Serie A","Alex Sandro","BRA","DF","31",1991,19.9,35,20,16,16,3,15,22,68.2,7,27,10,17,15,50,64,1,"https://fbref.com/en/players/0d82903c/Alex-Sandro"
2023,"Juventus","Serie A","Matìas Soulé","ARG","MF,FW","19",2003,4.7,7,4,3,2,2,5,7,71.4,2,7,1,6,3,10,3,0,"https://fbref.com/en/players/c13ddd3e/Matias-Soule"
2023,"Juventus","Serie A","Wojciech Szczęsny","POL","GK","32",1990,27.5,1,0,1,0,0,0,1,0,1,0,0,0,0,1,7,0,"https://fbref.com/en/players/01b8a2b2/Wojciech-Szczesny"
2023,"Juventus","Serie A","Dušan Vlahović","SRB","FW","22",2000,21.4,11,6,0,7,4,4,10,40,6,10,3,7,3,14,8,1,"https://fbref.com/en/players/79443529/Dusan-Vlahovic"
2023,"Juventus","Serie A","Denis Zakaria","SUI","MF","25",1996,1.4,6,3,1,4,1,2,2,100,0,2,0,2,2,8,1,0,"https://fbref.com/en/players/384d58d9/Denis-Zakaria"
2023,"Köln","Bundesliga","Sargis Adamyan","ARM","FW,MF","29",1993,7.2,14,7,5,3,6,7,17,41.2,10,12,0,12,4,18,5,0,"https://fbref.com/en/players/22919e97/Sargis-Adamyan"
2023,"Köln","Bundesliga","Julian Chabot","GER","DF","24",1998,20,36,23,19,14,3,20,35,57.1,15,30,18,12,41,77,105,0,"https://fbref.com/en/players/ae7058f9/Julian-Chabot"
2023,"Köln","Bundesliga","Justin Diehl","GER","MF,FW","17",2004,0.2,0,0,0,0,0,0,0,NA,0,0,0,0,0,0,0,0,"https://fbref.com/en/players/d82a310a/Justin-Diehl"
2023,"Köln","Bundesliga","Florian Dietz","GER","FW","23",1998,4.4,2,1,0,2,0,1,4,25,3,4,1,3,0,2,2,0,"https://fbref.com/en/players/8779ddf8/Florian-Dietz"
2023,"Köln","Bundesliga","Ondrej Duda","SVK","MF","27",1994,7.7,9,8,2,5,2,4,11,36.4,7,7,1,6,2,11,3,0,"https://fbref.com/en/players/79ca3e23/Ondrej-Duda"
2023,"Köln","Bundesliga","Kingsley Ehizibue","NED","DF","27",1995,0.7,0,0,0,0,0,0,0,NA,0,1,0,1,2,2,1,0,"https://fbref.com/en/players/76b2817e/Kingsley-Ehizibue"
2023,"Köln","Bundesliga","Jonas Hector","GER","DF","32",1990,31.4,112,66,59,43,10,66,113,58.4,47,61,9,52,39,151,74,1,"https://fbref.com/en/players/c2009df3/Jonas-Hector"
2023,"Köln","Bundesliga","Timo Hübers","GER","DF","26",1996,28.4,43,28,35,8,0,24,52,46.2,28,27,13,14,58,101,153,0,"https://fbref.com/en/players/94302c52/Timo-Hubers"
2023,"Köln","Bundesliga","Denis Huseinbasic","GER","MF,FW","21",2001,8.8,23,9,8,11,4,10,25,40,15,16,2,14,4,27,5,0,"https://fbref.com/en/players/b116c6e3/Denis-Huseinbasic"
2023,"Köln","Bundesliga","Florian Kainz","AUT","MF,FW","29",1992,26,21,10,7,12,2,8,26,30.8,18,27,6,21,32,53,30,1,"https://fbref.com/en/players/94c18565/Florian-Kainz"
2023,"Köln","Bundesliga","Luca Kilian","GER","DF","22",1999,12.5,22,16,14,7,1,12,21,57.1,9,16,8,8,11,33,48,0,"https://fbref.com/en/players/610aa1e9/Luca-Kilian"
2023,"Köln","Bundesliga","Tim Lemperle","GER","FW,MF","20",2002,1.5,6,4,3,1,2,3,5,60,2,5,0,5,1,7,4,0,"https://fbref.com/en/players/792ffa71/Tim-Lemperle"
2023,"Köln","Bundesliga","Dimitris Limnios","GRE","FW","24",1998,0.4,0,0,0,0,0,0,0,NA,0,0,0,0,1,1,0,0,"https://fbref.com/en/players/62c7067a/Dimitris-Limnios"
2023,"Köln","Bundesliga","Dejan Ljubicic","AUT","MF,FW","24",1997,19,25,14,7,14,4,13,40,32.5,27,20,1,19,8,33,8,1,"https://fbref.com/en/players/c455a2b2/Dejan-Ljubicic"
2023,"Köln","Bundesliga","Linton Maina","GER","FW,MF","23",1999,24.9,18,12,5,11,2,7,30,23.3,23,19,0,19,5,23,9,0,"https://fbref.com/en/players/e5d85da8/Linton-Maina"
2023,"Köln","Bundesliga","Eric Martel","GER","MF","20",2002,22.4,66,41,29,30,7,30,60,50,30,29,9,20,33,99,49,0,"https://fbref.com/en/players/92a16062/Eric-Martel"
2023,"Köln","Bundesliga","Mathias Olesen","LUX","MF","21",2001,5.3,10,5,4,4,2,5,8,62.5,3,6,1,5,2,12,3,0,"https://fbref.com/en/players/86adbcc7/Mathias-Olesen"
2023,"Köln","Bundesliga","Kristian Pedersen","DEN","DF","27",1994,3.1,5,4,4,1,0,0,2,0,2,3,0,3,6,11,17,0,"https://fbref.com/en/players/5154b2ba/Kristian-Pedersen"
2023,"Köln","Bundesliga","Kingsley Schindler","GHA","DF,MF","29",1993,12.1,23,12,13,8,2,18,28,64.3,10,14,2,12,15,38,24,0,"https://fbref.com/en/players/bd527260/Kingsley-Schindler"
2023,"Köln","Bundesliga","Benno Schmitz","GER","DF","27",1994,26.9,64,42,31,28,5,42,82,51.2,40,34,4,30,26,90,57,0,"https://fbref.com/en/players/ad00b1a8/Benno-Schmitz"
2023,"Köln","Bundesliga","Marvin Schwäbe","GER","GK","27",1995,34,1,0,1,0,0,1,1,100,0,0,0,0,2,3,8,2,"https://fbref.com/en/players/87436846/Marvin-Schwabe"
2023,"Köln","Bundesliga","Davie Selke","GER","FW","27",1995,9.7,0,0,0,0,0,0,4,0,4,4,1,3,0,0,11,0,"https://fbref.com/en/players/1238a3f9/Davie-Selke"
2023,"Köln","Bundesliga","Ellyes Skhiri","TUN","MF","27",1995,31.7,79,44,29,42,8,26,66,39.4,40,52,12,40,56,135,48,0,"https://fbref.com/en/players/c2211709/Ellyes-Skhiri"
2023,"Köln","Bundesliga","Nikola Soldo","CRO","DF","21",2001,6.6,15,9,8,7,0,7,11,63.6,4,7,6,1,7,22,28,0,"https://fbref.com/en/players/4f627629/Nikola-Soldo"
2023,"Köln","Bundesliga","Jan Thielmann","GER","FW","20",2002,9.7,9,8,3,4,2,2,11,18.2,9,16,3,13,9,18,7,0,"https://fbref.com/en/players/fd53759d/Jan-Thielmann"
2023,"Köln","Bundesliga","Steffen Tigges","GER","FW","24",1998,17.7,12,7,1,8,3,4,14,28.6,10,13,2,11,8,20,17,0,"https://fbref.com/en/players/6b8887c2/Steffen-Tigges"
2023,"Köln","Bundesliga","Mark Uth","GER","MF,FW","30",1991,0.5,0,0,0,0,0,0,0,NA,0,0,0,0,0,0,0,0,"https://fbref.com/en/players/a3ddb1b9/Mark-Uth"
2023,"Lazio","Serie A","Luis Alberto","ESP","MF","29",1992,27.1,49,29,18,20,11,23,72,31.9,49,35,6,29,9,58,4,0,"https://fbref.com/en/players/5294a83f/Luis-Alberto"
2023,"Lazio","Serie A","Felipe Anderson","BRA","FW","29",1993,32.9,80,50,31,41,8,31,88,35.2,57,58,6,52,31,111,27,0,"https://fbref.com/en/players/9f1893b9/Felipe-Anderson"
2023,"Lazio","Serie A","Marcos Antônio","BRA","MF","22",2000,6.6,9,6,4,5,0,9,20,45,11,7,2,5,11,20,18,0,"https://fbref.com/en/players/108fe016/Marcos-Antonio"
2023,"Lazio","Serie A","Toma Bašić","CRO","MF","25",1996,5.7,6,4,4,1,1,3,8,37.5,5,9,0,9,7,13,8,0,"https://fbref.com/en/players/80556f08/Toma-Basic"
2023,"Lazio","Serie A","Marco Bertini","ITA","MF","19",2002,0,0,0,0,0,0,0,0,NA,0,0,0,0,0,0,0,0,"https://fbref.com/en/players/4b520f96/Marco-Bertini"
2023,"Lazio","Serie A","Matteo Cancellieri","ITA","FW","20",2002,2.8,10,4,5,3,2,5,9,55.6,4,4,0,4,1,11,2,0,"https://fbref.com/en/players/b6a1cdf9/Matteo-Cancellieri"
2023,"Lazio","Serie A","Nicolò Casale","ITA","DF","24",1998,27.1,42,20,28,14,0,22,34,64.7,12,25,17,8,17,59,73,1,"https://fbref.com/en/players/3f5f38fb/Nicolo-Casale"
2023,"Lazio","Serie A","Danilo Cataldi","ITA","MF","27",1994,21.3,25,16,7,15,3,14,40,35,26,23,9,14,24,49,33,0,"https://fbref.com/en/players/ba3d3bea/Danilo-Cataldi"
2023,"Lazio","Serie A","Mario Gila","ESP","DF","21",2000,1,3,1,3,0,0,0,1,0,1,0,0,0,3,6,3,0,"https://fbref.com/en/players/9c435456/Mario-Gila"
2023,"Lazio","Serie A","Elseid Hysaj","ALB","DF","28",1994,22.2,39,23,24,11,4,23,41,56.1,18,31,7,24,20,59,42,0,"https://fbref.com/en/players/2f3452eb/Elseid-Hysaj"
2023,"Lazio","Serie A","Ciro Immobile","ITA","FW","32",1990,24.7,11,5,4,4,3,6,9,66.7,3,10,2,8,1,12,14,0,"https://fbref.com/en/players/4431aed2/Ciro-Immobile"
2023,"Lazio","Serie A","Manuel Lazzari","ITA","DF","28",1993,20.9,33,21,13,14,6,21,36,58.3,15,20,6,14,18,51,36,1,"https://fbref.com/en/players/02caf6e0/Manuel-Lazzari"
2023,"Lazio","Serie A","Adam Marušić","MNE","DF","29",1992,30.7,41,30,23,14,4,25,39,64.1,14,20,6,14,38,79,63,1,"https://fbref.com/en/players/d4535821/Adam-Marusic"
2023,"Lazio","Serie A","Luís Maximiano","POR","GK","23",1999,0.1,0,0,0,0,0,0,0,NA,0,0,0,0,0,0,0,0,"https://fbref.com/en/players/3318286e/Luis-Maximiano"
2023,"Lazio","Serie A","Sergej Milinković-Savić","SRB","MF","27",1995,33.6,58,35,22,23,13,24,67,35.8,43,50,12,38,28,86,49,0,"https://fbref.com/en/players/4e6dbac4/Sergej-Milinkovic-Savic"
2023,"Lazio","Serie A","Patric","ESP","DF","29",1993,15.7,17,11,12,3,2,11,16,68.8,5,17,12,5,11,28,53,1,"https://fbref.com/en/players/f7223718/Patric"
2023,"Lazio","Serie A","Pedro","ESP","FW","35",1987,21.1,35,24,14,10,11,11,30,36.7,19,18,2,16,6,41,4,1,"https://fbref.com/en/players/3ca7254a/Pedro"
2023,"Lazio","Serie A","Luca Pellegrini","ITA","DF","23",1999,2,1,0,0,1,0,1,4,25,3,3,0,3,7,8,4,0,"https://fbref.com/en/players/3b61c9ec/Luca-Pellegrini"
2023,"Lazio","Serie A","Ivan Provedel","ITA","GK","28",1994,37.9,1,0,1,0,0,0,0,NA,0,0,0,0,0,1,15,1,"https://fbref.com/en/players/277da414/Ivan-Provedel"
2023,"Lazio","Serie A","Ștefan Radu","ROU","FW","35",1986,0,0,0,0,0,0,0,0,NA,0,0,0,0,0,0,0,0,"https://fbref.com/en/players/53de807a/Stefan-Radu"
2023,"Lazio","Serie A","Alessio Romagnoli","ITA","DF","27",1995,32.5,33,15,19,14,0,11,22,50,11,33,26,7,38,71,108,0,"https://fbref.com/en/players/3ead85f9/Alessio-Romagnoli"
2023,"Lazio","Serie A","Luka Romero","ARG","FW","17",2004,1.7,0,0,0,0,0,0,3,0,3,4,0,4,3,3,1,0,"https://fbref.com/en/players/ca6edaa0/Luka-Romero"
2023,"Lazio","Serie A","Matías Vecino","URU","MF","30",1991,18.8,47,27,13,23,11,23,48,47.9,25,33,10,23,16,63,39,1,"https://fbref.com/en/players/44ac04e9/Matias-Vecino"
2023,"Lazio","Serie A","Mattia Zaccagni","ITA","FW","27",1995,30.8,42,28,16,18,8,14,38,36.8,24,37,3,34,21,63,10,1,"https://fbref.com/en/players/d85c238b/Mattia-Zaccagni"
2023,"Lecce","Serie A","Kristoffer Askildsen","NOR","MF","21",2001,8.1,7,3,2,3,2,4,10,40,6,15,4,11,11,18,6,0,"https://fbref.com/en/players/a69cc629/Kristoffer-Askildsen"
2023,"Lecce","Serie A","Lameck Banda","ZAM","FW,MF","21",2001,18.2,30,20,13,14,3,15,41,36.6,26,24,2,22,8,38,5,0,"https://fbref.com/en/players/8a6de8c7/Lameck-Banda"
2023,"Lecce","Serie A","Federico Baschirotto","ITA","DF","25",1996,37,40,30,35,5,0,22,36,61.1,14,45,29,16,36,76,192,0,"https://fbref.com/en/players/5a08ee41/Federico-Baschirotto"
2023,"Lecce","Serie A","Kristijan Bistrović","CRO","MF","24",1998,5.1,3,1,3,0,0,0,5,0,5,3,0,3,0,3,4,0,"https://fbref.com/en/players/79370f8c/Kristijan-Bistrovic"
2023,"Lecce","Serie A","Alexis Blin","FRA","MF","25",1996,26.4,69,39,27,33,9,38,73,52.1,35,55,15,40,34,103,74,0,"https://fbref.com/en/players/c69ef855/Alexis-Blin"
2023,"Lecce","Serie A","Tommaso Cassandro","ITA","DF","22",2000,0.1,1,1,0,1,0,0,0,NA,0,1,1,0,0,1,0,0,"https://fbref.com/en/players/6c4307ee/Tommaso-Cassandro"
2023,"Lecce","Serie A","Pietro Ceccaroni","ITA","DF","26",1995,0.5,0,0,0,0,0,0,0,NA,0,1,1,0,3,3,2,0,"https://fbref.com/en/players/4d1efb48/Pietro-Ceccaroni"
2023,"Lecce","Serie A","Assan Ceesay","GAM","FW","28",1994,20.1,23,18,7,8,8,9,17,52.9,8,15,2,13,3,26,24,0,"https://fbref.com/en/players/07f8bcc8/Assan-Ceesay"
2023,"Lecce","Serie A","Lorenzo Colombo","ITA","FW","20",2002,16.8,17,9,1,9,7,6,14,42.9,8,22,0,22,2,19,7,0,"https://fbref.com/en/players/04df29a5/Lorenzo-Colombo"
2023,"Lecce","Serie A","Kastriot Dermaku","ALB","DF","30",1992,0.4,0,0,0,0,0,0,0,NA,0,0,0,0,0,0,0,0,"https://fbref.com/en/players/2990c466/Kastriot-Dermaku"
2023,"Lecce","Serie A","Federico Di Francesco","ITA","FW,MF","28",1994,22.6,28,16,7,11,10,9,19,47.4,10,16,0,16,8,36,14,0,"https://fbref.com/en/players/1fca9171/Federico-Di-Francesco"
2023,"Lecce","Serie A","Wladimiro Falcone","ITA","GK","27",1995,38,2,0,2,0,0,2,2,100,0,0,0,0,2,4,21,3,"https://fbref.com/en/players/9f5a610b/Wladimiro-Falcone"
2023,"Lecce","Serie A","Antonino Gallo","ITA","DF","22",2000,27.6,56,36,35,12,9,38,57,66.7,19,37,6,31,13,69,71,0,"https://fbref.com/en/players/c74d63ac/Antonino-Gallo"
2023,"Lecce","Serie A","Valentin Gendrey","FRA","DF","22",2000,34.5,88,57,54,25,9,40,71,56.3,31,45,4,41,37,125,89,0,"https://fbref.com/en/players/822ed0ec/Valentin-Gendrey"
2023,"Lecce","Serie A","Joan Gonzàlez","ESP","MF","20",2002,24.4,48,28,20,18,10,17,51,33.3,34,37,8,29,16,64,28,0,"https://fbref.com/en/players/f025eade/Joan-Gonzalez"
2023,"Lecce","Serie A","Morten Hjulmand","DEN","MF","23",1999,32.9,90,52,49,40,1,37,67,55.2,30,43,11,32,72,162,54,0,"https://fbref.com/en/players/d4456fb3/Morten-Hjulmand"
2023,"Lecce","Serie A","Þórir Jóhann Helgason","ISL","MF","21",2000,2.5,2,2,1,0,1,2,3,66.7,1,3,1,2,3,5,3,0,"https://fbref.com/en/players/dc765618/Thorir-Johann-Helgason"
2023,"Lecce","Serie A","Marcin Listkowski","POL","MF,FW","24",1998,0.9,0,0,0,0,0,0,0,NA,0,0,0,0,3,3,2,0,"https://fbref.com/en/players/a3695ac2/Marcin-Listkowski"
2023,"Lecce","Serie A","Youssef Maleh","MAR","MF","23",1998,7.5,17,8,3,7,7,6,14,42.9,8,20,1,19,5,22,10,0,"https://fbref.com/en/players/4c8845f7/Youssef-Maleh"
2023,"Lecce","Serie A","Yıldırım Mert Çetin","TUR","DF","25",1997,0.2,1,0,1,0,0,0,0,NA,0,0,0,0,1,2,1,0,"https://fbref.com/en/players/c730da00/Yildirim-Mert-Cetin"
2023,"Lecce","Serie A","Remi Oudin","FRA","FW,MF","25",1996,14.7,25,13,9,12,4,10,23,43.5,13,16,2,14,29,54,23,0,"https://fbref.com/en/players/ea02beaf/Remi-Oudin"
2023,"Lecce","Serie A","Giuseppe Pezzella","ITA","DF","24",1997,10.2,21,9,16,2,3,9,16,56.3,7,11,3,8,8,29,31,1,"https://fbref.com/en/players/149c5f5d/Giuseppe-Pezzella"
2023,"Lecce","Serie A","Marin Pongračić","CRO","DF","24",1997,8.8,16,14,8,7,1,5,7,71.4,2,4,3,1,16,32,31,0,"https://fbref.com/en/players/2a6cd437/Marin-Pongracic"
2023,"Lecce","Serie A","Pablo Rodríguez","ESP","FW,MF","20",2001,0.6,2,1,2,0,0,0,2,0,2,3,0,3,0,2,0,0,"https://fbref.com/en/players/1d4e63b6/Pablo-Rodriguez"
2023,"Lecce","Serie A","Simone Romagnoli","ITA","DF","32",1990,1.9,6,5,3,3,0,2,2,100,0,4,1,3,1,7,11,0,"https://fbref.com/en/players/09899de8/Simone-Romagnoli"
2023,"Lecce","Serie A","Gabriel Strefezza","","DF,FW","25",1997,27.1,NA,27,NA,NA,NA,NA,NA,NA,NA,NA,NA,NA,16,NA,NA,NA,"https://fbref.com/en/players/ac4a4508/Gabriel-Strefezza"
2023,"Lecce","Serie A","Alessandro Tuia","ITA","DF","32",1990,5.7,10,6,6,4,0,3,9,33.3,6,3,1,2,15,25,29,0,"https://fbref.com/en/players/26c54058/Alessandro-Tuia"
2023,"Lecce","Serie A","Samuel Umtiti","FRA","DF","28",1993,23.5,52,34,25,25,2,18,26,69.2,8,26,14,12,26,78,79,0,"https://fbref.com/en/players/3eed9821/Samuel-Umtiti"
2023,"Lecce","Serie A","Joel Voelkerling Persson","SWE","FW,MF","19",2003,1.1,1,1,0,0,1,0,1,0,1,1,0,1,0,1,0,0,"https://fbref.com/en/players/b3ef6517/Joel-Voelkerling-Persson"
2023,"Leeds United","Premier League","Brenden Aaronson","USA","MF,FW","21",2000,26.4,45,18,16,22,7,15,46,32.6,31,43,3,40,5,50,6,1,"https://fbref.com/en/players/5bc43860/Brenden-Aaronson"
2023,"Leeds United","Premier League","Tyler Adams","USA","MF","23",1999,24,89,46,44,35,10,50,77,64.9,27,48,8,40,35,124,29,0,"https://fbref.com/en/players/2b09d998/Tyler-Adams"
2023,"Leeds United","Premier League","Luke Ayling","ENG","DF","30",1991,22.8,66,37,42,15,9,42,85,49.4,43,34,11,23,26,92,52,2,"https://fbref.com/en/players/420d7c7d/Luke-Ayling"
2023,"Leeds United","Premier League","Patrick Bamford","ENG","FW","28",1993,16.8,9,6,0,6,3,4,20,20,16,12,5,7,5,14,13,0,"https://fbref.com/en/players/93feac6e/Patrick-Bamford"
2023,"Leeds United","Premier League","Liam Cooper","SCO","DF","30",1991,15.8,38,23,27,9,2,23,36,63.9,13,16,8,8,34,72,57,3,"https://fbref.com/en/players/dc64b8b3/Liam-Cooper"
2023,"Leeds United","Premier League","Cody Drameh","ENG","DF","20",2001,0.8,5,4,0,4,1,2,3,66.7,1,0,0,0,1,6,1,0,"https://fbref.com/en/players/e0d1510a/Cody-Drameh"
2023,"Leeds United","Premier League","Junior Firpo","ESP","DF","25",1996,15.2,47,25,27,15,5,24,46,52.2,22,23,7,16,24,71,40,0,"https://fbref.com/en/players/24f59bb2/Junior-Firpo"
2023,"Leeds United","Premier League","Adam Forshaw","ENG","MF","30",1991,5.3,12,9,5,7,0,7,17,41.2,10,9,1,8,4,16,2,0,"https://fbref.com/en/players/9f1938ab/Adam-Forshaw"
2023,"Leeds United","Premier League","Joe Gelhardt","ENG","FW","20",2002,2.4,6,2,1,3,2,3,5,60,2,5,0,5,0,6,4,0,"https://fbref.com/en/players/01962d0d/Joe-Gelhardt"
2023,"Leeds United","Premier League","Degnand Gnonto","ITA","FW,MF","18",2003,15,27,17,7,15,5,10,30,33.3,20,24,1,23,5,32,7,0,"https://fbref.com/en/players/75fdd638/Degnand-Gnonto"
2023,"Leeds United","Premier League","Sam Greenwood","ENG","MF,FW","20",2002,4.7,15,7,7,8,0,8,21,38.1,13,10,2,8,1,16,1,0,"https://fbref.com/en/players/f3354c07/Sam-Greenwood"
2023,"Leeds United","Premier League","Darko Gyabi","ENG","FW","18",2004,0.1,2,2,1,1,0,0,0,NA,0,2,0,2,0,2,0,0,"https://fbref.com/en/players/56d838f7/Darko-Gyabi"
2023,"Leeds United","Premier League","Jack Harrison","ENG","FW,MF","25",1996,30.1,41,17,5,15,21,12,52,23.1,40,47,2,45,22,63,25,0,"https://fbref.com/en/players/aa849a12/Jack-Harrison"
2023,"Leeds United","Premier League","Daniel James","WAL","FW","24",1997,2.2,6,2,1,3,2,3,6,50,3,4,0,4,2,8,2,0,"https://fbref.com/en/players/c931d9f9/Daniel-James"
2023,"Leeds United","Premier League","Mateo Joseph","ENG","FW,MF","18",2003,0.3,0,0,0,0,0,0,0,NA,0,1,0,1,0,0,1,0,"https://fbref.com/en/players/6ad43f9a/Mateo-Joseph"
2023,"Leeds United","Premier League","Mateusz Klich","POL","MF,FW","32",1990,3.1,12,8,3,4,5,7,13,53.8,6,4,0,4,0,12,1,0,"https://fbref.com/en/players/282679b4/Mateusz-Klich"
2023,"Leeds United","Premier League","Robin Koch","GER","DF","26",1996,35.3,53,30,32,16,5,24,56,42.9,32,44,21,23,43,96,152,1,"https://fbref.com/en/players/ea6bc03a/Robin-Koch"
2023,"Leeds United","Premier League","Diego Llorente","ESP","DF","28",1993,7.2,13,10,8,5,0,4,8,50,4,6,2,4,15,28,24,2,"https://fbref.com/en/players/bba30585/Diego-Llorente"
2023,"Leeds United","Premier League","Weston McKennie","USA","MF","23",1998,16,30,13,5,18,7,10,29,34.5,19,22,3,19,22,52,26,0,"https://fbref.com/en/players/01c3aff5/Weston-McKennie"
2023,"Leeds United","Premier League","Illan Meslier","FRA","GK","22",2000,34,2,1,2,0,0,2,4,50,2,0,0,0,1,3,30,3,"https://fbref.com/en/players/6b625ac2/Illan-Meslier"
2023,"Leeds United","Premier League","Rasmus Nissen","DEN","DF","25",1997,21.8,62,35,35,21,6,42,76,55.3,34,32,14,18,35,97,61,0,"https://fbref.com/en/players/39769cff/Rasmus-Nissen"
2023,"Leeds United","Premier League","Joel Robles","ESP","GK","32",1990,4,0,0,0,0,0,0,1,0,1,0,0,0,0,0,2,1,"https://fbref.com/en/players/cda0b317/Joel-Robles"
2023,"Leeds United","Premier League","Marc Roca","ESP","MF","25",1996,25.7,66,40,27,34,5,20,65,30.8,45,34,10,24,23,89,24,2,"https://fbref.com/en/players/da27e268/Marc-Roca"
2023,"Leeds United","Premier League","Rodrigo","ESP","FW,MF","31",1991,21.5,24,10,2,15,7,8,19,42.1,11,16,4,12,6,30,21,1,"https://fbref.com/en/players/1fb1c435/Rodrigo"
2023,"Leeds United","Premier League","Georginio Rutter","FRA","FW,MF","20",2002,3,10,9,5,3,2,5,8,62.5,3,5,0,5,3,13,3,0,"https://fbref.com/en/players/c64c01fc/Georginio-Rutter"
2023,"Leeds United","Premier League","Luis Sinisterra","COL","FW","23",1999,9.6,21,14,8,9,4,11,18,61.1,7,11,1,10,8,29,2,0,"https://fbref.com/en/players/8e16dd48/Luis-Sinisterra"
2023,"Leeds United","Premier League","Pascal Struijk","NED","DF","22",1999,24.4,84,57,43,31,10,49,75,65.3,26,32,12,20,32,116,70,1,"https://fbref.com/en/players/f4d296e4/Pascal-Struijk"
2023,"Leeds United","Premier League","Crysencio Summerville","NED","FW","20",2001,15.8,30,20,14,14,2,11,23,47.8,12,20,2,18,13,43,11,0,"https://fbref.com/en/players/df04eb4b/Crysencio-Summerville"
2023,"Leeds United","Premier League","Maximilian Wöber","AUT","DF","24",1998,14.1,25,18,9,15,1,16,24,66.7,8,32,14,18,27,52,67,1,"https://fbref.com/en/players/4b803b3c/Maximilian-Wober"
2023,"Leicester City","Premier League","Marc Albrighton","ENG","FW,MF","32",1989,2.6,4,1,0,2,2,1,8,12.5,7,6,2,4,1,5,5,0,"https://fbref.com/en/players/b827d5b3/Marc-Albrighton"
2023,"Leicester City","Premier League","Daniel Amartey","GHA","DF","27",1994,17.9,19,8,13,5,1,12,14,85.7,2,24,17,7,8,27,71,0,"https://fbref.com/en/players/1a4ef233/Daniel-Amartey"
2023,"Leicester City","Premier League","Harvey Barnes","ENG","FW,MF","24",1997,30.1,26,14,8,14,4,14,42,33.3,28,32,1,31,8,34,12,0,"https://fbref.com/en/players/3ea50f67/Harvey-Barnes"
2023,"Leicester City","Premier League","Victor Bernth Kristiansen","DEN","DF","19",2002,9.9,38,23,18,16,4,22,30,73.3,8,16,4,12,3,41,26,0,"https://fbref.com/en/players/505486d6/Victor-Bernth-Kristiansen"
2023,"Leicester City","Premier League","Lewis Brunt","ENG","DF","21",2000,0.3,0,0,0,0,0,0,0,NA,0,0,0,0,0,0,2,0,"https://fbref.com/en/players/a2081c6b/Lewis-Brunt"
2023,"Leicester City","Premier League","Timothy Castagne","BEL","DF","26",1995,36.2,87,44,53,27,7,41,84,48.8,43,50,13,37,43,130,110,0,"https://fbref.com/en/players/197640fd/Timothy-Castagne"
2023,"Leicester City","Premier League","Patson Daka","ZAM","FW","23",1998,13.2,14,8,6,8,0,3,12,25,9,14,2,12,7,21,7,0,"https://fbref.com/en/players/ca45605e/Patson-Daka"
2023,"Leicester City","Premier League","Kiernan Dewsbury-Hall","ENG","MF","23",1998,25.6,53,29,14,34,5,19,47,40.4,28,55,13,42,28,81,21,0,"https://fbref.com/en/players/5c74c0f5/Kiernan-Dewsbury-Hall"
2023,"Leicester City","Premier League","Jonny Evans","NIR","DF","34",1988,11.7,13,5,12,1,0,7,11,63.6,4,15,11,4,18,31,51,0,"https://fbref.com/en/players/f8fcd2a5/Jonny-Evans"
2023,"Leicester City","Premier League","Wout Faes","BEL","DF","24",1998,31,56,33,28,26,2,28,44,63.6,16,53,37,16,41,97,113,2,"https://fbref.com/en/players/9c221d14/Wout-Faes"
2023,"Leicester City","Premier League","Wesley Fofana","FRA","DF","21",2000,2,4,2,1,2,1,1,3,33.3,2,1,1,0,9,13,5,0,"https://fbref.com/en/players/132a82f1/Wesley-Fofana"
2023,"Leicester City","Premier League","Kelechi Iheanacho","NGA","FW,MF","25",1996,12.5,7,2,0,3,4,3,10,30,7,9,1,8,0,7,8,0,"https://fbref.com/en/players/c92e1a31/Kelechi-Iheanacho"
2023,"Leicester City","Premier League","Daniel Iversen","DEN","GK","25",1997,12,0,0,0,0,0,0,0,NA,0,0,0,0,0,0,6,1,"https://fbref.com/en/players/10d221cd/Daniel-Iversen"
2023,"Leicester City","Premier League","James Justin","ENG","DF","24",1998,13.9,20,18,7,12,1,9,14,64.3,5,24,6,18,15,35,47,0,"https://fbref.com/en/players/fb614c44/James-Justin"
2023,"Leicester City","Premier League","James Maddison","ENG","MF,FW","25",1996,27.6,51,26,25,19,7,19,50,38,31,19,1,18,13,64,6,1,"https://fbref.com/en/players/ee38d9c5/James-Maddison"
2023,"Leicester City","Premier League","Nampalys Mendy","SEN","MF","30",1992,8.4,13,9,7,6,0,8,15,53.3,7,20,4,16,13,26,2,0,"https://fbref.com/en/players/1598599e/Nampalys-Mendy"
2023,"Leicester City","Premier League","Wilfred Ndidi","NGA","MF","25",1996,18.7,61,42,34,24,3,17,43,39.5,26,32,14,18,38,99,48,3,"https://fbref.com/en/players/6b47c5db/Wilfred-Ndidi"
2023,"Leicester City","Premier League","Ricardo Pereira","POR","DF,MF","28",1993,5,11,7,8,3,0,7,17,41.2,10,8,2,6,4,15,20,0,"https://fbref.com/en/players/75a72a99/Ricardo-Pereira"
2023,"Leicester City","Premier League","Ayoze Pérez","ESP","MF,FW","29",1993,4.2,11,8,5,4,2,8,19,42.1,11,6,0,6,2,13,3,0,"https://fbref.com/en/players/819aa8e7/Ayoze-Perez"
2023,"Leicester City","Premier League","Dennis Praet","BEL","MF,FW","28",1994,7.2,12,9,5,6,1,6,11,54.5,5,12,2,10,5,17,6,0,"https://fbref.com/en/players/86695068/Dennis-Praet"
2023,"Leicester City","Premier League","Boubakary Soumaré","FRA","MF","23",1999,18.1,57,34,29,26,2,23,43,53.5,20,15,4,11,33,90,27,1,"https://fbref.com/en/players/ae59b359/Boubakary-Soumare"
2023,"Leicester City","Premier League","Harry Souttar","AUS","DF","23",1998,11,15,9,10,5,0,7,18,38.9,11,16,12,4,12,27,45,0,"https://fbref.com/en/players/0a6cb1b1/Harry-Souttar"
2023,"Leicester City","Premier League","Çağlar Söyüncü","TUR","DF","26",1996,5.9,14,9,10,4,0,7,10,70,3,9,8,1,7,21,30,0,"https://fbref.com/en/players/21166ff4/Caglar-Soyuncu"
2023,"Leicester City","Premier League","Tetê","BRA","FW","22",2000,8.2,14,8,5,7,2,6,21,28.6,15,9,0,9,2,16,3,0,"https://fbref.com/en/players/7120a04d/Tete"
2023,"Leicester City","Premier League","Luke Thomas","ENG","DF","21",2001,11.9,23,19,15,5,3,15,32,46.9,17,20,4,16,27,50,35,0,"https://fbref.com/en/players/fc027d02/Luke-Thomas"
2023,"Leicester City","Premier League","Youri Tielemans","BEL","MF","25",1997,26,66,39,27,30,9,23,61,37.7,38,35,8,27,28,94,24,1,"https://fbref.com/en/players/56f7a928/Youri-Tielemans"
2023,"Leicester City","Premier League","Jamie Vardy","ENG","FW","35",1987,20.6,10,5,4,3,3,1,7,14.3,6,17,3,14,2,12,30,0,"https://fbref.com/en/players/45963054/Jamie-Vardy"
2023,"Leicester City","Premier League","Danny Ward","WAL","GK","29",1993,26,1,1,1,0,0,1,3,33.3,2,0,0,0,0,1,14,2,"https://fbref.com/en/players/d3ce0e89/Danny-Ward"
2023,"Lens","Ligue 1","Salis Abdul Samed","GHA","MF","22",2000,32.2,46,26,18,23,5,29,52,55.8,23,38,9,29,36,82,26,0,"https://fbref.com/en/players/82464ce3/Salis-Abdul-Samed"
2023,"Lens","Ligue 1","Patrick Berg","NOR","MF,FW","24",1997,0.3,0,0,0,0,0,0,1,0,1,0,0,0,1,1,0,0,"https://fbref.com/en/players/e4114f5d/Patrick-Berg"
2023,"Lens","Ligue 1","Ismaëlben Boura","FRA","DF,FW","21",2000,1,6,4,4,2,0,5,6,83.3,1,2,1,1,2,8,3,0,"https://fbref.com/en/players/62e02107/Ismaelben-Boura"
2023,"Lens","Ligue 1","Adam Buksa","POL","FW,MF","26",1996,1.1,1,0,0,0,1,0,3,0,3,0,0,0,0,1,0,0,"https://fbref.com/en/players/3b676989/Adam-Buksa"
2023,"Lens","Ligue 1","Jimmy Cabot","FRA","DF,MF","28",1994,5.7,20,12,10,8,2,12,26,46.2,14,5,0,5,4,24,12,0,"https://fbref.com/en/players/46359159/Jimmy-Cabot"
2023,"Lens","Ligue 1","Alexis Claude-Maurice","FRA","MF,FW","24",1998,6.7,14,9,5,8,1,6,16,37.5,10,6,0,6,2,16,1,0,"https://fbref.com/en/players/741418c3/Alexis-Claude-Maurice"
2023,"Lens","Ligue 1","David Pereira da Costa","POR","MF,FW","21",2001,15.6,13,7,1,10,2,7,19,36.8,12,19,1,18,11,24,6,0,"https://fbref.com/en/players/59948ef7/David-Pereira-da-Costa"
2023,"Lens","Ligue 1","Kevin Danso","AUT","DF","23",1998,35.9,37,19,25,11,1,19,30,63.3,11,48,34,14,33,70,124,0,"https://fbref.com/en/players/6e33125f/Kevin-Danso"
2023,"Lens","Ligue 1","Seko Fofana","CIV","MF","27",1995,34.1,28,13,8,18,2,15,39,38.5,24,17,4,13,19,47,14,0,"https://fbref.com/en/players/5313ed43/Seko-Fofana"
2023,"Lens","Ligue 1","Steven Fortes","CPV","DF","30",1992,0.1,0,0,0,0,0,0,0,NA,0,0,0,0,0,0,0,0,"https://fbref.com/en/players/574aa9ec/Steven-Fortes"
2023,"Lens","Ligue 1","Przemysław Frankowski","POL","DF,MF","27",1995,31.5,77,51,37,31,9,39,80,48.8,41,38,6,32,41,118,42,2,"https://fbref.com/en/players/00a8d210/Przemyslaw-Frankowski"
2023,"Lens","Ligue 1","Angelo Fulgini","FRA","MF,FW","25",1996,9.5,14,7,2,4,8,5,14,35.7,9,11,0,11,8,22,2,0,"https://fbref.com/en/players/4b96c347/Angelo-Fulgini"
2023,"Lens","Ligue 1","Ignatius Ganago","CMR","FW","23",1999,0.7,0,0,0,0,0,0,0,NA,0,0,0,0,0,0,1,0,"https://fbref.com/en/players/23c63b7f/Ignatius-Ganago"
2023,"Lens","Ligue 1","Jonathan Gradit","FRA","DF","29",1992,31.4,62,40,30,25,7,31,53,58.5,22,40,26,14,38,100,83,0,"https://fbref.com/en/players/06c48679/Jonathan-Gradit"
2023,"Lens","Ligue 1","Massadio Haïdara","MLI","DF,MF","29",1992,18.6,24,16,9,9,6,12,24,50,12,26,9,17,36,60,39,1,"https://fbref.com/en/players/5167c97e/Massadio-Haidara"
2023,"Lens","Ligue 1","Gaël Kakuta","COD","FW","31",1991,0.2,0,0,0,0,0,0,0,NA,0,0,0,0,0,0,1,0,"https://fbref.com/en/players/5b1bf5e3/Gael-Kakuta"
2023,"Lens","Ligue 1","Rémy Labeau Lascary","GLP","FW,MF","19",2003,1.4,4,2,4,0,0,0,0,NA,0,4,0,4,1,5,0,0,"https://fbref.com/en/players/c90f380c/Remy-Labeau-Lascary"
2023,"Lens","Ligue 1","Julien Le Cardinal","FRA","DF","24",1997,1.8,6,4,5,0,1,4,6,66.7,2,3,0,3,2,8,5,0,"https://fbref.com/en/players/547a72ad/Julien-Le-Cardinal"
2023,"Lens","Ligue 1","Jean-Louis Leca","FRA","GK","36",1985,1,0,0,0,0,0,0,0,NA,0,0,0,0,0,0,0,1,"https://fbref.com/en/players/edbe46dc/Jean-Louis-Leca"
2023,"Lens","Ligue 1","Deiver Machado","COL","DF,MF","28",1993,24.3,45,26,18,20,7,21,34,61.8,13,21,4,17,21,66,27,0,"https://fbref.com/en/players/b3f8bdef/Deiver-Machado"
2023,"Lens","Ligue 1","Facundo Medina","ARG","DF","23",1999,30.9,31,20,16,15,0,13,35,37.1,22,25,9,16,26,57,62,1,"https://fbref.com/en/players/6f5ec8bb/Facundo-Medina"
2023,"Lens","Ligue 1","Jean Onana","CMR","MF,DF","22",2000,9,28,17,8,17,3,10,22,45.5,12,15,5,10,18,46,20,0,"https://fbref.com/en/players/b5bb8188/Jean-Onana"
2023,"Lens","Ligue 1","Loïs Openda","BEL","FW","22",2000,28,11,9,2,6,3,2,13,15.4,11,9,0,9,2,13,6,0,"https://fbref.com/en/players/8652a85c/Lois-Openda"
2023,"Lens","Ligue 1","Łukasz Poręba","POL","MF","22",2000,2.9,5,4,2,1,2,2,3,66.7,1,3,0,3,4,9,2,0,"https://fbref.com/en/players/be98f358/Lukasz-Poreba"
2023,"Lens","Ligue 1","Wesley Saïd","FRA","FW,MF","27",1995,7.2,4,1,1,2,1,2,6,33.3,4,4,0,4,1,5,2,0,"https://fbref.com/en/players/90fcf472/Wesley-Said"
2023,"Lens","Ligue 1","Brice Samba","FRA","GK","28",1994,37,1,0,1,0,0,1,2,50,1,1,0,1,0,1,12,2,"https://fbref.com/en/players/60d90c55/Brice-Samba"
2023,"Lens","Ligue 1","Florian Sotoca","FRA","MF,FW","31",1990,33.9,39,19,11,17,11,15,40,37.5,25,41,2,39,29,68,51,0,"https://fbref.com/en/players/7a42d0df/Florian-Sotoca"
2023,"Lens","Ligue 1","Adrien Thomasson","FRA","MF,FW","28",1993,14.2,24,17,8,11,5,12,45,26.7,33,25,2,23,4,28,17,0,"https://fbref.com/en/players/c76b7567/Adrien-Thomasson"
2023,"Lens","Ligue 1","Christopher Wooh","CMR","MF","20",2001,0,0,0,0,0,0,0,1,0,1,0,0,0,0,0,1,0,"https://fbref.com/en/players/b003239d/Christopher-Wooh"
2023,"Leverkusen","Bundesliga","Amine Adli","FRA","FW,MF","22",2000,15.9,18,10,4,6,8,5,17,29.4,12,28,2,26,6,24,7,0,"https://fbref.com/en/players/dcfb17f4/Amine-Adli"
2023,"Leverkusen","Bundesliga","Nadiem Amiri","GER","MF,FW","25",1996,10.9,15,6,5,8,2,9,20,45,11,12,1,11,6,21,10,2,"https://fbref.com/en/players/555d5edd/Nadiem-Amiri"
2023,"Leverkusen","Bundesliga","Robert Andrich","GER","MF","27",1994,26.7,61,38,30,27,4,26,45,57.8,19,27,9,18,42,103,55,2,"https://fbref.com/en/players/e0b113a7/Robert-Andrich"
2023,"Leverkusen","Bundesliga","Charles Aránguiz","CHI","MF","33",1989,5.5,17,7,7,10,0,12,20,60,8,4,0,4,7,24,4,0,"https://fbref.com/en/players/56413b1f/Charles-Aranguiz"
2023,"Leverkusen","Bundesliga","Ayman Azhil","MAR","MF","21",2001,0,0,0,0,0,0,0,0,NA,0,0,0,0,0,0,0,0,"https://fbref.com/en/players/ce81d82d/Ayman-Azhil"
2023,"Leverkusen","Bundesliga","Sardar Azmoun","IRN","FW,MF","27",1995,10.3,6,3,1,4,1,1,7,14.3,6,4,0,4,2,8,14,0,"https://fbref.com/en/players/10549b49/Sardar-Azmoun"
2023,"Leverkusen","Bundesliga","Mitchel Bakker","NED","DF,MF","22",2000,18.4,16,8,9,7,0,6,15,40,9,20,2,18,15,31,20,2,"https://fbref.com/en/players/a8567629/Mitchel-Bakker"
2023,"Leverkusen","Bundesliga","Karim Bellarabi","GER","FW,MF","32",1990,0.9,2,0,1,1,0,2,3,66.7,1,0,0,0,0,2,0,0,"https://fbref.com/en/players/bee0bab1/Karim-Bellarabi"
2023,"Leverkusen","Bundesliga","Kerem Demirbay","GER","MF","29",1993,17.2,36,18,16,17,3,18,34,52.9,16,26,6,20,16,52,11,0,"https://fbref.com/en/players/54b4dc4e/Kerem-Demirbay"
2023,"Leverkusen","Bundesliga","Moussa Diaby","FRA","FW,MF","23",1999,30,14,8,4,8,2,7,14,50,7,8,0,8,5,19,3,0,"https://fbref.com/en/players/aeed5c06/Moussa-Diaby"
2023,"Leverkusen","Bundesliga","Timothy Fosu-Mensah","NED","DF","24",1998,2.1,7,5,3,3,1,4,4,100,0,2,0,2,0,7,1,0,"https://fbref.com/en/players/a9142dc3/Timothy-Fosu-Mensah"
2023,"Leverkusen","Bundesliga","Jeremie Frimpong","NED","DF,MF","21",2000,30.1,53,27,22,26,5,23,44,52.3,21,24,3,21,16,69,40,0,"https://fbref.com/en/players/74f2e748/Jeremie-Frimpong"
2023,"Leverkusen","Bundesliga","Piero Hincapié","ECU","DF","20",2002,27.3,51,34,28,20,3,25,38,65.8,13,41,20,21,31,82,83,1,"https://fbref.com/en/players/0c7a48f8/Piero-Hincapie"
2023,"Leverkusen","Bundesliga","Adam Hložek","CZE","FW,MF","20",2002,14.3,9,4,4,3,2,3,9,33.3,6,9,2,7,6,15,9,0,"https://fbref.com/en/players/5521f419/Adam-Hlozek"
2023,"Leverkusen","Bundesliga","Lukáš Hrádecký","FIN","GK","32",1989,33,0,0,0,0,0,0,0,NA,0,0,0,0,0,0,3,3,"https://fbref.com/en/players/ad3389d5/Lukas-Hradecky"
2023,"Leverkusen","Bundesliga","Callum Hudson-Odoi","ENG","FW,MF","21",2000,6.7,5,3,4,0,1,1,1,100,0,0,0,0,2,7,4,0,"https://fbref.com/en/players/15f3ec41/Callum-Hudson-Odoi"
2023,"Leverkusen","Bundesliga","Odilon Kossonou","CIV","DF","21",2001,16.9,21,14,12,7,2,8,16,50,8,26,11,15,24,45,58,1,"https://fbref.com/en/players/1f3afdcb/Odilon-Kossonou"
2023,"Leverkusen","Bundesliga","Andrey Lunyov","RUS","GK","30",1991,1,0,0,0,0,0,0,0,NA,0,0,0,0,0,0,0,0,"https://fbref.com/en/players/8a6ab963/Andrey-Lunyov"
2023,"Leverkusen","Bundesliga","Noah Mbamba","BEL","MF","17",2005,0,0,0,0,0,0,0,0,NA,0,0,0,0,0,0,0,0,"https://fbref.com/en/players/e75129bd/Noah-Mbamba"
2023,"Leverkusen","Bundesliga","Exequiel Palacios","ARG","MF","23",1998,18.4,59,36,20,33,6,29,48,60.4,19,29,2,27,33,92,28,0,"https://fbref.com/en/players/e82adcab/Exequiel-Palacios"
2023,"Leverkusen","Bundesliga","Paulinho","BRA","FW","22",2000,0.9,0,0,0,0,0,0,0,NA,0,1,0,1,0,0,2,0,"https://fbref.com/en/players/53070b63/Paulinho"
2023,"Leverkusen","Bundesliga","Joel Pohjanpalo","FIN","FW,MF","27",1994,0,0,0,0,0,0,0,0,NA,0,0,0,0,0,0,0,0,"https://fbref.com/en/players/ea003d07/Joel-Pohjanpalo"
2023,"Leverkusen","Bundesliga","Patrik Schick","CZE","FW","26",1996,10.5,0,0,0,0,0,0,1,0,1,4,1,3,1,1,7,0,"https://fbref.com/en/players/5d4f7d61/Patrik-Schick"
2023,"Leverkusen","Bundesliga","Daley Sinkgraven","NED","DF,MF","27",1995,3.8,10,7,7,3,0,7,9,77.8,2,8,4,4,5,15,7,0,"https://fbref.com/en/players/73000a79/Daley-Sinkgraven"
2023,"Leverkusen","Bundesliga","Jonathan Tah","GER","DF","26",1996,27.6,25,12,21,4,0,12,18,66.7,6,30,18,12,40,65,118,0,"https://fbref.com/en/players/bd142efb/Jonathan-Tah"
2023,"Leverkusen","Bundesliga","Edmond Tapsoba","BFA","DF","23",1999,31.9,51,30,35,12,4,30,42,71.4,12,40,17,23,36,87,109,1,"https://fbref.com/en/players/a73c8f95/Edmond-Tapsoba"
2023,"Leverkusen","Bundesliga","Florian Wirtz","GER","FW,MF","19",2003,12.1,18,10,9,7,2,8,16,50,8,15,1,14,1,19,6,0,"https://fbref.com/en/players/e7fcf289/Florian-Wirtz"
2023,"Lille","Ligue 1","Benjamin André","FRA","MF","31",1990,32.4,128,74,51,60,17,65,121,53.7,56,50,8,42,47,175,60,0,"https://fbref.com/en/players/ef9c1c95/Benjamin-Andre"
2023,"Lille","Ligue 1","Carlos Baleba","CMR","MF","18",2004,5.3,13,11,2,9,2,9,14,64.3,5,13,3,10,1,14,3,2,"https://fbref.com/en/players/a1390d2f/Carlos-Baleba"
2023,"Lille","Ligue 1","Jonathan Bamba","CIV","FW","26",1996,30.9,37,17,12,14,11,14,45,31.1,31,36,1,35,22,59,14,0,"https://fbref.com/en/players/b2bd0f6c/Jonathan-Bamba"
2023,"Lille","Ligue 1","Rémy Cabella","FRA","MF,FW","32",1990,28.1,64,37,21,28,15,29,64,45.3,35,41,5,36,17,81,7,1,"https://fbref.com/en/players/148e136f/Remy-Cabella"
2023,"Lille","Ligue 1","Leonardo César Jardim","BRA","GK","27",1995,6,NA,0,NA,NA,NA,NA,NA,NA,NA,NA,NA,NA,0,NA,NA,NA,"https://fbref.com/en/players/f5dfc256/Leonardo-Cesar-Jardim"
2023,"Lille","Ligue 1","Lucas Chevalier","FRA","GK","20",2001,32,2,1,2,0,0,2,2,100,0,1,0,1,2,4,7,2,"https://fbref.com/en/players/b3d76d84/Lucas-Chevalier"
2023,"Lille","Ligue 1","Jonathan David","CAN","FW","22",2000,35.2,24,17,6,11,7,10,27,37,17,20,2,18,8,32,13,0,"https://fbref.com/en/players/ce50fd99/Jonathan-David"
2023,"Lille","Ligue 1","Bafodé Diakité","FRA","DF","21",2001,29.5,54,35,23,24,7,32,57,56.1,25,37,8,29,17,71,58,0,"https://fbref.com/en/players/1bfb6fef/Bafode-Diakite"
2023,"Lille","Ligue 1","Tiago Djaló","POR","DF","22",2000,22.4,31,21,23,7,1,13,20,65,7,17,11,6,23,54,60,1,"https://fbref.com/en/players/b2336681/Tiago-Djalo"
2023,"Lille","Ligue 1","José Fonte","POR","DF","38",1983,28.8,23,17,18,4,1,10,21,47.6,11,27,14,13,25,48,112,2,"https://fbref.com/en/players/90f87966/Jose-Fonte"
2023,"Lille","Ligue 1","André Gomes","POR","MF","29",1993,18.1,37,19,12,17,8,19,52,36.5,33,20,5,15,9,46,16,1,"https://fbref.com/en/players/1961b2aa/Andre-Gomes"
2023,"Lille","Ligue 1","Angel Gomes","ENG","MF","21",2000,31.3,41,19,12,21,8,18,49,36.7,31,22,2,20,13,54,11,1,"https://fbref.com/en/players/645a3363/Angel-Gomes"
2023,"Lille","Ligue 1","Gabriel Gudmundsson","SWE","DF,FW","23",1999,9.3,19,11,7,10,2,12,22,54.5,10,11,2,9,10,29,20,0,"https://fbref.com/en/players/d5d22a58/Gabriel-Gudmundsson"
2023,"Lille","Ligue 1","Ismaily","BRA","DF","32",1990,19.8,41,18,16,16,9,17,32,53.1,15,25,5,20,21,62,39,0,"https://fbref.com/en/players/cf182add/Ismaily"
2023,"Lille","Ligue 1","Mohamed Lamine Bayo","GUI","FW,MF","24",1998,7.2,3,3,0,2,1,0,12,0,12,3,1,2,0,3,1,0,"https://fbref.com/en/players/01870104/Mohamed-Lamine-Bayo"
2023,"Lille","Ligue 1","Jonas Martin","FRA","MF","32",1990,3.1,9,7,4,5,0,5,14,35.7,9,3,1,2,7,16,3,0,"https://fbref.com/en/players/468fdbad/Jonas-Martin"
2023,"Lille","Ligue 1","Amine Messoussa","FRA","FW","17",2004,0,0,0,0,0,0,0,0,NA,0,0,0,0,0,0,0,0,"https://fbref.com/en/players/f29131b5/Amine-Messoussa"
2023,"Lille","Ligue 1","Adam Ounas","ALG","FW,MF","25",1996,11.8,20,11,4,10,6,8,13,61.5,5,16,0,16,7,27,5,0,"https://fbref.com/en/players/ed90babd/Adam-Ounas"
2023,"Lille","Ligue 1","Simon Ramet","FRA","DF","19",2003,0,0,0,0,0,0,0,0,NA,0,0,0,0,0,0,0,0,"https://fbref.com/en/players/ed8cecc9/Simon-Ramet"
2023,"Lille","Ligue 1","Alexsandro Ribeiro","BRA","DF","22",1999,17.9,32,18,24,7,1,19,28,67.9,9,11,2,9,25,57,59,1,"https://fbref.com/en/players/102c9665/Alexsandro-Ribeiro"
2023,"Lille","Ligue 1","Alan Virginius","FRA","FW","19",2003,2.9,3,2,1,1,1,0,4,0,4,0,0,0,2,5,1,0,"https://fbref.com/en/players/01becd60/Alan-Virginius"
2023,"Lille","Ligue 1","Timothy Weah","USA","DF,FW","22",2000,19.4,24,14,13,9,2,16,29,55.2,13,17,3,14,23,47,18,0,"https://fbref.com/en/players/8eec784d/Timothy-Weah"
2023,"Lille","Ligue 1","Yusuf Yazıcı","TUR","MF","25",1997,2.2,0,0,0,0,0,0,0,NA,0,2,0,2,0,0,1,0,"https://fbref.com/en/players/f5c8b425/Yusuf-Yazici"
2023,"Lille","Ligue 1","Leny Yoro","FRA","DF","16",2005,8.5,11,5,8,3,0,4,9,44.4,5,6,1,5,18,29,27,1,"https://fbref.com/en/players/6763f716/Leny-Yoro"
2023,"Lille","Ligue 1","Akim Zedadka","ALG","DF,MF","27",1995,3.9,1,1,1,0,0,0,2,0,2,3,0,3,2,3,6,0,"https://fbref.com/en/players/0ff630d0/Akim-Zedadka"
2023,"Lille","Ligue 1","Edon Zhegrova","KVX","FW,MF","23",1999,11.7,18,12,6,7,5,12,20,60,8,9,0,9,2,20,2,0,"https://fbref.com/en/players/34a88e3e/Edon-Zhegrova"
2023,"Liverpool","Premier League","Thiago Alcántara","ESP","MF","31",1991,13.9,43,24,20,21,2,14,23,60.9,9,15,3,12,21,64,13,2,"https://fbref.com/en/players/77e84962/Thiago-Alcantara"
2023,"Liverpool","Premier League","Trent Alexander-Arnold","ENG","DF","23",1998,32.5,57,40,32,16,9,42,79,53.2,37,25,7,18,43,100,41,2,"https://fbref.com/en/players/cd1acf9d/Trent-Alexander-Arnold"
2023,"Liverpool","Premier League","Alisson","BRA","GK","29",1992,37,0,0,0,0,0,0,3,0,3,3,0,3,0,0,20,0,"https://fbref.com/en/players/7a2e46a8/Alisson"
2023,"Liverpool","Premier League","Stefan Bajcetic","ESP","MF","17",2004,5.8,9,6,5,3,1,8,27,29.6,19,7,0,7,9,18,4,0,"https://fbref.com/en/players/32e8417f/Stefan-Bajcetic"
2023,"Liverpool","Premier League","Fabio Carvalho","POR","MF,FW","19",2002,3.9,8,8,3,3,2,3,6,50,3,6,0,6,6,14,0,0,"https://fbref.com/en/players/966e28d0/Fabio-Carvalho"
2023,"Liverpool","Premier League","Bobby Clark","ENG","MF","17",2005,0.1,0,0,0,0,0,0,0,NA,0,2,0,2,0,0,0,0,"https://fbref.com/en/players/73341ace/Bobby-Clark"
2023,"Liverpool","Premier League","Luis Díaz","COL","FW","25",1997,11.1,17,11,4,8,5,8,15,53.3,7,8,0,8,6,23,2,0,"https://fbref.com/en/players/4a1a9578/Luis-Diaz"
2023,"Liverpool","Premier League","Ben Doak","SCO","FW","16",2005,0.3,3,2,1,2,0,1,1,100,0,1,0,1,0,3,0,0,"https://fbref.com/en/players/733f1a7d/Ben-Doak"
2023,"Liverpool","Premier League","Harvey Elliott","ENG","MF,FW","19",2003,17.9,27,18,6,12,9,9,36,25,27,26,1,25,15,42,8,0,"https://fbref.com/en/players/b9e1436c/Harvey-Elliott"
2023,"Liverpool","Premier League","Fabinho","BRA","MF","28",1993,29.7,65,38,18,40,7,24,62,38.7,38,38,11,27,37,102,40,0,"https://fbref.com/en/players/7f3b388c/Fabinho"
2023,"Liverpool","Premier League","Roberto Firmino","BRA","FW,MF","30",1991,13.5,17,12,2,12,3,4,21,19,17,16,1,15,7,24,2,0,"https://fbref.com/en/players/4c370d81/Roberto-Firmino"
2023,"Liverpool","Premier League","Cody Gakpo","NED","FW,MF","23",1999,16.2,26,15,4,13,9,13,38,34.2,25,13,1,12,4,30,2,0,"https://fbref.com/en/players/1971591f/Cody-Gakpo"
2023,"Liverpool","Premier League","Joe Gomez","ENG","DF","25",1997,16.3,28,21,15,11,2,11,19,57.9,8,17,11,6,24,52,51,2,"https://fbref.com/en/players/7a11550b/Joe-Gomez"
2023,"Liverpool","Premier League","Jordan Henderson","ENG","MF","32",1990,23,32,23,10,18,4,15,36,41.7,21,21,3,18,21,53,16,1,"https://fbref.com/en/players/935e6b8f/Jordan-Henderson"
2023,"Liverpool","Premier League","Curtis Jones","ENG","MF","21",2001,11.5,34,17,8,12,14,18,31,58.1,13,12,2,10,3,37,9,0,"https://fbref.com/en/players/4fb9c88f/Curtis-Jones"
2023,"Liverpool","Premier League","Diogo Jota","POR","FW","25",1996,12.6,23,15,8,8,7,12,37,32.4,25,5,0,5,3,26,11,0,"https://fbref.com/en/players/178ae8f8/Diogo-Jota"
2023,"Liverpool","Premier League","Naby Keïta","GUI","MF","27",1995,3.3,5,4,2,3,0,1,4,25,3,1,0,1,2,7,3,0,"https://fbref.com/en/players/f25c8e3a/Naby-Keita"
2023,"Liverpool","Premier League","Caoimhín Kelleher","IRL","GK","23",1998,1,0,0,0,0,0,0,0,NA,0,0,0,0,0,0,0,0,"https://fbref.com/en/players/62d7ef38/Caoimhin-Kelleher"
2023,"Liverpool","Premier League","Ibrahima Konaté","FRA","DF","23",1999,17.2,38,26,25,13,0,16,27,59.3,11,12,5,7,26,64,61,4,"https://fbref.com/en/players/5ed9b537/Ibrahima-Konate"
2023,"Liverpool","Premier League","Joël Matip","CMR","DF","30",1991,12.1,14,8,12,2,0,11,23,47.8,12,8,3,5,21,35,45,3,"https://fbref.com/en/players/b217ef29/Joel-Matip"
2023,"Liverpool","Premier League","James Milner","ENG","MF,DF","36",1986,10.1,26,16,11,11,4,15,34,44.1,19,14,2,12,12,38,15,0,"https://fbref.com/en/players/2f90f6b8/James-Milner"
2023,"Liverpool","Premier League","Darwin Núñez","URU","FW","23",1999,18.8,11,5,2,4,5,4,17,23.5,13,10,0,10,3,14,13,0,"https://fbref.com/en/players/4d77b365/Darwin-Nunez"
2023,"Liverpool","Premier League","Alex Oxlade-Chamberlain","ENG","FW,MF","28",1993,3.7,5,4,1,2,2,1,5,20,4,5,2,3,1,6,4,0,"https://fbref.com/en/players/38c7feef/Alex-Oxlade-Chamberlain"
2023,"Liverpool","Premier League","Nathaniel Phillips","ENG","DF","25",1997,0.7,2,1,0,2,0,2,2,100,0,0,0,0,2,4,1,0,"https://fbref.com/en/players/515ebe8d/Nathaniel-Phillips"
2023,"Liverpool","Premier League","Andrew Robertson","SCO","DF","28",1994,28.7,38,21,12,16,10,21,41,51.2,20,32,5,27,18,56,50,3,"https://fbref.com/en/players/2e4f5f03/Andrew-Robertson"
2023,"Liverpool","Premier League","Mohamed Salah","EGY","FW","30",1992,36.6,21,12,4,5,12,10,26,38.5,16,21,0,21,6,27,4,0,"https://fbref.com/en/players/e342ad68/Mohamed-Salah"
2023,"Liverpool","Premier League","Kostas Tsimikas","GRE","DF","26",1996,8.6,14,9,10,2,2,10,16,62.5,6,8,1,7,12,26,15,0,"https://fbref.com/en/players/f315ca93/Kostas-Tsimikas"
2023,"Liverpool","Premier League","Virgil van Dijk","NED","DF","31",1991,31.5,27,14,13,11,3,8,19,42.1,11,24,16,8,31,58,138,2,"https://fbref.com/en/players/e06683ca/Virgil-van-Dijk"
2023,"Lorient","Ligue 1","Laurent Abergel","FRA","MF","29",1993,26,92,52,59,30,3,39,92,42.4,53,47,8,39,34,126,39,0,"https://fbref.com/en/players/31626657/Laurent-Abergel"
2023,"Lorient","Ligue 1","Adil Aouchiche","FRA","MF","20",2002,2.8,5,2,3,1,1,1,9,11.1,8,1,0,1,4,9,1,0,"https://fbref.com/en/players/b94b8be1/Adil-Aouchiche"
2023,"Lorient","Ligue 1","Quentin Boisgard","FRA","MF","25",1997,2,6,2,1,4,1,3,4,75,1,3,1,2,4,10,2,0,"https://fbref.com/en/players/f6496133/Quentin-Boisgard"
2023,"Lorient","Ligue 1","Igor Carioca","BRA","DF","25",1996,5.1,18,11,12,2,4,12,21,57.1,9,7,0,7,5,23,17,0,"https://fbref.com/en/players/e3e32fbb/Igor-Carioca"
2023,"Lorient","Ligue 1","Yoann Cathline","FRA","FW,MF","20",2002,12.1,19,12,7,6,6,5,12,41.7,7,10,1,9,8,27,16,1,"https://fbref.com/en/players/4db5915d/Yoann-Cathline"
2023,"Lorient","Ligue 1","Stéphane Diarra","FRA","FW,MF","23",1998,11.8,25,17,14,9,2,11,29,37.9,18,13,1,12,22,47,9,0,"https://fbref.com/en/players/29939a1d/Stephane-Diarra"
2023,"Lorient","Ligue 1","Bamba Dieng","SEN","FW","22",2000,8.3,19,10,5,12,2,3,11,27.3,8,6,0,6,2,21,6,0,"https://fbref.com/en/players/40774c6b/Bamba-Dieng"
2023,"Lorient","Ligue 1","Ckene Doucouré","COM","FW,MF","20",2002,1.5,2,2,2,0,0,1,2,50,1,0,0,0,1,3,0,0,"https://fbref.com/en/players/92d90c8f/Ckene-Doucoure"
2023,"Lorient","Ligue 1","Romain Faivre","FRA","MF,FW","24",1998,13.8,13,8,5,4,4,5,25,20,20,11,0,11,1,14,4,0,"https://fbref.com/en/players/745ca0a3/Romain-Faivre"
2023,"Lorient","Ligue 1","Adrian Grbić","AUT","MF,FW","25",1996,0.3,0,0,0,0,0,0,1,0,1,3,0,3,0,0,0,0,"https://fbref.com/en/players/4a987ffa/Adrian-Grbic"
2023,"Lorient","Ligue 1","Bonke Innocent","NGA","MF","26",1996,13.1,28,17,13,14,1,11,36,30.6,25,22,5,17,26,54,31,0,"https://fbref.com/en/players/546bb36e/Bonke-Innocent"
2023,"Lorient","Ligue 1","Eli Junior Kroupi","FRA","FW,MF","16",2006,0.1,0,0,0,0,0,0,1,0,1,0,0,0,1,1,0,0,"https://fbref.com/en/players/b2fe86e5/Eli-Junior-Kroupi"
2023,"Lorient","Ligue 1","Gedeon Kalulu","COD","DF","24",1997,27.1,64,34,43,14,7,30,48,62.5,18,32,3,29,28,92,79,2,"https://fbref.com/en/players/dd211559/Gedeon-Kalulu"
2023,"Lorient","Ligue 1","Ayman Kari","FRA","MF,DF","17",2004,1.1,0,0,0,0,0,0,0,NA,0,4,0,4,3,3,0,0,"https://fbref.com/en/players/0e8d7b6c/Ayman-Kari"
2023,"Lorient","Ligue 1","Ibrahima Koné","MLI","FW","23",1999,17.5,24,13,3,13,8,5,11,45.5,6,13,0,13,4,28,18,0,"https://fbref.com/en/players/04bb2b06/Ibrahima-Kone"
2023,"Lorient","Ligue 1","Julien Laporte","FRA","DF","28",1993,18.4,22,16,18,3,1,16,22,72.7,6,33,27,6,18,40,108,2,"https://fbref.com/en/players/f066022d/Julien-Laporte"
2023,"Lorient","Ligue 1","Armand Lauriente","FRA","FW","23",1998,3,8,7,3,4,1,3,7,42.9,4,5,1,4,4,12,1,0,"https://fbref.com/en/players/2d22cea7/Armand-Lauriente"
2023,"Lorient","Ligue 1","Théo Le Bris","FRA","MF,DF","19",2002,16.1,31,19,17,11,3,15,33,45.5,18,21,2,19,18,49,31,0,"https://fbref.com/en/players/afe39ca8/Theo-Le-Bris"
2023,"Lorient","Ligue 1","Enzo Le Fée","FRA","MF","22",2000,33.6,108,64,52,40,16,43,113,38.1,70,50,5,45,34,142,38,1,"https://fbref.com/en/players/6f806d99/Enzo-Le-Fee"
2023,"Lorient","Ligue 1","Vincent Le Goff","FRA","DF","32",1989,37,75,32,56,16,3,45,62,72.6,17,29,9,20,41,116,105,1,"https://fbref.com/en/players/2321ea6e/Vincent-Le-Goff"
2023,"Lorient","Ligue 1","Jean-Victor Makengo","FRA","MF","24",1998,11.8,16,8,5,10,1,6,20,30,14,8,5,3,10,26,13,1,"https://fbref.com/en/players/22bfb57e/Jean-Victor-Makengo"
2023,"Lorient","Ligue 1","Vito Mannone","ITA","GK","34",1988,17.9,0,0,0,0,0,0,0,NA,0,0,0,0,0,0,4,3,"https://fbref.com/en/players/c4173f1a/Vito-Mannone"
2023,"Lorient","Ligue 1","Chrislain Matsima","FRA","DF,MF","20",2002,2.5,0,0,0,0,0,0,0,NA,0,3,3,0,2,2,7,0,"https://fbref.com/en/players/cf1ef7ec/Chrislain-Matsima"
2023,"Lorient","Ligue 1","Bamo Meïté","CIV","DF","21",2001,16.7,18,8,13,4,1,7,16,43.8,9,33,23,10,16,34,70,0,"https://fbref.com/en/players/04ac78d2/Bamo-Meite"
2023,"Lorient","Ligue 1","Terem Moffi","NGA","FW","23",1999,15.4,8,5,1,4,3,3,5,60,2,11,3,8,3,11,10,0,"https://fbref.com/en/players/065dc209/Terem-Moffi"
2023,"Lorient","Ligue 1","Yvon Mvogo","SUI","GK","28",1994,20.1,0,0,0,0,0,0,0,NA,0,0,0,0,2,2,6,3,"https://fbref.com/en/players/dc29b608/Yvon-Mvogo"
2023,"Lorient","Ligue 1","Dango Ouattara","BFA","FW,MF","20",2002,17.2,41,26,20,11,10,15,28,53.6,13,24,6,18,19,60,21,0,"https://fbref.com/en/players/2f9e4435/Dango-Ouattara"
2023,"Lorient","Ligue 1","Julien Ponceau","FRA","MF","21",2000,18.4,28,19,10,14,4,10,32,31.3,22,27,3,24,14,42,12,0,"https://fbref.com/en/players/e546b2e3/Julien-Ponceau"
2023,"Lorient","Ligue 1","Montassar Talbi","TUN","DF","24",1998,38,53,25,40,13,0,22,35,62.9,13,55,34,21,40,93,190,3,"https://fbref.com/en/players/a4a44eb0/Montassar-Talbi"
2023,"Lorient","Ligue 1","Darlin Yongwa","CMR","DF","21",2000,8.7,13,11,7,5,1,4,15,26.7,11,13,1,12,5,18,11,0,"https://fbref.com/en/players/061266cd/Darlin-Yongwa"
2023,"Lyon","Ligue 1","Houssem Aouar","ALG","MF","24",1998,5.8,12,5,5,5,2,3,9,33.3,6,12,2,10,8,20,3,0,"https://fbref.com/en/players/a5db0bec/Houssem-Aouar"
2023,"Lyon","Ligue 1","Mohamed El Arouch","FRA","MF","18",2004,0,1,1,1,0,0,0,0,NA,0,0,0,0,0,1,0,0,"https://fbref.com/en/players/508a9011/Mohamed-El-Arouch"
2023,"Lyon","Ligue 1","Bradley Barcola","FRA","FW,MF","19",2002,16,25,16,8,10,7,8,39,20.5,31,29,0,29,19,44,10,0,"https://fbref.com/en/players/a0d55a09/Bradley-Barcola"
2023,"Lyon","Ligue 1","Jérôme Boateng","GER","DF","33",1988,4.8,3,0,2,1,0,2,6,33.3,4,8,5,3,6,9,16,0,"https://fbref.com/en/players/2db2fd7b/Jerome-Boateng"
2023,"Lyon","Ligue 1","Maxence Caqueret","FRA","MF","22",2000,30.7,87,54,27,38,22,43,109,39.4,66,45,3,42,39,126,27,0,"https://fbref.com/en/players/f81ef10d/Maxence-Caqueret"
2023,"Lyon","Ligue 1","Rayan Cherki","FRA","MF,FW","18",2003,20.8,14,8,2,5,7,8,23,34.8,15,6,0,6,5,19,1,0,"https://fbref.com/en/players/b34c63a5/Rayan-Cherki"
2023,"Lyon","Ligue 1","Damien Da Silva","FRA","DF","34",1988,3.8,8,7,5,3,0,3,3,100,0,4,3,1,5,13,12,0,"https://fbref.com/en/players/1ec7e1c5/Damien-Da-Silva"
2023,"Lyon","Ligue 1","Moussa Dembélé","FRA","FW,MF","26",1996,9.7,8,4,3,3,2,4,7,57.1,3,5,0,5,2,10,6,0,"https://fbref.com/en/players/e7986081/Moussa-Dembele"
2023,"Lyon","Ligue 1","Sinaly Diomande","CIV","DF","21",2001,21.7,42,24,26,15,1,31,49,63.3,18,26,13,13,49,91,75,1,"https://fbref.com/en/players/6de23ab0/Sinaly-Diomande"
2023,"Lyon","Ligue 1","Romain Faivre","FRA","MF","24",1998,3.3,6,3,2,2,2,1,3,33.3,2,3,0,3,0,6,0,0,"https://fbref.com/en/players/745ca0a3/Romain-Faivre"
2023,"Lyon","Ligue 1","Malo Gusto","FRA","DF","19",2003,17.7,42,26,23,11,8,21,43,48.8,22,22,5,17,28,70,23,1,"https://fbref.com/en/players/d56b9520/Malo-Gusto"
2023,"Lyon","Ligue 1","Henrique","BRA","DF,FW","28",1994,4,9,4,3,2,4,6,13,46.2,7,3,1,2,5,14,8,0,"https://fbref.com/en/players/f28474a4/Henrique"
2023,"Lyon","Ligue 1","Jefferson","BRA","FW","22",1999,5,17,4,4,9,4,6,15,40,9,6,0,6,1,18,0,0,"https://fbref.com/en/players/45cce300/Jefferson"
2023,"Lyon","Ligue 1","Sael Kumbedi","FRA","DF","17",2005,14.7,47,27,27,13,7,20,38,52.6,18,23,7,16,10,57,16,0,"https://fbref.com/en/players/c385bf49/Sael-Kumbedi"
2023,"Lyon","Ligue 1","Alexandre Lacazette","FRA","FW","31",1991,32.5,43,23,7,17,19,10,29,34.5,19,23,3,20,15,58,4,0,"https://fbref.com/en/players/9dbb75ca/Alexandre-Lacazette"
2023,"Lyon","Ligue 1","Johann Lepenant","FRA","MF","19",2002,21.5,58,34,24,27,7,32,86,37.2,54,29,5,24,28,86,17,3,"https://fbref.com/en/players/1e52971c/Johann-Lepenant"
2023,"Lyon","Ligue 1","Anthony Lopes","POR","GK","31",1990,31.3,1,0,1,0,0,1,4,25,3,0,0,0,3,4,10,0,"https://fbref.com/en/players/f00de885/Anthony-Lopes"
2023,"Lyon","Ligue 1","Dejan Lovren","CRO","DF","33",1989,16.2,25,19,20,5,0,20,29,69,9,20,10,10,26,51,70,1,"https://fbref.com/en/players/1a2935f6/Dejan-Lovren"
2023,"Lyon","Ligue 1","Castello Lukeba","FRA","DF","19",2002,33.2,39,23,27,8,4,21,31,67.7,10,42,24,18,75,114,105,1,"https://fbref.com/en/players/5b9512c5/Castello-Lukeba"
2023,"Lyon","Ligue 1","Thiago Mendes","BRA","MF,DF","30",1992,22.9,48,27,24,21,3,30,40,75,10,28,8,20,47,95,51,4,"https://fbref.com/en/players/c6e5d20f/Thiago-Mendes"
2023,"Lyon","Ligue 1","Lucas Paquetá","BRA","MF","24",1997,1.8,5,4,0,5,0,1,3,33.3,2,2,0,2,1,6,3,0,"https://fbref.com/en/players/9b6f7fd5/Lucas-Paqueta"
2023,"Lyon","Ligue 1","Jeff Reine-Adélaïde","FRA","MF","24",1998,3.7,8,5,1,5,2,5,9,55.6,4,4,0,4,6,14,0,0,"https://fbref.com/en/players/d504b3e1/Jeff-Reine-Adelaide"
2023,"Lyon","Ligue 1","Rémy Riou","FRA","GK","34",1987,6.7,1,0,1,0,0,1,1,100,0,0,0,0,0,1,3,0,"https://fbref.com/en/players/7f41ee30/Remy-Riou"
2023,"Lyon","Ligue 1","Amin Sarr","SWE","FW","21",2001,6,9,6,1,4,4,1,4,25,3,2,0,2,0,9,4,0,"https://fbref.com/en/players/d5326924/Amin-Sarr"
2023,"Lyon","Ligue 1","Mamadou Sarr","FRA","MF","16",2005,0.1,0,0,0,0,0,0,0,NA,0,0,0,0,0,0,0,0,"https://fbref.com/en/players/61f80c89/Mamadou-Sarr"
2023,"Lyon","Ligue 1","Nicolás Tagliafico","ARG","DF","29",1992,33.2,91,53,36,41,14,50,78,64.1,28,45,11,34,57,148,47,0,"https://fbref.com/en/players/f0661424/Nicolas-Tagliafico"
2023,"Lyon","Ligue 1","Tetê","BRA","FW,MF","22",2000,12.3,21,10,8,5,8,10,19,52.6,9,9,0,9,13,34,2,0,"https://fbref.com/en/players/7120a04d/Tete"
2023,"Lyon","Ligue 1","Karl Toko Ekambi","CMR","FW,MF","29",1992,15,9,9,2,4,3,4,15,26.7,11,12,2,10,9,18,6,0,"https://fbref.com/en/players/5ceba7fc/Karl-Toko-Ekambi"
2023,"Lyon","Ligue 1","Corentin Tolisso","FRA","MF","27",1994,22.6,44,27,16,23,5,25,66,37.9,41,25,5,20,24,68,23,1,"https://fbref.com/en/players/652d4c37/Corentin-Tolisso"
2023,"M'Gladbach","Bundesliga","Ramy Bensebaini","ALG","DF","27",1995,27.6,34,21,21,10,3,26,39,66.7,13,44,14,30,36,70,98,1,"https://fbref.com/en/players/378825c7/Ramy-Bensebaini"
2023,"M'Gladbach","Bundesliga","Yvandro Borges Sanches","LUX","FW,MF","18",2004,0.3,2,2,0,2,0,2,2,100,0,0,0,0,0,2,0,0,"https://fbref.com/en/players/36578017/Yvandro-Borges-Sanches"
2023,"M'Gladbach","Bundesliga","Nico Elvedi","SUI","DF","25",1996,31.4,46,24,32,12,2,27,41,65.9,14,31,16,15,35,81,149,3,"https://fbref.com/en/players/48035304/Nico-Elvedi"
2023,"M'Gladbach","Bundesliga","Oscar Fraulo","DEN","FW,MF","18",2003,0.1,0,0,0,0,0,0,0,NA,0,0,0,0,0,0,0,0,"https://fbref.com/en/players/458e3479/Oscar-Fraulo"
2023,"M'Gladbach","Bundesliga","Marvin Friedrich","GER","DF","26",1995,13.9,17,11,13,3,1,10,13,76.9,3,14,6,8,11,28,52,0,"https://fbref.com/en/players/b77f44a4/Marvin-Friedrich"
2023,"M'Gladbach","Bundesliga","Patrick Herrmann","GER","FW,MF","31",1991,1.8,6,2,4,1,1,2,4,50,2,2,0,2,2,8,1,0,"https://fbref.com/en/players/dfb6490a/Patrick-Herrmann"
2023,"M'Gladbach","Bundesliga","Jonas Hofmann","GER","FW,MF","30",1992,29.8,31,16,17,8,6,15,52,28.8,37,36,2,34,16,47,21,0,"https://fbref.com/en/players/2903a856/Jonas-Hofmann"
2023,"M'Gladbach","Bundesliga","Ko Itakura","JPN","DF","25",1997,22,29,17,18,7,4,16,30,53.3,14,41,25,16,27,56,95,0,"https://fbref.com/en/players/97d545ae/Ko-Itakura"
2023,"M'Gladbach","Bundesliga","Tony Jantschke","GER","DF,MF","32",1990,1.1,2,1,1,1,0,1,1,100,0,5,3,2,0,2,5,0,"https://fbref.com/en/players/34b54da7/Tony-Jantschke"
2023,"M'Gladbach","Bundesliga","Kouadio Koné","FRA","MF","21",2001,29,74,39,37,33,4,24,47,51.1,23,44,12,32,32,106,21,0,"https://fbref.com/en/players/86574238/Kouadio-Kone"
2023,"M'Gladbach","Bundesliga","Christoph Kramer","GER","MF","31",1991,24.7,44,33,24,15,5,22,55,40,33,34,2,32,17,61,40,0,"https://fbref.com/en/players/496aeede/Christoph-Kramer"
2023,"M'Gladbach","Bundesliga","Stefan Lainer","AUT","DF","29",1992,9.1,16,8,10,5,1,10,23,43.5,13,8,1,7,14,30,34,1,"https://fbref.com/en/players/4aea5077/Stefan-Lainer"
2023,"M'Gladbach","Bundesliga","Nathan N'Goumou","FRA","FW","22",2000,7.7,11,5,5,5,1,7,13,53.8,6,9,0,9,1,12,4,0,"https://fbref.com/en/players/e110ea4b/Nathan-NGoumou"
2023,"M'Gladbach","Bundesliga","Luca Netz","GER","DF","19",2003,7.8,25,13,19,3,3,19,32,59.4,13,5,1,4,6,31,27,0,"https://fbref.com/en/players/e79269bd/Luca-Netz"
2023,"M'Gladbach","Bundesliga","Florian Neuhaus","GER","MF","25",1997,15.6,19,9,9,5,5,8,27,29.6,19,20,3,17,12,31,5,0,"https://fbref.com/en/players/36a59ba4/Florian-Neuhaus"
2023,"M'Gladbach","Bundesliga","Jan Olschowsky","GER","GK","20",2001,4,0,0,0,0,0,0,1,0,1,1,0,1,0,0,1,0,"https://fbref.com/en/players/fa4cabd1/Jan-Olschowsky"
2023,"M'Gladbach","Bundesliga","Jonas Omlin","SUI","GK","28",1994,14.3,1,1,1,0,0,1,3,33.3,2,1,0,1,0,1,9,1,"https://fbref.com/en/players/c631f952/Jonas-Omlin"
2023,"M'Gladbach","Bundesliga","Alassane Pléa","FRA","FW","29",1993,19.7,16,8,5,7,4,8,26,30.8,18,23,3,20,12,28,14,0,"https://fbref.com/en/players/bc6bd723/Alassane-Plea"
2023,"M'Gladbach","Bundesliga","Rocco Reitz","GER","MF","20",2002,0,0,0,0,0,0,0,0,NA,0,0,0,0,0,0,0,0,"https://fbref.com/en/players/cc971106/Rocco-Reitz"
2023,"M'Gladbach","Bundesliga","Joe Scally","USA","DF","19",2002,24.5,31,20,25,5,1,24,31,77.4,7,17,6,11,8,39,61,0,"https://fbref.com/en/players/236f02cd/Joe-Scally"
2023,"M'Gladbach","Bundesliga","Tobias Sippel","GER","GK","34",1988,5.7,0,0,0,0,0,0,0,NA,0,0,0,0,0,0,1,1,"https://fbref.com/en/players/0d8a37c2/Tobias-Sippel"
2023,"M'Gladbach","Bundesliga","Yann Sommer","SUI","GK","33",1988,10,1,0,1,0,0,1,1,100,0,0,0,0,0,1,8,0,"https://fbref.com/en/players/420c18a1/Yann-Sommer"
2023,"M'Gladbach","Bundesliga","Lars Stindl","GER","FW,MF","33",1988,19.3,24,14,4,17,3,10,28,35.7,18,24,5,19,11,35,19,0,"https://fbref.com/en/players/7cd6badb/Lars-Stindl"
2023,"M'Gladbach","Bundesliga","Semir Telalovic","GER","MF,FW","22",1999,0.1,0,0,0,0,0,0,0,NA,0,0,0,0,0,0,0,0,"https://fbref.com/en/players/0b45a8d7/Semir-Telalovic"
2023,"M'Gladbach","Bundesliga","Marcus Thuram","FRA","FW","24",1997,27.9,14,7,3,6,5,6,13,46.2,7,20,3,17,6,20,22,0,"https://fbref.com/en/players/6f8cd6d0/Marcus-Thuram"
2023,"M'Gladbach","Bundesliga","Julian Weigl","GER","MF","26",1995,21,43,16,21,21,1,23,41,56.1,18,23,2,21,18,61,32,0,"https://fbref.com/en/players/346d51d9/Julian-Weigl"
2023,"M'Gladbach","Bundesliga","Hannes Wolf","AUT","FW","23",1999,5,11,8,4,5,2,5,13,38.5,8,3,0,3,3,14,9,0,"https://fbref.com/en/players/be42a291/Hannes-Wolf"
2023,"Mainz 05","Bundesliga","Ludovic Ajorque","FRA","FW,MF","28",1994,13.5,6,5,1,4,1,1,9,11.1,8,8,2,6,1,7,8,0,"https://fbref.com/en/players/462475ed/Ludovic-Ajorque"
2023,"Mainz 05","Bundesliga","Aymen Barkok","MAR","MF","24",1998,6.5,18,8,10,5,3,5,10,50,5,7,0,7,3,21,9,0,"https://fbref.com/en/players/a2a85828/Aymen-Barkok"
2023,"Mainz 05","Bundesliga","Leandro Barreiro Martins","LUX","MF","22",2000,23.8,60,38,19,28,13,22,49,44.9,27,38,13,25,41,101,39,1,"https://fbref.com/en/players/00242b75/Leandro-Barreiro-Martins"
2023,"Mainz 05","Bundesliga","Stefan Bell","GER","DF","30",1991,26.6,43,28,32,10,1,22,44,50,22,42,15,27,44,87,133,0,"https://fbref.com/en/players/857a5abe/Stefan-Bell"
2023,"Mainz 05","Bundesliga","Delano Burgzorg","NED","FW,MF","23",1998,2.7,3,3,1,1,1,2,3,66.7,1,2,0,2,0,3,2,0,"https://fbref.com/en/players/05e2d5ea/Delano-Burgzorg"
2023,"Mainz 05","Bundesliga","Jonathan Burkardt","GER","MF,FW","22",2000,5.9,3,1,0,1,2,1,4,25,3,6,1,5,1,4,1,0,"https://fbref.com/en/players/05f99a4a/Jonathan-Burkardt"
2023,"Mainz 05","Bundesliga","Anthony Caci","FRA","DF","25",1997,22.6,58,33,32,20,6,28,42,66.7,14,28,4,24,54,112,40,0,"https://fbref.com/en/players/0118c54c/Anthony-Caci"
2023,"Mainz 05","Bundesliga","Danny da Costa","GER","DF","29",1993,13.7,20,16,7,8,5,12,20,60,8,22,3,19,9,29,26,0,"https://fbref.com/en/players/5ddb8f9f/Danny-da-Costa"
2023,"Mainz 05","Bundesliga","Finn Dahmen","GER","GK","24",1998,8,0,0,0,0,0,0,0,NA,0,0,0,0,0,0,3,0,"https://fbref.com/en/players/dee3013b/Finn-Dahmen"
2023,"Mainz 05","Bundesliga","Edimilson Fernandes","SUI","DF","26",1996,27.1,35,25,26,5,4,18,34,52.9,16,37,16,21,54,89,87,2,"https://fbref.com/en/players/3bb625ac/Edimilson-Fernandes"
2023,"Mainz 05","Bundesliga","Angelo Fulgini","FRA","MF","25",1996,5.8,6,5,2,3,1,5,12,41.7,7,5,0,5,5,11,7,0,"https://fbref.com/en/players/4b96c347/Angelo-Fulgini"
2023,"Mainz 05","Bundesliga","Brajan Gruda","GER","MF","18",2004,0,0,0,0,0,0,0,0,NA,0,0,0,0,0,0,0,0,"https://fbref.com/en/players/ae9b998d/Brajan-Gruda"
2023,"Mainz 05","Bundesliga","Alexander Hack","GER","DF","28",1993,12.6,30,18,21,9,0,19,33,57.6,14,18,5,13,24,54,45,1,"https://fbref.com/en/players/a5ec3ede/Alexander-Hack"
2023,"Mainz 05","Bundesliga","Andreas Hanche-Olsen","NOR","DF","25",1997,16.6,35,23,24,7,4,22,39,56.4,17,16,8,8,33,68,77,2,"https://fbref.com/en/players/2e77d607/Andreas-Hanche-Olsen"
2023,"Mainz 05","Bundesliga","Marcus Ingvartsen","DEN","FW,MF","26",1996,14.6,4,1,0,2,2,1,10,10,9,9,1,8,4,8,10,0,"https://fbref.com/en/players/271b8617/Marcus-Ingvartsen"
2023,"Mainz 05","Bundesliga","Lee Jae-sung","KOR","MF","29",1992,21,38,17,9,21,8,16,36,44.4,20,29,5,24,17,55,21,0,"https://fbref.com/en/players/34b0387f/Lee-Jae-sung"
2023,"Mainz 05","Bundesliga","Dominik Kohr","GER","MF","28",1994,25.5,59,33,23,31,5,29,61,47.5,32,46,9,37,34,93,26,1,"https://fbref.com/en/players/0fbecd11/Dominik-Kohr"
2023,"Mainz 05","Bundesliga","Maxim Leitsch","GER","DF","24",1998,7.4,9,7,6,3,0,4,5,80,1,7,4,3,18,27,26,1,"https://fbref.com/en/players/7e12a98d/Maxim-Leitsch"
2023,"Mainz 05","Bundesliga","Aarón Martín","ESP","DF","25",1997,20.5,42,27,25,11,6,21,40,52.5,19,22,1,21,15,57,31,0,"https://fbref.com/en/players/2f3e911a/Aaron-Martin"
2023,"Mainz 05","Bundesliga","Marlon Mustapha","AUT","FW,MF","21",2001,0.8,2,2,0,2,0,0,0,NA,0,4,0,4,0,2,0,0,"https://fbref.com/en/players/9ff8ec4a/Marlon-Mustapha"
2023,"Mainz 05","Bundesliga","Karim Onisiwo","AUT","FW,MF","30",1992,28.2,19,12,3,10,6,4,21,19,17,19,0,19,2,21,7,0,"https://fbref.com/en/players/f26834c7/Karim-Onisiwo"
2023,"Mainz 05","Bundesliga","Eniss Shabani","GER","MF","19",2003,0.1,0,0,0,0,0,0,0,NA,0,0,0,0,0,0,0,0,"https://fbref.com/en/players/0c88efca/Eniss-Shabani"
2023,"Mainz 05","Bundesliga","Anton Stach","GER","MF","23",1998,23,27,21,10,15,2,16,38,42.1,22,28,2,26,41,68,25,0,"https://fbref.com/en/players/0f59a7bf/Anton-Stach"
2023,"Mainz 05","Bundesliga","Niklas Tauer","GER","DF,MF","21",2001,1,2,1,2,0,0,1,3,33.3,2,2,1,1,2,4,4,0,"https://fbref.com/en/players/27270af4/Niklas-Tauer"
2023,"Mainz 05","Bundesliga","Nelson Weiper","GER","FW,DF","17",2005,1.1,2,0,0,0,2,1,3,33.3,2,2,0,2,0,2,1,0,"https://fbref.com/en/players/231c67ff/Nelson-Weiper"
2023,"Mainz 05","Bundesliga","Silvan Widmer","SUI","DF","29",1993,18.8,26,17,15,10,1,20,39,51.3,19,22,8,14,31,57,28,0,"https://fbref.com/en/players/f68b64fc/Silvan-Widmer"
2023,"Mainz 05","Bundesliga","Robin Zentner","GER","GK","27",1994,26,0,0,0,0,0,0,4,0,4,0,0,0,0,0,17,1,"https://fbref.com/en/players/5c4bf6ba/Robin-Zentner"
2023,"Mallorca","La Liga","Amath","SEN","MF,FW","26",1996,13.6,29,19,14,8,7,14,22,63.6,8,13,1,12,5,34,5,0,"https://fbref.com/en/players/f3b1d9a2/Amath"
2023,"Mallorca","La Liga","Josep Antoni Gayá","ESP","DF,MF","22",2000,1.1,0,0,0,0,0,0,0,NA,0,4,2,2,1,1,6,0,"https://fbref.com/en/players/4a5f2032/Josep-Antoni-Gaya"
2023,"Mallorca","La Liga","Ludwig Augustinsson","SWE","DF","28",1994,1.5,2,1,2,0,0,1,3,33.3,2,1,0,1,1,3,3,0,"https://fbref.com/en/players/9fec8860/Ludwig-Augustinsson"
2023,"Mallorca","La Liga","Iddrisu Baba","GHA","MF,DF","26",1996,18.9,31,17,15,16,0,15,32,46.9,17,18,8,10,11,42,39,0,"https://fbref.com/en/players/bfd381b3/Iddrisu-Baba"
2023,"Mallorca","La Liga","Rodrigo Battaglia","ARG","MF","31",1991,7.6,12,5,7,5,0,6,14,42.9,8,16,7,9,5,17,18,0,"https://fbref.com/en/players/d637fc22/Rodrigo-Battaglia"
2023,"Mallorca","La Liga","Copete","ESP","DF","22",1999,24.5,53,28,35,16,2,26,36,72.2,10,38,17,21,44,97,111,2,"https://fbref.com/en/players/0f26ffd7/Copete"
2023,"Mallorca","La Liga","Jaume Costa","ESP","DF","34",1988,28.9,50,34,26,17,7,29,51,56.9,22,13,5,8,22,72,44,1,"https://fbref.com/en/players/808d48f3/Jaume-Costa"
2023,"Mallorca","La Liga","Braian Cufré","ARG","DF","25",1996,2.4,5,2,2,1,2,2,5,40,3,2,1,1,2,7,1,0,"https://fbref.com/en/players/192c89a6/Braian-Cufre"
2023,"Mallorca","La Liga","Iñigo Ruiz de Galarreta","ESP","MF","28",1993,27.2,54,38,27,23,4,20,52,38.5,32,26,9,17,30,84,19,0,"https://fbref.com/en/players/91f7631f/Inigo-Ruiz-de-Galarreta"
2023,"Mallorca","La Liga","Giovanni González","URU","DF","27",1994,10.3,16,8,11,2,3,9,22,40.9,13,8,2,6,7,23,22,0,"https://fbref.com/en/players/1fc474ae/Giovanni-Gonzalez"
2023,"Mallorca","La Liga","Dominik Greif","SVK","GK","25",1997,1,0,0,0,0,0,0,0,NA,0,0,0,0,0,0,0,0,"https://fbref.com/en/players/30061f53/Dominik-Greif"
2023,"Mallorca","La Liga","Clément Grenier","FRA","MF","31",1991,8,20,8,6,12,2,10,20,50,10,9,1,8,6,26,7,0,"https://fbref.com/en/players/8b298f56/Clement-Grenier"
2023,"Mallorca","La Liga","Dennis Hadzikadunic","BIH","DF","24",1998,6.8,9,6,4,5,0,4,4,100,0,5,4,1,3,12,27,0,"https://fbref.com/en/players/82cfae2a/Dennis-Hadzikadunic"
2023,"Mallorca","La Liga","Lago Junior","CIV","FW,MF","31",1990,0.6,1,0,0,1,0,1,1,100,0,0,0,0,0,1,0,0,"https://fbref.com/en/players/360d70f8/Lago-Junior"
2023,"Mallorca","La Liga","Tino Kadewere","ZIM","FW,MF","26",1996,6,6,3,3,3,0,4,9,44.4,5,6,2,4,2,8,1,0,"https://fbref.com/en/players/7d08063d/Tino-Kadewere"
2023,"Mallorca","La Liga","Javier Llabrés","ESP","FW","19",2002,0.2,0,0,0,0,0,0,0,NA,0,0,0,0,0,0,1,0,"https://fbref.com/en/players/38b0cf42/Javier-Llabres"
2023,"Mallorca","La Liga","Pablo Maffeo","ESP","DF","25",1997,33.1,75,46,54,16,5,45,78,57.7,33,38,11,27,26,101,76,0,"https://fbref.com/en/players/5db04597/Pablo-Maffeo"
2023,"Mallorca","La Liga","Manu Morlanes","ESP","MF","23",1999,7.8,22,9,12,8,2,13,24,54.2,11,10,5,5,5,27,9,0,"https://fbref.com/en/players/a0255c67/Manu-Morlanes"
2023,"Mallorca","La Liga","Vedat Muriqi","KVX","FW","28",1994,32.6,12,7,4,7,1,3,13,23.1,10,19,7,12,12,24,73,0,"https://fbref.com/en/players/0cadc46d/Vedat-Muriqi"
2023,"Mallorca","La Liga","Matija Nastasić","SRB","DF","29",1993,10.1,10,8,7,1,2,3,6,50,3,11,4,7,18,28,43,1,"https://fbref.com/en/players/f35430a4/Matija-Nastasic"
2023,"Mallorca","La Liga","Abdón Prats","ESP","FW,MF","29",1992,4.6,1,0,1,0,0,0,0,NA,0,5,0,5,0,1,2,0,"https://fbref.com/en/players/d1b060e2/Abdon-Prats"
2023,"Mallorca","La Liga","Rubén Quintanilla","ESP","DF","20",2002,0,0,0,0,0,0,0,0,NA,0,1,0,1,0,0,0,0,"https://fbref.com/en/players/2f456b86/Ruben-Quintanilla"
2023,"Mallorca","La Liga","Antonio Raillo","ESP","DF","30",1991,30.7,34,21,23,11,0,10,15,66.7,5,38,29,9,31,65,158,1,"https://fbref.com/en/players/b857bd29/Antonio-Raillo"
2023,"Mallorca","La Liga","Predrag Rajković","SRB","GK","26",1995,36,0,0,0,0,0,0,2,0,2,0,0,0,0,0,16,1,"https://fbref.com/en/players/58ad9383/Predrag-Rajkovic"
2023,"Mallorca","La Liga","Ángel Rodríguez","ESP","FW,MF","35",1987,4.4,1,1,0,1,0,0,2,0,2,3,0,3,1,2,1,0,"https://fbref.com/en/players/8cfc2f69/Angel-Rodriguez"
2023,"Mallorca","La Liga","Dani Rodríguez","ESP","MF","34",1988,23.3,42,23,18,22,2,21,46,45.7,25,31,8,23,21,63,14,0,"https://fbref.com/en/players/70f8e0bd/Dani-Rodriguez"
2023,"Mallorca","La Liga","Leonardo Román","ESP","GK","22",2000,1,0,0,0,0,0,0,0,NA,0,0,0,0,0,0,0,0,"https://fbref.com/en/players/924ff27e/Leonardo-Roman"
2023,"Mallorca","La Liga","Franco Russo","ARG","DF","27",1994,1.6,2,1,2,0,0,0,1,0,1,5,0,5,3,5,5,0,"https://fbref.com/en/players/b75ac54b/Franco-Russo"
2023,"Mallorca","La Liga","Antonio Sánchez","ESP","MF,DF","25",1997,12,19,8,13,4,2,10,34,29.4,24,18,0,18,22,41,14,1,"https://fbref.com/en/players/a254bbe0/Antonio-Sanchez"
2023,"Mallorca","La Liga","Martin Valjent","SVK","DF","26",1995,29.5,35,27,22,12,1,19,28,67.9,9,39,21,18,29,64,137,0,"https://fbref.com/en/players/f2c6ac01/Martin-Valjent"
2023,"Mallorca","La Liga","이강인","KOR","FW,MF","21",2001,31.4,NA,25,NA,NA,NA,NA,NA,NA,NA,NA,NA,NA,12,NA,NA,NA,"https://fbref.com/en/players/461d1848/igangin"
2023,"Manchester City","Premier League","Manuel Akanji","SUI","DF","27",1995,25.4,36,25,15,18,3,23,36,63.9,13,27,9,18,16,52,33,0,"https://fbref.com/en/players/89ac64a6/Manuel-Akanji"
2023,"Manchester City","Premier League","Nathan Aké","NED","DF","27",1995,20.8,26,12,15,9,2,11,15,73.3,4,20,10,10,20,46,48,0,"https://fbref.com/en/players/eaeca114/Nathan-Ake"
2023,"Manchester City","Premier League","Julián Álvarez","ARG","FW,MF","22",2000,16.3,26,16,3,13,10,9,29,31,20,13,0,13,2,28,6,0,"https://fbref.com/en/players/15ab5a2b/Julian-Alvarez"
2023,"Manchester City","Premier League","João Cancelo","POR","DF","28",1994,14.2,29,21,16,9,4,17,24,70.8,7,7,1,6,19,48,9,1,"https://fbref.com/en/players/bd6351cd/Joao-Cancelo"
2023,"Manchester City","Premier League","Shea Charles","NIR","DF","18",2003,0.3,4,0,4,0,0,1,1,100,0,0,0,0,1,5,2,0,"https://fbref.com/en/players/5cc3ce65/Shea-Charles"
2023,"Manchester City","Premier League","Kevin De Bruyne","BEL","MF","31",1991,26.9,28,12,3,12,13,14,39,35.9,25,27,2,25,9,37,10,0,"https://fbref.com/en/players/e46012d4/Kevin-De-Bruyne"
2023,"Manchester City","Premier League","Rúben Dias","POR","DF","25",1997,22.2,21,13,10,10,1,11,18,61.1,7,21,13,8,18,39,56,1,"https://fbref.com/en/players/31c69ef1/Ruben-Dias"
2023,"Manchester City","Premier League","Ederson","BRA","GK","28",1993,35,3,1,3,0,0,1,2,50,1,0,0,0,1,4,10,2,"https://fbref.com/en/players/3bb7b8b4/Ederson"
2023,"Manchester City","Premier League","Phil Foden","ENG","FW","22",2000,20.5,16,10,9,5,2,8,19,42.1,11,25,2,23,5,21,12,0,"https://fbref.com/en/players/ed1e53f3/Phil-Foden"
2023,"Manchester City","Premier League","Sergio Gómez","ESP","DF,MF","21",2000,3.9,9,4,6,1,2,5,8,62.5,3,5,3,2,2,11,9,1,"https://fbref.com/en/players/01e5f06e/Sergio-Gomez"
2023,"Manchester City","Premier League","Jack Grealish","ENG","FW","26",1995,22.8,25,16,10,12,3,13,22,59.1,9,17,3,14,7,32,9,0,"https://fbref.com/en/players/b0b4fd3e/Jack-Grealish"
2023,"Manchester City","Premier League","İlkay Gündoğan","GER","MF","31",1990,26.1,30,18,7,13,10,12,33,36.4,21,18,3,15,20,50,13,0,"https://fbref.com/en/players/819b3158/Ilkay-Gundogan"
2023,"Manchester City","Premier League","Erling Haaland","NOR","FW","22",2000,30.8,3,2,0,2,1,1,5,20,4,12,4,8,3,6,14,0,"https://fbref.com/en/players/1f44ac21/Erling-Haaland"
2023,"Manchester City","Premier League","Aymeric Laporte","ESP","DF","28",1994,11,11,8,6,4,1,7,11,63.6,4,10,4,6,3,14,30,1,"https://fbref.com/en/players/119b9a8e/Aymeric-Laporte"
2023,"Manchester City","Premier League","Rico Lewis","ENG","DF,MF","17",2004,10,16,9,9,5,2,6,11,54.5,5,8,4,4,6,22,13,1,"https://fbref.com/en/players/b57e066e/Rico-Lewis"
2023,"Manchester City","Premier League","Riyad Mahrez","ALG","FW,MF","31",1991,21.3,30,14,8,13,9,13,38,34.2,25,27,1,26,9,39,5,0,"https://fbref.com/en/players/892d5bb1/Riyad-Mahrez"
2023,"Manchester City","Premier League","Stefan Ortega","GER","GK","29",1992,3,0,0,0,0,0,0,0,NA,0,0,0,0,0,0,0,0,"https://fbref.com/en/players/c1242d4e/Stefan-Ortega"
2023,"Manchester City","Premier League","Cole Palmer","ENG","MF,FW","20",2002,4.1,5,1,0,3,2,3,5,60,2,2,1,1,1,6,2,0,"https://fbref.com/en/players/dc7f8a28/Cole-Palmer"
2023,"Manchester City","Premier League","Máximo Perrone","ARG","MF","19",2003,0.2,0,0,0,0,0,0,0,NA,0,1,0,1,0,0,0,0,"https://fbref.com/en/players/53552942/Maximo-Perrone"
2023,"Manchester City","Premier League","Kalvin Phillips","ENG","MF","26",1995,3.3,6,4,3,3,0,2,9,22.2,7,7,3,4,5,11,10,0,"https://fbref.com/en/players/4f565d77/Kalvin-Phillips"
2023,"Manchester City","Premier League","Rodri","ESP","MF","26",1996,32.3,67,41,28,28,11,26,52,50,26,40,14,26,33,100,43,1,"https://fbref.com/en/players/6434f10d/Rodri"
2023,"Manchester City","Premier League","Bernardo Silva","POR","MF,FW","27",1994,24.5,44,23,11,25,8,18,44,40.9,26,23,6,17,16,60,6,0,"https://fbref.com/en/players/3eb22ec9/Bernardo-Silva"
2023,"Manchester City","Premier League","John Stones","ENG","DF,MF","28",1994,20.5,23,13,11,8,4,7,10,70,3,17,10,7,9,32,40,0,"https://fbref.com/en/players/5eecec3d/John-Stones"
2023,"Manchester City","Premier League","Kyle Walker","ENG","DF","32",1990,21.8,13,9,8,5,0,4,24,16.7,20,12,2,10,18,31,22,0,"https://fbref.com/en/players/86dd77d1/Kyle-Walker"
2023,"Manchester Utd","Premier League","Antony","BRA","FW","22",2000,20,22,9,9,9,4,8,28,28.6,20,18,0,18,11,33,6,0,"https://fbref.com/en/players/99127249/Antony"
2023,"Manchester Utd","Premier League","Donny van de Beek","NED","MF","25",1997,1.9,0,0,0,0,0,0,1,0,1,2,1,1,1,1,1,0,"https://fbref.com/en/players/50dc94ce/Donny-van-de-Beek"
2023,"Manchester Utd","Premier League","Casemiro","BRA","MF","30",1992,23.6,89,46,43,35,11,48,92,52.2,44,49,11,38,34,123,64,0,"https://fbref.com/en/players/4d224fe8/Casemiro"
2023,"Manchester Utd","Premier League","Diogo Dalot","POR","DF","23",1999,23.9,54,41,40,13,1,33,45,73.3,12,25,7,18,37,91,55,2,"https://fbref.com/en/players/d9565625/Diogo-Dalot"
2023,"Manchester Utd","Premier League","Anthony Elanga","SWE","FW","20",2002,4.7,3,0,0,2,1,1,2,50,1,4,0,4,2,5,4,0,"https://fbref.com/en/players/2fba6108/Anthony-Elanga"
2023,"Manchester Utd","Premier League","Christian Eriksen","DEN","MF","30",1992,22.8,22,18,10,7,5,10,32,31.3,22,23,9,14,11,33,20,1,"https://fbref.com/en/players/980522ec/Christian-Eriksen"
2023,"Manchester Utd","Premier League","Bruno Fernandes","POR","MF,FW","27",1994,36.8,68,42,24,25,19,30,71,42.3,41,37,5,32,25,93,40,1,"https://fbref.com/en/players/507c7bdf/Bruno-Fernandes"
2023,"Manchester Utd","Premier League","Fred","BRA","MF","29",1993,13.9,47,30,24,20,3,15,38,39.5,23,38,2,36,19,66,19,0,"https://fbref.com/en/players/b853e0ad/Fred"
2023,"Manchester Utd","Premier League","Alejandro Garnacho","ARG","FW,MF","18",2004,6.3,5,2,2,0,3,1,11,9.1,10,5,0,5,5,10,3,0,"https://fbref.com/en/players/7aa8adfe/Alejandro-Garnacho"
2023,"Manchester Utd","Premier League","David de Gea","ESP","GK","31",1990,38,0,0,0,0,0,0,1,0,1,0,0,0,1,1,15,3,"https://fbref.com/en/players/7ba6d84e/David-de-Gea"
2023,"Manchester Utd","Premier League","Victor Lindelöf","SWE","DF","28",1994,15.2,22,17,10,9,3,9,17,52.9,8,18,9,9,21,43,63,1,"https://fbref.com/en/players/f5deef4c/Victor-Lindelof"
2023,"Manchester Utd","Premier League","Harry Maguire","ENG","DF","29",1993,8.5,8,6,6,1,1,4,5,80,1,18,11,7,13,21,41,0,"https://fbref.com/en/players/d8931174/Harry-Maguire"
2023,"Manchester Utd","Premier League","Kobbie Mainoo","ENG","MF","17",2005,0.1,0,0,0,0,0,0,0,NA,0,1,1,0,0,0,0,0,"https://fbref.com/en/players/c6220452/Kobbie-Mainoo"
2023,"Manchester Utd","Premier League","Tyrell Malacia","NED","DF","22",1999,15.5,46,33,33,12,1,14,25,56,11,13,3,10,25,71,49,0,"https://fbref.com/en/players/6b6c793c/Tyrell-Malacia"
2023,"Manchester Utd","Premier League","Anthony Martial","FRA","FW","26",1995,10.9,5,3,0,2,3,1,4,25,3,11,2,9,1,6,4,0,"https://fbref.com/en/players/8b788c01/Anthony-Martial"
2023,"Manchester Utd","Premier League","Lisandro Martínez","ARG","DF","24",1998,23.5,54,28,33,18,3,30,43,69.8,13,51,27,24,33,87,103,0,"https://fbref.com/en/players/bac46a10/Lisandro-Martinez"
2023,"Manchester Utd","Premier League","Scott McTominay","SCO","MF","25",1996,12.9,32,19,16,10,6,13,22,59.1,9,15,6,9,14,46,45,0,"https://fbref.com/en/players/d93c2511/Scott-McTominay"
2023,"Manchester Utd","Premier League","Facundo Pellistri","URU","FW,MF","20",2001,0.7,1,1,0,1,0,0,0,NA,0,0,0,0,0,1,3,0,"https://fbref.com/en/players/ac7e7b1c/Facundo-Pellistri"
2023,"Manchester Utd","Premier League","Marcus Rashford","ENG","FW","24",1997,32,20,10,7,8,5,9,24,37.5,15,31,4,27,7,27,14,0,"https://fbref.com/en/players/a1d5bd30/Marcus-Rashford"
2023,"Manchester Utd","Premier League","Cristiano Ronaldo","POR","FW","37",1985,5.8,2,2,1,0,1,1,2,50,1,0,0,0,1,3,9,0,"https://fbref.com/en/players/dea698d9/Cristiano-Ronaldo"
2023,"Manchester Utd","Premier League","Marcel Sabitzer","AUT","MF","28",1994,7,12,8,3,8,1,2,11,18.2,9,6,2,4,8,20,11,0,"https://fbref.com/en/players/e280527c/Marcel-Sabitzer"
2023,"Manchester Utd","Premier League","Jadon Sancho","ENG","FW,MF","22",2000,18.7,16,10,7,5,4,8,28,28.6,20,25,2,23,7,23,6,0,"https://fbref.com/en/players/dbf053da/Jadon-Sancho"
2023,"Manchester Utd","Premier League","Luke Shaw","ENG","DF","27",1995,28.4,55,36,31,22,2,32,45,71.1,13,51,17,34,36,91,55,2,"https://fbref.com/en/players/9c94165b/Luke-Shaw"
2023,"Manchester Utd","Premier League","Raphaël Varane","FRA","DF","29",1993,21.2,24,9,18,6,0,7,17,41.2,10,24,17,7,11,35,91,0,"https://fbref.com/en/players/9f8e9423/Raphael-Varane"
2023,"Manchester Utd","Premier League","Aaron Wan-Bissaka","ENG","DF","24",1997,15.9,40,25,20,17,3,23,25,92,2,24,8,16,22,62,41,0,"https://fbref.com/en/players/9e525177/Aaron-Wan-Bissaka"
2023,"Manchester Utd","Premier League","Wout Weghorst","NED","FW,MF","29",1992,8.9,11,5,6,1,4,2,9,22.2,7,7,2,5,7,18,9,0,"https://fbref.com/en/players/c4e87b8b/Wout-Weghorst"
2023,"Marseille","Ligue 1","Eric Bailly","CIV","DF","28",1994,6,13,10,6,6,1,7,7,100,0,15,12,3,12,25,18,1,"https://fbref.com/en/players/a1232f4e/Eric-Bailly"
2023,"Marseille","Ligue 1","Cédric Bakambu","COD","MF","31",1991,0.7,2,1,2,0,0,2,2,100,0,0,0,0,0,2,0,0,"https://fbref.com/en/players/0af4dcf0/Cedric-Bakambu"
2023,"Marseille","Ligue 1","Leonardo Balerdi","ARG","DF","23",1999,29.3,57,37,43,12,2,32,45,71.1,13,48,29,19,63,120,91,1,"https://fbref.com/en/players/7c3ed041/Leonardo-Balerdi"
2023,"Marseille","Ligue 1","Salim Ben Seghir","FRA","MF","19",2003,0,0,0,0,0,0,0,0,NA,0,1,0,1,0,0,0,0,"https://fbref.com/en/players/1f6298f2/Salim-Ben-Seghir"
2023,"Marseille","Ligue 1","Rubén Blanco","ESP","GK","27",1995,5.5,0,0,0,0,0,0,0,NA,0,0,0,0,0,0,1,0,"https://fbref.com/en/players/967f34d3/Ruben-Blanco"
2023,"Marseille","Ligue 1","Duje Ćaleta-Car","CRO","DF","25",1996,0.1,0,0,0,0,0,0,0,NA,0,0,0,0,0,0,1,0,"https://fbref.com/en/players/94f8d10c/Duje-Caleta-Car"
2023,"Marseille","Ligue 1","Jonathan Clauss","FRA","DF","29",1992,28.8,46,28,21,16,9,23,52,44.2,29,29,4,25,31,77,40,2,"https://fbref.com/en/players/5219ab4a/Jonathan-Clauss"
2023,"Marseille","Ligue 1","Bamba Dieng","SEN","FW,MF","22",2000,2.2,4,4,2,1,1,3,4,75,1,5,1,4,0,4,0,0,"https://fbref.com/en/players/40774c6b/Bamba-Dieng"
2023,"Marseille","Ligue 1","Gerson","BRA","MF","25",1997,4.6,6,4,1,4,1,3,5,60,2,5,0,5,2,8,4,0,"https://fbref.com/en/players/8827bf46/Gerson"
2023,"Marseille","Ligue 1","Samuel Gigot","FRA","DF","28",1993,20.9,46,24,22,21,3,12,15,80,3,24,7,17,45,91,85,1,"https://fbref.com/en/players/41eebdf5/Samuel-Gigot"
2023,"Marseille","Ligue 1","Mattéo Guendouzi","FRA","MF","23",1999,23.4,39,18,9,21,9,14,38,36.8,24,12,5,7,21,60,18,0,"https://fbref.com/en/players/5ea8ef20/Matteo-Guendouzi"
2023,"Marseille","Ligue 1","Pape Gueye","SEN","MF,DF","23",1999,5.5,18,7,10,7,1,7,15,46.7,8,9,2,7,9,27,2,0,"https://fbref.com/en/players/7155e3e1/Pape-Gueye"
2023,"Marseille","Ligue 1","Amine Harit","MAR","MF,FW","25",1997,5.7,6,4,0,3,3,3,8,37.5,5,4,1,3,4,10,6,0,"https://fbref.com/en/players/e7d59f4f/Amine-Harit"
2023,"Marseille","Ligue 1","Luis Javier Suárez","COL","FW","24",1997,3.3,4,1,1,2,1,1,4,25,3,1,0,1,3,7,6,0,"https://fbref.com/en/players/eeba07f8/Luis-Javier-Suarez"
2023,"Marseille","Ligue 1","Issa Kaboré","BFA","DF","21",2001,11.4,33,19,10,18,5,21,32,65.6,11,11,1,10,12,45,21,1,"https://fbref.com/en/players/c066d1a5/Issa-Kabore"
2023,"Marseille","Ligue 1","Sead Kolašinac","BIH","DF","29",1993,24.6,52,36,24,22,6,24,37,64.9,13,19,2,17,43,95,35,1,"https://fbref.com/en/players/3935e52e/Sead-Kolasinac"
2023,"Marseille","Ligue 1","Pau López","ESP","GK","27",1994,32.5,0,0,0,0,0,0,1,0,1,0,0,0,0,0,5,1,"https://fbref.com/en/players/20b9f052/Pau-Lopez"
2023,"Marseille","Ligue 1","Ruslan Malinovskyi","UKR","MF,FW","29",1993,13.6,21,11,3,12,6,10,26,38.5,16,13,1,12,3,24,9,0,"https://fbref.com/en/players/48d5bd33/Ruslan-Malinovskyi"
2023,"Marseille","Ligue 1","Chancel Mbemba","COD","DF","27",1994,31.7,43,26,24,17,2,22,31,71,9,25,12,13,42,85,89,0,"https://fbref.com/en/players/e76cb9cc/Chancel-Mbemba"
2023,"Marseille","Ligue 1","Arkadiusz Milik","POL","FW","28",1994,1.4,1,1,0,0,1,0,1,0,1,0,0,0,0,1,2,0,"https://fbref.com/en/players/85613cf0/Arkadiusz-Milik"
2023,"Marseille","Ligue 1","François Mughe","CMR","MF","18",2004,0.1,0,0,0,0,0,0,0,NA,0,0,0,0,0,0,0,0,"https://fbref.com/en/players/7af655fe/Francois-Mughe"
2023,"Marseille","Ligue 1","Azzedine Ounahi","MAR","MF,FW","22",2000,1.3,2,1,1,1,0,0,2,0,2,1,0,1,0,2,0,0,"https://fbref.com/en/players/83299cc0/Azzedine-Ounahi"
2023,"Marseille","Ligue 1","Dimitri Payet","FRA","MF,FW","35",1987,9.3,6,4,2,2,2,3,10,30,7,4,0,4,0,6,4,0,"https://fbref.com/en/players/58ae47b2/Dimitri-Payet"
2023,"Marseille","Ligue 1","Valentin Rongier","FRA","MF","27",1994,33.7,93,59,33,47,13,41,77,53.2,36,50,11,39,54,147,38,1,"https://fbref.com/en/players/ed45c4a5/Valentin-Rongier"
2023,"Marseille","Ligue 1","Alexis Sánchez","CHI","FW,MF","33",1988,29.8,27,17,5,16,6,3,24,12.5,21,14,0,14,5,32,6,0,"https://fbref.com/en/players/2c0f8e9e/Alexis-Sanchez"
2023,"Marseille","Ligue 1","Nuno Tavares","POR","DF,MF","22",2000,26.1,56,30,19,24,13,28,55,50.9,27,32,4,28,15,71,25,0,"https://fbref.com/en/players/a65c844b/Nuno-Tavares"
2023,"Marseille","Ligue 1","Souleymane Touré","FRA","DF","19",2003,0.8,2,1,1,1,0,1,2,50,1,1,0,1,0,2,5,0,"https://fbref.com/en/players/01fd01e8/Souleymane-Toure"
2023,"Marseille","Ligue 1","Cengiz Ünder","TUR","MF,DF","25",1997,27.7,37,19,15,13,9,13,34,38.2,21,18,2,16,18,55,13,0,"https://fbref.com/en/players/1880614f/Cengiz-Under"
2023,"Marseille","Ligue 1","Jordan Veretout","FRA","MF","29",1993,31.8,56,35,17,32,7,25,53,47.2,28,22,7,15,36,92,40,2,"https://fbref.com/en/players/4a56052c/Jordan-Veretout"
2023,"Marseille","Ligue 1","Vitinha","POR","FW","22",2000,5.2,15,7,0,6,9,3,11,27.3,8,3,0,3,2,17,6,0,"https://fbref.com/en/players/74d4cec6/Vitinha"
2023,"Milan","Serie A","Yacine Adli","FRA","MF,FW","22",2000,1.6,6,3,2,4,0,2,2,100,0,2,0,2,1,7,1,0,"https://fbref.com/en/players/26777636/Yacine-Adli"
2023,"Milan","Serie A","Tiemoué Bakayoko","FRA","MF","27",1994,0.5,5,5,4,1,0,3,3,100,0,0,0,0,0,5,0,1,"https://fbref.com/en/players/59bf127b/Tiemoue-Bakayoko"
2023,"Milan","Serie A","Fodé Ballo-Touré","SEN","DF","25",1997,5.8,14,9,7,6,1,7,10,70,3,11,3,8,2,16,3,0,"https://fbref.com/en/players/f449640d/Fode-Ballo-Toure"
2023,"Milan","Serie A","Ismaël Bennacer","ALG","MF","24",1997,22.3,59,33,26,31,2,30,51,58.8,21,25,7,18,26,85,16,1,"https://fbref.com/en/players/db092d3b/Ismael-Bennacer"
2023,"Milan","Serie A","Davide Calabria","ITA","DF","25",1996,18.8,71,44,31,32,8,38,61,62.3,23,22,7,15,25,96,34,0,"https://fbref.com/en/players/2146785a/Davide-Calabria"
2023,"Milan","Serie A","Charles De Ketelaere","BEL","MF,FW","21",2001,12.4,26,12,7,14,5,13,30,43.3,17,14,2,12,4,30,9,0,"https://fbref.com/en/players/2ef7c612/Charles-De-Ketelaere"
2023,"Milan","Serie A","Sergiño Dest","USA","DF","21",2000,3.7,12,6,3,5,4,3,4,75,1,1,0,1,4,16,2,0,"https://fbref.com/en/players/5976f83e/Sergino-Dest"
2023,"Milan","Serie A","Brahim Díaz","ESP","MF,FW","22",1999,21.4,32,15,5,22,5,5,15,33.3,10,11,0,11,7,39,6,0,"https://fbref.com/en/players/407feb71/Brahim-Diaz"
2023,"Milan","Serie A","Alessandro Florenzi","ITA","DF","31",1991,2.3,6,4,3,2,1,4,7,57.1,3,1,0,1,4,10,2,0,"https://fbref.com/en/players/e288d4b3/Alessandro-Florenzi"
2023,"Milan","Serie A","Matteo Gabbia","ITA","DF","22",1999,6.8,17,10,12,5,0,6,8,75,2,8,3,5,5,22,29,0,"https://fbref.com/en/players/c235e803/Matteo-Gabbia"
2023,"Milan","Serie A","Olivier Giroud","FRA","FW","35",1986,23.8,8,5,2,4,2,2,10,20,8,11,3,8,3,11,23,0,"https://fbref.com/en/players/16ceb862/Olivier-Giroud"
2023,"Milan","Serie A","Theo Hernández","FRA","DF","24",1997,30.8,43,24,27,15,1,22,38,57.9,16,34,7,27,21,64,35,1,"https://fbref.com/en/players/d4c9725f/Theo-Hernandez"
2023,"Milan","Serie A","Zlatan Ibrahimović","SWE","FW","40",1981,1.6,0,0,0,0,0,0,0,NA,0,1,1,0,0,0,2,0,"https://fbref.com/en/players/4cde5509/Zlatan-Ibrahimovic"
2023,"Milan","Serie A","Pierre Kalulu","FRA","DF","22",2000,28.3,57,39,33,21,3,28,42,66.7,14,41,17,24,41,98,56,1,"https://fbref.com/en/players/85f7d1be/Pierre-Kalulu"
2023,"Milan","Serie A","Simon Kjær","DEN","DF","33",1989,11.2,15,8,9,6,0,7,11,63.6,4,14,11,3,9,24,35,1,"https://fbref.com/en/players/8b8a56ce/Simon-Kjaer"
2023,"Milan","Serie A","Rade Krunić","BIH","MF","28",1993,18.4,40,28,18,18,4,16,50,32,34,31,11,20,16,56,21,0,"https://fbref.com/en/players/817c6964/Rade-Krunic"
2023,"Milan","Serie A","Marko Lazetić","SRB","FW","18",2004,0.1,0,0,0,0,0,0,0,NA,0,0,0,0,0,0,0,0,"https://fbref.com/en/players/93088fbb/Marko-Lazetic"
2023,"Milan","Serie A","Rafael Leão","POR","FW,MF","23",1999,26.9,8,7,2,3,3,6,14,42.9,8,9,2,7,15,23,8,0,"https://fbref.com/en/players/20730eae/Rafael-Leao"
2023,"Milan","Serie A","Mike Maignan","FRA","GK","27",1995,22,1,0,1,0,0,1,1,100,0,0,0,0,1,2,10,1,"https://fbref.com/en/players/fcb38f57/Mike-Maignan"
2023,"Milan","Serie A","Junior Messias","BRA","FW,DF","31",1991,16.6,24,18,9,9,6,5,19,26.3,14,20,4,16,7,31,28,0,"https://fbref.com/en/players/f49c4ae9/Junior-Messias"
2023,"Milan","Serie A","Antonio Mirante","ITA","GK","39",1983,0,0,0,0,0,0,0,0,NA,0,0,0,0,0,0,0,0,"https://fbref.com/en/players/30223b33/Antonio-Mirante"
2023,"Milan","Serie A","Divock Origi","BEL","FW","27",1995,11.4,10,5,4,3,3,5,10,50,5,6,2,4,0,10,13,0,"https://fbref.com/en/players/43a166b4/Divock-Origi"
2023,"Milan","Serie A","Tommaso Pobega","ITA","MF","23",1999,9.8,27,16,8,15,4,13,20,65,7,12,4,8,9,36,11,0,"https://fbref.com/en/players/55a1cac2/Tommaso-Pobega"
2023,"Milan","Serie A","Ante Rebić","CRO","FW,MF","28",1993,10.9,10,8,1,3,6,3,11,27.3,8,6,1,5,1,11,5,0,"https://fbref.com/en/players/536cebe5/Ante-Rebic"
2023,"Milan","Serie A","Alexis Saelemaekers","BEL","FW,DF","23",1999,15.6,31,20,12,16,3,19,41,46.3,22,13,1,12,19,50,11,0,"https://fbref.com/en/players/ee251371/Alexis-Saelemaekers"
2023,"Milan","Serie A","Ciprian Tătărușanu","ROU","GK","36",1986,16,0,0,0,0,0,0,0,NA,0,0,0,0,1,1,2,0,"https://fbref.com/en/players/b056e3da/Ciprian-Tatarusanu"
2023,"Milan","Serie A","Malick Thiaw","GER","DF","20",2001,15.1,31,26,22,9,0,11,20,55,9,11,5,6,12,43,65,1,"https://fbref.com/en/players/ff5ea0bf/Malick-Thiaw"
2023,"Milan","Serie A","Fikayo Tomori","ENG","DF","24",1997,30.7,70,34,44,25,1,22,34,64.7,12,46,25,21,29,99,88,1,"https://fbref.com/en/players/7edfbb8a/Fikayo-Tomori"
2023,"Milan","Serie A","Sandro Tonali","ITA","MF","22",2000,30.1,64,41,35,24,5,27,44,61.4,17,34,9,25,25,89,26,1,"https://fbref.com/en/players/0db169ae/Sandro-Tonali"
2023,"Milan","Serie A","Aster Vranckx","BEL","MF","19",2002,2.7,3,2,0,2,1,2,7,28.6,5,3,1,2,2,5,1,0,"https://fbref.com/en/players/f86cd5df/Aster-Vranckx"
2023,"Monaco","Ligue 1","Ruben Aguilar","FRA","DF","29",1993,13,19,9,7,7,5,8,22,36.4,14,13,1,12,18,37,28,1,"https://fbref.com/en/players/3dd738a1/Ruben-Aguilar"
2023,"Monaco","Ligue 1","Maghnes Akliouche","FRA","MF,FW","20",2002,4.5,7,4,4,3,0,2,8,25,6,2,0,2,3,10,2,0,"https://fbref.com/en/players/b625b241/Maghnes-Akliouche"
2023,"Monaco","Ligue 1","Benoît Badiashile","FRA","DF","21",2001,9.3,10,8,6,4,0,5,10,50,5,9,6,3,17,27,40,1,"https://fbref.com/en/players/06df8256/Benoit-Badiashile"
2023,"Monaco","Ligue 1","Eliesse Ben Seghir","FRA","FW,MF","17",2005,11.7,18,10,4,12,2,4,12,33.3,8,18,1,17,4,22,1,0,"https://fbref.com/en/players/3bd65247/Eliesse-Ben-Seghir"
2023,"Monaco","Ligue 1","Wissam Ben Yedder","FRA","FW","31",1990,23.5,16,9,2,5,9,4,13,30.8,9,15,0,15,4,20,0,0,"https://fbref.com/en/players/942b4f90/Wissam-Ben-Yedder"
2023,"Monaco","Ligue 1","Myron Boadu","NED","FW","21",2001,3.3,3,3,0,2,1,1,7,14.3,6,1,0,1,0,3,1,0,"https://fbref.com/en/players/5b479568/Myron-Boadu"
2023,"Monaco","Ligue 1","Mohamed Camara","MLI","MF","22",2000,24.4,83,45,38,39,6,48,92,52.2,44,45,6,39,27,110,14,1,"https://fbref.com/en/players/489e80e3/Mohamed-Camara"
2023,"Monaco","Ligue 1","Krépin Diatta","SEN","MF,FW","23",1999,23,30,21,4,17,9,13,32,40.6,19,29,1,28,17,47,12,0,"https://fbref.com/en/players/8104e41e/Krepin-Diatta"
2023,"Monaco","Ligue 1","Edan Diop","FRA","DF,FW","17",2004,2.5,13,8,3,3,7,7,15,46.7,8,7,1,6,4,17,1,0,"https://fbref.com/en/players/37143438/Edan-Diop"
2023,"Monaco","Ligue 1","Sofiane Diop","FRA","MF","22",2000,0.7,0,0,0,0,0,0,0,NA,0,0,0,0,1,1,0,0,"https://fbref.com/en/players/19053e31/Sofiane-Diop"
2023,"Monaco","Ligue 1","Axel Disasi","FRA","DF","24",1998,37,30,20,13,13,4,13,27,48.1,14,51,31,20,56,86,112,2,"https://fbref.com/en/players/ad82197c/Axel-Disasi"
2023,"Monaco","Ligue 1","Breel Embolo","SUI","FW","25",1997,20.7,15,9,2,7,6,5,10,50,5,14,3,11,5,20,12,0,"https://fbref.com/en/players/0b4f388a/Breel-Embolo"
2023,"Monaco","Ligue 1","Youssouf Fofana","FRA","MF","23",1999,34.3,81,41,31,42,8,38,74,51.4,36,50,6,44,56,137,32,1,"https://fbref.com/en/players/822d51d7/Youssouf-Fofana"
2023,"Monaco","Ligue 1","Aleksandr Golovin","RUS","MF,FW","26",1996,27.4,62,36,19,32,11,28,72,38.9,44,28,1,27,37,99,10,0,"https://fbref.com/en/players/3708e9fa/Aleksandr-Golovin"
2023,"Monaco","Ligue 1","Ismail Jakobs","SEN","DF,FW","22",1999,12.4,11,5,7,3,1,5,12,41.7,7,9,1,8,9,20,18,0,"https://fbref.com/en/players/a0415710/Ismail-Jakobs"
2023,"Monaco","Ligue 1","Jean Lucas","BRA","MF","24",1998,3.2,9,5,3,5,1,6,12,50,6,2,1,1,4,13,2,0,"https://fbref.com/en/players/a99138af/Jean-Lucas"
2023,"Monaco","Ligue 1","Soungoutou Magassa","FRA","MF","18",2003,0.9,4,1,2,2,0,2,4,50,2,3,0,3,1,5,1,0,"https://fbref.com/en/players/dfc5d4fa/Soungoutou-Magassa"
2023,"Monaco","Ligue 1","Guillermo Maripán","CHI","DF","28",1994,24,46,26,26,20,0,17,33,51.5,16,39,27,12,38,84,87,0,"https://fbref.com/en/players/d9764034/Guillermo-Maripan"
2023,"Monaco","Ligue 1","Gelson Martins","POR","MF,FW","27",1995,3.8,15,8,6,4,5,4,13,30.8,9,4,1,3,3,18,2,0,"https://fbref.com/en/players/3ef0fa48/Gelson-Martins"
2023,"Monaco","Ligue 1","Eliot Matazo","BEL","MF","20",2002,13.1,26,12,11,13,2,11,26,42.3,15,18,4,14,15,41,11,1,"https://fbref.com/en/players/15944afd/Eliot-Matazo"
2023,"Monaco","Ligue 1","Chrislain Matsima","FRA","DF","20",2002,5,11,6,7,2,2,4,7,57.1,3,5,5,0,9,20,16,0,"https://fbref.com/en/players/cf1ef7ec/Chrislain-Matsima"
2023,"Monaco","Ligue 1","Takumi Minamino","JPN","MF,FW","27",1995,8,15,8,5,7,3,7,35,20,28,14,0,14,6,21,4,0,"https://fbref.com/en/players/f833a830/Takumi-Minamino"
2023,"Monaco","Ligue 1","Alexander Nübel","GER","GK","25",1996,38,0,0,0,0,0,0,1,0,1,0,0,0,1,1,10,3,"https://fbref.com/en/players/afb0c500/Alexander-Nubel"
2023,"Monaco","Ligue 1","Malang Sarr","FRA","DF","23",1999,8,6,3,5,1,0,1,5,20,4,11,7,4,15,21,29,2,"https://fbref.com/en/players/4315f30d/Malang-Sarr"
2023,"Monaco","Ligue 1","Caio Henrique Oliveira Silva","BRA","DF","25",1997,32.2,74,51,42,28,4,44,76,57.9,32,28,8,20,26,100,68,1,"https://fbref.com/en/players/30af8b93/Caio-Henrique-Oliveira-Silva"
2023,"Monaco","Ligue 1","Vanderson","BRA","DF,MF","21",2001,24.6,84,48,36,34,14,44,75,58.7,31,36,9,27,48,132,36,1,"https://fbref.com/en/players/ee45fd85/Vanderson"
2023,"Monaco","Ligue 1","Kevin Volland","GER","FW,MF","30",1992,7.1,8,4,1,5,2,2,8,25,6,8,0,8,2,10,0,0,"https://fbref.com/en/players/64f69877/Kevin-Volland"
2023,"Montpellier","Ligue 1","Matis Carvalho","POR","GK","23",1999,1.5,0,0,0,0,0,0,0,NA,0,0,0,0,1,1,0,0,"https://fbref.com/en/players/8608f269/Matis-Carvalho"
2023,"Montpellier","Ligue 1","Joris Chotard","FRA","MF","20",2001,27.3,64,34,37,23,4,40,78,51.3,38,40,11,29,40,104,42,1,"https://fbref.com/en/players/7909ffa4/Joris-Chotard"
2023,"Montpellier","Ligue 1","Nicolas Cozza","FRA","DF","23",1999,14.2,38,21,27,9,2,26,38,68.4,12,11,5,6,21,59,35,1,"https://fbref.com/en/players/8f325097/Nicolas-Cozza"
2023,"Montpellier","Ligue 1","Sacha Delaye","FRA","FW,MF","20",2002,0.2,1,0,0,0,1,1,1,100,0,0,0,0,0,1,0,0,"https://fbref.com/en/players/e4448c8c/Sacha-Delaye"
2023,"Montpellier","Ligue 1","Maxime Estève","FRA","DF","20",2002,18.3,24,13,17,5,2,12,17,70.6,5,28,17,11,34,58,90,0,"https://fbref.com/en/players/1a066e69/Maxime-Esteve"
2023,"Montpellier","Ligue 1","Khalil Fayad","FRA","MF","18",2004,8,30,14,12,16,2,12,21,57.1,9,8,1,7,9,39,4,0,"https://fbref.com/en/players/faf00ab8/Khalil-Fayad"
2023,"Montpellier","Ligue 1","Cheikh Faye","SEN","FW","23",1999,0.4,0,0,0,0,0,0,0,NA,0,0,0,0,1,1,0,0,"https://fbref.com/en/players/4b792f35/Cheikh-Faye"
2023,"Montpellier","Ligue 1","Jordan Ferri","FRA","MF","30",1992,30.4,55,35,32,19,4,30,89,33.7,59,22,6,16,26,81,21,0,"https://fbref.com/en/players/375622c5/Jordan-Ferri"
2023,"Montpellier","Ligue 1","Valère Germain","FRA","FW,MF","32",1990,7.6,13,11,3,5,5,4,12,33.3,8,8,0,8,6,19,12,0,"https://fbref.com/en/players/ea0ff634/Valere-Germain"
2023,"Montpellier","Ligue 1","Axel Gueguin","FRA","FW,MF","17",2005,0.3,0,0,0,0,0,0,0,NA,0,1,0,1,0,0,0,0,"https://fbref.com/en/players/f6857b4f/Axel-Gueguin"
2023,"Montpellier","Ligue 1","Christopher Jullien","FRA","DF","29",1993,29.9,46,28,29,14,3,28,51,54.9,23,35,18,17,43,89,114,1,"https://fbref.com/en/players/f323d995/Christopher-Jullien"
2023,"Montpellier","Ligue 1","Bingourou Kamara","SEN","GK","25",1996,4.5,0,0,0,0,0,0,0,NA,0,0,0,0,0,0,2,0,"https://fbref.com/en/players/3814120d/Bingourou-Kamara"
2023,"Montpellier","Ligue 1","Wahbi Khazri","TUN","FW,MF","31",1991,18.2,26,13,13,7,6,6,25,24,19,17,1,16,9,35,20,0,"https://fbref.com/en/players/2677a1de/Wahbi-Khazri"
2023,"Montpellier","Ligue 1","Boubakar Kouyaté","MLI","DF","25",1997,14,31,18,18,11,2,19,35,54.3,16,24,14,10,34,65,73,1,"https://fbref.com/en/players/562a4799/Boubakar-Kouyate"
2023,"Montpellier","Ligue 1","Benjamin Lecomte","FRA","GK","31",1991,19,0,0,0,0,0,0,2,0,2,0,0,0,0,0,6,0,"https://fbref.com/en/players/2fa2a875/Benjamin-Lecomte"
2023,"Montpellier","Ligue 1","Léo Leroy","FRA","MF","22",2000,13.2,53,38,24,26,3,31,57,54.4,26,25,2,23,14,67,8,0,"https://fbref.com/en/players/fcc84a07/Leo-Leroy"
2023,"Montpellier","Ligue 1","Béni Makouana","CGO","FW,MF","19",2002,2.2,1,0,0,1,0,0,2,0,2,3,1,2,0,1,1,0,"https://fbref.com/en/players/654f49ca/Beni-Makouana"
2023,"Montpellier","Ligue 1","Faitout Maouassa","FRA","FW,DF","24",1998,21.4,52,32,26,20,6,18,41,43.9,23,31,3,28,20,72,23,0,"https://fbref.com/en/players/e54a9890/Faitout-Maouassa"
2023,"Montpellier","Ligue 1","Stephy Mavididi","ENG","FW","24",1998,14.3,24,19,12,8,4,13,27,48.1,14,21,1,20,4,28,10,0,"https://fbref.com/en/players/30144daa/Stephy-Mavididi"
2023,"Montpellier","Ligue 1","Pedro Mendes","POR","DF","31",1990,0.1,0,0,0,0,0,0,0,NA,0,0,0,0,0,0,0,1,"https://fbref.com/en/players/6690ef25/Pedro-Mendes"
2023,"Montpellier","Ligue 1","Arnaud Nordin","FRA","FW","24",1998,26.7,26,14,10,12,4,12,28,42.9,16,19,1,18,14,40,7,0,"https://fbref.com/en/players/7b9a9e25/Arnaud-Nordin"
2023,"Montpellier","Ligue 1","Jonas Omlin","SUI","GK","28",1994,13,1,0,1,0,0,0,0,NA,0,0,0,0,0,1,8,1,"https://fbref.com/en/players/c631f952/Jonas-Omlin"
2023,"Montpellier","Ligue 1","Falaye Sacko","MLI","DF","27",1995,28.7,46,25,25,15,6,32,51,62.7,19,43,14,29,33,79,75,1,"https://fbref.com/en/players/6388e356/Falaye-Sacko"
2023,"Montpellier","Ligue 1","Théo Sainte-Luce","FRA","DF","23",1998,5.9,13,11,8,5,0,7,14,50,7,7,2,5,10,23,11,0,"https://fbref.com/en/players/93c942fb/Theo-Sainte-Luce"
2023,"Montpellier","Ligue 1","Mamadou Sakho","FRA","DF","32",1990,8.5,9,5,4,5,0,3,5,60,2,17,12,5,8,17,35,1,"https://fbref.com/en/players/87935cf3/Mamadou-Sakho"
2023,"Montpellier","Ligue 1","Téji Savanier","FRA","MF","30",1991,28.3,46,30,16,19,11,23,70,32.9,47,30,2,28,30,76,12,1,"https://fbref.com/en/players/6bde367b/Teji-Savanier"
2023,"Montpellier","Ligue 1","Arnaud Souquet","FRA","DF,FW","30",1992,4,22,16,13,7,2,11,14,78.6,3,8,3,5,4,26,4,0,"https://fbref.com/en/players/4e0afc5d/Arnaud-Souquet"
2023,"Montpellier","Ligue 1","Issiaga Sylla","GUI","DF","28",1994,14.5,28,16,19,8,1,15,31,48.4,16,19,3,16,32,60,35,0,"https://fbref.com/en/players/b99bec05/Issiaga-Sylla"
2023,"Montpellier","Ligue 1","Thibault Tamas","FRA","DF","21",2001,0.1,0,0,0,0,0,0,0,NA,0,0,0,0,1,1,0,0,"https://fbref.com/en/players/4a0c6555/Thibault-Tamas"
2023,"Montpellier","Ligue 1","Enzo Tchato","CMR","DF","19",2002,12.2,26,17,14,11,1,13,22,59.1,9,17,2,15,7,33,33,0,"https://fbref.com/en/players/7f783431/Enzo-Tchato"
2023,"Montpellier","Ligue 1","Elye Wahi","FRA","FW","19",2003,27.9,9,3,2,3,4,5,14,35.7,9,14,2,12,3,12,5,0,"https://fbref.com/en/players/0d7b6576/Elye-Wahi"
2023,"Monza","Serie A","Valentin Antov","BUL","DF","21",2000,3.4,6,5,3,3,0,1,5,20,4,5,4,1,4,10,14,1,"https://fbref.com/en/players/8f68aa41/Valentin-Antov"
2023,"Monza","Serie A","Andrea Barberis","ITA","MF","28",1993,3.8,7,2,4,3,0,5,11,45.5,6,0,0,0,8,15,1,0,"https://fbref.com/en/players/32ebfe1e/Andrea-Barberis"
2023,"Monza","Serie A","Samuele Birindelli","ITA","DF","23",1999,15.6,35,19,21,10,4,18,29,62.1,11,28,8,20,16,51,30,0,"https://fbref.com/en/players/204ac005/Samuele-Birindelli"
2023,"Monza","Serie A","Warren Bondo","FRA","MF","18",2003,0.7,1,0,1,0,0,0,0,NA,0,1,0,1,0,1,0,0,"https://fbref.com/en/players/0def2376/Warren-Bondo"
2023,"Monza","Serie A","Luca Caldirola","ITA","DF","31",1991,26.1,26,14,19,4,3,13,26,50,13,32,18,14,25,51,66,1,"https://fbref.com/en/players/226008f1/Luca-Caldirola"
2023,"Monza","Serie A","Gianluca Caprari","ITA","MF,FW","29",1993,27.1,16,6,3,11,2,8,26,30.8,18,22,1,21,8,24,3,0,"https://fbref.com/en/players/54e53b7e/Gianluca-Caprari"
2023,"Monza","Serie A","Andrea Carboni","ITA","DF","21",2001,1.9,3,2,2,0,1,2,5,40,3,3,2,1,3,6,2,1,"https://fbref.com/en/players/f7e2af2c/Andrea-Carboni"
2023,"Monza","Serie A","Franco Carboni","ITA","DF,FW","19",2003,0.7,1,1,1,0,0,0,2,0,2,3,0,3,1,2,0,0,"https://fbref.com/en/players/b033f803/Franco-Carboni"
2023,"Monza","Serie A","Carlos","BRA","DF","23",1999,34.3,73,38,42,23,8,33,54,61.1,21,24,6,18,24,97,85,1,"https://fbref.com/en/players/8d3cd59d/Carlos"
2023,"Monza","Serie A","Patrick Ciurria","ITA","DF,MF","27",1995,30.6,31,18,20,10,1,17,33,51.5,16,24,2,22,7,38,32,0,"https://fbref.com/en/players/5de3866c/Patrick-Ciurria"
2023,"Monza","Serie A","Andrea Colpani","ITA","MF","23",1999,10.5,14,9,6,5,3,8,12,66.7,4,14,2,12,3,17,6,0,"https://fbref.com/en/players/6499048c/Andrea-Colpani"
2023,"Monza","Serie A","Alessio Cragno","ITA","GK","28",1994,1,0,0,0,0,0,0,1,0,1,0,0,0,0,0,0,0,"https://fbref.com/en/players/f554e29b/Alessio-Cragno"
2023,"Monza","Serie A","Marco D'Alessandro","ITA","DF,FW","31",1991,3.2,4,4,3,1,0,2,5,40,3,2,0,2,1,5,3,0,"https://fbref.com/en/players/060606ec/Marco-DAlessandro"
2023,"Monza","Serie A","Michele Di Gregorio","ITA","GK","25",1997,37,0,0,0,0,0,0,3,0,3,1,0,1,4,4,18,3,"https://fbref.com/en/players/4e0c8d66/Michele-Di-Gregorio"
2023,"Monza","Serie A","Giulio Donati","ITA","DF","32",1990,4.7,4,1,1,1,2,3,6,50,3,3,1,2,4,8,11,0,"https://fbref.com/en/players/22051fbe/Giulio-Donati"
2023,"Monza","Serie A","Christian Gytkjær","DEN","FW,MF","32",1990,6.2,6,2,1,4,1,2,5,40,3,6,1,5,0,6,2,0,"https://fbref.com/en/players/9250bcff/Christian-Gytkjaer"
2023,"Monza","Serie A","Armando Izzo","ITA","DF","30",1992,27.4,73,50,44,27,2,29,45,64.4,16,29,17,12,50,123,87,1,"https://fbref.com/en/players/89976232/Armando-Izzo"
2023,"Monza","Serie A","Pablo Marí","ESP","DF","28",1993,27.6,37,19,29,7,1,17,26,65.4,9,22,14,8,31,68,111,3,"https://fbref.com/en/players/aa54ec6f/Pablo-Mari"
2023,"Monza","Serie A","Marlon","BRA","DF","26",1995,17.7,35,21,20,14,1,15,29,51.7,14,13,4,9,18,53,50,0,"https://fbref.com/en/players/cdf65d12/Marlon"
2023,"Monza","Serie A","Luca Marrone","ITA","DF","32",1990,1.5,0,0,0,0,0,0,2,0,2,2,2,0,0,0,4,1,"https://fbref.com/en/players/ea468ea8/Luca-Marrone"
2023,"Monza","Serie A","Salvatore Molina","ITA","DF","30",1992,2.5,6,5,2,4,0,4,5,80,1,4,2,2,1,7,2,0,"https://fbref.com/en/players/54ab971f/Salvatore-Molina"
2023,"Monza","Serie A","Dany Mota","POR","FW,MF","24",1998,21.2,8,7,1,3,4,2,10,20,8,5,1,4,6,14,25,0,"https://fbref.com/en/players/efc9e31f/Dany-Mota"
2023,"Monza","Serie A","Pepín","EQG","MF","25",1996,12.5,28,19,10,11,7,9,27,33.3,18,14,3,11,13,41,17,0,"https://fbref.com/en/players/7afb1573/Pepin"
2023,"Monza","Serie A","Matteo Pessina","ITA","MF","25",1997,32.6,57,36,28,21,8,26,62,41.9,36,50,15,35,37,94,33,1,"https://fbref.com/en/players/780e3631/Matteo-Pessina"
2023,"Monza","Serie A","Andrea Petagna","ITA","FW","27",1995,18.5,7,5,2,3,2,3,6,50,3,16,4,12,3,10,18,0,"https://fbref.com/en/players/03f946ed/Andrea-Petagna"
2023,"Monza","Serie A","Andrea Ranocchia","ITA","DF","34",1988,0.5,3,1,1,2,0,3,4,75,1,5,5,0,0,3,7,0,"https://fbref.com/en/players/539230cf/Andrea-Ranocchia"
2023,"Monza","Serie A","Filippo Ranocchia","ITA","MF","21",2001,5.9,11,6,5,4,2,4,12,33.3,8,5,1,4,4,15,7,0,"https://fbref.com/en/players/d9ebed1c/Filippo-Ranocchia"
2023,"Monza","Serie A","Nicolò Rovella","ITA","MF","20",2001,19.3,45,29,22,21,2,13,36,36.1,23,20,1,19,40,85,17,0,"https://fbref.com/en/players/e58cbfd5/Nicolo-Rovella"
2023,"Monza","Serie A","Stefano Sensi","ITA","MF","26",1995,18,41,26,25,13,3,18,48,37.5,30,13,3,10,20,61,4,0,"https://fbref.com/en/players/b70bde8f/Stefano-Sensi"
2023,"Monza","Serie A","Mattia Valoti","ITA","MF,FW","28",1993,5,17,10,7,9,1,5,16,31.3,11,13,3,10,3,20,6,0,"https://fbref.com/en/players/c414df9d/Mattia-Valoti"
2023,"Monza","Serie A","Samuele Vignato","ITA","MF,FW","18",2004,0.7,0,0,0,0,0,0,0,NA,0,1,0,1,0,0,0,0,"https://fbref.com/en/players/a14d0ab0/Samuele-Vignato"
2023,"Nantes","Ligue 1","Mohamed Achi","FRA","FW","20",2002,0.4,1,1,1,0,0,1,1,100,0,0,0,0,0,1,0,0,"https://fbref.com/en/players/1e93fc5d/Mohamed-Achi"
2023,"Nantes","Ligue 1","Dennis Appiah","FRA","DF,MF","30",1992,8.8,21,11,14,7,0,10,27,37,17,13,5,8,10,31,16,0,"https://fbref.com/en/players/feb5d3ab/Dennis-Appiah"
2023,"Nantes","Ligue 1","Stredair Appuah","FRA","DF,MF","18",2004,0.7,2,1,0,2,0,0,0,NA,0,2,0,2,1,3,0,0,"https://fbref.com/en/players/42f0113f/Stredair-Appuah"
2023,"Nantes","Ligue 1","Ludovic Blas","FRA","MF,FW","24",1997,31.3,47,30,17,19,11,17,49,34.7,32,26,1,25,19,66,8,0,"https://fbref.com/en/players/6191093d/Ludovic-Blas"
2023,"Nantes","Ligue 1","Jean-Charles Castelletto","CMR","DF","27",1995,28.5,43,26,29,12,2,22,36,61.1,14,35,22,13,58,101,90,0,"https://fbref.com/en/players/e0f3a1f6/Jean-Charles-Castelletto"
2023,"Nantes","Ligue 1","Fabien Centonze","FRA","DF","26",1996,18.8,58,37,30,22,6,30,42,71.4,12,24,7,17,44,102,55,1,"https://fbref.com/en/players/3c6bbbab/Fabien-Centonze"
2023,"Nantes","Ligue 1","Pedro Chirivella","ESP","MF","25",1997,22.5,33,22,12,15,6,17,44,38.6,27,24,1,23,20,53,7,0,"https://fbref.com/en/players/68a26d51/Pedro-Chirivella"
2023,"Nantes","Ligue 1","Marcus Coco","FRA","FW,MF","26",1996,7.1,24,15,11,9,4,11,23,47.8,12,13,3,10,14,38,7,0,"https://fbref.com/en/players/3010aefb/Marcus-Coco"
2023,"Nantes","Ligue 1","Sébastien Corchia","FRA","DF","31",1990,8.7,16,6,10,2,4,11,22,50,11,9,3,6,14,30,21,0,"https://fbref.com/en/players/0e7ccfc4/Sebastien-Corchia"
2023,"Nantes","Ligue 1","Andy Delort","ALG","FW","30",1991,5.2,5,4,1,2,2,2,6,33.3,4,3,0,3,0,5,2,0,"https://fbref.com/en/players/d33c706e/Andy-Delort"
2023,"Nantes","Ligue 1","Rémy Descamps","FRA","GK","26",1996,1,0,0,0,0,0,0,0,NA,0,0,0,0,0,0,0,0,"https://fbref.com/en/players/477e50ce/Remy-Descamps"
2023,"Nantes","Ligue 1","Lohann Doucet","FRA","MF,FW","19",2002,1,3,0,2,0,1,3,4,75,1,2,0,2,2,5,4,0,"https://fbref.com/en/players/dff0c299/Lohann-Doucet"
2023,"Nantes","Ligue 1","Fábio","BRA","DF,MF","32",1990,2.5,4,2,1,2,1,4,6,66.7,2,2,0,2,3,7,11,0,"https://fbref.com/en/players/bc7b4580/Fabio"
2023,"Nantes","Ligue 1","Ignatius Ganago","CMR","FW,MF","23",1999,16.9,9,7,2,3,4,4,7,57.1,3,13,1,12,2,11,12,0,"https://fbref.com/en/players/23c63b7f/Ignatius-Ganago"
2023,"Nantes","Ligue 1","Andrei Girotto","BRA","DF,MF","30",1992,35,122,73,71,45,6,74,132,56.1,58,55,24,31,73,195,176,1,"https://fbref.com/en/players/3befc2b6/Andrei-Girotto"
2023,"Nantes","Ligue 1","Evann Guessand","FRA","FW,MF","21",2001,14,24,16,8,13,3,6,12,50,6,17,1,16,9,33,6,0,"https://fbref.com/en/players/b73f17f8/Evann-Guessand"
2023,"Nantes","Ligue 1","Jaouen Hadjam","ALG","DF","19",2003,8.9,27,21,13,9,5,16,25,64,9,10,3,7,12,39,12,0,"https://fbref.com/en/players/576817b7/Jaouen-Hadjam"
2023,"Nantes","Ligue 1","Abdoul Kader Bamba","FRA","FW,MF","28",1994,0.9,0,0,0,0,0,0,2,0,2,3,1,2,0,0,1,0,"https://fbref.com/en/players/32f3d97e/Abdoul-Kader-Bamba"
2023,"Nantes","Ligue 1","Alban Lafont","FRA","GK","23",1999,37,0,0,0,0,0,0,1,0,1,0,0,0,0,0,20,4,"https://fbref.com/en/players/4e7db402/Alban-Lafont"
2023,"Nantes","Ligue 1","Quentin Merlin","FRA","DF","20",2002,19.9,31,19,19,8,4,18,38,47.4,20,27,4,23,24,55,30,0,"https://fbref.com/en/players/0bfca6a1/Quentin-Merlin"
2023,"Nantes","Ligue 1","Mostafa Mohamed","EGY","FW","24",1997,21.5,18,13,5,7,6,9,20,45,11,23,1,22,10,28,33,0,"https://fbref.com/en/players/595e6f3e/Mostafa-Mohamed"
2023,"Nantes","Ligue 1","Florent Mollet","FRA","MF","30",1991,12.1,14,6,5,4,5,7,24,29.2,17,12,1,11,10,24,11,0,"https://fbref.com/en/players/7e82a78f/Florent-Mollet"
2023,"Nantes","Ligue 1","Samuel Moutoussamy","COD","MF","25",1996,26.7,64,34,27,28,9,26,76,34.2,50,23,2,21,24,88,15,0,"https://fbref.com/en/players/af0c835b/Samuel-Moutoussamy"
2023,"Nantes","Ligue 1","Nicolas Pallois","FRA","DF","34",1987,24.6,69,44,51,16,2,42,70,60,28,35,18,17,30,99,131,2,"https://fbref.com/en/players/779847d6/Nicolas-Pallois"
2023,"Nantes","Ligue 1","Moses Simon","NGA","FW,MF","27",1995,26.1,18,9,6,7,5,7,15,46.7,8,14,1,13,11,29,3,0,"https://fbref.com/en/players/5f3eaaf5/Moses-Simon"
2023,"Nantes","Ligue 1","Moussa Sissoko","FRA","MF","32",1989,21.3,26,16,16,7,3,12,18,66.7,6,22,5,17,16,42,17,0,"https://fbref.com/en/players/2acd49b9/Moussa-Sissoko"
2023,"Nantes","Ligue 1","Charles Traore","MLI","DF","30",1992,5.4,8,5,5,2,1,5,7,71.4,2,9,2,7,10,18,12,0,"https://fbref.com/en/players/de488e56/Charles-Traore"
2023,"Nantes","Ligue 1","João Victor","BRA","DF","24",1998,9.4,19,11,9,7,3,12,22,54.5,10,11,1,10,15,34,30,0,"https://fbref.com/en/players/d60cf08d/Joao-Victor"
2023,"Nantes","Ligue 1","Nathan Zeze","FRA","DF","17",2005,0.7,3,2,2,1,0,1,1,100,0,0,0,0,0,3,1,0,"https://fbref.com/en/players/fb4c5b6e/Nathan-Zeze"
2023,"Napoli","Serie A","Bartosz Bereszyński","POL","DF","30",1992,1.8,3,2,1,1,1,2,2,100,0,4,0,4,3,6,3,0,"https://fbref.com/en/players/61b3978f/Bartosz-Bereszynski"
2023,"Napoli","Serie A","Diego Demme","GER","MF","30",1991,1.6,1,0,1,0,0,0,4,0,4,2,0,2,0,1,1,0,"https://fbref.com/en/players/dc3fa3b5/Diego-Demme"
2023,"Napoli","Serie A","Giovanni Di Lorenzo","ITA","DF","28",1993,36.2,60,29,33,19,8,25,49,51,24,30,9,21,30,90,60,0,"https://fbref.com/en/players/230a2fac/Giovanni-Di-Lorenzo"
2023,"Napoli","Serie A","Elif Elmas","MKD","FW,MF","22",1999,18.1,24,13,8,12,4,11,23,47.8,12,18,2,16,11,35,5,0,"https://fbref.com/en/players/cf007308/Elif-Elmas"
2023,"Napoli","Serie A","Gianluca Gaetano","ITA","MF","22",2000,0.8,5,3,1,3,1,0,0,NA,0,1,0,1,1,6,0,0,"https://fbref.com/en/players/3b387cc7/Gianluca-Gaetano"
2023,"Napoli","Serie A","Pierluigi Gollini","ITA","GK","27",1995,4,0,0,0,0,0,0,0,NA,0,0,0,0,0,0,1,0,"https://fbref.com/en/players/f0f7f62f/Pierluigi-Gollini"
2023,"Napoli","Serie A","Juan Jesus","BRA","DF","31",1991,10.4,16,11,9,6,1,9,12,75,3,18,11,7,10,26,29,0,"https://fbref.com/en/players/79083382/Juan-Jesus"
2023,"Napoli","Serie A","Khvicha Kvaratskhelia","GEO","FW","21",2001,28,43,23,12,8,23,17,43,39.5,26,20,0,20,5,48,6,1,"https://fbref.com/en/players/dea88efd/Khvicha-Kvaratskhelia"
2023,"Napoli","Serie A","Stanislav Lobotka","SVK","MF","27",1994,34.5,83,44,35,35,13,43,73,58.9,30,29,7,22,23,106,16,0,"https://fbref.com/en/players/e1cbb531/Stanislav-Lobotka"
2023,"Napoli","Serie A","Hirving Lozano","MEX","FW","27",1995,17.8,24,13,10,6,8,9,21,42.9,12,31,0,31,15,39,6,0,"https://fbref.com/en/players/a69e4806/Hirving-Lozano"
2023,"Napoli","Serie A","Alex Meret","ITA","GK","25",1997,34,0,0,0,0,0,0,0,NA,0,0,0,0,0,0,6,1,"https://fbref.com/en/players/9413b19f/Alex-Meret"
2023,"Napoli","Serie A","Kim Min-jae","KOR","DF","25",1996,33.9,55,30,32,22,1,25,29,86.2,4,36,26,10,41,96,123,1,"https://fbref.com/en/players/e0f8151c/Kim-Min-jae"
2023,"Napoli","Serie A","Tanguy Ndombele","FRA","MF","25",1996,9,14,8,4,8,2,4,7,57.1,3,10,1,9,7,21,7,1,"https://fbref.com/en/players/5cdddffa/Tanguy-Ndombele"
2023,"Napoli","Serie A","Mathías Olivera","URU","DF","24",1997,18.3,39,23,16,16,7,22,43,51.2,21,28,2,26,22,61,26,0,"https://fbref.com/en/players/41c12f75/Mathias-Olivera"
2023,"Napoli","Serie A","Victor Osimhen","NGA","FW","23",1998,28.5,10,6,1,2,7,0,7,0,7,6,1,5,6,16,29,0,"https://fbref.com/en/players/8c90fd7a/Victor-Osimhen"
2023,"Napoli","Serie A","Adam Ounas","ALG","FW","25",1996,0.2,0,0,0,0,0,0,0,NA,0,0,0,0,1,1,0,0,"https://fbref.com/en/players/ed90babd/Adam-Ounas"
2023,"Napoli","Serie A","Matteo Politano","ITA","FW","28",1993,13,18,9,9,5,4,11,25,44,14,6,0,6,7,25,7,0,"https://fbref.com/en/players/5e861944/Matteo-Politano"
2023,"Napoli","Serie A","Giacomo Raspadori","ITA","FW,MF","22",2000,10.1,10,8,0,6,4,4,10,40,6,9,0,9,4,14,4,0,"https://fbref.com/en/players/6e058f06/Giacomo-Raspadori"
2023,"Napoli","Serie A","Amir Rrahmani","KVX","DF","28",1994,27.2,33,18,20,13,0,17,26,65.4,9,36,20,16,14,47,79,1,"https://fbref.com/en/players/4b3e1a38/Amir-Rrahmani"
2023,"Napoli","Serie A","Mário Rui","POR","DF","31",1991,19.4,34,22,17,13,4,20,41,48.8,21,17,4,13,15,49,24,1,"https://fbref.com/en/players/0b5a292a/Mario-Rui"
2023,"Napoli","Serie A","Giovanni Simeone","ARG","FW","27",1995,4.5,12,3,3,5,4,3,8,37.5,5,2,1,1,1,13,4,0,"https://fbref.com/en/players/343c0d52/Giovanni-Simeone"
2023,"Napoli","Serie A","Leo Skiri Østigård","NOR","DF","22",1999,4.7,4,1,3,1,0,1,1,100,0,3,3,0,6,10,18,1,"https://fbref.com/en/players/b35a7399/Leo-Skiri-Ostigard"
2023,"Napoli","Serie A","Andre-Frank Zambo Anguissa","CMR","MF","26",1995,33.9,53,32,16,29,8,16,64,25,48,50,4,46,49,102,25,0,"https://fbref.com/en/players/6bb2c084/Andre-Frank-Zambo-Anguissa"
2023,"Napoli","Serie A","Alessandro Zanoli","ITA","DF","21",2000,0.1,1,0,0,1,0,0,0,NA,0,0,0,0,0,1,1,0,"https://fbref.com/en/players/3b12b11f/Alessandro-Zanoli"
2023,"Napoli","Serie A","Karim Zedadka","FRA","FW","22",2000,0.2,0,0,0,0,0,0,0,NA,0,0,0,0,0,0,1,0,"https://fbref.com/en/players/2f45300d/Karim-Zedadka"
2023,"Napoli","Serie A","Alessio Zerbin","ITA","FW","23",1999,2.2,10,5,4,5,1,4,8,50,4,2,0,2,2,12,2,0,"https://fbref.com/en/players/d19ef4ef/Alessio-Zerbin"
2023,"Napoli","Serie A","Piotr Zieliński","POL","MF","28",1994,25.4,17,10,1,11,5,12,25,48,13,16,5,11,14,31,7,0,"https://fbref.com/en/players/a5296e55/Piotr-Zielinski"
2023,"Newcastle Utd","Premier League","Miguel Almirón","PAR","FW","28",1994,27.7,46,30,16,19,11,18,42,42.9,24,25,2,23,10,56,17,0,"https://fbref.com/en/players/862a1c15/Miguel-Almiron"
2023,"Newcastle Utd","Premier League","Elliot Anderson","SCO","MF,FW","19",2002,4.6,11,5,5,3,3,6,12,50,6,11,2,9,6,17,2,0,"https://fbref.com/en/players/de31038e/Elliot-Anderson"
2023,"Newcastle Utd","Premier League","Sven Botman","NED","DF","22",2000,34.7,38,24,31,7,0,22,28,78.6,6,44,24,20,34,72,126,2,"https://fbref.com/en/players/ccce7025/Sven-Botman"
2023,"Newcastle Utd","Premier League","Dan Burn","ENG","DF","30",1992,34.6,60,38,29,23,8,34,67,50.7,33,42,16,26,32,92,120,2,"https://fbref.com/en/players/b2d31e83/Dan-Burn"
2023,"Newcastle Utd","Premier League","Martin Dúbravka","SVK","GK","33",1989,1.7,0,0,0,0,0,0,1,0,1,0,0,0,0,0,1,0,"https://fbref.com/en/players/3a949a25/Martin-Dubravka"
2023,"Newcastle Utd","Premier League","Ryan Fraser","SCO","FW","28",1994,3.5,2,2,0,0,2,2,5,40,3,3,1,2,0,2,3,0,"https://fbref.com/en/players/d56543a0/Ryan-Fraser"
2023,"Newcastle Utd","Premier League","Anthony Gordon","ENG","FW,MF","21",2001,5.4,14,12,5,7,2,9,20,45,11,9,1,8,2,16,1,1,"https://fbref.com/en/players/2bd83368/Anthony-Gordon"
2023,"Newcastle Utd","Premier League","Bruno Guimarães","BRA","MF","24",1997,30.3,78,40,27,46,5,38,65,58.5,27,28,4,24,36,114,22,1,"https://fbref.com/en/players/82518f62/Bruno-Guimaraes"
2023,"Newcastle Utd","Premier League","Alexander Isak","SWE","FW","22",1999,16.9,18,8,4,7,7,10,28,35.7,18,21,2,19,4,22,8,0,"https://fbref.com/en/players/8e92be30/Alexander-Isak"
2023,"Newcastle Utd","Premier League","Joelinton","BRA","MF,FW","25",1996,29.6,70,49,36,26,8,26,62,41.9,36,52,7,45,48,118,39,0,"https://fbref.com/en/players/c17bfb65/Joelinton"
2023,"Newcastle Utd","Premier League","Emil Krafth","SWE","DF","27",1994,0,0,0,0,0,0,0,0,NA,0,0,0,0,0,0,0,0,"https://fbref.com/en/players/77cf6852/Emil-Krafth"
2023,"Newcastle Utd","Premier League","Jamaal Lascelles","ENG","DF","28",1993,2.4,1,0,1,0,0,1,1,100,0,3,2,1,0,1,17,0,"https://fbref.com/en/players/450ab6fc/Jamaal-Lascelles"
2023,"Newcastle Utd","Premier League","Jamal Lewis","NIR","DF,FW","24",1998,0.1,0,0,0,0,0,0,0,NA,0,0,0,0,0,0,0,0,"https://fbref.com/en/players/efb9215a/Jamal-Lewis"
2023,"Newcastle Utd","Premier League","Sean Longstaff","ENG","MF","24",1997,28,42,21,16,20,6,20,52,38.5,32,35,8,27,16,58,23,0,"https://fbref.com/en/players/a2b105e0/Sean-Longstaff"
2023,"Newcastle Utd","Premier League","Javier Manquillo","ESP","DF","28",1994,0.4,3,2,2,1,0,2,2,100,0,1,0,1,1,4,1,0,"https://fbref.com/en/players/758dd7f0/Javier-Manquillo"
2023,"Newcastle Utd","Premier League","Lewis Miley","ENG","MF","16",2006,0.2,0,0,0,0,0,0,0,NA,0,1,0,1,0,0,0,0,"https://fbref.com/en/players/2c6835e5/Lewis-Miley"
2023,"Newcastle Utd","Premier League","Jacob Murphy","ENG","FW","27",1995,13.9,15,7,3,8,4,8,20,40,12,17,0,17,7,22,3,0,"https://fbref.com/en/players/de112b84/Jacob-Murphy"
2023,"Newcastle Utd","Premier League","Nick Pope","ENG","GK","30",1992,36.2,1,0,1,0,0,1,3,33.3,2,0,0,0,0,1,27,2,"https://fbref.com/en/players/4b40d9ca/Nick-Pope"
2023,"Newcastle Utd","Premier League","Matt Ritchie","SCO","FW,MF","32",1989,0.4,1,1,0,1,0,1,3,33.3,2,0,0,0,1,2,0,0,"https://fbref.com/en/players/71ef519e/Matt-Ritchie"
2023,"Newcastle Utd","Premier League","Allan Saint-Maximin","FRA","FW","25",1997,12.4,10,3,3,6,1,2,11,18.2,9,4,0,4,5,15,2,0,"https://fbref.com/en/players/2b16cb1a/Allan-Saint-Maximin"
2023,"Newcastle Utd","Premier League","Fabian Schär","SUI","DF","30",1991,35.6,47,22,31,13,3,24,39,61.5,15,34,19,15,52,99,139,0,"https://fbref.com/en/players/c8aa95da/Fabian-Schar"
2023,"Newcastle Utd","Premier League","Jonjo Shelvey","ENG","MF","30",1992,0.4,1,0,1,0,0,0,1,0,1,1,0,1,0,1,0,0,"https://fbref.com/en/players/3727dd3c/Jonjo-Shelvey"
2023,"Newcastle Utd","Premier League","Matt Targett","ENG","DF","26",1995,6.8,13,10,8,3,2,9,24,37.5,15,8,3,5,9,22,16,0,"https://fbref.com/en/players/e514ab62/Matt-Targett"
2023,"Newcastle Utd","Premier League","Kieran Trippier","ENG","DF","31",1990,37.1,71,49,36,27,8,46,90,51.1,44,45,15,30,43,114,84,2,"https://fbref.com/en/players/21512407/Kieran-Trippier"
2023,"Newcastle Utd","Premier League","Joe Willock","ENG","MF","22",1999,28.4,51,30,13,26,12,25,58,43.1,33,54,8,46,25,76,17,0,"https://fbref.com/en/players/a3b03921/Joe-Willock"
2023,"Newcastle Utd","Premier League","Callum Wilson","ENG","FW","30",1992,20.9,9,3,0,8,1,0,3,0,3,8,0,8,1,10,5,0,"https://fbref.com/en/players/c596fcb0/Callum-Wilson"
2023,"Newcastle Utd","Premier League","Chris Wood","NZL","FW","30",1991,5,5,4,0,3,2,3,5,60,2,2,2,0,1,6,7,0,"https://fbref.com/en/players/4e9a0555/Chris-Wood"
2023,"Nice","Ligue 1","Ayoub Amraoui","MAR","DF,FW","18",2004,3.3,6,5,3,3,0,2,5,40,3,1,0,1,4,10,4,0,"https://fbref.com/en/players/ae11ba3d/Ayoub-Amraoui"
2023,"Nice","Ligue 1","Youcef Atal","ALG","DF,MF","26",1996,8.7,38,22,18,15,5,23,32,71.9,9,9,0,9,14,52,13,0,"https://fbref.com/en/players/6a827d8e/Youcef-Atal"
2023,"Nice","Ligue 1","Melvin Bard","FRA","DF","21",2000,27.3,96,60,61,29,6,59,89,66.3,30,35,4,31,64,160,40,1,"https://fbref.com/en/players/1ddbc7ca/Melvin-Bard"
2023,"Nice","Ligue 1","Ross Barkley","ENG","MF,FW","28",1993,10.7,16,9,7,4,5,7,13,53.8,6,7,2,5,8,24,6,0,"https://fbref.com/en/players/3a24769f/Ross-Barkley"
2023,"Nice","Ligue 1","Alexis Beka Beka","FRA","MF,DF","21",2001,6.1,16,5,6,9,1,4,15,26.7,11,9,1,8,12,28,6,0,"https://fbref.com/en/players/4a5e83ad/Alexis-Beka-Beka"
2023,"Nice","Ligue 1","Reda Belahyane","FRA","MF","18",2004,2,8,6,5,3,0,3,5,60,2,5,1,4,2,10,0,0,"https://fbref.com/en/players/705a1642/Reda-Belahyane"
2023,"Nice","Ligue 1","Badredine Bouanani","ALG","FW,MF","17",2004,9.6,13,9,2,7,4,7,14,50,7,4,0,4,1,14,2,0,"https://fbref.com/en/players/0400dd2f/Badredine-Bouanani"
2023,"Nice","Ligue 1","Hicham Boudaoui","ALG","MF","22",1999,20.8,67,32,31,30,6,35,53,66,18,34,5,29,36,103,16,0,"https://fbref.com/en/players/f9d5908e/Hicham-Boudaoui"
2023,"Nice","Ligue 1","Bilal Brahimi","ALG","FW,MF","22",2000,8.9,8,5,2,5,1,1,7,14.3,6,4,0,4,4,12,0,0,"https://fbref.com/en/players/02bcaf8e/Bilal-Brahimi"
2023,"Nice","Ligue 1","Joe Bryan","ENG","MF,DF","28",1993,2,5,4,3,2,0,4,4,100,0,2,0,2,1,6,1,0,"https://fbref.com/en/players/af69e7f0/Joe-Bryan"
2023,"Nice","Ligue 1","Marcin Bułka","POL","GK","22",1999,2,0,0,0,0,0,0,1,0,1,0,0,0,1,1,0,0,"https://fbref.com/en/players/db87a2c4/Marcin-Bulka"
2023,"Nice","Ligue 1","Alexis Claude-Maurice","FRA","FW","24",1998,0.7,3,2,2,1,0,3,3,100,0,0,0,0,2,5,1,0,"https://fbref.com/en/players/741418c3/Alexis-Claude-Maurice"
2023,"Nice","Ligue 1","Andréa Dacourt","FRA","MF","17",2005,0,0,0,0,0,0,0,0,NA,0,0,0,0,0,0,0,0,"https://fbref.com/en/players/4a021593/Andrea-Dacourt"
2023,"Nice","Ligue 1","Flavius Daniliuc","AUT","DF","21",2001,1,2,0,2,0,0,1,1,100,0,4,1,3,0,2,1,0,"https://fbref.com/en/players/7ef972c3/Flavius-Daniliuc"
2023,"Nice","Ligue 1","Dante","BRA","DF","38",1983,36.7,70,40,45,21,4,36,59,61,23,52,31,21,47,117,125,2,"https://fbref.com/en/players/fd2bc67d/Dante"
2023,"Nice","Ligue 1","Andy Delort","ALG","FW","30",1991,8.7,2,0,1,1,0,1,2,50,1,0,0,0,1,3,7,0,"https://fbref.com/en/players/d33c706e/Andy-Delort"
2023,"Nice","Ligue 1","Sofiane Diop","FRA","MF,FW","22",2000,13.6,23,11,12,6,5,7,20,35,13,14,2,12,16,39,5,0,"https://fbref.com/en/players/19053e31/Sofiane-Diop"
2023,"Nice","Ligue 1","Amine Gouiri","FRA","FW,MF","22",2000,2.5,1,1,1,0,0,0,1,0,1,1,0,1,0,1,3,0,"https://fbref.com/en/players/aad56ca3/Amine-Gouiri"
2023,"Nice","Ligue 1","Rareş Ilie","ROU","MF,FW","19",2003,1.6,3,3,0,1,2,2,4,50,2,2,0,2,1,4,1,0,"https://fbref.com/en/players/c9f49454/Rares-Ilie"
2023,"Nice","Ligue 1","Gaëtan Laborde","FRA","FW","28",1994,27.8,45,25,13,17,15,18,40,45,22,27,2,25,9,54,13,0,"https://fbref.com/en/players/7cdda3bf/Gaetan-Laborde"
2023,"Nice","Ligue 1","Mario Lemina","GAB","MF,DF","28",1993,9.3,32,21,11,14,7,12,18,66.7,6,13,5,8,11,43,20,0,"https://fbref.com/en/players/2b471f99/Mario-Lemina"
2023,"Nice","Ligue 1","Jordan Lotomba","SUI","DF","23",1998,27.3,65,38,33,24,8,31,48,64.6,17,38,11,27,32,97,53,0,"https://fbref.com/en/players/fc4cf6a7/Jordan-Lotomba"
2023,"Nice","Ligue 1","Antoine Mendy","FRA","DF","18",2004,5.8,22,13,16,5,1,9,15,60,6,6,1,5,2,24,16,0,"https://fbref.com/en/players/3322e296/Antoine-Mendy"
2023,"Nice","Ligue 1","Terem Moffi","NGA","FW","23",1999,14.8,12,6,0,6,6,2,12,16.7,10,3,0,3,2,14,5,0,"https://fbref.com/en/players/065dc209/Terem-Moffi"
2023,"Nice","Ligue 1","Youssouf Ndayishimiye","BDI","MF,DF","23",1998,6.3,13,9,8,5,0,6,11,54.5,5,8,5,3,12,25,22,1,"https://fbref.com/en/players/65c55288/Youssouf-Ndayishimiye"
2023,"Nice","Ligue 1","Nicolas Pépé","CIV","FW,MF","27",1995,16.6,25,13,14,5,6,11,25,44,14,17,0,17,3,28,1,0,"https://fbref.com/en/players/57e3f0c7/Nicolas-Pepe"
2023,"Nice","Ligue 1","Aaron Ramsey","WAL","MF","31",1990,17.6,47,25,18,19,10,16,39,41,23,25,4,21,17,64,18,1,"https://fbref.com/en/players/ef619b0b/Aaron-Ramsey"
2023,"Nice","Ligue 1","Pablo Rosario","NED","MF,DF","25",1997,19.6,46,26,22,20,4,18,34,52.9,16,15,5,10,23,69,32,1,"https://fbref.com/en/players/1a6b7ea4/Pablo-Rosario"
2023,"Nice","Ligue 1","Kasper Schmeichel","DEN","GK","35",1986,36,1,0,1,0,0,1,4,25,3,1,0,1,1,2,11,1,"https://fbref.com/en/players/53af52f3/Kasper-Schmeichel"
2023,"Nice","Ligue 1","Calvin Stengs","NED","FW","23",1998,2.4,2,2,1,0,1,1,2,50,1,0,0,0,0,2,0,0,"https://fbref.com/en/players/8f7e6783/Calvin-Stengs"
2023,"Nice","Ligue 1","Khéphren Thuram","FRA","MF","21",2001,28.3,51,25,22,23,6,19,43,44.2,24,33,13,20,38,89,34,0,"https://fbref.com/en/players/7d9397f8/Khephren-Thuram"
2023,"Nice","Ligue 1","Jean-Clair Todibo","FRA","DF","22",1999,31.9,76,48,54,19,3,41,56,73.2,15,41,19,22,41,117,110,2,"https://fbref.com/en/players/88f130ed/Jean-Clair-Todibo"
2023,"Nice","Ligue 1","Théo Trinker","FRA","MF","21",2001,0,0,0,0,0,0,0,0,NA,0,0,0,0,0,0,0,0,"https://fbref.com/en/players/7a3f8712/Theo-Trinker"
2023,"Nice","Ligue 1","Mattia Viti","ITA","DF","20",2002,7,4,2,1,1,2,2,5,40,3,9,3,6,8,12,22,0,"https://fbref.com/en/players/75438a9a/Mattia-Viti"
2023,"Nott'ham Forest","Premier League","Serge Aurier","CIV","DF","29",1992,21.6,64,41,41,18,5,23,33,69.7,10,34,11,23,29,93,75,0,"https://fbref.com/en/players/5c2b4f07/Serge-Aurier"
2023,"Nott'ham Forest","Premier League","Taiwo Awoniyi","NGA","FW","24",1997,15.6,17,10,2,10,5,6,10,60,4,18,4,14,4,21,20,0,"https://fbref.com/en/players/e5478b87/Taiwo-Awoniyi"
2023,"Nott'ham Forest","Premier League","André Ayew","GHA","FW,MF","32",1989,3.5,5,3,0,4,1,2,4,50,2,6,1,5,0,5,7,0,"https://fbref.com/en/players/5dbefa9d/Andre-Ayew"
2023,"Nott'ham Forest","Premier League","Giulian Biancone","FRA","DF","22",2000,0.2,2,1,2,0,0,1,1,100,0,0,0,0,1,3,0,0,"https://fbref.com/en/players/de40e38c/Giulian-Biancone"
2023,"Nott'ham Forest","Premier League","Willy Boly","CIV","DF","31",1991,7.6,13,6,8,3,2,8,13,61.5,5,13,4,9,12,25,45,0,"https://fbref.com/en/players/a4ac4b8f/Willy-Boly"
2023,"Nott'ham Forest","Premier League","Cafú","POR","MF","29",1993,0.1,0,0,0,0,0,0,0,NA,0,0,0,0,0,0,1,0,"https://fbref.com/en/players/85322440/Cafu"
2023,"Nott'ham Forest","Premier League","Jack Colback","ENG","MF","32",1989,5.5,18,13,12,6,0,5,8,62.5,3,3,0,3,3,21,9,0,"https://fbref.com/en/players/963a9201/Jack-Colback"
2023,"Nott'ham Forest","Premier League","Steve Cook","ENG","DF","31",1991,10.6,8,4,4,4,0,5,7,71.4,2,16,11,5,12,20,51,0,"https://fbref.com/en/players/3e5e4e63/Steve-Cook"
2023,"Nott'ham Forest","Premier League","Danilo","BRA","MF","21",2001,10.8,18,7,7,9,2,6,25,24,19,26,6,20,9,27,19,0,"https://fbref.com/en/players/a816dbfb/Danilo"
2023,"Nott'ham Forest","Premier League","Emmanuel Dennis","NGA","FW,MF","24",1997,8,17,11,5,5,7,8,17,47.1,9,13,1,12,2,19,6,0,"https://fbref.com/en/players/2c44a35d/Emmanuel-Dennis"
2023,"Nott'ham Forest","Premier League","Felipe","BRA","DF","33",1989,15.8,42,23,29,13,0,24,41,58.5,17,34,13,21,36,78,90,0,"https://fbref.com/en/players/51a3c4c8/Felipe"
2023,"Nott'ham Forest","Premier League","Remo Freuler","SUI","MF","30",1992,24,43,23,23,15,5,19,43,44.2,24,36,9,27,29,72,45,0,"https://fbref.com/en/players/98d2c2c4/Remo-Freuler"
2023,"Nott'ham Forest","Premier League","Morgan Gibbs-White","ENG","MF,FW","22",2000,33,26,14,7,7,12,11,32,34.4,21,23,4,19,14,40,15,0,"https://fbref.com/en/players/32f60ed8/Morgan-Gibbs-White"
2023,"Nott'ham Forest","Premier League","Dean Henderson","ENG","GK","25",1997,18,0,0,0,0,0,0,0,NA,0,0,0,0,0,0,12,1,"https://fbref.com/en/players/e5a76dfe/Dean-Henderson"
2023,"Nott'ham Forest","Premier League","Wayne Hennessey","WAL","GK","35",1987,3,1,0,1,0,0,1,1,100,0,0,0,0,0,1,2,0,"https://fbref.com/en/players/76eca7e2/Wayne-Hennessey"
2023,"Nott'ham Forest","Premier League","Brennan Johnson","WAL","FW,MF","21",2001,32.6,34,20,18,8,8,8,28,28.6,20,30,1,29,5,39,7,1,"https://fbref.com/en/players/0cd31129/Brennan-Johnson"
2023,"Nott'ham Forest","Premier League","Cheikhou Kouyaté","SEN","MF","32",1989,9.8,29,21,18,8,3,9,13,69.2,4,14,2,12,10,39,24,0,"https://fbref.com/en/players/8d3c902d/Cheikhou-Kouyate"
2023,"Nott'ham Forest","Premier League","Jesse Lingard","ENG","FW,MF","29",1992,10.3,4,4,2,2,0,1,7,14.3,6,11,0,11,5,9,4,0,"https://fbref.com/en/players/810e3c74/Jesse-Lingard"
2023,"Nott'ham Forest","Premier League","Renan Lodi","BRA","DF","24",1998,24.6,52,39,38,8,6,33,66,50,33,25,6,19,33,85,74,0,"https://fbref.com/en/players/ed9f7cfe/Renan-Lodi"
2023,"Nott'ham Forest","Premier League","Orel Mangala","BEL","MF","24",1998,17.2,28,20,16,10,2,12,29,41.4,17,21,7,14,23,51,15,0,"https://fbref.com/en/players/a572e291/Orel-Mangala"
2023,"Nott'ham Forest","Premier League","Scott McKenna","SCO","DF","25",1996,17.5,12,7,7,3,2,6,10,60,4,20,14,6,12,24,85,1,"https://fbref.com/en/players/4e5a4cbc/Scott-McKenna"
2023,"Nott'ham Forest","Premier League","Alexander Mighten","ENG","FW","20",2002,0.1,0,0,0,0,0,0,1,0,1,0,0,0,0,0,0,0,"https://fbref.com/en/players/10ec4169/Alexander-Mighten"
2023,"Nott'ham Forest","Premier League","Keylor Navas","CRC","GK","35",1986,17,0,0,0,0,0,0,0,NA,0,0,0,0,1,1,11,1,"https://fbref.com/en/players/ecada4fc/Keylor-Navas"
2023,"Nott'ham Forest","Premier League","Moussa Niakhate","SEN","DF","26",1996,12.9,18,9,15,3,0,11,22,50,11,18,8,10,19,37,60,0,"https://fbref.com/en/players/00242715/Moussa-Niakhate"
2023,"Nott'ham Forest","Premier League","Lewis O'Brien","ENG","MF","23",1998,6.5,16,9,4,11,1,6,12,50,6,13,2,11,5,21,9,0,"https://fbref.com/en/players/089667a5/Lewis-OBrien"
2023,"Nott'ham Forest","Premier League","Gustavo Scarpa","BRA","MF,FW","28",1994,2,5,2,3,1,1,2,5,40,3,4,0,4,0,5,3,0,"https://fbref.com/en/players/2964fd20/Gustavo-Scarpa"
2023,"Nott'ham Forest","Premier League","Jonjo Shelvey","ENG","MF","30",1992,6,2,1,0,1,1,1,9,11.1,8,7,2,5,5,7,10,1,"https://fbref.com/en/players/3727dd3c/Jonjo-Shelvey"
2023,"Nott'ham Forest","Premier League","Sam Surridge","ENG","FW","24",1998,3.6,5,0,1,3,1,1,4,25,3,5,2,3,0,5,7,0,"https://fbref.com/en/players/b017b770/Sam-Surridge"
2023,"Nott'ham Forest","Premier League","Harry Toffolo","ENG","DF","26",1995,10.4,17,8,10,4,3,10,14,71.4,4,16,8,8,10,27,33,0,"https://fbref.com/en/players/a105d46a/Harry-Toffolo"
2023,"Nott'ham Forest","Premier League","Neco Williams","WAL","DF","21",2001,20.9,72,47,49,17,6,38,71,53.5,33,33,8,25,33,105,48,0,"https://fbref.com/en/players/dd323728/Neco-Williams"
2023,"Nott'ham Forest","Premier League","Chris Wood","NZL","FW","30",1991,4.1,0,0,0,0,0,0,1,0,1,2,1,1,1,1,2,0,"https://fbref.com/en/players/4e9a0555/Chris-Wood"
2023,"Nott'ham Forest","Premier League","Joe Worrall","ENG","DF","25",1997,24.7,53,25,39,12,2,25,35,71.4,10,33,23,10,26,79,111,1,"https://fbref.com/en/players/a5212312/Joe-Worrall"
2023,"Nott'ham Forest","Premier League","Ryan Yates","ENG","MF","24",1997,20.4,38,19,19,16,3,14,22,63.6,8,26,8,18,10,48,44,0,"https://fbref.com/en/players/c1fe2a48/Ryan-Yates"
2023,"Osasuna","La Liga","Ezequiel Ávila","ARG","FW,MF","28",1994,19,8,5,2,4,2,6,23,26.1,17,12,1,11,8,16,16,0,"https://fbref.com/en/players/253a06b9/Ezequiel-Avila"
2023,"Osasuna","La Liga","Kike Barja","ESP","FW,MF","25",1997,14.6,15,9,6,5,4,8,24,33.3,16,7,0,7,4,19,3,0,"https://fbref.com/en/players/aad53e64/Kike-Barja"
2023,"Osasuna","La Liga","Iker Benito","ESP","FW,MF","19",2002,2,4,3,0,3,1,2,4,50,2,0,0,0,2,6,4,0,"https://fbref.com/en/players/50cbc806/Iker-Benito"
2023,"Osasuna","La Liga","Darko Brašanac","SRB","MF","30",1992,11.6,29,20,12,10,7,12,23,52.2,11,14,2,12,12,41,9,0,"https://fbref.com/en/players/4accb7e0/Darko-Brasanac"
2023,"Osasuna","La Liga","Ante Budimir","CRO","FW","31",1991,20,19,9,0,12,7,2,10,20,8,10,0,10,5,24,19,0,"https://fbref.com/en/players/8f3565b3/Ante-Budimir"
2023,"Osasuna","La Liga","Juan Cruz Armada","ESP","DF","30",1992,22.9,24,14,17,4,3,13,23,56.5,10,21,8,13,13,37,58,0,"https://fbref.com/en/players/a56da3ba/Juan-Cruz-Armada"
2023,"Osasuna","La Liga","Abdessamad Ezzalzouli","MAR","FW,MF","20",2001,16.7,29,19,13,12,4,13,23,56.5,10,20,0,20,4,33,6,0,"https://fbref.com/en/players/bed68338/Abdessamad-Ezzalzouli"
2023,"Osasuna","La Liga","Aitor Fernández","ESP","GK","31",1991,21,1,1,1,0,0,0,1,0,1,0,0,0,2,3,17,0,"https://fbref.com/en/players/a01c3d54/Aitor-Fernandez"
2023,"Osasuna","La Liga","David García","ESP","DF","28",1994,29.8,34,20,22,12,0,19,22,86.4,3,28,13,15,45,79,151,0,"https://fbref.com/en/players/3e42f707/David-Garcia"
2023,"Osasuna","La Liga","Rubén García","ESP","FW,MF","29",1993,12.9,20,11,12,4,4,7,24,29.2,17,14,1,13,12,32,13,0,"https://fbref.com/en/players/5c96b017/Ruben-Garcia"
2023,"Osasuna","La Liga","Unai García","ESP","DF","30",1992,19,23,13,13,8,2,12,17,70.6,5,23,14,9,19,42,60,2,"https://fbref.com/en/players/4a633cfe/Unai-Garcia"
2023,"Osasuna","La Liga","Moi Gómez","ESP","MF,FW","28",1994,27.3,26,17,9,14,3,15,32,46.9,17,15,3,12,10,36,5,1,"https://fbref.com/en/players/5a626448/Moi-Gomez"
2023,"Osasuna","La Liga","Aridane Hernández","ESP","DF","33",1989,19.9,21,15,17,4,0,12,25,48,13,34,21,13,28,49,96,1,"https://fbref.com/en/players/132ac341/Aridane-Hernandez"
2023,"Osasuna","La Liga","Jorge Herrando","ESP","DF","21",2001,0.3,0,0,0,0,0,0,0,NA,0,1,0,1,0,0,3,0,"https://fbref.com/en/players/e19c989c/Jorge-Herrando"
2023,"Osasuna","La Liga","Sergio Herrera","ESP","GK","29",1993,17,2,0,2,0,0,2,2,100,0,1,0,1,1,3,6,2,"https://fbref.com/en/players/a4995f48/Sergio-Herrera"
2023,"Osasuna","La Liga","Pablo Ibáñez","ESP","MF","23",1998,11.8,29,13,7,17,5,12,35,34.3,23,19,2,17,8,37,24,0,"https://fbref.com/en/players/3701906c/Pablo-Ibanez"
2023,"Osasuna","La Liga","Kike","ESP","FW","32",1989,11.3,6,3,0,4,2,2,5,40,3,6,1,5,1,7,13,0,"https://fbref.com/en/players/e897d8ba/Kike"
2023,"Osasuna","La Liga","Jon Moncayola","ESP","MF,DF","24",1998,27.2,55,39,24,22,9,30,76,39.5,46,37,5,32,17,72,32,2,"https://fbref.com/en/players/9939e168/Jon-Moncayola"
2023,"Osasuna","La Liga","Diego Moreno","ESP","DF","21",2001,7.1,4,4,2,2,0,3,8,37.5,5,7,4,3,5,9,21,0,"https://fbref.com/en/players/a21417e2/Diego-Moreno"
2023,"Osasuna","La Liga","Iker Muñoz","ESP","MF","19",2002,2.8,1,0,0,1,0,0,3,0,3,2,1,1,3,4,8,0,"https://fbref.com/en/players/175ece4c/Iker-Munoz"
2023,"Osasuna","La Liga","Aimar Oroz","ESP","MF,FW","20",2001,22.4,26,14,8,10,8,8,30,26.7,22,24,1,23,24,50,6,0,"https://fbref.com/en/players/7c363088/Aimar-Oroz"
2023,"Osasuna","La Liga","Rubén Peña","ESP","DF,MF","31",1991,14.2,32,18,10,18,4,20,41,48.8,21,23,8,15,17,49,31,0,"https://fbref.com/en/players/1f079188/Ruben-Pena"
2023,"Osasuna","La Liga","Manu Sánchez","ESP","DF","21",2000,23.6,51,35,35,9,7,33,63,52.4,30,33,5,28,14,65,51,0,"https://fbref.com/en/players/ffacd3d5/Manu-Sanchez"
2023,"Osasuna","La Liga","Roberto Torres","ESP","FW,MF","33",1989,0.1,0,0,0,0,0,0,0,NA,0,0,0,0,0,0,0,0,"https://fbref.com/en/players/d733aa38/Roberto-Torres"
2023,"Osasuna","La Liga","Lucas Torró","ESP","MF","28",1994,27.5,48,32,28,15,5,18,42,42.9,24,24,3,21,42,90,64,1,"https://fbref.com/en/players/0e4fef6e/Lucas-Torro"
2023,"Osasuna","La Liga","Nacho Vidal","ESP","DF","27",1995,13.9,27,14,16,6,5,17,32,53.1,15,17,4,13,19,46,33,1,"https://fbref.com/en/players/3a9c4b7b/Nacho-Vidal"
2023,"Paris S-G","Ligue 1","Juan Bernat","ESP","DF,MF","29",1993,18.3,32,16,18,9,5,21,39,53.8,18,11,2,9,9,41,22,1,"https://fbref.com/en/players/433dc9a2/Juan-Bernat"
2023,"Paris S-G","Ligue 1","El Chadaille Bitshiabu","FRA","DF","17",2005,6.5,10,7,7,2,1,3,12,25,9,9,7,2,9,19,13,3,"https://fbref.com/en/players/2180c761/El-Chadaille-Bitshiabu"
2023,"Paris S-G","Ligue 1","Gianluigi Donnarumma","ITA","GK","23",1999,37.9,1,0,1,0,0,1,2,50,1,0,0,0,0,1,12,4,"https://fbref.com/en/players/08f5afaa/Gianluigi-Donnarumma"
2023,"Paris S-G","Ligue 1","Hugo Ekitike","FRA","FW","20",2002,12.8,12,4,1,10,1,4,12,33.3,8,12,0,12,9,21,3,0,"https://fbref.com/en/players/5b92d896/Hugo-Ekitike"
2023,"Paris S-G","Ligue 1","Ismaël Gharbi","ESP","MF,FW","18",2004,0.6,0,0,0,0,0,0,2,0,2,2,0,2,3,3,0,0,"https://fbref.com/en/players/5b3cfa12/Ismael-Gharbi"
2023,"Paris S-G","Ligue 1","Achraf Hakimi","MAR","DF,MF","23",1998,22.8,54,34,19,20,15,31,59,52.5,28,34,2,32,16,70,19,0,"https://fbref.com/en/players/e42d61c7/Achraf-Hakimi"
2023,"Paris S-G","Ligue 1","Ilyes Housni","FRA","FW","17",2005,0.1,1,1,1,0,0,1,1,100,0,0,0,0,0,1,0,0,"https://fbref.com/en/players/910e3cad/Ilyes-Housni"
2023,"Paris S-G","Ligue 1","Presnel Kimpembe","FRA","DF","26",1995,8.1,17,8,9,6,2,9,13,69.2,4,12,7,5,13,30,9,1,"https://fbref.com/en/players/aef6e670/Presnel-Kimpembe"
2023,"Paris S-G","Ligue 1","Alexandre Letellier","FRA","GK","31",1990,0.1,0,0,0,0,0,0,0,NA,0,0,0,0,0,0,0,0,"https://fbref.com/en/players/96fcd380/Alexandre-Letellier"
2023,"Paris S-G","Ligue 1","Marquinhos","BRA","DF","28",1994,30.2,33,25,18,12,3,18,26,69.2,8,43,27,16,23,56,83,2,"https://fbref.com/en/players/d5f2f82b/Marquinhos"
2023,"Paris S-G","Ligue 1","Kylian Mbappé","FRA","FW","23",1998,31.3,10,4,0,5,5,5,16,31.3,11,5,0,5,5,15,6,0,"https://fbref.com/en/players/42fd9c7f/Kylian-Mbappe"
2023,"Paris S-G","Ligue 1","Nuno Mendes","POR","DF","20",2002,17.2,45,30,29,12,4,30,41,73.2,11,19,3,16,17,62,18,0,"https://fbref.com/en/players/f20e4cc9/Nuno-Mendes"
2023,"Paris S-G","Ligue 1","Lionel Messi","ARG","FW,MF","35",1987,31.5,26,18,1,13,12,11,27,40.7,16,11,0,11,2,28,0,0,"https://fbref.com/en/players/d70ce98e/Lionel-Messi"
2023,"Paris S-G","Ligue 1","Nordi Mukiele","FRA","DF","24",1997,12.6,31,23,16,6,9,19,29,65.5,10,22,9,13,14,45,16,0,"https://fbref.com/en/players/ac73ec79/Nordi-Mukiele"
2023,"Paris S-G","Ligue 1","Neymar","BRA","MF,FW","30",1992,17.2,22,14,6,9,7,9,19,47.4,10,7,1,6,4,26,1,1,"https://fbref.com/en/players/69384e5d/Neymar"
2023,"Paris S-G","Ligue 1","Leandro Paredes","ARG","MF","28",1994,0.6,1,1,1,0,0,1,1,100,0,2,1,1,1,2,0,0,"https://fbref.com/en/players/dff153a4/Leandro-Paredes"
2023,"Paris S-G","Ligue 1","Timothee Pembele","FRA","DF","19",2002,2.9,5,5,3,1,1,2,4,50,2,2,0,2,4,9,2,0,"https://fbref.com/en/players/f8ce97ca/Timothee-Pembele"
2023,"Paris S-G","Ligue 1","Danilo Pereira","POR","DF,MF","30",1991,26.8,32,17,15,14,3,19,26,73.1,7,26,19,7,36,68,59,1,"https://fbref.com/en/players/8fd9996f/Danilo-Pereira"
2023,"Paris S-G","Ligue 1","Sergio Ramos","ESP","DF","36",1986,30,34,26,14,18,2,23,44,52.3,21,29,13,16,34,68,93,3,"https://fbref.com/en/players/08511d65/Sergio-Ramos"
2023,"Paris S-G","Ligue 1","Fabián Ruiz Peña","ESP","MF","26",1996,21,62,28,25,30,7,43,79,54.4,36,24,1,23,18,80,23,1,"https://fbref.com/en/players/c0c7ff58/Fabian-Ruiz-Pena"
2023,"Paris S-G","Ligue 1","Renato Sanches","POR","MF","24",1997,8,8,1,1,3,4,5,14,35.7,9,13,3,10,9,17,4,0,"https://fbref.com/en/players/032f894e/Renato-Sanches"
2023,"Paris S-G","Ligue 1","Pablo Sarabia","ESP","FW,MF","30",1992,4.1,5,4,2,2,1,1,7,14.3,6,3,0,3,2,7,0,0,"https://fbref.com/en/players/9744ff80/Pablo-Sarabia"
2023,"Paris S-G","Ligue 1","Carlos Soler","ESP","MF","25",1997,13.2,20,12,6,10,4,10,19,52.6,9,12,4,8,4,24,6,0,"https://fbref.com/en/players/fed17f5a/Carlos-Soler"
2023,"Paris S-G","Ligue 1","Marco Verratti","ITA","MF","29",1992,24.4,76,49,34,36,6,38,89,42.7,51,42,6,36,27,103,11,3,"https://fbref.com/en/players/1467af0d/Marco-Verratti"
2023,"Paris S-G","Ligue 1","Vitinha","POR","MF","22",2000,27.2,58,25,21,27,10,27,83,32.5,56,27,4,23,25,83,15,0,"https://fbref.com/en/players/3b029691/Vitinha"
2023,"Paris S-G","Ligue 1","Warren Zaire-Emery","FRA","MF,DF","16",2006,10.3,17,10,5,10,2,8,29,27.6,21,11,0,11,12,29,17,0,"https://fbref.com/en/players/6b9960cf/Warren-Zaire-Emery"
2023,"RB Leipzig","Bundesliga","Sanoussy Ba","GER","DF","18",2004,0,0,0,0,0,0,0,0,NA,0,0,0,0,0,0,0,0,"https://fbref.com/en/players/f582d5c1/Sanoussy-Ba"
2023,"RB Leipzig","Bundesliga","Janis Blaswich","GER","GK","31",1991,26,0,0,0,0,0,0,0,NA,0,0,0,0,0,0,10,0,"https://fbref.com/en/players/663e080e/Janis-Blaswich"
2023,"RB Leipzig","Bundesliga","Abdou Diallo","SEN","DF,MF","26",1996,5.3,6,5,5,1,0,1,3,33.3,2,8,5,3,8,14,22,0,"https://fbref.com/en/players/fc62f087/Abdou-Diallo"
2023,"RB Leipzig","Bundesliga","Emil Forsberg","SWE","MF,FW","30",1991,16.5,16,11,1,8,7,6,20,30,14,25,2,23,3,19,7,0,"https://fbref.com/en/players/9a2e0ccc/Emil-Forsberg"
2023,"RB Leipzig","Bundesliga","Péter Gulácsi","HUN","GK","32",1990,6,0,0,0,0,0,0,0,NA,0,0,0,0,0,0,2,0,"https://fbref.com/en/players/bcb2ccd8/Peter-Gulacsi"
2023,"RB Leipzig","Bundesliga","Joško Gvardiol","CRO","DF","20",2002,24.1,23,17,15,8,0,9,22,40.9,13,34,17,17,34,57,76,1,"https://fbref.com/en/players/5ad50391/Josko-Gvardiol"
2023,"RB Leipzig","Bundesliga","Amadou Haidara","MLI","MF","24",1998,15.9,25,11,15,10,0,13,34,38.2,21,26,6,20,26,51,20,0,"https://fbref.com/en/players/92432bc6/Amadou-Haidara"
2023,"RB Leipzig","Bundesliga","Marcel Halstenberg","GER","DF","30",1991,17.3,40,21,20,15,5,23,41,56.1,18,22,1,21,21,61,29,0,"https://fbref.com/en/players/8ff2354e/Marcel-Halstenberg"
2023,"RB Leipzig","Bundesliga","Benjamin Henrichs","GER","DF,MF","25",1997,24.3,73,46,41,29,3,43,66,65.2,23,48,4,44,35,108,46,0,"https://fbref.com/en/players/0a89e877/Benjamin-Henrichs"
2023,"RB Leipzig","Bundesliga","Kevin Kampl","SVN","MF","31",1990,15.2,21,11,6,14,1,6,27,22.2,21,26,9,17,22,43,11,0,"https://fbref.com/en/players/b825a650/Kevin-Kampl"
2023,"RB Leipzig","Bundesliga","Lukas Klostermann","GER","DF","26",1996,10.1,16,8,7,9,0,8,15,53.3,7,6,3,3,13,29,31,0,"https://fbref.com/en/players/ca8033cb/Lukas-Klostermann"
2023,"RB Leipzig","Bundesliga","Konrad Laimer","AUT","MF","25",1997,16.3,60,31,23,30,7,30,54,55.6,24,31,4,27,18,78,8,0,"https://fbref.com/en/players/c1b7847c/Konrad-Laimer"
2023,"RB Leipzig","Bundesliga","Christopher Nkunku","FRA","FW,MF","24",1997,21.1,6,4,2,1,3,1,6,16.7,5,8,3,5,8,14,11,0,"https://fbref.com/en/players/7c56da38/Christopher-Nkunku"
2023,"RB Leipzig","Bundesliga","Hugo Novoa","ESP","DF,FW","19",2003,2,8,2,1,3,4,4,7,57.1,3,4,0,4,1,9,0,0,"https://fbref.com/en/players/5458f670/Hugo-Novoa"
2023,"RB Leipzig","Bundesliga","Ørjan Nyland","NOR","GK","31",1990,2,0,0,0,0,0,0,0,NA,0,0,0,0,0,0,0,0,"https://fbref.com/en/players/bdedffac/Orjan-Nyland"
2023,"RB Leipzig","Bundesliga","Dani Olmo","ESP","MF,FW","24",1998,14.2,15,9,1,10,4,6,14,42.9,8,15,0,15,6,21,6,0,"https://fbref.com/en/players/ae44e8e2/Dani-Olmo"
2023,"RB Leipzig","Bundesliga","Willi Orban","HUN","DF","29",1992,32.8,51,30,33,18,0,26,43,60.5,17,42,24,18,39,90,129,1,"https://fbref.com/en/players/20030c06/Willi-Orban"
2023,"RB Leipzig","Bundesliga","Yussuf Poulsen","DEN","FW","28",1994,4.6,6,4,1,4,1,2,5,40,3,3,1,2,0,6,5,0,"https://fbref.com/en/players/d2416c2e/Yussuf-Poulsen"
2023,"RB Leipzig","Bundesliga","David Raum","GER","DF,MF","24",1998,18.7,39,25,23,12,4,17,29,58.6,12,24,6,18,16,55,26,1,"https://fbref.com/en/players/7d450ed3/David-Raum"
2023,"RB Leipzig","Bundesliga","Xaver Schlager","AUT","MF","24",1997,16.7,41,24,13,26,2,20,43,46.5,23,19,2,17,17,58,23,0,"https://fbref.com/en/players/8f056768/Xaver-Schlager"
2023,"RB Leipzig","Bundesliga","André Silva","POR","FW","26",1995,19.3,12,6,2,5,5,3,8,37.5,5,11,1,10,3,15,3,0,"https://fbref.com/en/players/3effaa34/Andre-Silva"
2023,"RB Leipzig","Bundesliga","Mohamed Simakan","FRA","DF","22",2000,16.2,21,14,12,5,4,14,21,66.7,7,21,4,17,16,37,55,0,"https://fbref.com/en/players/fcb27134/Mohamed-Simakan"
2023,"RB Leipzig","Bundesliga","Dominik Szoboszlai","HUN","MF,FW","21",2000,27.2,45,28,12,20,13,17,42,40.5,25,43,2,41,17,62,27,0,"https://fbref.com/en/players/934e1968/Dominik-Szoboszlai"
2023,"RB Leipzig","Bundesliga","Alexander Sørloth","NOR","FW","26",1995,0.1,0,0,0,0,0,0,0,NA,0,0,0,0,0,0,0,0,"https://fbref.com/en/players/e92cd3f7/Alexander-Sorloth"
2023,"RB Leipzig","Bundesliga","Timo Werner","GER","FW,MF","26",1996,21.5,10,5,4,3,3,4,12,33.3,8,12,0,12,7,17,5,0,"https://fbref.com/en/players/49fe9070/Timo-Werner"
2023,"Rayo Vallecano","La Liga","Iván Balliu","ALB","DF","30",1992,35.9,52,29,26,20,6,18,30,60,12,26,3,23,25,77,72,1,"https://fbref.com/en/players/cee88597/Ivan-Balliu"
2023,"Rayo Vallecano","La Liga","Bebé","CPV","FW","32",1990,0.7,0,0,0,0,0,0,2,0,2,1,0,1,0,0,0,0,"https://fbref.com/en/players/d8712bf9/Bebe"
2023,"Rayo Vallecano","La Liga","Sergio Camello","ESP","FW","21",2001,26.7,16,10,3,9,4,5,17,29.4,12,9,1,8,2,18,26,0,"https://fbref.com/en/players/873619c6/Sergio-Camello"
2023,"Rayo Vallecano","La Liga","Catena","ESP","DF","27",1994,34.5,29,14,23,4,2,13,27,48.1,14,32,25,7,28,57,159,1,"https://fbref.com/en/players/274ab13c/Catena"
2023,"Rayo Vallecano","La Liga","Pep Chavarría","ESP","FW,MF","24",1998,4.1,6,4,2,1,3,1,5,20,4,8,0,8,2,8,8,0,"https://fbref.com/en/players/63c5e56b/Pep-Chavarria"
2023,"Rayo Vallecano","La Liga","Pathé Ciss","SEN","MF,DF","28",1994,14.2,39,29,11,23,5,15,34,44.1,19,23,10,13,22,61,34,0,"https://fbref.com/en/players/9a0408b6/Pathe-Ciss"
2023,"Rayo Vallecano","La Liga","Santi Comesaña","ESP","MF","25",1996,27.2,71,44,24,41,6,38,82,46.3,44,39,3,36,32,103,17,0,"https://fbref.com/en/players/5ae499d0/Santi-Comesana"
2023,"Rayo Vallecano","La Liga","Stole Dimitrievski","MKD","GK","28",1993,36.9,1,0,1,0,0,1,2,50,1,2,0,2,1,2,17,3,"https://fbref.com/en/players/fc70e345/Stole-Dimitrievski"
2023,"Rayo Vallecano","La Liga","Radamel Falcao","COL","FW,MF","36",1986,6.8,4,4,1,3,0,1,8,12.5,7,5,1,4,2,6,10,0,"https://fbref.com/en/players/66116290/Radamel-Falcao"
2023,"Rayo Vallecano","La Liga","Álvaro García","ESP","FW,MF","29",1992,31.9,49,28,21,13,15,11,33,33.3,22,41,4,37,34,83,24,1,"https://fbref.com/en/players/90bbd822/Alvaro-Garcia"
2023,"Rayo Vallecano","La Liga","Fran Garcia","ESP","DF","22",1999,37.9,84,54,53,23,8,55,96,57.3,41,49,8,41,44,128,66,0,"https://fbref.com/en/players/7226539b/Fran-Garcia"
2023,"Rayo Vallecano","La Liga","Mario Hernández","ESP","DF","23",1999,1.1,3,2,2,1,0,3,7,42.9,4,2,0,2,2,5,0,0,"https://fbref.com/en/players/90162357/Mario-Hernandez"
2023,"Rayo Vallecano","La Liga","Florian Lejeune","FRA","DF","31",1991,28.5,28,17,19,8,1,17,25,68,8,24,16,8,15,43,123,0,"https://fbref.com/en/players/6eaed4eb/Florian-Lejeune"
2023,"Rayo Vallecano","La Liga","Diego López","ESP","GK","40",1981,1.1,0,0,0,0,0,0,0,NA,0,0,0,0,0,0,0,1,"https://fbref.com/en/players/73683fa9/Diego-Lopez"
2023,"Rayo Vallecano","La Liga","Unai López","ESP","MF","26",1995,13.9,32,20,10,17,5,13,37,35.1,24,12,1,11,15,47,6,1,"https://fbref.com/en/players/88050721/Unai-Lopez"
2023,"Rayo Vallecano","La Liga","Andrés Martín","ESP","FW,MF","23",1999,2.3,4,2,2,1,1,3,5,60,2,2,0,2,1,5,2,0,"https://fbref.com/en/players/2ae30661/Andres-Martin"
2023,"Rayo Vallecano","La Liga","Diego Méndez","ESP","MF","18",2003,0,0,0,0,0,0,0,0,NA,0,0,0,0,1,1,0,0,"https://fbref.com/en/players/b151a3f2/Diego-Mendez"
2023,"Rayo Vallecano","La Liga","Abdul Mumin","GHA","DF","24",1998,10.2,11,9,5,6,0,3,7,42.9,4,13,5,8,9,20,36,2,"https://fbref.com/en/players/5487adcd/Abdul-Mumin"
2023,"Rayo Vallecano","La Liga","Pablo Muñoz","ESP","MF","18",2003,0.1,0,0,0,0,0,0,1,0,1,0,0,0,0,0,0,0,"https://fbref.com/en/players/44e8521b/Pablo-Munoz"
2023,"Rayo Vallecano","La Liga","Randy Ntekja","FRA","FW,MF","24",1997,1.3,4,2,2,2,0,1,1,100,0,2,0,2,2,6,3,0,"https://fbref.com/en/players/a6103274/Randy-Ntekja"
2023,"Rayo Vallecano","La Liga","Isaac Palazón Camacho","ESP","FW,MF","27",1994,32.9,45,30,11,23,11,24,66,36.4,42,42,3,39,17,62,30,0,"https://fbref.com/en/players/49dbab27/Isaac-Palazon-Camacho"
2023,"Rayo Vallecano","La Liga","José Pozo","ESP","MF,FW","26",1996,1,2,2,0,2,0,0,0,NA,0,0,0,0,1,3,1,0,"https://fbref.com/en/players/fc8b614b/Jose-Pozo"
2023,"Rayo Vallecano","La Liga","Salvi","ESP","FW,MF","31",1991,5.4,13,8,5,5,3,2,8,25,6,0,0,0,2,15,2,0,"https://fbref.com/en/players/405f267a/Salvi"
2023,"Rayo Vallecano","La Liga","Esteban Saveljich","MNE","FW","31",1991,0,0,0,0,0,0,0,0,NA,0,0,0,0,0,0,0,0,"https://fbref.com/en/players/79f2a5f5/Esteban-Saveljich"
2023,"Rayo Vallecano","La Liga","Mario Suárez","ESP","MF,DF","35",1987,0.1,0,0,0,0,0,0,0,NA,0,1,0,1,0,0,0,0,"https://fbref.com/en/players/7106f0a0/Mario-Suarez"
2023,"Rayo Vallecano","La Liga","Raúl de Tomás","ESP","FW","27",1994,8.9,3,2,0,1,2,2,6,33.3,4,4,0,4,0,3,6,0,"https://fbref.com/en/players/02ef8778/Raul-de-Tomas"
2023,"Rayo Vallecano","La Liga","Óscar Trejo","ARG","MF,FW","34",1988,23.8,48,32,12,23,13,9,44,20.5,35,31,3,28,8,56,8,1,"https://fbref.com/en/players/fc647b34/Oscar-Trejo"
2023,"Rayo Vallecano","La Liga","Óscar Valentín","ESP","MF","27",1994,28.4,92,51,29,50,13,46,121,38,75,60,9,51,44,136,30,0,"https://fbref.com/en/players/592f3158/Oscar-Valentin"
2023,"Real Madrid","La Liga","David Alaba","AUT","DF","30",1992,20.4,15,11,8,4,3,9,15,60,6,18,9,9,14,29,37,1,"https://fbref.com/en/players/05439de2/David-Alaba"
2023,"Real Madrid","La Liga","Sergio Arribas","ESP","MF,FW","20",2001,0.2,0,0,0,0,0,0,0,NA,0,1,0,1,0,0,0,0,"https://fbref.com/en/players/1e465e70/Sergio-Arribas"
2023,"Real Madrid","La Liga","Marco Asensio","ESP","FW,MF","26",1996,16,16,10,8,6,2,8,19,42.1,11,8,3,5,5,21,4,0,"https://fbref.com/en/players/45af8a54/Marco-Asensio"
2023,"Real Madrid","La Liga","Karim Benzema","FRA","FW","34",1987,22.6,9,5,2,4,3,2,11,18.2,9,11,0,11,2,11,5,0,"https://fbref.com/en/players/70d74ece/Karim-Benzema"
2023,"Real Madrid","La Liga","Eduardo Camavinga","FRA","MF,DF","19",2002,22.3,68,48,32,21,15,24,64,37.5,40,24,5,19,17,85,25,0,"https://fbref.com/en/players/7b9c2d84/Eduardo-Camavinga"
2023,"Real Madrid","La Liga","Dani Carvajal","ESP","DF","30",1992,19.8,32,18,15,12,5,18,35,51.4,17,24,6,18,15,47,49,0,"https://fbref.com/en/players/4958bfb2/Dani-Carvajal"
2023,"Real Madrid","La Liga","Casemiro","BRA","MF","30",1992,0.1,0,0,0,0,0,0,0,NA,0,0,0,0,0,0,1,0,"https://fbref.com/en/players/4d224fe8/Casemiro"
2023,"Real Madrid","La Liga","Dani Ceballos","ESP","MF","25",1996,17.4,43,29,13,15,15,25,64,39.1,39,23,2,21,25,68,6,1,"https://fbref.com/en/players/c0617e2b/Dani-Ceballos"
2023,"Real Madrid","La Liga","Thibaut Courtois","BEL","GK","30",1992,31,1,0,1,0,0,1,1,100,0,0,0,0,3,4,7,1,"https://fbref.com/en/players/1840e36d/Thibaut-Courtois"
2023,"Real Madrid","La Liga","Eden Hazard","BEL","FW","31",1991,2.2,0,0,0,0,0,0,2,0,2,1,0,1,1,1,0,0,"https://fbref.com/en/players/a39bb753/Eden-Hazard"
2023,"Real Madrid","La Liga","Vinicius Júnior","BRA","FW","22",2000,31.4,30,21,10,12,8,14,39,35.9,25,24,1,23,6,36,1,0,"https://fbref.com/en/players/7111d552/Vinicius-Junior"
2023,"Real Madrid","La Liga","Toni Kroos","GER","MF","32",1990,23.9,51,32,16,33,2,23,69,33.3,46,23,4,19,24,75,11,0,"https://fbref.com/en/players/6ce1f46f/Toni-Kroos"
2023,"Real Madrid","La Liga","Andriy Lunin","UKR","GK","23",1999,7,0,0,0,0,0,0,0,NA,0,0,0,0,0,0,1,0,"https://fbref.com/en/players/3061e1ec/Andriy-Lunin"
2023,"Real Madrid","La Liga","Mariano","DOM","FW","28",1993,1.7,1,0,0,1,0,0,0,NA,0,1,0,1,0,1,0,0,"https://fbref.com/en/players/5c4dc0ff/Mariano"
2023,"Real Madrid","La Liga","Ferland Mendy","FRA","DF","27",1995,15,21,12,14,6,1,12,20,60,8,7,2,5,14,35,16,0,"https://fbref.com/en/players/3cefcaef/Ferland-Mendy"
2023,"Real Madrid","La Liga","Éder Militão","BRA","DF","24",1998,30,46,32,25,18,3,26,33,78.8,7,67,39,28,42,88,104,2,"https://fbref.com/en/players/2784f898/Eder-Militao"
2023,"Real Madrid","La Liga","Luka Modrić","CRO","MF","36",1985,19.4,19,9,6,6,7,10,25,40,15,15,5,10,10,29,7,0,"https://fbref.com/en/players/6025fab1/Luka-Modric"
2023,"Real Madrid","La Liga","Álvaro Muñoz","URU","FW","18",2004,0.9,2,1,1,0,1,1,1,100,0,0,0,0,0,2,1,0,"https://fbref.com/en/players/49a6ecbb/Alvaro-Munoz"
2023,"Real Madrid","La Liga","Nacho","ESP","DF","32",1990,18.2,24,16,17,5,2,12,29,41.4,17,11,6,5,18,42,37,0,"https://fbref.com/en/players/2946f9a1/Nacho"
2023,"Real Madrid","La Liga","Álvaro Odriozola","ESP","DF","26",1995,0.4,0,0,0,0,0,0,0,NA,0,0,0,0,0,0,0,0,"https://fbref.com/en/players/1d1691ad/Alvaro-Odriozola"
2023,"Real Madrid","La Liga","Rodrygo","BRA","FW,MF","21",2001,26.4,17,10,3,7,7,4,23,17.4,19,23,0,23,8,25,5,0,"https://fbref.com/en/players/8f5e92a6/Rodrygo"
2023,"Real Madrid","La Liga","Antonio Rüdiger","GER","DF","29",1993,26.8,18,16,12,5,1,14,23,60.9,9,23,13,10,19,37,74,0,"https://fbref.com/en/players/18b896d6/Antonio-Rudiger"
2023,"Real Madrid","La Liga","Aurélien Tchouaméni","FRA","MF","22",2000,23.5,64,40,23,36,5,23,38,60.5,15,20,6,14,49,113,50,0,"https://fbref.com/en/players/4f255115/Aurelien-Tchouameni"
2023,"Real Madrid","La Liga","Jesús Vallejo","ESP","DF","25",1997,0.2,0,0,0,0,0,0,0,NA,0,0,0,0,0,0,0,0,"https://fbref.com/en/players/c2111b45/Jesus-Vallejo"
2023,"Real Madrid","La Liga","Federico Valverde","URU","MF,FW","24",1998,27.8,31,20,14,11,6,13,26,50,13,31,4,27,17,48,15,0,"https://fbref.com/en/players/0959c2a2/Federico-Valverde"
2023,"Real Madrid","La Liga","Lucas Vázquez","ESP","DF","31",1991,12.7,34,23,22,10,2,20,28,71.4,8,10,0,10,7,41,13,0,"https://fbref.com/en/players/fd51b456/Lucas-Vazquez"
2023,"Real Sociedad","La Liga","Mohamed Ali Cho","FRA","FW,MF","18",2004,6.5,13,10,6,5,2,4,10,40,6,9,0,9,2,15,2,0,"https://fbref.com/en/players/f8405304/Mohamed-Ali-Cho"
2023,"Real Sociedad","La Liga","Ander Barrenetxea","ESP","FW,DF","20",2001,9.8,21,15,15,6,0,12,28,42.9,16,15,1,14,5,26,7,0,"https://fbref.com/en/players/200e89e1/Ander-Barrenetxea"
2023,"Real Sociedad","La Liga","Aritz Elustondo","ESP","DF","28",1994,16.1,26,17,15,10,1,14,26,53.8,12,15,6,9,20,46,43,1,"https://fbref.com/en/players/f7dc2ae5/Aritz-Elustondo"
2023,"Real Sociedad","La Liga","Carlos Fernández","ESP","FW","26",1996,7,6,4,1,3,2,1,15,6.7,14,1,0,1,1,7,4,0,"https://fbref.com/en/players/e08647d6/Carlos-Fernandez"
2023,"Real Sociedad","La Liga","Andoni Gorosabel","ESP","DF","25",1996,19,41,25,23,9,9,26,43,60.5,17,21,2,19,17,58,23,0,"https://fbref.com/en/players/6f5f82c0/Andoni-Gorosabel"
2023,"Real Sociedad","La Liga","Ander Guevara","ESP","MF","25",1997,2.5,5,2,2,2,1,1,4,25,3,6,1,5,2,7,3,0,"https://fbref.com/en/players/8e48dc61/Ander-Guevara"
2023,"Real Sociedad","La Liga","Asier Illarramendi","ESP","MF","32",1990,12,36,18,10,22,4,16,44,36.4,28,27,8,19,18,54,20,0,"https://fbref.com/en/players/5ce0b5ba/Asier-Illarramendi"
2023,"Real Sociedad","La Liga","Alexander Isak","SWE","FW","22",1999,1.7,1,1,0,0,1,0,0,NA,0,0,0,0,0,1,2,0,"https://fbref.com/en/players/8e92be30/Alexander-Isak"
2023,"Real Sociedad","La Liga","Jon Karrikaburu","ESP","FW","19",2002,1,1,0,0,1,0,0,0,NA,0,2,0,2,0,1,0,0,"https://fbref.com/en/players/211589b8/Jon-Karrikaburu"
2023,"Real Sociedad","La Liga","Takefusa Kubo","JPN","FW,MF","21",2001,27.1,44,26,18,16,10,16,38,42.1,22,29,1,28,9,53,4,0,"https://fbref.com/en/players/16aa3654/Takefusa-Kubo"
2023,"Real Sociedad","La Liga","Robin Le Normand","ESP","DF","25",1996,31.1,36,23,25,9,2,14,27,51.9,13,22,14,8,33,69,93,0,"https://fbref.com/en/players/9a64e67e/Robin-Le-Normand"
2023,"Real Sociedad","La Liga","Jon Magunacelaya","ESP","MF,FW","22",2000,0.7,1,0,0,0,1,0,2,0,2,0,0,0,0,1,1,0,"https://fbref.com/en/players/d4808594/Jon-Magunacelaya"
2023,"Real Sociedad","La Liga","Pablo Marín","ESP","MF,FW","19",2003,4,10,5,5,4,1,2,7,28.6,5,1,0,1,4,14,2,0,"https://fbref.com/en/players/a83c19cf/Pablo-Marin"
2023,"Real Sociedad","La Liga","Ander Martin","ESP","MF,FW","21",2000,0.5,2,2,1,1,0,1,4,25,3,0,0,0,0,2,1,0,"https://fbref.com/en/players/e1e75690/Ander-Martin"
2023,"Real Sociedad","La Liga","Brais Méndez","ESP","MF","25",1997,26.7,58,34,18,30,10,24,64,37.5,40,27,3,24,12,70,14,1,"https://fbref.com/en/players/c9e39d91/Brais-Mendez"
2023,"Real Sociedad","La Liga","Mikel Merino","ESP","MF","26",1996,27.7,77,49,28,33,16,31,62,50,31,38,8,30,20,97,51,1,"https://fbref.com/en/players/d080ed5e/Mikel-Merino"
2023,"Real Sociedad","La Liga","Aihen Muñoz","ESP","DF","24",1997,19.5,38,23,17,17,4,22,47,46.8,25,26,5,21,9,47,38,0,"https://fbref.com/en/players/228b0d9d/Aihen-Munoz"
2023,"Real Sociedad","La Liga","Roberto Navarro","ESP","MF,FW","20",2002,3.9,5,4,4,0,1,1,2,50,1,7,0,7,2,7,2,0,"https://fbref.com/en/players/c997b942/Roberto-Navarro"
2023,"Real Sociedad","La Liga","Olasagasti","ESP","MF,DF","21",2000,0.7,4,4,1,2,1,1,2,50,1,2,0,2,0,4,1,0,"https://fbref.com/en/players/3d99999d/Olasagasti"
2023,"Real Sociedad","La Liga","Mikel Oyarzabal","ESP","FW,MF","25",1997,13.5,13,7,5,3,5,5,19,26.3,14,14,4,10,3,16,5,0,"https://fbref.com/en/players/8c3c640c/Mikel-Oyarzabal"
2023,"Real Sociedad","La Liga","Jon Pacheco","ESP","DF","21",2001,13.3,16,10,10,6,0,6,10,60,4,9,6,3,12,28,37,1,"https://fbref.com/en/players/44150beb/Jon-Pacheco"
2023,"Real Sociedad","La Liga","Álex Remiro","ESP","GK","27",1995,38,1,1,1,0,0,1,3,33.3,2,0,0,0,0,1,17,3,"https://fbref.com/en/players/374ee424/Alex-Remiro"
2023,"Real Sociedad","La Liga","Diego Rico","ESP","DF","29",1993,18.3,35,21,17,11,7,12,27,44.4,15,18,5,13,20,55,51,1,"https://fbref.com/en/players/d9ba39fc/Diego-Rico"
2023,"Real Sociedad","La Liga","Umar Sadiq","NGA","FW","25",1997,0.9,1,1,0,0,1,0,1,0,1,2,0,2,0,1,0,0,"https://fbref.com/en/players/686cbe7d/Umar-Sadiq"
2023,"Real Sociedad","La Liga","David Silva","ESP","MF","36",1986,21.5,36,21,11,18,7,11,19,57.9,8,17,2,15,15,51,16,0,"https://fbref.com/en/players/e2716bd0/David-Silva"
2023,"Real Sociedad","La Liga","Alex Sola","ESP","DF","23",1999,3.9,18,9,14,3,1,7,10,70,3,7,2,5,7,25,10,0,"https://fbref.com/en/players/5fa714d5/Alex-Sola"
2023,"Real Sociedad","La Liga","Alexander Sørloth","NOR","FW","26",1995,26.5,18,9,3,6,9,7,14,50,7,15,1,14,2,20,26,1,"https://fbref.com/en/players/e92cd3f7/Alexander-Sorloth"
2023,"Real Sociedad","La Liga","Beñat Turrientes","ESP","MF,FW","20",2002,1.2,3,3,3,0,0,1,5,20,4,2,0,2,0,3,3,0,"https://fbref.com/en/players/068f4dec/Benat-Turrientes"
2023,"Real Sociedad","La Liga","Igor Zubeldia","ESP","DF","25",1997,28.2,35,18,28,7,0,25,35,71.4,10,23,17,6,21,56,93,0,"https://fbref.com/en/players/5c7845f6/Igor-Zubeldia"
2023,"Real Sociedad","La Liga","Martín Zubimendi","ESP","MF","23",1999,34.5,59,33,23,30,6,24,45,53.3,21,44,17,27,37,96,55,4,"https://fbref.com/en/players/3ee0dd59/Martin-Zubimendi"
2023,"Reims","Ligue 1","Yunis Abdelhamid","MAR","DF","34",1987,37,82,50,47,33,2,39,52,75,13,65,27,38,64,146,116,1,"https://fbref.com/en/players/32c2d95f/Yunis-Abdelhamid"
2023,"Reims","Ligue 1","Martin Adeline","FRA","MF,FW","18",2003,1.2,3,3,2,1,0,3,4,75,1,3,1,2,3,6,3,0,"https://fbref.com/en/players/7587446d/Martin-Adeline"
2023,"Reims","Ligue 1","Emmanuel Agbadou","CIV","DF","25",1997,26.5,71,49,53,16,2,42,65,64.6,23,30,14,16,32,103,107,3,"https://fbref.com/en/players/75f1ed80/Emmanuel-Agbadou"
2023,"Reims","Ligue 1","Valentin Atangana Edoa","FRA","MF","16",2005,1.9,8,3,4,2,2,3,6,50,3,2,1,1,0,8,1,0,"https://fbref.com/en/players/6b5edd5d/Valentin-Atangana-Edoa"
2023,"Reims","Ligue 1","Folarin Balogun","USA","FW","21",2001,33.3,9,5,1,5,3,2,20,10,18,20,1,19,3,12,15,0,"https://fbref.com/en/players/31822f8c/Folarin-Balogun"
2023,"Reims","Ligue 1","Mitchell van Bergen","NED","FW,DF","22",1999,10.1,18,8,6,7,5,8,20,40,12,8,2,6,6,24,11,0,"https://fbref.com/en/players/0b2c9aec/Mitchell-van-Bergen"
2023,"Reims","Ligue 1","El Bilal Touré","MLI","FW","20",2001,1,0,0,0,0,0,0,0,NA,0,2,0,2,0,0,1,0,"https://fbref.com/en/players/47c609d5/El-Bilal-Toure"
2023,"Reims","Ligue 1","Maxime Busi","BEL","DF","22",1999,11.6,21,16,9,11,1,13,29,44.8,16,14,6,8,14,35,24,0,"https://fbref.com/en/players/7b082ec2/Maxime-Busi"
2023,"Reims","Ligue 1","Jens Cajuste","SWE","MF","22",1999,17,46,25,25,14,7,25,48,52.1,23,30,6,24,18,64,22,0,"https://fbref.com/en/players/928a4a61/Jens-Cajuste"
2023,"Reims","Ligue 1","Thibault De Smet","BEL","DF","24",1998,19.5,24,17,10,14,0,11,37,29.7,26,28,5,23,20,44,40,1,"https://fbref.com/en/players/5fdcb075/Thibault-De-Smet"
2023,"Reims","Ligue 1","Mamadou Diakhon","FRA","FW","16",2005,0.2,2,0,2,0,0,0,1,0,1,1,0,1,1,3,0,0,"https://fbref.com/en/players/331c5a98/Mamadou-Diakhon"
2023,"Reims","Ligue 1","Ibrahim Diakité","GUI","DF","18",2003,1.5,3,3,3,0,0,2,3,66.7,1,0,0,0,5,8,6,0,"https://fbref.com/en/players/d8c19a60/Ibrahim-Diakite"
2023,"Reims","Ligue 1","Yehvann Diouf","FRA","GK","22",1999,31,2,0,2,0,0,1,3,33.3,2,0,0,0,1,3,13,5,"https://fbref.com/en/players/eedea60b/Yehvann-Diouf"
2023,"Reims","Ligue 1","Kamory Doumbia","MLI","MF","19",2003,12.8,31,16,9,14,8,12,37,32.4,25,17,1,16,13,44,3,0,"https://fbref.com/en/players/9226aa22/Kamory-Doumbia"
2023,"Reims","Ligue 1","Wout Faes","BEL","DF","24",1998,3,1,1,1,0,0,1,2,50,1,6,3,3,7,8,19,0,"https://fbref.com/en/players/9c221d14/Wout-Faes"
2023,"Reims","Ligue 1","Fallou Fall","SEN","DF","18",2004,0.4,0,0,0,0,0,0,1,0,1,3,3,0,0,0,4,0,"https://fbref.com/en/players/2c8a91b9/Fallou-Fall"
2023,"Reims","Ligue 1","Alexis Flips","FRA","FW,MF","22",2000,22,51,30,18,17,16,27,64,42.2,37,35,5,30,24,75,12,0,"https://fbref.com/en/players/caef7840/Alexis-Flips"
2023,"Reims","Ligue 1","Thomas Foket","BEL","DF","27",1994,22,35,22,18,11,6,17,46,37,29,21,7,14,33,68,29,2,"https://fbref.com/en/players/90eb507d/Thomas-Foket"
2023,"Reims","Ligue 1","Andrew Gravillon","GLP","DF","24",1998,11.5,16,8,9,6,1,8,13,61.5,5,18,9,9,21,37,36,0,"https://fbref.com/en/players/49136c42/Andrew-Gravillon"
2023,"Reims","Ligue 1","Rafik Guitane","FRA","FW","23",1999,0,0,0,0,0,0,0,0,NA,0,0,0,0,0,0,1,0,"https://fbref.com/en/players/7091324a/Rafik-Guitane"
2023,"Reims","Ligue 1","Noah Holm","NOR","FW,MF","21",2001,2.2,6,4,2,2,2,2,5,40,3,0,0,0,0,6,5,0,"https://fbref.com/en/players/61b77d0a/Noah-Holm"
2023,"Reims","Ligue 1","Junya Ito","JPN","FW","29",1993,32.4,40,20,14,15,11,13,53,24.5,40,29,1,28,8,48,4,1,"https://fbref.com/en/players/dbd3a428/Junya-Ito"
2023,"Reims","Ligue 1","Check Keita","FRA","DF","19",2003,7.6,12,9,9,3,0,4,9,44.4,5,6,5,1,5,17,24,1,"https://fbref.com/en/players/c9f2f83a/Check-Keita"
2023,"Reims","Ligue 1","Samuel Koeberlé","FRA","MF","17",2004,0,0,0,0,0,0,0,0,NA,0,0,0,0,0,0,0,0,"https://fbref.com/en/players/6751b938/Samuel-Koeberle"
2023,"Reims","Ligue 1","Bradley Locko","FRA","DF","20",2002,11.8,31,16,21,4,6,15,27,55.6,12,17,4,13,20,51,21,0,"https://fbref.com/en/players/40221fa7/Bradley-Locko"
2023,"Reims","Ligue 1","Dion Lopy","SEN","MF","20",2002,15.3,45,24,22,16,7,23,62,37.1,39,27,3,24,22,67,18,0,"https://fbref.com/en/players/64c14d49/Dion-Lopy"
2023,"Reims","Ligue 1","Myziane Maolida","FRA","MF,FW","23",1999,2.6,8,3,2,5,1,5,12,41.7,7,1,0,1,2,10,0,0,"https://fbref.com/en/players/706a60e1/Myziane-Maolida"
2023,"Reims","Ligue 1","Azor Matusiwa","NED","MF","24",1998,27.6,66,41,30,29,7,36,61,59,25,37,11,26,46,112,52,0,"https://fbref.com/en/players/a17a94d6/Azor-Matusiwa"
2023,"Reims","Ligue 1","Nathanael Mbuku","FRA","FW,MF","20",2002,0.7,2,1,2,0,0,2,2,100,0,0,0,0,0,2,0,0,"https://fbref.com/en/players/46750e9c/Nathanael-Mbuku"
2023,"Reims","Ligue 1","Marshall Munetsi","ZIM","MF","26",1996,30,58,27,13,31,14,20,48,41.7,28,37,11,26,26,84,41,1,"https://fbref.com/en/players/2acf0cd7/Marshall-Munetsi"
2023,"Reims","Ligue 1","Patrick Pentz","AUT","GK","25",1997,7,0,0,0,0,0,0,0,NA,0,0,0,0,0,0,1,0,"https://fbref.com/en/players/0810b6df/Patrick-Pentz"
2023,"Reims","Ligue 1","Kaj Sierhuis","NED","FW,MF","24",1998,2.4,3,3,1,0,2,0,5,0,5,3,1,2,1,4,2,0,"https://fbref.com/en/players/9c2b1f11/Kaj-Sierhuis"
2023,"Reims","Ligue 1","Mohamed Toure","AUS","FW,MF","18",2004,0.3,0,0,0,0,0,0,0,NA,0,0,0,0,0,0,0,0,"https://fbref.com/en/players/8ac64b4e/Mohamed-Toure"
2023,"Reims","Ligue 1","Arber Zeneli","KVX","FW,MF","27",1995,11.1,9,3,3,3,3,5,12,41.7,7,8,0,8,2,11,2,0,"https://fbref.com/en/players/095e4199/Arber-Zeneli"
2023,"Rennes","Ligue 1","Matthis Abline","FRA","FW,MF","19",2003,1.2,1,1,0,0,1,1,1,100,0,1,0,1,2,3,1,0,"https://fbref.com/en/players/0e46fa2f/Matthis-Abline"
2023,"Rennes","Ligue 1","Doğan Alemdar","TUR","GK","19",2002,4.5,0,0,0,0,0,0,0,NA,0,0,0,0,0,0,1,1,"https://fbref.com/en/players/9e17ccff/Dogan-Alemdar"
2023,"Rennes","Ligue 1","Lorenz Assignon","TOG","DF","22",2000,2.9,6,2,4,2,0,2,4,50,2,6,0,6,2,8,9,0,"https://fbref.com/en/players/b026bbf6/Lorenz-Assignon"
2023,"Rennes","Ligue 1","Loïc Bade","FRA","DF","22",2000,1,1,1,1,0,0,0,0,NA,0,0,0,0,1,2,3,0,"https://fbref.com/en/players/114bbdee/Loic-Bade"
2023,"Rennes","Ligue 1","Jeanöel Belocian","FRA","DF","17",2005,5.6,10,7,3,5,2,5,9,55.6,4,6,3,3,6,16,11,0,"https://fbref.com/en/players/c678ddd7/Jeanoel-Belocian"
2023,"Rennes","Ligue 1","Benjamin Bourigeaud","FRA","MF,FW","28",1994,34.1,45,29,16,23,6,21,65,32.3,44,38,3,35,31,76,32,0,"https://fbref.com/en/players/20e73fac/Benjamin-Bourigeaud"
2023,"Rennes","Ligue 1","Alan Do Marcolino","GAB","FW","20",2002,0.2,0,0,0,0,0,0,0,NA,0,0,0,0,0,0,1,0,"https://fbref.com/en/players/1bd5bdc4/Alan-Do-Marcolino"
2023,"Rennes","Ligue 1","Jeremy Doku","BEL","MF,FW","20",2002,14.3,25,16,6,13,6,12,24,50,12,10,0,10,5,30,2,0,"https://fbref.com/en/players/fffea3e5/Jeremy-Doku"
2023,"Rennes","Ligue 1","Désiré Doué","FRA","MF,FW","17",2005,12.4,37,18,10,23,4,13,32,40.6,19,17,1,16,13,50,3,0,"https://fbref.com/en/players/9e7483ff/Desire-Doue"
2023,"Rennes","Ligue 1","Guela Doué","FRA","FW,MF","19",2002,0.1,0,0,0,0,0,0,0,NA,0,0,0,0,0,0,0,0,"https://fbref.com/en/players/b4ef3fb5/Guela-Doue"
2023,"Rennes","Ligue 1","Amine Gouiri","FRA","FW,MF","22",2000,28,42,25,14,16,12,14,33,42.4,19,21,0,21,12,54,10,0,"https://fbref.com/en/players/aad56ca3/Amine-Gouiri"
2023,"Rennes","Ligue 1","Serhou Guirassy","GUI","MF","26",1996,0.3,0,0,0,0,0,0,0,NA,0,0,0,0,0,0,0,0,"https://fbref.com/en/players/923f4dda/Serhou-Guirassy"
2023,"Rennes","Ligue 1","Arnaud Kalimuendo","FRA","FW","20",2002,20.5,15,8,3,6,6,5,20,25,15,15,2,13,2,17,9,0,"https://fbref.com/en/players/bf4c41f9/Arnaud-Kalimuendo"
2023,"Rennes","Ligue 1","Gaëtan Laborde","FRA","FW","28",1994,2.8,1,1,1,0,0,0,1,0,1,1,0,1,0,1,1,0,"https://fbref.com/en/players/7cdda3bf/Gaetan-Laborde"
2023,"Rennes","Ligue 1","Lovro Majer","CRO","MF,FW","24",1998,18.5,34,23,16,13,5,8,29,27.6,21,21,1,20,21,55,5,1,"https://fbref.com/en/players/fc46aab1/Lovro-Majer"
2023,"Rennes","Ligue 1","Steve Mandanda","FRA","GK","37",1985,33.5,0,0,0,0,0,0,2,0,2,0,0,0,0,0,9,3,"https://fbref.com/en/players/1d2d5cc8/Steve-Mandanda"
2023,"Rennes","Ligue 1","Birger Meling","NOR","DF","27",1994,13.4,24,15,9,12,3,12,25,48,13,18,2,16,23,47,26,0,"https://fbref.com/en/players/70c52749/Birger-Meling"
2023,"Rennes","Ligue 1","Warmed Omari","FRA","DF","22",2000,15.1,20,11,14,6,0,14,28,50,14,13,7,6,17,37,43,1,"https://fbref.com/en/players/4534a352/Warmed-Omari"
2023,"Rennes","Ligue 1","Joe Rodon","WAL","DF","24",1997,15.7,11,7,9,2,0,4,10,40,6,16,12,4,9,20,54,1,"https://fbref.com/en/players/8d62d31a/Joe-Rodon"
2023,"Rennes","Ligue 1","Ibrahim Salah","MAR","FW,MF","20",2001,2.5,8,1,5,3,0,2,15,13.3,13,3,0,3,2,10,0,0,"https://fbref.com/en/players/cad3fd4d/Ibrahim-Salah"
2023,"Rennes","Ligue 1","Baptiste Santamaria","FRA","MF","27",1995,20.1,41,22,13,23,5,21,41,51.2,20,21,5,16,21,62,23,0,"https://fbref.com/en/players/5e22e2a4/Baptiste-Santamaria"
2023,"Rennes","Ligue 1","Djed Spence","ENG","DF","21",2000,6.4,14,6,8,2,4,11,18,61.1,7,10,3,7,4,18,15,0,"https://fbref.com/en/players/9bc9a519/Djed-Spence"
2023,"Rennes","Ligue 1","Kamaldeen Sulemana","GHA","FW,MF","20",2002,3.6,6,3,1,4,1,1,5,20,4,2,0,2,4,10,2,0,"https://fbref.com/en/players/a62f8bf1/Kamaldeen-Sulemana"
2023,"Rennes","Ligue 1","Flavien Tait","FRA","MF","29",1993,18.7,30,15,8,17,5,19,42,45.2,23,16,4,12,20,50,12,0,"https://fbref.com/en/players/a0f9b535/Flavien-Tait"
2023,"Rennes","Ligue 1","Martin Terrier","FRA","FW,MF","25",1997,14.7,25,11,7,9,9,13,24,54.2,11,15,2,13,14,39,6,0,"https://fbref.com/en/players/5148dcc5/Martin-Terrier"
2023,"Rennes","Ligue 1","Arthur Theate","BEL","DF","22",2000,34.7,29,19,17,8,4,17,30,56.7,13,26,14,12,30,59,114,3,"https://fbref.com/en/players/df8d6029/Arthur-Theate"
2023,"Rennes","Ligue 1","Karl Toko Ekambi","CMR","FW,MF","29",1992,10.8,3,1,1,1,1,3,9,33.3,6,5,0,5,9,12,3,0,"https://fbref.com/en/players/5ceba7fc/Karl-Toko-Ekambi"
2023,"Rennes","Ligue 1","Hamari Traoré","MLI","DF","30",1992,28.1,48,32,26,15,7,28,52,53.8,24,33,7,26,38,86,64,0,"https://fbref.com/en/players/a4b1028a/Hamari-Traore"
2023,"Rennes","Ligue 1","Adrien Truffert","FRA","DF","20",2001,21.7,62,32,36,17,9,31,46,67.4,15,32,8,24,22,84,55,0,"https://fbref.com/en/players/5d0e0a1f/Adrien-Truffert"
2023,"Rennes","Ligue 1","Lesley Ugochukwu","FRA","MF","18",2004,14.8,36,19,13,20,3,16,24,66.7,8,24,10,14,21,57,16,0,"https://fbref.com/en/players/1df4a109/Lesley-Ugochukwu"
2023,"Rennes","Ligue 1","Christopher Wooh","CMR","DF","20",2001,11.2,16,7,8,8,0,9,11,81.8,2,11,5,6,6,22,49,0,"https://fbref.com/en/players/b003239d/Christopher-Wooh"
2023,"Rennes","Ligue 1","Xeka","POR","MF","27",1994,6.1,10,3,6,3,1,7,16,43.8,9,11,2,9,6,16,8,0,"https://fbref.com/en/players/f3600c02/Xeka"
2023,"Roma","Serie A","Tammy Abraham","ENG","FW","24",1997,24.3,17,10,4,8,5,3,16,18.8,13,10,4,6,3,20,14,0,"https://fbref.com/en/players/f586779e/Tammy-Abraham"
2023,"Roma","Serie A","Andrea Belotti","ITA","FW","28",1993,12.7,12,5,3,5,4,5,11,45.5,6,11,1,10,3,15,5,0,"https://fbref.com/en/players/d705ba44/Andrea-Belotti"
2023,"Roma","Serie A","Edoardo Bove","ITA","MF","20",2002,11,35,18,12,15,8,16,39,41,23,15,1,14,10,45,11,0,"https://fbref.com/en/players/ae94a6c5/Edoardo-Bove"
2023,"Roma","Serie A","Mohamed Camara","GUI","MF","25",1997,7.7,13,10,3,7,3,5,15,33.3,10,5,1,4,10,23,8,0,"https://fbref.com/en/players/13ea2544/Mohamed-Camara"
2023,"Roma","Serie A","Zeki Çelik","TUR","DF","25",1997,16.7,42,21,19,21,2,24,41,58.5,17,33,6,27,14,56,36,2,"https://fbref.com/en/players/31a62dc7/Zeki-Celik"
2023,"Roma","Serie A","Bryan Cristante","ITA","MF,DF","27",1995,32.6,113,62,55,49,9,55,90,61.1,35,39,10,29,18,131,53,0,"https://fbref.com/en/players/16657b95/Bryan-Cristante"
2023,"Roma","Serie A","Paulo Dybala","ARG","MF,FW","28",1993,19.3,14,4,1,8,5,8,26,30.8,18,12,1,11,8,22,4,0,"https://fbref.com/en/players/e0921a4f/Paulo-Dybala"
2023,"Roma","Serie A","Roger Ibanez","BRA","DF","23",1998,31.1,67,33,38,26,3,32,48,66.7,16,30,11,19,66,133,95,2,"https://fbref.com/en/players/82efe6fa/Roger-Ibanez"
2023,"Roma","Serie A","Rick Karsdorp","NED","DF","27",1995,7.9,21,13,11,7,3,13,22,59.1,9,0,0,0,7,28,15,1,"https://fbref.com/en/players/9f84febe/Rick-Karsdorp"
2023,"Roma","Serie A","Marash Kumbulla","ALB","DF","22",2000,2.9,4,4,2,2,0,2,3,66.7,1,2,1,1,4,8,6,0,"https://fbref.com/en/players/a40819d9/Marash-Kumbulla"
2023,"Roma","Serie A","Diego Llorente","ESP","DF","28",1993,6.4,10,5,6,4,0,5,12,41.7,7,4,2,2,11,21,20,0,"https://fbref.com/en/players/bba30585/Diego-Llorente"
2023,"Roma","Serie A","Jordan Majchrzak","POL","FW","17",2004,0.2,0,0,0,0,0,0,0,NA,0,0,0,0,0,0,0,0,"https://fbref.com/en/players/2e7dafe5/Jordan-Majchrzak"
2023,"Roma","Serie A","Gianluca Mancini","ITA","DF","26",1996,31.8,37,19,27,9,1,18,34,52.9,16,38,17,21,46,83,67,0,"https://fbref.com/en/players/5aa53281/Gianluca-Mancini"
2023,"Roma","Serie A","Nemanja Matić","SRB","MF","33",1988,20.6,47,27,24,19,4,19,33,57.6,14,27,7,20,25,72,21,1,"https://fbref.com/en/players/eb7822d7/Nemanja-Matic"
2023,"Roma","Serie A","Filippo Missori","ITA","DF","18",2004,2,4,3,3,0,1,3,6,50,3,0,0,0,3,7,5,0,"https://fbref.com/en/players/2d3d7c0d/Filippo-Missori"
2023,"Roma","Serie A","Rui Patrício","POR","GK","34",1988,35,1,1,1,0,0,1,1,100,0,0,0,0,2,3,6,3,"https://fbref.com/en/players/79b0d6a0/Rui-Patricio"
2023,"Roma","Serie A","Lorenzo Pellegrini","ITA","MF","26",1996,28.3,52,29,24,24,4,22,48,45.8,26,27,4,23,26,78,22,0,"https://fbref.com/en/players/4a5a45c7/Lorenzo-Pellegrini"
2023,"Roma","Serie A","Niccolò Pisilli","ITA","MF","17",2004,0,0,0,0,0,0,0,0,NA,0,0,0,0,0,0,0,0,"https://fbref.com/en/players/c84dcc88/Niccolo-Pisilli"
2023,"Roma","Serie A","Stephan El Shaarawy","ITA","DF,MF","29",1992,16.9,21,9,8,10,3,6,22,27.3,16,11,1,10,15,36,11,0,"https://fbref.com/en/players/d3aaad90/Stephan-El-Shaarawy"
2023,"Roma","Serie A","Eldor Shomurodov","UZB","FW","27",1995,1.3,1,0,1,0,0,0,2,0,2,1,0,1,1,2,0,0,"https://fbref.com/en/players/57469b2d/Eldor-Shomurodov"
2023,"Roma","Serie A","Chris Smalling","ENG","DF","32",1989,31.2,26,15,16,10,0,13,21,61.9,8,51,36,15,43,69,123,0,"https://fbref.com/en/players/b6964eb6/Chris-Smalling"
2023,"Roma","Serie A","Ola Solbakken","NOR","MF,FW","23",1998,5.6,2,2,1,1,0,2,7,28.6,5,2,0,2,2,4,8,0,"https://fbref.com/en/players/78f13530/Ola-Solbakken"
2023,"Roma","Serie A","Leonardo Spinazzola","ITA","DF","29",1993,18.4,15,8,7,6,2,8,23,34.8,15,13,3,10,9,24,25,0,"https://fbref.com/en/players/3626daea/Leonardo-Spinazzola"
2023,"Roma","Serie A","Mile Svilar","SRB","GK","22",1999,3,0,0,0,0,0,0,0,NA,0,0,0,0,0,0,1,0,"https://fbref.com/en/players/bcf5058a/Mile-Svilar"
2023,"Roma","Serie A","Benjamin Tahirovic","BIH","MF","19",2003,3.9,8,5,5,2,1,4,12,33.3,8,9,4,5,3,11,3,0,"https://fbref.com/en/players/eb3022c3/Benjamin-Tahirovic"
2023,"Roma","Serie A","Matías Viña","URU","DF","24",1997,0.6,3,1,1,1,1,1,3,33.3,2,5,1,4,2,5,5,0,"https://fbref.com/en/players/08eb3b58/Matias-Vina"
2023,"Roma","Serie A","Cristian Volpato","ITA","MF","18",2003,2.5,3,2,1,1,1,0,2,0,2,2,0,2,2,5,0,0,"https://fbref.com/en/players/72f87f25/Cristian-Volpato"
2023,"Roma","Serie A","Georginio Wijnaldum","NED","MF","31",1990,8.5,4,3,1,3,0,0,2,0,2,7,1,6,2,6,3,0,"https://fbref.com/en/players/eb58eef0/Georginio-Wijnaldum"
2023,"Roma","Serie A","Nicola Zalewski","POL","DF","20",2002,24.4,45,26,25,15,5,22,71,31,49,27,1,26,31,76,23,0,"https://fbref.com/en/players/45191c29/Nicola-Zalewski"
2023,"Roma","Serie A","Nicolò Zaniolo","ITA","MF,FW","23",1999,9.9,7,5,2,4,1,2,7,28.6,5,11,0,11,2,9,0,0,"https://fbref.com/en/players/9907b1c8/Nicolo-Zaniolo"
2023,"Salernitana","Serie A","Emil Bohinen","NOR","MF","23",1999,9.2,25,13,15,8,2,12,23,52.2,11,25,7,18,17,42,21,0,"https://fbref.com/en/players/c83c203f/Emil-Bohinen"
2023,"Salernitana","Serie A","Federico Bonazzoli","ITA","FW,MF","25",1997,12.4,5,3,0,3,2,0,9,0,9,9,1,8,3,8,0,0,"https://fbref.com/en/players/bf57eaab/Federico-Bonazzoli"
2023,"Salernitana","Serie A","Erik Botheim","NOR","MF,FW","22",2000,9.6,11,7,3,4,4,6,13,46.2,7,3,0,3,0,11,4,0,"https://fbref.com/en/players/3d13d9e4/Erik-Botheim"
2023,"Salernitana","Serie A","Domagoj Bradarić","CRO","DF","22",1999,25,26,19,14,8,4,7,16,43.8,9,20,5,15,21,47,44,0,"https://fbref.com/en/players/8bbe2df5/Domagoj-Bradaric"
2023,"Salernitana","Serie A","Dylan Bronn","TUN","DF","27",1995,18.7,34,18,17,16,1,20,30,66.7,10,32,20,12,20,54,58,1,"https://fbref.com/en/players/edd81e2a/Dylan-Bronn"
2023,"Salernitana","Serie A","Antonio Candreva","ITA","MF,DF","35",1987,30.3,17,7,13,2,2,11,38,28.9,27,7,3,4,17,34,32,0,"https://fbref.com/en/players/356c9002/Antonio-Candreva"
2023,"Salernitana","Serie A","Lassana Coulibaly","MLI","MF","26",1996,32.1,84,50,42,35,7,30,73,41.1,43,35,7,28,25,109,33,2,"https://fbref.com/en/players/85a44ecc/Lassana-Coulibaly"
2023,"Salernitana","Serie A","Domen Črnigoj","SVN","MF","26",1995,3.3,8,3,0,7,1,1,2,50,1,9,1,8,9,17,6,0,"https://fbref.com/en/players/22cd43d2/Domen-Crnigoj"
2023,"Salernitana","Serie A","Flavius Daniliuc","AUT","DF","21",2001,24.4,57,29,37,17,3,26,47,55.3,21,30,13,17,29,86,76,0,"https://fbref.com/en/players/7ef972c3/Flavius-Daniliuc"
2023,"Salernitana","Serie A","Boulaye Dia","SEN","FW,MF","25",1996,28,12,5,3,6,3,2,7,28.6,5,10,0,10,7,19,27,1,"https://fbref.com/en/players/244bc2c8/Boulaye-Dia"
2023,"Salernitana","Serie A","Federico Fazio","ARG","DF","35",1987,11.9,15,12,8,7,0,4,11,36.4,7,9,4,5,28,43,61,0,"https://fbref.com/en/players/4e358a2d/Federico-Fazio"
2023,"Salernitana","Serie A","Vincenzo Fiorillo","ITA","GK","32",1990,1,0,0,0,0,0,0,0,NA,0,0,0,0,0,0,0,0,"https://fbref.com/en/players/a2565f79/Vincenzo-Fiorillo"
2023,"Salernitana","Serie A","Norbert Gyömbér","SVK","DF","30",1992,19.3,32,23,25,6,1,16,24,66.7,8,33,22,11,35,67,92,0,"https://fbref.com/en/players/0be276c6/Norbert-Gyomber"
2023,"Salernitana","Serie A","Antonio Iervolino","ITA","MF","19",2003,0.1,0,0,0,0,0,0,1,0,1,0,0,0,0,0,0,0,"https://fbref.com/en/players/daa4c94c/Antonio-Iervolino"
2023,"Salernitana","Serie A","Grigoris Kastanos","CYP","MF,DF","24",1998,14.3,39,23,18,19,2,16,40,40,24,20,6,14,8,47,8,0,"https://fbref.com/en/players/2a82aa85/Grigoris-Kastanos"
2023,"Salernitana","Serie A","Julian Kristoffersen","NOR","FW","25",1997,0.2,0,0,0,0,0,0,0,NA,0,1,0,1,0,0,0,0,"https://fbref.com/en/players/b804c280/Julian-Kristoffersen"
2023,"Salernitana","Serie A","Matteo Lovato","ITA","DF","22",2000,9,17,14,14,3,0,10,25,40,15,8,5,3,13,30,33,2,"https://fbref.com/en/players/5fa57166/Matteo-Lovato"
2023,"Salernitana","Serie A","Giulio Maggiore","ITA","MF","24",1998,9.9,20,8,11,6,3,10,21,47.6,11,19,4,15,8,28,10,0,"https://fbref.com/en/players/957e4c87/Giulio-Maggiore"
2023,"Salernitana","Serie A","Pasquale Mazzocchi","ITA","DF","27",1995,21.8,32,18,21,5,6,17,37,45.9,20,10,2,8,10,42,37,2,"https://fbref.com/en/players/eb0ec070/Pasquale-Mazzocchi"
2023,"Salernitana","Serie A","Hans Nicolussi Caviglia","ITA","MF","22",2000,6.5,15,6,5,8,2,9,15,60,6,9,0,9,7,22,7,1,"https://fbref.com/en/players/b136c945/Hans-Nicolussi-Caviglia"
2023,"Salernitana","Serie A","Guillermo Ochoa","MEX","GK","37",1985,20,0,0,0,0,0,0,2,0,2,0,0,0,0,0,9,1,"https://fbref.com/en/players/1e9bde92/Guillermo-Ochoa"
2023,"Salernitana","Serie A","Krzysztof Piątek","POL","FW","27",1995,23.8,18,11,3,9,6,5,21,23.8,16,17,4,13,2,20,39,0,"https://fbref.com/en/players/17f3620a/Krzysztof-Piatek"
2023,"Salernitana","Serie A","Lorenzo Pirola","ITA","DF","20",2002,21.6,33,29,18,14,1,19,27,70.4,8,50,35,15,30,63,85,1,"https://fbref.com/en/players/caec77da/Lorenzo-Pirola"
2023,"Salernitana","Serie A","Ivan Radovanović","SRB","MF,DF","33",1988,7.5,12,4,8,4,0,4,10,40,6,9,3,6,7,19,9,1,"https://fbref.com/en/players/023937a9/Ivan-Radovanovic"
2023,"Salernitana","Serie A","Franck Ribéry","FRA","MF","39",1983,0.4,0,0,0,0,0,0,0,NA,0,1,0,1,0,0,0,0,"https://fbref.com/en/players/f61c7c4e/Franck-Ribery"
2023,"Salernitana","Serie A","Junior Sambia","FRA","DF","25",1996,7.7,12,5,7,4,1,6,10,60,4,9,3,6,8,20,16,1,"https://fbref.com/en/players/24eb7ed6/Junior-Sambia"
2023,"Salernitana","Serie A","Luigi Sepe","ITA","GK","31",1991,17,0,0,0,0,0,0,1,0,1,0,0,0,0,0,0,0,"https://fbref.com/en/players/343f753a/Luigi-Sepe"
2023,"Salernitana","Serie A","William Troost-Ekong","NGA","DF","28",1993,4.9,11,3,7,4,0,6,7,85.7,1,7,4,3,6,17,10,0,"https://fbref.com/en/players/7ed4921e/William-Troost-Ekong"
2023,"Salernitana","Serie A","Diego Valencia","CHI","MF,FW","22",2000,2.6,8,5,4,2,2,2,9,22.2,7,10,1,9,1,9,2,0,"https://fbref.com/en/players/71005acd/Diego-Valencia"
2023,"Salernitana","Serie A","Tonny Vilhena","NED","MF","27",1995,25.2,44,22,16,23,5,20,50,40,30,17,7,10,18,62,21,0,"https://fbref.com/en/players/c7069d87/Tonny-Vilhena"
2023,"Sampdoria","Serie A","Bruno Amione","ARG","DF","20",2002,23.2,50,33,36,14,0,19,43,44.2,24,26,11,15,25,75,62,1,"https://fbref.com/en/players/2df7cc43/Bruno-Amione"
2023,"Sampdoria","Serie A","Emil Audero","ITA","GK","25",1997,25,0,0,0,0,0,0,2,0,2,0,0,0,0,0,7,1,"https://fbref.com/en/players/649b01d8/Emil-Audero"
2023,"Sampdoria","Serie A","Tommaso Augello","ITA","DF","27",1994,34,17,14,13,2,2,9,20,45,11,23,7,16,17,34,61,1,"https://fbref.com/en/players/3cd3b384/Tommaso-Augello"
2023,"Sampdoria","Serie A","Bartosz Bereszyński","POL","DF","30",1992,13.3,28,18,15,11,2,17,26,65.4,9,18,4,14,21,49,25,0,"https://fbref.com/en/players/61b3978f/Bartosz-Bereszynski"
2023,"Sampdoria","Serie A","Francesco Caputo","ITA","FW","34",1987,12.2,3,1,0,0,3,0,3,0,3,0,0,0,1,4,3,0,"https://fbref.com/en/players/5bd72174/Francesco-Caputo"
2023,"Sampdoria","Serie A","Omar Colley","GAM","DF","29",1992,15.4,17,10,10,7,0,9,12,75,3,9,5,4,22,39,69,1,"https://fbref.com/en/players/8b95acda/Omar-Colley"
2023,"Sampdoria","Serie A","Andrea Conti","ITA","DF","28",1994,0.3,0,0,0,0,0,0,0,NA,0,0,0,0,0,0,0,0,"https://fbref.com/en/players/8fef5412/Andrea-Conti"
2023,"Sampdoria","Serie A","Mickaël Cuisance","FRA","MF","22",1999,6.9,13,10,7,5,1,5,23,21.7,18,10,0,10,5,18,4,0,"https://fbref.com/en/players/5722eced/Mickael-Cuisance"
2023,"Sampdoria","Serie A","Manuel De Luca","ITA","FW,MF","24",1998,0.5,0,0,0,0,0,0,0,NA,0,0,0,0,0,0,0,0,"https://fbref.com/en/players/60e3603d/Manuel-De-Luca"
2023,"Sampdoria","Serie A","Fabio Depaoli","ITA","DF,MF","25",1997,1.5,5,3,2,3,0,3,4,75,1,1,0,1,1,6,4,0,"https://fbref.com/en/players/d97f2e8d/Fabio-Depaoli"
2023,"Sampdoria","Serie A","Alex Ferrari","ITA","DF","28",1994,9.6,9,5,7,2,0,4,8,50,4,21,10,11,19,28,25,0,"https://fbref.com/en/players/d0dbca9f/Alex-Ferrari"
2023,"Sampdoria","Serie A","Manolo Gabbiadini","ITA","FW,MF","30",1991,26.2,23,15,8,9,6,9,23,39.1,14,16,2,14,6,29,25,0,"https://fbref.com/en/players/8f866fe8/Manolo-Gabbiadini"
2023,"Sampdoria","Serie A","Koray Günter","GER","DF","27",1994,8.6,10,8,6,4,0,6,9,66.7,3,10,5,5,11,21,46,0,"https://fbref.com/en/players/f1f1f238/Koray-Gunter"
2023,"Sampdoria","Serie A","Emirhan İlkhan","TUR","MF","18",2004,1.3,6,3,2,2,2,2,3,66.7,1,5,1,4,0,6,3,0,"https://fbref.com/en/players/a47c6309/Emirhan-Ilkhan"
2023,"Sampdoria","Serie A","Mihailo Ivanović","SRB","FW","17",2004,0,0,0,0,0,0,0,0,NA,0,0,0,0,0,0,0,0,"https://fbref.com/en/players/71c620d7/Mihailo-Ivanovic"
2023,"Sampdoria","Serie A","Jesé","ESP","FW","29",1993,2.3,2,0,0,2,0,0,1,0,1,3,1,2,1,3,2,0,"https://fbref.com/en/players/4a537185/Jese"
2023,"Sampdoria","Serie A","Sam Lammers","NED","FW","25",1997,12.2,12,5,2,7,3,6,15,40,9,10,3,7,6,18,11,0,"https://fbref.com/en/players/c283ddef/Sam-Lammers"
2023,"Sampdoria","Serie A","Mehdi Léris","ALG","MF,DF","24",1998,27.3,63,46,30,24,9,23,55,41.8,32,38,6,32,27,90,34,0,"https://fbref.com/en/players/7d3cbc67/Mehdi-Leris"
2023,"Sampdoria","Serie A","Lorenzo Malagrida","ITA","MF,DF","18",2003,1.2,1,0,0,0,1,1,3,33.3,2,1,0,1,0,1,1,0,"https://fbref.com/en/players/2bffcbf2/Lorenzo-Malagrida"
2023,"Sampdoria","Serie A","Daniele Montevago","ITA","FW","19",2003,2.6,1,0,0,0,1,0,1,0,1,2,1,1,0,1,1,0,"https://fbref.com/en/players/ca73910d/Daniele-Montevago"
2023,"Sampdoria","Serie A","Jeison Murillo","COL","DF","30",1992,11.7,22,11,16,6,0,17,26,65.4,9,22,14,8,8,30,39,0,"https://fbref.com/en/players/b233e8e4/Jeison-Murillo"
2023,"Sampdoria","Serie A","Nicola Murru","ITA","DF","27",1994,8.7,24,14,15,8,1,7,13,53.8,6,17,7,10,10,34,21,0,"https://fbref.com/en/players/d183e9d6/Nicola-Murru"
2023,"Sampdoria","Serie A","Samuel Ntanda","BEL","MF","17",2005,0,0,0,0,0,0,0,0,NA,0,0,0,0,0,0,0,0,"https://fbref.com/en/players/48329ff8/Samuel-Ntanda"
2023,"Sampdoria","Serie A","Bram Nuytinck","NED","DF","32",1990,16.6,54,38,33,21,0,23,34,67.6,11,36,21,15,23,77,84,0,"https://fbref.com/en/players/e33f36d5/Bram-Nuytinck"
2023,"Sampdoria","Serie A","Marios Oikonomou","GRE","DF","29",1992,2.4,3,2,3,0,0,1,3,33.3,2,5,4,1,4,7,13,0,"https://fbref.com/en/players/3b9858f5/Marios-Oikonomou"
2023,"Sampdoria","Serie A","Flavio Paoletti","ITA","MF","19",2003,3.2,2,2,0,2,0,1,5,20,4,1,0,1,5,7,9,0,"https://fbref.com/en/players/3d6cee81/Flavio-Paoletti"
2023,"Sampdoria","Serie A","Ignacio Pussetto","ARG","MF,DF","26",1995,1.7,6,3,2,3,1,3,4,75,1,4,0,4,0,6,3,0,"https://fbref.com/en/players/62437b4f/Ignacio-Pussetto"
2023,"Sampdoria","Serie A","Fabio Quagliarella","ITA","FW","39",1983,8.9,2,1,1,1,0,1,7,14.3,6,5,1,4,0,2,9,0,"https://fbref.com/en/players/ee4f2f3b/Fabio-Quagliarella"
2023,"Sampdoria","Serie A","Nicola Ravaglia","ITA","GK","33",1988,9,0,0,0,0,0,0,1,0,1,0,0,0,0,0,7,0,"https://fbref.com/en/players/d7a35008/Nicola-Ravaglia"
2023,"Sampdoria","Serie A","Tomás Rincón","VEN","MF","34",1988,28.4,56,27,22,26,8,29,61,47.5,32,37,7,30,30,86,18,0,"https://fbref.com/en/players/f1cfc209/Tomas-Rincon"
2023,"Sampdoria","Serie A","Abdelhamid Sabiri","MAR","MF,FW","25",1996,11.9,18,7,5,9,4,4,13,30.8,9,18,4,14,2,20,5,0,"https://fbref.com/en/players/4830e0af/Abdelhamid-Sabiri"
2023,"Sampdoria","Serie A","Telasco Segovia","VEN","MF","19",2003,0,0,0,0,0,0,0,0,NA,0,0,0,0,0,0,0,0,"https://fbref.com/en/players/9142b22f/Telasco-Segovia"
2023,"Sampdoria","Serie A","Martin Turk","SVN","GK","18",2003,4,0,0,0,0,0,0,0,NA,0,0,0,0,0,0,1,0,"https://fbref.com/en/players/14ae023f/Martin-Turk"
2023,"Sampdoria","Serie A","Valerio Verre","ITA","MF","28",1994,7.5,14,7,6,5,3,8,17,47.1,9,9,1,8,9,23,3,0,"https://fbref.com/en/players/33ecf462/Valerio-Verre"
2023,"Sampdoria","Serie A","Ronaldo Vieira","GNB","MF","24",1998,9.1,NA,10,NA,NA,NA,NA,NA,NA,NA,NA,NA,NA,13,NA,NA,NA,"https://fbref.com/en/players/75e60d75/Ronaldo-Vieira"
2023,"Sampdoria","Serie A","Gonzalo Villar","ESP","MF","24",1998,7.7,13,7,4,8,1,7,15,46.7,8,11,3,8,4,17,9,1,"https://fbref.com/en/players/bdc74a8f/Gonzalo-Villar"
2023,"Sampdoria","Serie A","Harry Winks","ENG","MF","26",1996,19.1,27,12,7,18,2,14,43,32.6,29,14,8,6,24,51,24,0,"https://fbref.com/en/players/2f7acede/Harry-Winks"
2023,"Sampdoria","Serie A","Gerard Yepes","ESP","MF","19",2002,2.2,5,3,2,3,0,1,3,33.3,2,3,0,3,4,9,3,0,"https://fbref.com/en/players/ee9040b4/Gerard-Yepes"
2023,"Sampdoria","Serie A","Alessandro Zanoli","ITA","DF","21",2000,17.1,22,14,14,6,2,8,17,47.1,9,19,15,4,12,34,39,0,"https://fbref.com/en/players/3b12b11f/Alessandro-Zanoli"
2023,"Sampdoria","Serie A","Filip Đuričić","SRB","MF,FW","30",1992,24.1,43,22,18,20,5,14,32,43.8,18,19,6,13,7,50,8,0,"https://fbref.com/en/players/eccbe56a/Filip-Djuricic"
2023,"Sassuolo","Serie A","Agustín Álvarez Martínez","URU","FW,MF","21",2001,4.1,6,3,0,5,1,1,4,25,3,5,1,4,3,9,3,0,"https://fbref.com/en/players/ab472696/Agustin-Alvarez-Martinez"
2023,"Sassuolo","Serie A","Janis Antiste","FRA","FW","19",2002,0.6,1,0,1,0,0,1,1,100,0,0,0,0,0,1,0,0,"https://fbref.com/en/players/38d9ce53/Janis-Antiste"
2023,"Sassuolo","Serie A","Kaan Ayhan","TUR","DF","27",1994,6.1,10,4,6,4,0,7,7,100,0,5,4,1,5,15,26,1,"https://fbref.com/en/players/2200181e/Kaan-Ayhan"
2023,"Sassuolo","Serie A","Nedim Bajrami","ALB","FW,MF","23",1999,9.1,12,7,6,2,4,5,11,45.5,6,9,1,8,7,19,6,0,"https://fbref.com/en/players/f42d6c13/Nedim-Bajrami"
2023,"Sassuolo","Serie A","Domenico Berardi","ITA","FW","27",1994,20.7,23,14,8,10,5,9,40,22.5,31,13,0,13,19,42,18,0,"https://fbref.com/en/players/53a0e358/Domenico-Berardi"
2023,"Sassuolo","Serie A","Emil Ceide","NOR","FW","20",2001,5.7,5,2,5,0,0,3,5,60,2,3,1,2,1,6,0,0,"https://fbref.com/en/players/98a84572/Emil-Ceide"
2023,"Sassuolo","Serie A","Andrea Consigli","ITA","GK","35",1987,35,1,0,1,0,0,0,1,0,1,0,0,0,0,1,13,3,"https://fbref.com/en/players/8cabdc1e/Andrea-Consigli"
2023,"Sassuolo","Serie A","Luca D'Andrea","ITA","FW","17",2004,3.5,4,0,2,1,1,1,4,25,3,2,0,2,1,5,1,0,"https://fbref.com/en/players/f778fe3f/Luca-DAndrea"
2023,"Sassuolo","Serie A","Grégoire Defrel","MTQ","FW","31",1991,13,9,7,5,2,2,4,13,30.8,9,11,0,11,2,11,5,0,"https://fbref.com/en/players/854ee61a/Gregoire-Defrel"
2023,"Sassuolo","Serie A","Martin Erlic","CRO","DF","24",1998,25.9,27,16,18,8,1,10,23,43.5,13,36,23,13,31,58,120,1,"https://fbref.com/en/players/0fee6bda/Martin-Erlic"
2023,"Sassuolo","Serie A","Davide Frattesi","ITA","MF","22",1999,31.9,63,36,24,29,10,25,44,56.8,19,27,6,21,16,79,42,0,"https://fbref.com/en/players/2a7d27c1/Davide-Frattesi"
2023,"Sassuolo","Serie A","Abdou Harroui","NED","MF","24",1998,7.2,17,6,6,7,4,2,7,28.6,5,6,1,5,2,19,10,0,"https://fbref.com/en/players/65fd099c/Abdou-Harroui"
2023,"Sassuolo","Serie A","Matheus Henrique","BRA","MF","24",1997,21.6,26,12,9,11,6,12,24,50,12,15,4,11,12,38,10,0,"https://fbref.com/en/players/a2d9f138/Matheus-Henrique"
2023,"Sassuolo","Serie A","Hamed Junior Traorè","CIV","MF,FW","22",2000,6.6,11,6,4,6,1,4,11,36.4,7,4,0,4,2,13,0,1,"https://fbref.com/en/players/570bb4b9/Hamed-Junior-Traore"
2023,"Sassuolo","Serie A","Giorgos Kyriakopoulos","GRE","FW,DF","26",1996,8.5,21,8,7,9,5,10,14,71.4,4,7,1,6,11,32,12,1,"https://fbref.com/en/players/0a483542/Giorgos-Kyriakopoulos"
2023,"Sassuolo","Serie A","Armand Lauriente","FRA","FW","23",1998,24.2,21,15,5,7,9,8,21,38.1,13,20,0,20,12,33,8,0,"https://fbref.com/en/players/2d22cea7/Armand-Lauriente"
2023,"Sassuolo","Serie A","Maxime Lopez","FRA","MF","24",1997,25.5,42,18,26,12,4,16,56,28.6,40,24,6,18,22,64,21,0,"https://fbref.com/en/players/20094685/Maxime-Lopez"
2023,"Sassuolo","Serie A","Riccardo Marchizza","ITA","DF","24",1998,3.1,2,2,1,1,0,2,4,50,2,2,0,2,2,4,8,0,"https://fbref.com/en/players/91d0fabf/Riccardo-Marchizza"
2023,"Sassuolo","Serie A","Gian Marco Ferrari","ITA","DF","30",1992,24.7,23,16,11,10,2,10,17,58.8,7,29,20,9,23,46,81,4,"https://fbref.com/en/players/8650af85/Gian-Marco-Ferrari"
2023,"Sassuolo","Serie A","Mert Müldür","TUR","FW,DF","23",1999,0.1,0,0,0,0,0,0,0,NA,0,0,0,0,0,0,0,0,"https://fbref.com/en/players/1295552e/Mert-Muldur"
2023,"Sassuolo","Serie A","Pedro Obiang","EQG","MF","30",1992,9.7,26,17,12,12,2,10,18,55.6,8,12,2,10,8,34,15,0,"https://fbref.com/en/players/ba1e04b3/Pedro-Obiang"
2023,"Sassuolo","Serie A","Gianluca Pegolo","ITA","GK","41",1981,2,0,0,0,0,0,0,1,0,1,0,0,0,0,0,1,0,"https://fbref.com/en/players/f058ed1f/Gianluca-Pegolo"
2023,"Sassuolo","Serie A","Andrea Pinamonti","ITA","FW","23",1999,24,10,7,0,5,5,3,7,42.9,4,19,2,17,2,12,11,0,"https://fbref.com/en/players/08aa9cd1/Andrea-Pinamonti"
2023,"Sassuolo","Serie A","Giacomo Raspadori","ITA","FW","22",2000,0.5,0,0,0,0,0,0,0,NA,0,0,0,0,0,0,0,0,"https://fbref.com/en/players/6e058f06/Giacomo-Raspadori"
2023,"Sassuolo","Serie A","Rogério","BRA","DF","24",1998,33.3,37,21,22,8,7,17,35,48.6,18,32,9,23,37,74,70,0,"https://fbref.com/en/players/10e7f486/Rogerio"
2023,"Sassuolo","Serie A","Filippo Romagna","ITA","DF","25",1997,0.5,0,0,0,0,0,0,0,NA,0,1,1,0,0,0,2,0,"https://fbref.com/en/players/84594618/Filippo-Romagna"
2023,"Sassuolo","Serie A","Ruan","BRA","DF","23",1999,19,38,26,25,12,1,19,29,65.5,10,29,17,12,24,62,80,3,"https://fbref.com/en/players/a378a02a/Ruan"
2023,"Sassuolo","Serie A","Alessandro Russo","ITA","GK","21",2001,1,0,0,0,0,0,0,0,NA,0,0,0,0,0,0,1,1,"https://fbref.com/en/players/3945ac70/Alessandro-Russo"
2023,"Sassuolo","Serie A","Kristian Thorstvedt","NOR","MF","23",1999,12.6,16,7,4,9,3,6,17,35.3,11,19,5,14,14,30,13,0,"https://fbref.com/en/players/76ff8d0d/Kristian-Thorstvedt"
2023,"Sassuolo","Serie A","Jeremy Toljan","GER","DF","27",1994,29.7,36,23,17,14,5,22,33,66.7,11,31,14,17,18,54,60,1,"https://fbref.com/en/players/a96e5dc0/Jeremy-Toljan"
2023,"Sassuolo","Serie A","Nadir Zortea","ITA","DF","23",1999,7.3,15,8,12,2,1,9,14,64.3,5,10,4,6,4,19,21,0,"https://fbref.com/en/players/82598b71/Nadir-Zortea"
2023,"Schalke 04","Bundesliga","Éder Álvarez Balanta","COL","MF,FW","29",1993,2.6,5,4,2,3,0,2,6,33.3,4,0,0,0,3,8,4,0,"https://fbref.com/en/players/8ce30c57/Eder-Alvarez-Balanta"
2023,"Schalke 04","Bundesliga","Mehmet Aydin","GER","DF,FW","20",2002,6.3,25,18,14,9,2,11,24,45.8,13,11,0,11,10,35,15,0,"https://fbref.com/en/players/fe46e261/Mehmet-Aydin"
2023,"Schalke 04","Bundesliga","Cédric Brunner","SUI","DF","28",1994,25.7,39,27,26,11,2,30,45,66.7,15,24,7,17,43,82,79,0,"https://fbref.com/en/players/f0a37d36/Cedric-Brunner"
2023,"Schalke 04","Bundesliga","Marius Bülter","GER","FW,MF","29",1993,28.9,22,11,8,7,7,12,32,37.5,20,34,1,33,10,32,20,0,"https://fbref.com/en/players/ab5b7dc1/Marius-Bulter"
2023,"Schalke 04","Bundesliga","Kerim Calhanoglu","GER","DF","19",2002,0.7,2,1,2,0,0,2,2,100,0,1,0,1,0,2,3,0,"https://fbref.com/en/players/d1db4b83/Kerim-Calhanoglu"
2023,"Schalke 04","Bundesliga","Sepp van den Berg","NED","DF","20",2001,7.7,5,4,2,2,1,1,4,25,3,8,5,3,13,18,33,2,"https://fbref.com/en/players/7bf9400b/Sepp-van-den-Berg"
2023,"Schalke 04","Bundesliga","Dominick Drexler","GER","MF,FW","32",1990,15.2,25,17,12,10,3,9,22,40.9,13,18,2,16,8,33,12,0,"https://fbref.com/en/players/809940aa/Dominick-Drexler"
2023,"Schalke 04","Bundesliga","Ralf Fährmann","GER","GK","33",1988,11.4,1,0,1,0,0,1,1,100,0,0,0,0,0,1,10,2,"https://fbref.com/en/players/1e43fad8/Ralf-Fahrmann"
2023,"Schalke 04","Bundesliga","Florian Flick","GER","MF","22",2000,5.7,12,3,7,5,0,4,14,28.6,10,9,3,6,4,16,18,0,"https://fbref.com/en/players/9642c929/Florian-Flick"
2023,"Schalke 04","Bundesliga","Michael Frey","SUI","FW","28",1994,9.6,13,5,2,8,3,4,13,30.8,9,6,0,6,2,15,1,0,"https://fbref.com/en/players/33182cb8/Michael-Frey"
2023,"Schalke 04","Bundesliga","Leo Greiml","AUT","DF","21",2001,4,10,5,4,5,1,5,12,41.7,7,7,3,4,3,13,16,0,"https://fbref.com/en/players/f9dfb7ae/Leo-Greiml"
2023,"Schalke 04","Bundesliga","Andreas Ivan","ROU","MF","27",1995,0.5,0,0,0,0,0,0,1,0,1,0,0,0,0,0,1,0,"https://fbref.com/en/players/8bf58a80/Andreas-Ivan"
2023,"Schalke 04","Bundesliga","Moritz Jenz","GER","DF","23",1999,10.5,14,11,8,5,1,5,8,62.5,3,16,10,6,8,22,53,1,"https://fbref.com/en/players/ee644761/Moritz-Jenz"
2023,"Schalke 04","Bundesliga","Marcin Kamiński","POL","DF","30",1992,7,6,4,4,0,2,2,4,50,2,8,7,1,9,15,28,0,"https://fbref.com/en/players/463503e2/Marcin-Kaminski"
2023,"Schalke 04","Bundesliga","Kenan Karaman","TUR","FW","28",1994,10.8,11,8,3,5,3,3,12,25,9,9,1,8,3,14,9,0,"https://fbref.com/en/players/8f0f2230/Kenan-Karaman"
2023,"Schalke 04","Bundesliga","Timothée Kolodziejczak","FRA","DF","30",1991,0.3,0,0,0,0,0,0,1,0,1,0,0,0,1,1,1,0,"https://fbref.com/en/players/ab096c6f/Timothee-Kolodziejczak"
2023,"Schalke 04","Bundesliga","Soichiro Kozuki","JPN","FW,MF","21",2000,4.2,6,4,3,3,0,4,6,66.7,2,5,0,5,3,9,3,0,"https://fbref.com/en/players/f1e855eb/Soichiro-Kozuki"
2023,"Schalke 04","Bundesliga","Alex Král","CZE","MF","24",1998,26.2,34,24,10,22,2,17,37,45.9,20,31,6,25,17,51,53,0,"https://fbref.com/en/players/e717705a/Alex-Kral"
2023,"Schalke 04","Bundesliga","Tom Krauß","GER","MF","21",2001,27.9,112,68,39,62,11,51,100,51,49,39,6,33,36,148,35,0,"https://fbref.com/en/players/9f77012e/Tom-Krauss"
2023,"Schalke 04","Bundesliga","Jordan Larsson","SWE","FW,MF","25",1997,5.1,8,5,1,7,0,2,9,22.2,7,9,0,9,4,12,3,0,"https://fbref.com/en/players/72984eee/Jordan-Larsson"
2023,"Schalke 04","Bundesliga","Danny Latza","GER","MF","32",1989,9.5,17,13,8,8,1,5,17,29.4,12,16,1,15,5,22,15,0,"https://fbref.com/en/players/33b554b7/Danny-Latza"
2023,"Schalke 04","Bundesliga","Henning Matriciani","GER","DF","22",2000,20.7,43,23,28,12,3,26,60,43.3,34,28,11,17,23,66,57,1,"https://fbref.com/en/players/ab3f1bdf/Henning-Matriciani"
2023,"Schalke 04","Bundesliga","Keke Maximilian Topp","GER","FW","18",2004,0.2,0,0,0,0,0,0,0,NA,0,0,0,0,1,1,0,0,"https://fbref.com/en/players/ebb32f3a/Keke-Maximilian-Topp"
2023,"Schalke 04","Bundesliga","Tobias Mohr","GER","DF,MF","26",1995,9.3,8,5,3,5,0,2,7,28.6,5,14,5,9,8,16,19,0,"https://fbref.com/en/players/9ec9c8b6/Tobias-Mohr"
2023,"Schalke 04","Bundesliga","Florent Mollet","FRA","MF","30",1991,4.6,4,1,0,4,0,2,7,28.6,5,7,1,6,1,5,1,0,"https://fbref.com/en/players/7e82a78f/Florent-Mollet"
2023,"Schalke 04","Bundesliga","Thomas Ouwejan","NED","DF","25",1996,10,20,8,13,5,2,6,10,60,4,17,4,13,13,33,27,0,"https://fbref.com/en/players/36d9dabe/Thomas-Ouwejan"
2023,"Schalke 04","Bundesliga","Sebastian Polter","GER","FW","31",1991,7,4,3,0,4,0,1,4,25,3,4,0,4,1,5,6,0,"https://fbref.com/en/players/3745e8bd/Sebastian-Polter"
2023,"Schalke 04","Bundesliga","Sidi Sané","GER","FW","19",2003,0.3,1,1,1,0,0,1,1,100,0,0,0,0,0,1,0,0,"https://fbref.com/en/players/6a52a6c6/Sidi-Sane"
2023,"Schalke 04","Bundesliga","Alexander Schwolow","GER","GK","30",1992,22.6,0,0,0,0,0,0,2,0,2,0,0,0,1,1,6,3,"https://fbref.com/en/players/0d55d942/Alexander-Schwolow"
2023,"Schalke 04","Bundesliga","Tim Skarke","GER","FW,MF","25",1996,4.9,13,7,3,8,2,8,11,72.7,3,5,0,5,0,13,4,0,"https://fbref.com/en/players/65857fdf/Tim-Skarke"
2023,"Schalke 04","Bundesliga","Simon Terodde","GER","FW","34",1988,20.3,15,8,4,7,4,3,14,21.4,11,6,2,4,6,21,9,0,"https://fbref.com/en/players/863ff1ee/Simon-Terodde"
2023,"Schalke 04","Bundesliga","Malick Thiaw","GER","DF","20",2001,3,3,1,2,1,0,1,2,50,1,4,3,1,9,12,24,1,"https://fbref.com/en/players/ff5ea0bf/Malick-Thiaw"
2023,"Schalke 04","Bundesliga","Jere Uronen","FIN","DF","28",1994,7.5,14,10,6,6,2,6,10,60,4,5,2,3,8,22,13,0,"https://fbref.com/en/players/d75f3980/Jere-Uronen"
2023,"Schalke 04","Bundesliga","Maya Yoshida","JPN","DF","33",1988,28.4,34,22,19,13,2,18,29,62.1,11,40,29,11,46,80,132,2,"https://fbref.com/en/players/caffaf5a/Maya-Yoshida"
2023,"Schalke 04","Bundesliga","Rodrigo Zalazar","URU","MF,FW","22",1999,14.7,16,8,5,9,2,9,24,37.5,15,16,1,15,7,23,13,0,"https://fbref.com/en/players/fc3697dd/Rodrigo-Zalazar"
2023,"Sevilla","La Liga","Marcos Acuña","ARG","DF","30",1991,21.2,57,36,34,17,6,30,42,71.4,12,16,5,11,23,80,36,0,"https://fbref.com/en/players/81442ecb/Marcos-Acuna"
2023,"Sevilla","La Liga","Carlos Álvarez","ESP","FW","18",2003,0.1,NA,1,NA,NA,NA,NA,NA,NA,NA,NA,NA,NA,0,NA,NA,NA,"https://fbref.com/en/players/629081bd/Carlos-Alvarez"
2023,"Sevilla","La Liga","Loïc Bade","FRA","DF","22",2000,16.1,27,20,23,3,1,17,30,56.7,13,21,13,8,23,50,77,0,"https://fbref.com/en/players/114bbdee/Loic-Bade"
2023,"Sevilla","La Liga","Yassine Bounou","MAR","GK","31",1991,23.9,2,1,2,0,0,1,4,25,3,0,0,0,2,4,11,1,"https://fbref.com/en/players/f6798fc3/Yassine-Bounou"
2023,"Sevilla","La Liga","Carmona","ESP","DF","20",2002,5.9,13,11,5,3,5,9,16,56.3,7,10,6,4,7,20,17,1,"https://fbref.com/en/players/2dce876a/Carmona"
2023,"Sevilla","La Liga","Jesús Corona","MEX","FW","29",1993,1.2,1,0,1,0,0,0,1,0,1,0,0,0,1,2,1,0,"https://fbref.com/en/players/fb938d24/Jesus-Corona"
2023,"Sevilla","La Liga","Thomas Delaney","DEN","MF","30",1991,3.4,4,2,0,4,0,3,5,60,2,3,2,1,4,8,3,0,"https://fbref.com/en/players/fe641c1a/Thomas-Delaney"
2023,"Sevilla","La Liga","Marko Dmitrović","SRB","GK","30",1992,14.1,0,0,0,0,0,0,0,NA,0,0,0,0,0,0,6,0,"https://fbref.com/en/players/ac295d9e/Marko-Dmitrovic"
2023,"Sevilla","La Liga","Kasper Dolberg","DEN","FW","24",1997,2.2,1,0,0,1,0,1,3,33.3,2,0,0,0,0,1,5,0,"https://fbref.com/en/players/cc83b74d/Kasper-Dolberg"
2023,"Sevilla","La Liga","Youssef En-Nesyri","MAR","FW","25",1997,18.5,16,8,3,7,6,4,14,28.6,10,6,2,4,4,20,16,0,"https://fbref.com/en/players/04e17fd5/Youssef-En-Nesyri"
2023,"Sevilla","La Liga","Fernando","BRA","MF,DF","35",1987,17.5,34,23,14,17,3,18,30,60,12,21,10,11,24,58,29,0,"https://fbref.com/en/players/41f32541/Fernando"
2023,"Sevilla","La Liga","Bryan Gil","ESP","FW,DF","21",2001,10.2,22,11,11,7,4,10,23,43.5,13,10,0,10,8,30,10,0,"https://fbref.com/en/players/7b5ab7f2/Bryan-Gil"
2023,"Sevilla","La Liga","Papu Gómez","ARG","FW,MF","34",1988,11.8,6,4,3,3,0,2,10,20,8,8,1,7,4,10,5,0,"https://fbref.com/en/players/6e4df551/Papu-Gomez"
2023,"Sevilla","La Liga","Nemanja Gudelj","SRB","DF,MF","30",1991,30.9,43,33,22,18,3,20,33,60.6,13,39,29,10,34,77,102,1,"https://fbref.com/en/players/0076ab7f/Nemanja-Gudelj"
2023,"Sevilla","La Liga","Pape Gueye","SEN","MF","23",1999,13,37,22,13,21,3,16,33,48.5,17,21,5,16,22,59,10,0,"https://fbref.com/en/players/7155e3e1/Pape-Gueye"
2023,"Sevilla","La Liga","Isco","ESP","MF,FW","30",1992,8.9,15,9,6,5,4,8,14,57.1,6,3,0,3,10,25,3,0,"https://fbref.com/en/players/a0b4bb3e/Isco"
2023,"Sevilla","La Liga","Diego Iturralde","ESP","DF","19",2003,0.5,1,0,1,0,0,0,2,0,2,0,0,0,0,1,1,0,"https://fbref.com/en/players/9d33c71a/Diego-Iturralde"
2023,"Sevilla","La Liga","Adnan Januzaj","BEL","FW","27",1995,0.5,0,0,0,0,0,0,1,0,1,0,0,0,1,1,0,0,"https://fbref.com/en/players/4737cebe/Adnan-Januzaj"
2023,"Sevilla","La Liga","Joan Jordán","ESP","MF","28",1994,17.7,32,17,13,17,2,16,38,42.1,22,14,7,7,16,48,14,2,"https://fbref.com/en/players/2a0c8ba4/Joan-Jordan"
2023,"Sevilla","La Liga","Érik Lamela","ARG","FW,MF","30",1992,20.5,46,27,14,16,16,12,34,35.3,22,26,2,24,7,53,3,0,"https://fbref.com/en/players/abe66106/Erik-Lamela"
2023,"Sevilla","La Liga","Marcão","BRA","DF","26",1996,4.2,2,2,1,1,0,1,1,100,0,3,3,0,6,8,14,0,"https://fbref.com/en/players/133faa84/Marcao"
2023,"Sevilla","La Liga","Rafa Mir","ESP","FW","25",1997,14.4,8,2,2,4,2,2,5,40,3,5,1,4,4,12,11,0,"https://fbref.com/en/players/bbf5c11b/Rafa-Mir"
2023,"Sevilla","La Liga","Gonzalo Montiel","ARG","DF","25",1997,16.9,26,15,12,14,0,15,29,51.7,14,25,7,18,19,45,38,0,"https://fbref.com/en/players/374d5158/Gonzalo-Montiel"
2023,"Sevilla","La Liga","Jesús Navas","ESP","DF,FW","36",1985,22,19,12,8,3,8,11,22,50,11,18,7,11,22,41,52,1,"https://fbref.com/en/players/3f10bd22/Jesus-Navas"
2023,"Sevilla","La Liga","Tanguy Nianzou","FRA","DF","20",2002,15.2,20,15,10,9,1,8,11,72.7,3,8,5,3,16,36,44,3,"https://fbref.com/en/players/5853ac44/Tanguy-Nianzou"
2023,"Sevilla","La Liga","Lucas Ocampos","ARG","FW,MF","28",1994,12.9,22,14,9,9,4,8,31,25.8,23,17,2,15,8,30,5,0,"https://fbref.com/en/players/a08b974a/Lucas-Ocampos"
2023,"Sevilla","La Liga","Pedro Ortiz","ESP","MF","21",2000,0,0,0,0,0,0,0,0,NA,0,0,0,0,0,0,0,0,"https://fbref.com/en/players/f9358b61/Pedro-Ortiz"
2023,"Sevilla","La Liga","Ivan Rakitić","CRO","MF","34",1988,19.9,37,26,10,18,9,19,40,47.5,21,21,1,20,27,64,20,0,"https://fbref.com/en/players/89f951b5/Ivan-Rakitic"
2023,"Sevilla","La Liga","Karim Rekik","NED","DF","27",1994,13.1,11,5,8,3,0,4,5,80,1,12,5,7,10,21,24,0,"https://fbref.com/en/players/3376a776/Karim-Rekik"
2023,"Sevilla","La Liga","Iván Romero","ESP","MF","21",2001,0.1,0,0,0,0,0,0,0,NA,0,0,0,0,0,0,0,0,"https://fbref.com/en/players/2fbe6af0/Ivan-Romero"
2023,"Sevilla","La Liga","Kike Salas","ESP","DF","20",2002,4.1,1,1,1,0,0,0,0,NA,0,4,3,1,5,6,23,0,"https://fbref.com/en/players/0a69de7b/Kike-Salas"
2023,"Sevilla","La Liga","Manuel Sebastián","ESP","MF","18",2004,1.7,7,4,3,3,1,5,8,62.5,3,0,0,0,0,7,2,0,"https://fbref.com/en/players/c5642098/Manuel-Sebastian"
2023,"Sevilla","La Liga","Suso","ESP","MF,FW","28",1993,11.8,16,10,5,7,4,10,22,45.5,12,7,1,6,2,18,3,0,"https://fbref.com/en/players/4e219ad2/Suso"
2023,"Sevilla","La Liga","Alex Telles","BRA","DF","29",1992,15.9,21,13,15,6,0,13,25,52,12,17,5,12,20,41,38,0,"https://fbref.com/en/players/e73c9bb2/Alex-Telles"
2023,"Sevilla","La Liga","Óliver Torres","ESP","MF,FW","27",1994,23.7,39,23,12,13,14,18,59,30.5,41,26,5,21,10,49,10,0,"https://fbref.com/en/players/58a9a4d9/Oliver-Torres"
2023,"Southampton","Premier League","Che Adams","SCO","FW","26",1996,22.1,17,13,7,8,2,7,12,58.3,5,13,4,9,4,21,22,0,"https://fbref.com/en/players/f2bf1b0f/Che-Adams"
2023,"Southampton","Premier League","Carlos Alcaraz","ARG","MF,FW","19",2002,11.4,10,5,2,7,1,6,22,27.3,16,14,5,9,1,11,11,0,"https://fbref.com/en/players/4abac767/Carlos-Alcaraz"
2023,"Southampton","Premier League","Samuel Amo-Ameyaw","ENG","MF","16",2006,0,0,0,0,0,0,0,1,0,1,0,0,0,0,0,0,0,"https://fbref.com/en/players/9eedf0e0/Samuel-Amo-Ameyaw"
2023,"Southampton","Premier League","Joe Aribo","NGA","MF,FW","26",1996,13.6,31,20,15,12,4,11,20,55,9,14,1,13,10,41,11,0,"https://fbref.com/en/players/328f7d51/Joe-Aribo"
2023,"Southampton","Premier League","Adam Armstrong","ENG","FW,MF","25",1997,14.8,14,9,6,5,3,3,10,30,7,15,3,12,5,19,6,0,"https://fbref.com/en/players/68c720b5/Adam-Armstrong"
2023,"Southampton","Premier League","Stuart Armstrong","SCO","MF,FW","30",1992,15.6,32,21,15,13,4,14,39,35.9,25,18,0,18,10,42,9,1,"https://fbref.com/en/players/97333cf5/Stuart-Armstrong"
2023,"Southampton","Premier League","Dominic Ballard","ENG","FW,MF","17",2005,0.3,0,0,0,0,0,0,0,NA,0,0,0,0,1,1,0,0,"https://fbref.com/en/players/ed8d597c/Dominic-Ballard"
2023,"Southampton","Premier League","Gavin Bazunu","IRL","GK","20",2002,32,1,0,1,0,0,1,1,100,0,0,0,0,1,2,24,2,"https://fbref.com/en/players/c91441dc/Gavin-Bazunu"
2023,"Southampton","Premier League","Jan Bednarek","POL","DF","26",1996,18.6,27,21,20,7,0,12,16,75,4,38,27,11,49,76,87,0,"https://fbref.com/en/players/4115ce4e/Jan-Bednarek"
2023,"Southampton","Premier League","Armel Bella Kotchap","GER","DF","20",2001,20.9,37,17,28,9,0,15,20,75,5,29,12,17,44,81,110,0,"https://fbref.com/en/players/a39d11bc/Armel-Bella-Kotchap"
2023,"Southampton","Premier League","James Bree","ENG","DF","24",1997,4.1,5,3,4,1,0,3,4,75,1,3,1,2,6,11,11,0,"https://fbref.com/en/players/c07b7c5c/James-Bree"
2023,"Southampton","Premier League","Duje Ćaleta-Car","CRO","DF","25",1996,10.5,14,10,9,4,1,6,9,66.7,3,15,11,4,15,29,65,1,"https://fbref.com/en/players/94f8d10c/Duje-Caleta-Car"
2023,"Southampton","Premier League","Ibrahima Diallo","FRA","MF","23",1999,9.1,25,15,14,10,1,8,14,57.1,6,11,1,10,6,31,11,0,"https://fbref.com/en/players/11ff3d56/Ibrahima-Diallo"
2023,"Southampton","Premier League","Moussa Djenepo","MLI","DF,FW","24",1998,7.9,19,11,13,5,1,11,26,42.3,15,19,2,17,11,30,7,0,"https://fbref.com/en/players/254147d4/Moussa-Djenepo"
2023,"Southampton","Premier League","Kami Doyle","ENG","MF","16",2005,0.1,0,0,0,0,0,0,0,NA,0,0,0,0,0,0,0,0,"https://fbref.com/en/players/65983e4d/Kami-Doyle"
2023,"Southampton","Premier League","Samuel Edozie","ENG","FW,MF","19",2003,6.3,17,10,6,10,1,3,8,37.5,5,7,0,7,6,23,6,0,"https://fbref.com/en/players/007414dd/Samuel-Edozie"
2023,"Southampton","Premier League","Mohamed Elyounoussi","NOR","MF,FW","27",1994,24.1,46,28,22,20,4,19,43,44.2,24,40,3,37,27,73,37,0,"https://fbref.com/en/players/68dc0dac/Mohamed-Elyounoussi"
2023,"Southampton","Premier League","Juan Larios","ESP","DF","18",2004,1.7,7,6,6,1,0,5,5,100,0,2,0,2,3,10,4,0,"https://fbref.com/en/players/cf7fb13a/Juan-Larios"
2023,"Southampton","Premier League","Roméo Lavia","BEL","MF","18",2004,24.7,60,35,27,29,4,21,53,39.6,32,47,11,36,33,93,23,1,"https://fbref.com/en/players/ecad9aa5/Romeo-Lavia"
2023,"Southampton","Premier League","Valentino Livramento","ENG","DF,FW","19",2002,0.3,2,1,2,0,0,0,0,NA,0,0,0,0,2,4,3,0,"https://fbref.com/en/players/afed6722/Valentino-Livramento"
2023,"Southampton","Premier League","Lyanco","BRA","DF","25",1997,13.1,24,16,15,9,0,12,18,66.7,6,30,25,5,20,44,65,2,"https://fbref.com/en/players/b5bf1770/Lyanco"
2023,"Southampton","Premier League","Ainsley Maitland-Niles","ENG","DF,MF","24",1997,15.6,45,24,23,18,4,28,44,63.6,16,28,7,21,22,67,45,1,"https://fbref.com/en/players/e3a5814e/Ainsley-Maitland-Niles"
2023,"Southampton","Premier League","Sekou Mara","FRA","FW,MF","20",2002,6.2,14,10,5,8,1,3,9,33.3,6,11,0,11,1,15,5,0,"https://fbref.com/en/players/3544641e/Sekou-Mara"
2023,"Southampton","Premier League","Alex McCarthy","ENG","GK","32",1989,6,0,0,0,0,0,0,1,0,1,0,0,0,1,1,3,1,"https://fbref.com/en/players/36c2ca73/Alex-McCarthy"
2023,"Southampton","Premier League","Paul Onuachu","NGA","FW","28",1994,4.5,3,2,1,1,1,1,3,33.3,2,4,1,3,0,3,4,0,"https://fbref.com/en/players/c06d1086/Paul-Onuachu"
2023,"Southampton","Premier League","Mislav Oršić","CRO","MF","29",1992,0.1,1,1,1,0,0,0,0,NA,0,0,0,0,0,1,0,0,"https://fbref.com/en/players/ee950928/Mislav-Orsic"
2023,"Southampton","Premier League","Romain Perraud","FRA","DF","24",1997,20.4,54,33,23,23,8,28,52,53.8,24,24,6,18,20,74,42,0,"https://fbref.com/en/players/6dfd8f05/Romain-Perraud"
2023,"Southampton","Premier League","Nathan Redmond","ENG","DF","28",1994,0,0,0,0,0,0,0,0,NA,0,0,0,0,0,0,0,0,"https://fbref.com/en/players/ab651565/Nathan-Redmond"
2023,"Southampton","Premier League","Oriol Romeu","ESP","MF","30",1991,0.8,1,0,0,1,0,0,0,NA,0,1,0,1,1,2,1,0,"https://fbref.com/en/players/4b511457/Oriol-Romeu"
2023,"Southampton","Premier League","Mohammed Salisu","GHA","DF","23",1999,21.9,51,29,33,16,2,24,34,70.6,10,56,25,31,31,82,122,1,"https://fbref.com/en/players/0b33f6ad/Mohammed-Salisu"
2023,"Southampton","Premier League","Jack Stephens","ENG","DF","28",1994,0.5,2,2,2,0,0,1,1,100,0,1,1,0,1,3,2,0,"https://fbref.com/en/players/6adbc307/Jack-Stephens"
2023,"Southampton","Premier League","Kamaldeen Sulemana","GHA","FW,MF","20",2002,10.7,15,9,4,7,4,4,14,28.6,10,16,0,16,6,21,6,0,"https://fbref.com/en/players/a62f8bf1/Kamaldeen-Sulemana"
2023,"Southampton","Premier League","Valery","ESP","DF,MF","22",1999,0.5,NA,0,NA,NA,NA,NA,NA,NA,NA,NA,NA,NA,0,NA,NA,NA,"https://fbref.com/en/players/4acd733a/Valery"
2023,"Southampton","Premier League","Theo Walcott","ENG","FW,MF","33",1989,12.5,13,6,8,4,1,8,27,29.6,19,8,1,7,9,22,7,0,"https://fbref.com/en/players/1ecb65be/Theo-Walcott"
2023,"Southampton","Premier League","Kyle Walker-Peters","ENG","DF","25",1997,29.4,61,32,34,24,3,22,42,52.4,20,47,8,39,27,88,52,0,"https://fbref.com/en/players/984a5a64/Kyle-Walker-Peters"
2023,"Southampton","Premier League","James Ward-Prowse","ENG","MF","27",1994,37.5,65,37,31,27,7,21,61,34.4,40,30,10,20,55,120,48,0,"https://fbref.com/en/players/3515d404/James-Ward-Prowse"
2023,"Spezia","Serie A","Kevin Agudelo","COL","MF,FW","23",1998,23.7,71,38,22,30,19,25,59,42.4,34,39,5,34,10,81,6,0,"https://fbref.com/en/players/46fa7204/Kevin-Agudelo"
2023,"Spezia","Serie A","Kelvin Amian","FRA","DF","24",1998,26.4,54,32,33,12,9,24,31,77.4,7,34,12,22,22,76,87,1,"https://fbref.com/en/players/bcc81786/Kelvin-Amian"
2023,"Spezia","Serie A","Ethan Ampadu","WAL","DF,MF","21",2000,29.3,66,37,33,28,5,17,41,41.5,24,48,23,25,36,102,98,0,"https://fbref.com/en/players/10b9fa99/Ethan-Ampadu"
2023,"Spezia","Serie A","Simone Bastoni","ITA","MF,DF","25",1996,13.2,47,24,23,19,5,15,33,45.5,18,20,5,15,8,55,14,0,"https://fbref.com/en/players/1ac232b8/Simone-Bastoni"
2023,"Spezia","Serie A","Julius Beck","DEN","MF","17",2005,0.1,2,1,1,1,0,0,0,NA,0,0,0,0,0,2,0,0,"https://fbref.com/en/players/e892c325/Julius-Beck"
2023,"Spezia","Serie A","Mehdi Bourabia","MAR","MF","30",1991,30.8,41,20,13,22,6,19,41,46.3,22,39,12,27,32,73,57,0,"https://fbref.com/en/players/0d077b88/Mehdi-Bourabia"
2023,"Spezia","Serie A","Mattia Caldara","ITA","DF","28",1994,13.9,23,14,10,11,2,9,20,45,11,23,16,7,17,40,88,2,"https://fbref.com/en/players/ac7e640b/Mattia-Caldara"
2023,"Spezia","Serie A","Tio Cipot","SVN","FW,MF","19",2003,1.5,12,7,6,3,3,6,8,75,2,0,0,0,0,12,2,0,"https://fbref.com/en/players/039a4fb6/Tio-Cipot"
2023,"Spezia","Serie A","Bartłomiej Drągowski","POL","GK","24",1997,32.7,1,0,1,0,0,1,5,20,4,0,0,0,1,2,15,3,"https://fbref.com/en/players/085e71a7/Bartlomiej-Dragowski"
2023,"Spezia","Serie A","Albin Ekdal","SWE","MF","33",1989,19.3,37,20,14,20,3,19,45,42.2,26,24,2,22,26,63,36,0,"https://fbref.com/en/players/f503ea63/Albin-Ekdal"
2023,"Spezia","Serie A","Mikael Ellertsson","ISL","MF,DF","20",2002,1.9,4,2,1,3,0,0,3,0,3,2,1,1,2,6,0,0,"https://fbref.com/en/players/c55967eb/Mikael-Ellertsson"
2023,"Spezia","Serie A","Salvatore Esposito","ITA","MF","21",2000,10.8,15,12,8,5,2,5,21,23.8,16,9,1,8,11,26,18,0,"https://fbref.com/en/players/5cf5c9ad/Salvatore-Esposito"
2023,"Spezia","Serie A","Salvador Ferrer","ESP","DF","24",1998,1.5,4,2,2,2,0,1,3,33.3,2,3,1,2,1,5,4,0,"https://fbref.com/en/players/eb76987d/Salvador-Ferrer"
2023,"Spezia","Serie A","Emmanuel Gyasi","GHA","FW,DF","28",1994,31.2,24,15,11,10,3,9,36,25,27,24,6,18,8,32,26,0,"https://fbref.com/en/players/f9758dae/Emmanuel-Gyasi"
2023,"Spezia","Serie A","Emil Holm","SWE","DF","22",2000,15.5,26,15,13,8,5,16,31,51.6,15,21,6,15,9,35,41,0,"https://fbref.com/en/players/c2357b65/Emil-Holm"
2023,"Spezia","Serie A","Petko Hristov","BUL","DF","23",1999,4.1,6,4,2,4,0,5,8,62.5,3,4,2,2,4,10,12,0,"https://fbref.com/en/players/d8800a46/Petko-Hristov"
2023,"Spezia","Serie A","Jakub Kiwior","POL","DF","22",2000,16,22,17,15,7,0,6,24,25,18,26,18,8,24,46,71,1,"https://fbref.com/en/players/dc3e663e/Jakub-Kiwior"
2023,"Spezia","Serie A","Viktor Kovalenko","UKR","MF","26",1996,6.1,9,5,1,6,2,5,8,62.5,3,11,2,9,4,13,7,0,"https://fbref.com/en/players/9d60028d/Viktor-Kovalenko"
2023,"Spezia","Serie A","Raimonds Krollis","LVA","FW,DF","20",2001,0.4,1,1,0,0,1,0,1,0,1,0,0,0,0,1,0,0,"https://fbref.com/en/players/b4101c2e/Raimonds-Krollis"
2023,"Spezia","Serie A","Daniel Maldini","ITA","FW,MF","20",2001,7,12,5,3,4,5,4,11,36.4,7,9,0,9,1,13,8,0,"https://fbref.com/en/players/801831fe/Daniel-Maldini"
2023,"Spezia","Serie A","Federico Marchetti","ITA","GK","39",1983,0.7,0,0,0,0,0,0,0,NA,0,0,0,0,0,0,0,0,"https://fbref.com/en/players/f794b426/Federico-Marchetti"
2023,"Spezia","Serie A","João Moutinho","POR","DF,FW","24",1998,0.6,7,1,5,1,1,3,4,75,1,1,1,0,0,7,0,0,"https://fbref.com/en/players/a0aee24e/Joao-Moutinho"
2023,"Spezia","Serie A","Dimitris Nikolaou","GRE","DF","23",1998,32.9,45,32,31,10,4,25,37,67.6,12,41,26,15,27,72,82,0,"https://fbref.com/en/players/cf961d8d/Dimitris-Nikolaou"
2023,"Spezia","Serie A","M'Bala Nzola","ANG","FW","25",1996,29.5,12,5,0,6,6,3,9,33.3,6,20,6,14,7,19,21,0,"https://fbref.com/en/players/a4948e67/MBala-Nzola"
2023,"Spezia","Serie A","Arkadiusz Reca","POL","DF","27",1995,24.1,44,28,22,12,10,19,32,59.4,13,21,5,16,24,68,54,0,"https://fbref.com/en/players/6213fd82/Arkadiusz-Reca"
2023,"Spezia","Serie A","Jacopo Sala","ITA","MF","30",1991,1.2,1,0,1,0,0,0,2,0,2,2,0,2,1,2,2,0,"https://fbref.com/en/players/da5a981b/Jacopo-Sala"
2023,"Spezia","Serie A","Leandro Sanca","GNB","FW,MF","22",2000,0.4,1,1,0,0,1,1,1,100,0,0,0,0,0,1,0,0,"https://fbref.com/en/players/4295f19c/Leandro-Sanca"
2023,"Spezia","Serie A","Eldor Shomurodov","UZB","FW","27",1995,9,5,5,3,1,1,2,11,18.2,9,5,1,4,3,8,4,0,"https://fbref.com/en/players/57469b2d/Eldor-Shomurodov"
2023,"Spezia","Serie A","Dávid Strelec","SVK","FW","21",2001,1.9,2,2,0,1,1,2,2,100,0,0,0,0,0,2,0,0,"https://fbref.com/en/players/2cb9486d/David-Strelec"
2023,"Spezia","Serie A","Daniele Verde","ITA","FW,MF","26",1996,11.1,4,4,3,0,1,3,7,42.9,4,6,0,6,8,12,4,0,"https://fbref.com/en/players/d3298c99/Daniele-Verde"
2023,"Spezia","Serie A","Przemysław Wiśniewski","POL","DF","24",1998,11.1,13,6,7,6,0,6,18,33.3,12,16,8,8,11,24,66,0,"https://fbref.com/en/players/1bfe5ac9/Przemyslaw-Wisniewski"
2023,"Spezia","Serie A","Jeroen Zoet","NED","GK","31",1991,3.7,1,1,1,0,0,1,1,100,0,0,0,0,0,1,1,0,"https://fbref.com/en/players/cc1a0c57/Jeroen-Zoet"
2023,"Spezia","Serie A","Petar Zovko","BIH","GK","20",2002,0.8,1,0,1,0,0,1,1,100,0,0,0,0,0,1,0,0,"https://fbref.com/en/players/54f6afe3/Petar-Zovko"
2023,"Spezia","Serie A","Szymon Żurkowski","POL","MF","24",1997,4.7,9,3,4,4,1,2,15,13.3,13,9,2,7,4,13,6,0,"https://fbref.com/en/players/4e1d5e59/Szymon-Zurkowski"
2023,"Strasbourg","Ligue 1","Jean-Eudes Aholou","CIV","MF","28",1994,14.4,34,20,10,20,4,12,31,38.7,19,25,0,25,24,58,15,0,"https://fbref.com/en/players/48b28bfd/Jean-Eudes-Aholou"
2023,"Strasbourg","Ligue 1","Ludovic Ajorque","FRA","FW","28",1994,8.6,5,4,1,4,0,3,9,33.3,6,3,1,2,2,7,7,0,"https://fbref.com/en/players/462475ed/Ludovic-Ajorque"
2023,"Strasbourg","Ligue 1","Jean-Ricner Bellegarde","FRA","MF,FW","24",1998,26.9,47,25,15,21,11,11,25,44,14,26,3,23,26,73,22,0,"https://fbref.com/en/players/10f0fdd3/Jean-Ricner-Bellegarde"
2023,"Strasbourg","Ligue 1","Franci Bouebari","FRA","DF","18",2003,0.8,3,0,1,2,0,3,5,60,2,0,0,0,2,5,2,0,"https://fbref.com/en/players/4fb18ca4/Franci-Bouebari"
2023,"Strasbourg","Ligue 1","Colin Dagba","FRA","DF,MF","23",1998,10.6,32,20,17,10,5,19,26,73.1,7,18,2,16,17,49,19,0,"https://fbref.com/en/players/29c02c9f/Colin-Dagba"
2023,"Strasbourg","Ligue 1","Thomas Delaine","FRA","DF,MF","30",1992,11.9,28,14,16,6,6,13,26,50,13,8,3,5,16,44,9,0,"https://fbref.com/en/players/8332db56/Thomas-Delaine"
2023,"Strasbourg","Ligue 1","Habib Diallo","SEN","FW","27",1995,32,18,10,8,7,3,6,16,37.5,10,19,4,15,12,30,26,0,"https://fbref.com/en/players/6605d143/Habib-Diallo"
2023,"Strasbourg","Ligue 1","Mouhamadou Diarra","SEN","MF,FW","18",2004,18.1,24,16,10,11,3,15,29,51.7,14,17,1,16,11,35,13,0,"https://fbref.com/en/players/6d0fe035/Mouhamadou-Diarra"
2023,"Strasbourg","Ligue 1","Alexander Djiku","GHA","DF","27",1994,29.7,53,36,37,16,0,26,46,56.5,20,45,19,26,66,119,151,3,"https://fbref.com/en/players/43e7a164/Alexander-Djiku"
2023,"Strasbourg","Ligue 1","Ismaël Doukouré","FRA","DF,MF","19",2003,25.5,48,24,23,21,4,20,34,58.8,14,26,8,18,27,75,54,0,"https://fbref.com/en/players/0512a60a/Ismael-Doukoure"
2023,"Strasbourg","Ligue 1","Karol Fila","POL","DF","24",1998,0.5,0,0,0,0,0,0,0,NA,0,0,0,0,1,1,1,0,"https://fbref.com/en/players/50ac8941/Karol-Fila"
2023,"Strasbourg","Ligue 1","Kévin Gameiro","FRA","FW","35",1987,23.3,20,10,6,10,4,8,28,28.6,20,10,1,9,9,29,0,0,"https://fbref.com/en/players/42276181/Kevin-Gameiro"
2023,"Strasbourg","Ligue 1","Frederic Guilbert","FRA","DF","27",1994,16.2,47,29,18,23,6,25,43,58.1,18,24,3,21,43,90,33,1,"https://fbref.com/en/players/5d8d7454/Frederic-Guilbert"
2023,"Strasbourg","Ligue 1","Dany Jean","HAI","DF,MF","19",2002,0.1,0,0,0,0,0,0,1,0,1,1,0,1,0,0,0,0,"https://fbref.com/en/players/300ec91c/Dany-Jean"
2023,"Strasbourg","Ligue 1","Nordine Kandil","FRA","MF,FW","20",2001,1.1,3,2,1,2,0,0,3,0,3,2,0,2,1,4,1,0,"https://fbref.com/en/players/c5908bc4/Nordine-Kandil"
2023,"Strasbourg","Ligue 1","Maxime Le Marchand","FRA","DF","32",1989,22.4,39,24,23,14,2,19,31,61.3,12,22,14,8,37,76,74,0,"https://fbref.com/en/players/321a71a7/Maxime-Le-Marchand"
2023,"Strasbourg","Ligue 1","Dimitri Liénard","FRA","DF,MF","34",1988,17.1,46,29,20,18,8,34,57,59.6,23,28,4,24,16,62,24,0,"https://fbref.com/en/players/f7691f63/Dimitri-Lienard"
2023,"Strasbourg","Ligue 1","Lebo Mothiba","RSA","FW,MF","26",1996,4.8,1,0,1,0,0,0,1,0,1,6,1,5,0,1,4,0,"https://fbref.com/en/players/3eaf8817/Lebo-Mothiba"
2023,"Strasbourg","Ligue 1","Gerzino Nyamsi","FRA","DF","25",1997,17.5,28,20,14,12,2,10,12,83.3,2,19,11,8,10,38,63,1,"https://fbref.com/en/players/6043997c/Gerzino-Nyamsi"
2023,"Strasbourg","Ligue 1","Lucas Perrin","FRA","DF","23",1998,19.6,44,27,28,14,2,25,49,51,24,13,5,8,36,80,53,0,"https://fbref.com/en/players/49070d66/Lucas-Perrin"
2023,"Strasbourg","Ligue 1","Ronaël Pierre-Gabriel","FRA","DF","24",1998,7.3,25,18,11,12,2,15,17,88.2,2,16,3,13,9,34,22,0,"https://fbref.com/en/players/64ba07c0/Ronael-Pierre-Gabriel"
2023,"Strasbourg","Ligue 1","Sanjin Prcić","BIH","MF","28",1993,18.1,27,12,6,16,5,19,31,61.3,12,22,7,15,25,52,22,0,"https://fbref.com/en/players/51c30111/Sanjin-Prcic"
2023,"Strasbourg","Ligue 1","Morgan Sanson","FRA","MF","27",1994,15.8,36,25,10,16,10,17,56,30.4,39,21,1,20,22,58,9,0,"https://fbref.com/en/players/6e7f1353/Morgan-Sanson"
2023,"Strasbourg","Ligue 1","Matz Sels","BEL","GK","30",1992,38,4,3,4,0,0,4,4,100,0,0,0,0,4,8,23,0,"https://fbref.com/en/players/834b5c4c/Matz-Sels"
2023,"Strasbourg","Ligue 1","Marvin Senaya","TOG","DF","21",2001,0.1,0,0,0,0,0,0,1,0,1,1,0,1,0,0,1,0,"https://fbref.com/en/players/1d383c10/Marvin-Senaya"
2023,"Strasbourg","Ligue 1","Ibrahima Sissoko","FRA","MF","24",1997,14.6,40,22,18,17,5,22,42,52.4,20,20,6,14,10,50,19,0,"https://fbref.com/en/players/0f8418aa/Ibrahima-Sissoko"
2023,"Strasbourg","Ligue 1","Eduard Sobol","UKR","DF","27",1995,9.7,19,10,10,6,3,9,13,69.2,4,10,1,9,8,27,19,0,"https://fbref.com/en/players/2ccd89a3/Eduard-Sobol"
2023,"Strasbourg","Ligue 1","Yuito Suzuki","JPN","FW,MF","20",2001,0.4,0,0,0,0,0,0,0,NA,0,3,0,3,0,0,0,0,"https://fbref.com/en/players/c25a7a2a/Yuito-Suzuki"
2023,"Strasbourg","Ligue 1","Adrien Thomasson","FRA","MF","28",1993,10.4,19,9,8,6,5,9,30,30,21,18,0,18,3,22,2,0,"https://fbref.com/en/players/c76b7567/Adrien-Thomasson"
2023,"Stuttgart","Bundesliga","Naouirou Ahamada","FRA","MF","20",2002,15.5,17,11,7,7,3,8,20,40,12,16,5,11,8,25,7,0,"https://fbref.com/en/players/a6c58494/Naouirou-Ahamada"
2023,"Stuttgart","Bundesliga","Waldemar Anton","GER","DF","26",1996,32.6,49,27,27,19,3,27,51,52.9,24,44,16,28,38,87,123,2,"https://fbref.com/en/players/5e66fa06/Waldemar-Anton"
2023,"Stuttgart","Bundesliga","Gil Bastião Dias","POR","FW","25",1996,4.4,8,6,3,4,1,3,12,25,9,7,0,7,2,10,3,0,"https://fbref.com/en/players/e61bdd69/Gil-Bastiao-Dias"
2023,"Stuttgart","Bundesliga","Fabian Bredlow","GER","GK","27",1995,15,1,1,1,0,0,1,1,100,0,0,0,0,0,1,4,2,"https://fbref.com/en/players/d28339cb/Fabian-Bredlow"
2023,"Stuttgart","Bundesliga","Darko Churlinov","MKD","FW","22",2000,0.3,3,2,2,1,0,2,3,66.7,1,1,0,1,0,3,0,0,"https://fbref.com/en/players/c6608135/Darko-Churlinov"
2023,"Stuttgart","Bundesliga","Tanguy Coulibaly","FRA","FW,DF","21",2001,3.6,12,9,9,1,2,5,12,41.7,7,10,0,10,3,15,0,0,"https://fbref.com/en/players/05ba9d7c/Tanguy-Coulibaly"
2023,"Stuttgart","Bundesliga","Lilian Egloff","GER","MF,FW","19",2002,2.7,12,10,4,5,3,4,6,66.7,2,2,0,2,1,13,1,0,"https://fbref.com/en/players/2f7fec15/Lilian-Egloff"
2023,"Stuttgart","Bundesliga","Wataru Endo","JPN","MF","29",1993,32.5,70,37,30,31,9,38,85,44.7,47,44,6,38,26,96,63,0,"https://fbref.com/en/players/c149016b/Wataru-Endo"
2023,"Stuttgart","Bundesliga","Chris Führich","GER","FW,MF","24",1998,20.9,36,14,15,14,7,24,44,54.5,20,29,2,27,7,43,13,0,"https://fbref.com/en/players/0cf778df/Chris-Fuhrich"
2023,"Stuttgart","Bundesliga","Serhou Guirassy","GUI","FW","26",1996,18.3,4,1,2,2,0,1,2,50,1,7,2,5,0,4,14,0,"https://fbref.com/en/players/923f4dda/Serhou-Guirassy"
2023,"Stuttgart","Bundesliga","Genki Haraguchi","JPN","MF","31",1991,8.3,16,7,7,7,2,4,16,25,12,13,2,11,8,24,6,0,"https://fbref.com/en/players/f24ea523/Genki-Haraguchi"
2023,"Stuttgart","Bundesliga","Hiroki Ito","JPN","DF","23",1999,28.5,40,29,24,14,2,18,35,51.4,17,38,17,21,40,80,94,0,"https://fbref.com/en/players/204dded0/Hiroki-Ito"
2023,"Stuttgart","Bundesliga","Sasa Kalajdzic","AUT","FW","25",1997,2.6,3,2,0,1,2,1,3,33.3,2,1,0,1,0,3,0,0,"https://fbref.com/en/players/15f24fe7/Sasa-Kalajdzic"
2023,"Stuttgart","Bundesliga","Atakan Karazor","GER","MF","25",1996,21.8,49,30,18,25,6,24,47,51.1,23,39,11,28,31,80,44,0,"https://fbref.com/en/players/5762be5c/Atakan-Karazor"
2023,"Stuttgart","Bundesliga","Thomas Kastanaras","GRE","FW,DF","19",2003,0.8,0,0,0,0,0,0,0,NA,0,1,0,1,0,0,0,0,"https://fbref.com/en/players/778ccc44/Thomas-Kastanaras"
2023,"Stuttgart","Bundesliga","Silas Katompa","COD","FW,MF","23",1998,22.1,25,17,5,14,6,6,20,30,14,17,2,15,8,33,1,0,"https://fbref.com/en/players/de4cac2d/Silas-Katompa"
2023,"Stuttgart","Bundesliga","Alou Kuol","AUS","FW","21",2000,0.1,0,0,0,0,0,0,0,NA,0,0,0,0,0,0,0,0,"https://fbref.com/en/players/f1bc3876/Alou-Kuol"
2023,"Stuttgart","Bundesliga","Konstantinos Mavropanos","GRE","DF","24",1997,25.4,50,27,32,15,3,28,38,73.7,10,39,18,21,63,113,99,0,"https://fbref.com/en/players/00963611/Konstantinos-Mavropanos"
2023,"Stuttgart","Bundesliga","Enzo Millot","FRA","MF","20",2002,9.9,23,16,9,10,4,12,19,63.2,7,20,3,17,12,35,7,0,"https://fbref.com/en/players/f76022e7/Enzo-Millot"
2023,"Stuttgart","Bundesliga","Clinton Mola","ENG","DF","21",2001,0.2,3,1,2,1,0,1,1,100,0,1,1,0,1,4,2,0,"https://fbref.com/en/players/29ddfb9c/Clinton-Mola"
2023,"Stuttgart","Bundesliga","Florian Müller","GER","GK","24",1997,19,0,0,0,0,0,0,0,NA,0,0,0,0,0,0,7,4,"https://fbref.com/en/players/cbac6ec9/Florian-Muller"
2023,"Stuttgart","Bundesliga","Nikolas Nartey","DEN","DF,MF","22",2000,5.3,11,6,7,3,1,5,9,55.6,4,9,0,9,4,15,12,0,"https://fbref.com/en/players/30261ba1/Nikolas-Nartey"
2023,"Stuttgart","Bundesliga","Juan Perea","COL","FW","22",2000,4.6,5,4,0,2,3,2,4,50,2,2,1,1,1,6,3,0,"https://fbref.com/en/players/ff3d391c/Juan-Perea"
2023,"Stuttgart","Bundesliga","Luca Pfeiffer","GER","FW","25",1996,7.8,1,1,1,0,0,0,1,0,1,4,0,4,1,2,5,0,"https://fbref.com/en/players/83e1f40e/Luca-Pfeiffer"
2023,"Stuttgart","Bundesliga","Borna Sosa","CRO","DF","24",1998,21.7,27,21,18,8,1,21,32,65.6,11,20,5,15,19,46,37,0,"https://fbref.com/en/players/af0d79a9/Borna-Sosa"
2023,"Stuttgart","Bundesliga","Pascal Stenzel","GER","DF","26",1996,3.7,12,8,8,4,0,5,9,55.6,4,9,2,7,5,17,6,0,"https://fbref.com/en/players/99f7e9aa/Pascal-Stenzel"
2023,"Stuttgart","Bundesliga","Tiago Tomás","POR","FW,MF","20",2002,14.3,10,4,2,4,4,8,13,61.5,5,9,2,7,1,11,5,0,"https://fbref.com/en/players/b492126a/Tiago-Tomas"
2023,"Stuttgart","Bundesliga","Lauren Ulrich","GER","MF","17",2005,0.1,1,1,0,0,1,0,0,NA,0,0,0,0,0,1,0,0,"https://fbref.com/en/players/cd61c7af/Lauren-Ulrich"
2023,"Stuttgart","Bundesliga","Josha Vagnoman","GER","DF","21",2000,16.4,26,15,12,11,3,15,27,55.6,12,20,2,18,8,34,29,1,"https://fbref.com/en/players/fb377d11/Josha-Vagnoman"
2023,"Stuttgart","Bundesliga","Dan-Axel Zagadou","FRA","DF","23",1999,14.1,14,9,10,4,0,5,14,35.7,9,19,16,3,21,35,81,1,"https://fbref.com/en/players/a4effc55/Dan-Axel-Zagadou"
2023,"Torino","Serie A","Ola Aina","NGA","DF","25",1996,9.7,17,13,5,8,4,9,15,60,6,12,2,10,11,28,26,0,"https://fbref.com/en/players/246d153b/Ola-Aina"
2023,"Torino","Serie A","Brian Bayeye","FRA","DF","22",2000,0.7,3,0,3,0,0,1,1,100,0,1,1,0,1,4,2,0,"https://fbref.com/en/players/78e6bf2c/Brian-Bayeye"
2023,"Torino","Serie A","Alessandro Buongiorno","ITA","DF","23",1999,30.2,38,25,22,16,0,16,31,51.6,15,38,19,19,60,98,105,2,"https://fbref.com/en/players/4ae67f27/Alessandro-Buongiorno"
2023,"Torino","Serie A","Koffi Djidji","CIV","DF","29",1992,26.9,50,25,32,17,1,18,32,56.3,14,29,14,15,34,84,72,0,"https://fbref.com/en/players/933d3b51/Koffi-Djidji"
2023,"Torino","Serie A","Gvidas Gineitis","LTU","MF","18",2004,1.5,3,1,0,2,1,1,2,50,1,0,0,0,0,3,1,0,"https://fbref.com/en/players/548bd0de/Gvidas-Gineitis"
2023,"Torino","Serie A","Andrew Gravillon","GLP","DF","24",1998,3.5,3,3,0,3,0,0,0,NA,0,4,2,2,9,12,16,0,"https://fbref.com/en/players/49136c42/Andrew-Gravillon"
2023,"Torino","Serie A","Ivan Ilić","SRB","MF","21",2001,13.1,18,7,6,11,1,10,20,50,10,12,3,9,5,23,10,0,"https://fbref.com/en/players/bb376bed/Ivan-Ilic"
2023,"Torino","Serie A","Emirhan İlkhan","TUR","MF","18",2004,1,1,1,0,1,0,1,1,100,0,3,1,2,2,3,2,0,"https://fbref.com/en/players/a47c6309/Emirhan-Ilkhan"
2023,"Torino","Serie A","Yann Karamoh","FRA","MF,FW","24",1998,8,5,2,3,2,0,1,5,20,4,5,0,5,0,5,2,1,"https://fbref.com/en/players/8b66d9cc/Yann-Karamoh"
2023,"Torino","Serie A","Valentino Lazaro","AUT","DF","26",1996,15.3,10,5,6,0,4,6,14,42.9,8,16,3,13,3,13,29,0,"https://fbref.com/en/players/016ff750/Valentino-Lazaro"
2023,"Torino","Serie A","Karol Linetty","POL","MF","27",1995,21,32,17,7,22,3,13,25,52,12,28,8,20,19,51,25,0,"https://fbref.com/en/players/d023d70f/Karol-Linetty"
2023,"Torino","Serie A","Saša Lukić","SRB","MF","25",1996,13.3,21,14,10,10,1,9,15,60,6,17,7,10,13,34,10,0,"https://fbref.com/en/players/c6e8cf1f/Sasa-Lukic"
2023,"Torino","Serie A","Vanja Milinković-Savić","SRB","GK","25",1997,38,2,1,2,0,0,2,2,100,0,0,0,0,1,3,19,1,"https://fbref.com/en/players/9fa26bc2/Vanja-Milinkovic-Savic"
2023,"Torino","Serie A","Aleksei Miranchuk","RUS","MF","26",1995,23.2,11,5,3,4,4,3,11,27.3,8,11,0,11,2,13,5,0,"https://fbref.com/en/players/a9aa0d1d/Aleksei-Miranchuk"
2023,"Torino","Serie A","Michel Ndary Adopo","FRA","MF,DF","22",2000,2.9,7,2,4,2,1,1,3,33.3,2,2,2,0,1,8,4,0,"https://fbref.com/en/players/599d91d0/Michel-Ndary-Adopo"
2023,"Torino","Serie A","Pietro Pellegri","ITA","FW","21",2001,5.2,6,2,1,3,2,2,3,66.7,1,5,1,4,0,6,4,0,"https://fbref.com/en/players/a44d3a3c/Pietro-Pellegri"
2023,"Torino","Serie A","Nemanja Radonjić","SRB","MF,FW","26",1996,16.2,2,1,2,0,0,0,4,0,4,3,0,3,2,4,4,0,"https://fbref.com/en/players/0630eb63/Nemanja-Radonjic"
2023,"Torino","Serie A","Samuele Ricci","ITA","MF","20",2001,23,32,21,17,10,5,18,23,78.3,5,20,5,15,17,49,29,1,"https://fbref.com/en/players/9823be92/Samuele-Ricci"
2023,"Torino","Serie A","Ricardo Rodríguez","SUI","DF","29",1992,29.7,54,33,30,17,7,28,42,66.7,14,30,15,15,38,92,61,0,"https://fbref.com/en/players/7f78ad23/Ricardo-Rodriguez"
2023,"Torino","Serie A","Antonio Sanabria","PAR","FW","26",1996,27,11,5,3,3,5,1,7,14.3,6,9,2,7,4,15,7,0,"https://fbref.com/en/players/0a447501/Antonio-Sanabria"
2023,"Torino","Serie A","Perr Schuurs","NED","DF","22",1999,25.8,51,25,29,17,5,14,26,53.8,12,28,16,12,28,79,102,0,"https://fbref.com/en/players/e613313c/Perr-Schuurs"
2023,"Torino","Serie A","Demba Seck","SEN","MF,FW","21",2001,5.8,5,2,3,2,0,2,3,66.7,1,3,1,2,1,6,1,0,"https://fbref.com/en/players/16463a79/Demba-Seck"
2023,"Torino","Serie A","Jacopo Segre","ITA","DF","25",1997,0.2,0,0,0,0,0,0,0,NA,0,0,0,0,0,0,0,0,"https://fbref.com/en/players/3cb132e6/Jacopo-Segre"
2023,"Torino","Serie A","Wilfried Singo","CIV","DF","21",2000,22.7,27,17,14,10,3,12,19,63.2,7,15,2,13,12,39,33,1,"https://fbref.com/en/players/8b609c34/Wilfried-Singo"
2023,"Torino","Serie A","Ronaldo Vieira","GNB","MF","24",1998,0.2,NA,0,NA,NA,NA,NA,NA,NA,NA,NA,NA,NA,0,NA,NA,NA,"https://fbref.com/en/players/75e60d75/Ronaldo-Vieira"
2023,"Torino","Serie A","Nikola Vlašić","CRO","MF,FW","24",1997,30.3,32,21,9,16,7,15,34,44.1,19,25,2,23,10,42,14,0,"https://fbref.com/en/players/aa8e289e/Nikola-Vlasic"
2023,"Torino","Serie A","Mërgim Vojvoda","KVX","DF","27",1995,19.1,22,12,15,6,1,12,24,50,12,14,2,12,10,32,31,1,"https://fbref.com/en/players/be2706c0/Mergim-Vojvoda"
2023,"Torino","Serie A","David Zima","CZE","DF","21",2000,4.5,9,5,5,4,0,3,4,75,1,7,2,5,9,18,11,2,"https://fbref.com/en/players/acf7e795/David-Zima"
2023,"Tottenham","Premier League","George Abbott","ENG","MF","16",2005,0,0,0,0,0,0,0,0,NA,0,0,0,0,1,1,0,0,"https://fbref.com/en/players/56628958/George-Abbott"
2023,"Tottenham","Premier League","Rodrigo Bentancur","URU","MF","25",1997,16.7,45,28,15,21,9,16,28,57.1,12,28,15,13,20,65,22,0,"https://fbref.com/en/players/3b8674e6/Rodrigo-Bentancur"
2023,"Tottenham","Premier League","Yves Bissouma","MLI","MF","25",1996,11.2,16,13,6,6,4,2,7,28.6,5,15,6,9,12,28,10,0,"https://fbref.com/en/players/6c203af0/Yves-Bissouma"
2023,"Tottenham","Premier League","Matthew Craig","SCO","MF","19",2003,0.2,4,1,2,2,0,0,0,NA,0,0,0,0,0,4,0,0,"https://fbref.com/en/players/bc914523/Matthew-Craig"
2023,"Tottenham","Premier League","Arnaut Danjuma","NED","FW,MF","25",1997,1.9,2,0,1,1,0,0,0,NA,0,1,0,1,0,2,0,0,"https://fbref.com/en/players/f08490a6/Arnaut-Danjuma"
2023,"Tottenham","Premier League","Ben Davies","WAL","DF","29",1993,25.4,28,11,13,13,2,14,26,53.8,12,17,8,9,18,46,72,0,"https://fbref.com/en/players/44781702/Ben-Davies"
2023,"Tottenham","Premier League","Eric Dier","ENG","DF","28",1994,31.3,30,19,16,12,2,9,19,47.4,10,41,24,17,35,65,112,2,"https://fbref.com/en/players/ac861941/Eric-Dier"
2023,"Tottenham","Premier League","Matt Doherty","IRL","DF,MF","30",1992,7.4,16,10,12,3,1,8,10,80,2,11,6,5,8,24,14,1,"https://fbref.com/en/players/d557d734/Matt-Doherty"
2023,"Tottenham","Premier League","Emerson","BRA","DF","23",1999,19.3,54,33,38,12,4,27,40,67.5,13,17,3,14,18,72,75,0,"https://fbref.com/en/players/df8b52a5/Emerson"
2023,"Tottenham","Premier League","Fraser Forster","ENG","GK","34",1988,13.5,1,0,1,0,0,0,0,NA,0,1,0,1,0,1,3,1,"https://fbref.com/en/players/c3e39f12/Fraser-Forster"
2023,"Tottenham","Premier League","Bryan Gil","ESP","MF,FW","21",2001,1.6,3,1,3,0,0,0,3,0,3,3,0,3,1,4,1,0,"https://fbref.com/en/players/7b5ab7f2/Bryan-Gil"
2023,"Tottenham","Premier League","Son Heung-min","KOR","MF,FW","30",1992,32.1,24,12,7,8,9,9,30,30,21,23,2,21,13,37,6,0,"https://fbref.com/en/players/92e7e919/Son-Heung-min"
2023,"Tottenham","Premier League","Pierre Højbjerg","DEN","MF","26",1995,34.8,56,30,28,22,6,26,67,38.8,41,46,17,29,49,105,64,1,"https://fbref.com/en/players/8b04d6c1/Pierre-Hojbjerg"
2023,"Tottenham","Premier League","Harry Kane","ENG","FW","29",1993,37.8,15,12,1,6,8,7,21,33.3,14,27,7,20,2,17,18,0,"https://fbref.com/en/players/21a66f6a/Harry-Kane"
2023,"Tottenham","Premier League","Dejan Kulusevski","SWE","MF,FW","22",2000,23,38,15,23,7,8,16,44,36.4,28,19,0,19,13,51,7,0,"https://fbref.com/en/players/df3cda47/Dejan-Kulusevski"
2023,"Tottenham","Premier League","Clément Lenglet","FRA","DF","27",1995,22.4,38,23,18,15,5,16,34,47.1,18,26,11,15,18,56,68,2,"https://fbref.com/en/players/4f28a6ff/Clement-Lenglet"
2023,"Tottenham","Premier League","Hugo Lloris","FRA","GK","35",1986,24.5,1,1,1,0,0,1,3,33.3,2,0,0,0,1,2,13,4,"https://fbref.com/en/players/8f62b6ee/Hugo-Lloris"
2023,"Tottenham","Premier League","Pape Matar Sarr","SEN","MF,FW","19",2002,2.4,7,6,4,2,1,4,8,50,4,3,2,1,6,13,6,0,"https://fbref.com/en/players/feb5d972/Pape-Matar-Sarr"
2023,"Tottenham","Premier League","Lucas Moura","BRA","MF,DF","29",1992,1.7,8,5,1,3,4,1,4,25,3,0,0,0,2,10,1,1,"https://fbref.com/en/players/2b622f01/Lucas-Moura"
2023,"Tottenham","Premier League","Ivan Perišić","CRO","DF,MF","33",1989,23.4,42,24,25,10,7,27,47,57.4,20,29,7,22,22,64,49,1,"https://fbref.com/en/players/6fe90922/Ivan-Perisic"
2023,"Tottenham","Premier League","Pedro Porro","ESP","DF,MF","22",1999,12.6,25,16,8,15,2,14,39,35.9,25,25,2,23,15,40,24,1,"https://fbref.com/en/players/27d0a506/Pedro-Porro"
2023,"Tottenham","Premier League","Richarlison","BRA","MF,FW","25",1997,11.2,21,16,13,5,3,12,27,44.4,15,14,1,13,5,26,10,0,"https://fbref.com/en/players/fa031b34/Richarlison"
2023,"Tottenham","Premier League","Cristian Romero","ARG","DF","24",1998,26.3,68,36,42,24,2,29,46,63,17,40,18,22,44,112,102,3,"https://fbref.com/en/players/a3d94a58/Cristian-Romero"
2023,"Tottenham","Premier League","Davinson Sánchez","COL","DF","26",1996,9.5,24,11,17,6,1,14,20,70,6,16,10,6,12,36,41,0,"https://fbref.com/en/players/da7b447d/Davinson-Sanchez"
2023,"Tottenham","Premier League","Ryan Sessegnon","ENG","DF","22",2000,9,16,11,9,7,0,6,12,50,6,8,1,7,6,22,17,1,"https://fbref.com/en/players/6aa3e78b/Ryan-Sessegnon"
2023,"Tottenham","Premier League","Oliver Skipp","ENG","MF","21",2000,16.6,34,17,18,15,1,16,33,48.5,17,17,8,9,17,51,19,1,"https://fbref.com/en/players/6250083a/Oliver-Skipp"
2023,"Tottenham","Premier League","Djed Spence","ENG","FW,DF","21",2000,0.1,0,0,0,0,0,0,0,NA,0,0,0,0,0,0,0,0,"https://fbref.com/en/players/9bc9a519/Djed-Spence"
2023,"Tottenham","Premier League","Japhet Tanganga","ENG","DF","23",1999,1.6,3,2,3,0,0,1,5,20,4,1,0,1,2,5,8,0,"https://fbref.com/en/players/e9971f2d/Japhet-Tanganga"
2023,"Tottenham","Premier League","Harvey White","ENG","MF","20",2001,0.1,0,0,0,0,0,0,1,0,1,0,0,0,0,0,0,0,"https://fbref.com/en/players/4d90ce8c/Harvey-White"
2023,"Toulouse","Ligue 1","Zakaria Aboukhlal","MAR","FW,MF","22",2000,27.5,33,23,13,9,11,14,45,31.1,31,18,1,17,22,55,23,0,"https://fbref.com/en/players/c2a6033c/Zakaria-Aboukhlal"
2023,"Toulouse","Ligue 1","Yanis Begraoui","MAR","FW,MF","21",2001,0.7,2,0,1,0,1,1,2,50,1,0,0,0,1,3,0,0,"https://fbref.com/en/players/5e6355f8/Yanis-Begraoui"
2023,"Toulouse","Ligue 1","Veljko Birmančević","SRB","FW,MF","24",1998,4.9,13,7,5,4,4,7,21,33.3,14,12,2,10,7,20,1,0,"https://fbref.com/en/players/636247ca/Veljko-Birmancevic"
2023,"Toulouse","Ligue 1","Fares Chaïbi","ALG","FW,MF","19",2002,26,31,18,8,15,8,17,50,34,33,38,5,33,19,50,36,1,"https://fbref.com/en/players/357103bd/Fares-Chaibi"
2023,"Toulouse","Ligue 1","Logan Costa","CPV","DF","21",2001,4.6,9,4,7,1,1,6,9,66.7,3,6,3,3,4,13,12,0,"https://fbref.com/en/players/bfb2056e/Logan-Costa"
2023,"Toulouse","Ligue 1","Thijs Dallinga","NED","FW","21",2000,26.1,NA,7,NA,NA,NA,NA,NA,NA,NA,NA,NA,NA,3,NA,NA,NA,"https://fbref.com/en/players/51590dff/Thijs-Dallinga"
2023,"Toulouse","Ligue 1","Brecht Dejaegere","BEL","MF","31",1991,20.1,40,23,10,20,10,15,51,29.4,36,25,5,20,14,54,11,0,"https://fbref.com/en/players/4ca4f601/Brecht-Dejaegere"
2023,"Toulouse","Ligue 1","Branco van den Boomen","NED","MF","27",1995,32.1,71,36,26,32,13,36,89,40.4,53,27,4,23,10,81,27,2,"https://fbref.com/en/players/99d660b2/Branco-van-den-Boomen"
2023,"Toulouse","Ligue 1","Mikkel Desler","DEN","DF","27",1995,25.1,71,38,36,27,8,43,67,64.2,24,35,6,29,36,107,48,2,"https://fbref.com/en/players/1d5c96f8/Mikkel-Desler"
2023,"Toulouse","Ligue 1","Moussa Diarra","MLI","DF","21",2000,13.6,20,9,9,9,2,9,15,60,6,25,10,15,19,39,27,1,"https://fbref.com/en/players/698f11e3/Moussa-Diarra"
2023,"Toulouse","Ligue 1","Maxime Dupé","FRA","GK","29",1993,38,0,0,0,0,0,0,0,NA,0,0,0,0,0,0,9,3,"https://fbref.com/en/players/0e12089d/Maxime-Dupe"
2023,"Toulouse","Ligue 1","Denis Genreau","AUS","MF","23",1999,7.3,35,13,16,12,7,13,31,41.9,18,16,1,15,8,43,9,0,"https://fbref.com/en/players/badcdcae/Denis-Genreau"
2023,"Toulouse","Ligue 1","Saïd Hamulic","BIH","FW","21",2000,1.2,0,0,0,0,0,0,0,NA,0,0,0,0,0,0,0,0,"https://fbref.com/en/players/52cd0e88/Said-Hamulic"
2023,"Toulouse","Ligue 1","Rhys Healey","WAL","FW","27",1994,0.7,0,0,0,0,0,0,0,NA,0,0,0,0,0,0,0,0,"https://fbref.com/en/players/07ace8c3/Rhys-Healey"
2023,"Toulouse","Ligue 1","Waren Kamanzi","NOR","DF","21",2000,7.4,16,9,9,5,2,13,19,68.4,6,8,2,6,8,24,9,0,"https://fbref.com/en/players/a426a912/Waren-Kamanzi"
2023,"Toulouse","Ligue 1","Kévin Keben Biakolo","CMR","DF","18",2004,4,3,2,2,0,1,0,4,0,4,1,0,1,5,8,9,0,"https://fbref.com/en/players/c43a8336/Kevin-Keben-Biakolo"
2023,"Toulouse","Ligue 1","Christian Mawissa","FRA","DF","17",2005,1.1,2,0,1,1,0,1,3,33.3,2,0,0,0,3,5,1,0,"https://fbref.com/en/players/2c70d915/Christian-Mawissa"
2023,"Toulouse","Ligue 1","Nathan N'Goumou","FRA","FW","22",2000,1,3,2,2,1,0,1,1,100,0,2,0,2,2,5,0,0,"https://fbref.com/en/players/e110ea4b/Nathan-NGoumou"
2023,"Toulouse","Ligue 1","Rasmus Nicolaisen","DEN","DF","25",1997,33.3,48,21,34,14,0,29,46,63,17,58,45,13,50,98,152,0,"https://fbref.com/en/players/3f319bb9/Rasmus-Nicolaisen"
2023,"Toulouse","Ligue 1","Ado Onaiwu","JPN","FW","26",1995,12,11,6,4,4,3,5,13,38.5,8,5,1,4,2,13,5,0,"https://fbref.com/en/players/ff4df82e/Ado-Onaiwu"
2023,"Toulouse","Ligue 1","Rafael Ratão","BRA","FW,MF","26",1995,20.6,52,36,29,16,7,27,73,37,46,34,0,34,21,73,7,0,"https://fbref.com/en/players/40ef7347/Rafael-Ratao"
2023,"Toulouse","Ligue 1","Anthony Rouault","FRA","DF","21",2001,36.8,66,37,54,10,2,30,58,51.7,28,52,26,26,56,122,126,4,"https://fbref.com/en/players/9b545925/Anthony-Rouault"
2023,"Toulouse","Ligue 1","Vincent Sierro","SUI","MF","26",1995,7.4,19,11,9,9,1,11,29,37.9,18,12,3,9,4,23,11,1,"https://fbref.com/en/players/92ffb8f9/Vincent-Sierro"
2023,"Toulouse","Ligue 1","Naatan Skyttä","FIN","MF","20",2002,0.3,0,0,0,0,0,0,0,NA,0,0,0,0,1,1,0,0,"https://fbref.com/en/players/d7547531/Naatan-Skytta"
2023,"Toulouse","Ligue 1","Stijn Spierings","NED","MF","26",1996,34.7,95,67,37,49,9,43,101,42.6,58,49,11,38,53,148,44,0,"https://fbref.com/en/players/a08985b8/Stijn-Spierings"
2023,"Toulouse","Ligue 1","Gabriel Suazo","CHI","DF","24",1997,14,38,22,20,15,3,29,63,46,34,21,5,16,22,60,24,1,"https://fbref.com/en/players/39b326ed/Gabriel-Suazo"
2023,"Toulouse","Ligue 1","Issiaga Sylla","GUI","DF","28",1994,15.2,28,15,14,9,5,15,34,44.1,19,15,5,10,38,66,38,0,"https://fbref.com/en/players/b99bec05/Issiaga-Sylla"
2023,"Toulouse","Ligue 1","Theocharis Tsingaras","GRE","MF","21",2000,0.1,0,0,0,0,0,0,0,NA,0,0,0,0,0,0,0,0,"https://fbref.com/en/players/906baf89/Theocharis-Tsingaras"
2023,"Toulouse","Ligue 1","Oliver Zandén","SWE","DF,MF","20",2001,1.6,2,1,1,0,1,2,5,40,3,0,0,0,1,3,7,0,"https://fbref.com/en/players/72d4922b/Oliver-Zanden"
2023,"Troyes","Ligue 1","Lucien Agoume","FRA","MF","20",2002,12.2,42,25,18,15,9,17,33,51.5,16,14,5,9,27,69,24,0,"https://fbref.com/en/players/8bc8829a/Lucien-Agoume"
2023,"Troyes","Ligue 1","Amar Ahmed","SWE","FW","18",2004,0.2,1,1,0,1,0,0,1,0,1,0,0,0,1,2,0,0,"https://fbref.com/en/players/22396615/Amar-Ahmed"
2023,"Troyes","Ligue 1","Thierno Balde","FRA","DF,MF","20",2002,23.9,27,14,19,4,4,18,30,60,12,15,3,12,23,50,39,0,"https://fbref.com/en/players/3975195f/Thierno-Balde"
2023,"Troyes","Ligue 1","Andreas Bruus","DEN","DF,FW","23",1999,18.1,12,6,9,3,0,8,20,40,12,13,2,11,17,29,24,0,"https://fbref.com/en/players/b088d5d3/Andreas-Bruus"
2023,"Troyes","Ligue 1","Xavier Chavalerin","FRA","MF","31",1991,27,82,50,39,30,13,27,71,38,44,31,8,23,41,123,24,0,"https://fbref.com/en/players/279ddf6a/Xavier-Chavalerin"
2023,"Troyes","Ligue 1","Abdu Conté","POR","DF","24",1998,14.6,25,17,14,8,3,12,22,54.5,10,13,6,7,6,31,25,0,"https://fbref.com/en/players/cfa49cc1/Abdu-Conte"
2023,"Troyes","Ligue 1","Tristan Dingomé","CMR","MF","31",1991,1.1,1,1,0,1,0,0,2,0,2,0,0,0,0,1,0,0,"https://fbref.com/en/players/92b56413/Tristan-Dingome"
2023,"Troyes","Ligue 1","Kyliane Dong","FRA","MF,FW","17",2004,2.4,3,1,0,2,1,1,2,50,1,1,0,1,1,4,0,0,"https://fbref.com/en/players/836dc4a8/Kyliane-Dong"
2023,"Troyes","Ligue 1","Jordan Dongmo","CMR","MF","21",2001,0.2,1,0,0,1,0,1,1,100,0,0,0,0,0,1,0,0,"https://fbref.com/en/players/1b5b32d2/Jordan-Dongmo"
2023,"Troyes","Ligue 1","Gauthier Gallon","FRA","GK","29",1993,29.6,2,2,2,0,0,2,4,50,2,0,0,0,2,4,17,0,"https://fbref.com/en/players/db3164e1/Gauthier-Gallon"
2023,"Troyes","Ligue 1","Mathis Hamdi","FRA","DF","18",2003,0.8,0,0,0,0,0,0,1,0,1,0,0,0,1,1,1,0,"https://fbref.com/en/players/a94571f6/Mathis-Hamdi"
2023,"Troyes","Ligue 1","Rudy Kohon","FRA","DF","18",2004,0.7,4,3,4,0,0,2,2,100,0,1,0,1,1,5,2,0,"https://fbref.com/en/players/9cd28348/Rudy-Kohon"
2023,"Troyes","Ligue 1","Rominigue Kouamé","MLI","MF","25",1996,29.6,44,27,28,14,2,17,41,41.5,24,32,11,21,49,93,46,1,"https://fbref.com/en/players/86a2ba20/Rominigue-Kouame"
2023,"Troyes","Ligue 1","Yasser Larouci","FRA","DF,MF","21",2001,20,23,13,13,8,2,15,24,62.5,9,15,1,14,26,49,46,0,"https://fbref.com/en/players/0ed063d6/Yasser-Larouci"
2023,"Troyes","Ligue 1","Mateusz Lis","POL","GK","25",1997,8.3,0,0,0,0,0,0,1,0,1,1,0,1,0,0,3,0,"https://fbref.com/en/players/fd78b105/Mateusz-Lis"
2023,"Troyes","Ligue 1","Rony Lopes","POR","MF,FW","26",1995,26.1,24,12,6,15,3,7,31,22.6,24,14,2,12,9,33,10,0,"https://fbref.com/en/players/7c2965bb/Rony-Lopes"
2023,"Troyes","Ligue 1","Derek Mazou-Sacko","FRA","MF","17",2004,0.2,0,0,0,0,0,0,1,0,1,1,0,1,1,1,1,0,"https://fbref.com/en/players/810edef9/Derek-Mazou-Sacko"
2023,"Troyes","Ligue 1","Marlos Moreno","COL","MF,DF","25",1996,0.1,2,2,2,0,0,2,3,66.7,1,1,1,0,0,2,0,0,"https://fbref.com/en/players/8499c713/Marlos-Moreno"
2023,"Troyes","Ligue 1","Papa Ndiaga Yade","SEN","DF,MF","22",2000,6.3,10,6,6,2,2,7,22,31.8,15,10,2,8,8,18,10,0,"https://fbref.com/en/players/87e9c7cd/Papa-Ndiaga-Yade"
2023,"Troyes","Ligue 1","Wilson Odobert","FRA","MF,FW","17",2004,19.6,20,14,10,7,3,9,25,36,16,11,0,11,15,35,5,0,"https://fbref.com/en/players/35516eac/Wilson-Odobert"
2023,"Troyes","Ligue 1","Ante Palaversa","CRO","MF","22",2000,0.3,1,1,1,0,0,0,0,NA,0,0,0,0,1,2,0,0,"https://fbref.com/en/players/cd9b37a3/Ante-Palaversa"
2023,"Troyes","Ligue 1","Erik Palmer-Brown","USA","DF","25",1997,35.5,42,27,31,10,1,18,33,54.5,15,56,29,27,26,68,166,1,"https://fbref.com/en/players/e5c1e0ca/Erik-Palmer-Brown"
2023,"Troyes","Ligue 1","Jackson Porozo","ECU","DF","21",2000,18,32,20,24,7,1,13,31,41.9,18,24,17,7,33,65,75,0,"https://fbref.com/en/players/7d704e92/Jackson-Porozo"
2023,"Troyes","Ligue 1","Adil Rami","FRA","DF","36",1985,17.7,19,14,13,5,1,17,32,53.1,15,23,16,7,25,44,75,3,"https://fbref.com/en/players/8dbff17c/Adil-Rami"
2023,"Troyes","Ligue 1","Jeff Reine-Adélaïde","FRA","MF","24",1998,2.6,3,2,2,1,0,1,2,50,1,2,0,2,2,5,1,0,"https://fbref.com/en/players/d504b3e1/Jeff-Reine-Adelaide"
2023,"Troyes","Ligue 1","Renaud Ripart","FRA","FW,MF","29",1993,14.7,40,23,14,20,6,19,52,36.5,33,29,2,27,7,47,5,0,"https://fbref.com/en/players/beae3a73/Renaud-Ripart"
2023,"Troyes","Ligue 1","Yoann Salmier","GUF","DF","29",1992,29.4,51,29,34,12,5,21,35,60,14,34,19,15,39,90,124,0,"https://fbref.com/en/players/c3725db2/Yoann-Salmier"
2023,"Troyes","Ligue 1","Mama Samba Baldé","GNB","FW","26",1995,29.6,46,21,14,21,11,13,28,46.4,15,30,3,27,10,56,13,0,"https://fbref.com/en/players/fb14aa28/Mama-Samba-Balde"
2023,"Troyes","Ligue 1","Florian Tardieu","FRA","MF","30",1992,11.2,31,20,19,12,0,12,31,38.7,19,19,4,15,23,54,15,0,"https://fbref.com/en/players/ed39121c/Florian-Tardieu"
2023,"Troyes","Ligue 1","Alexis Tibidi","FRA","FW,MF","18",2003,0.8,1,1,1,0,0,0,0,NA,0,0,0,0,0,1,0,0,"https://fbref.com/en/players/ca6f4846/Alexis-Tibidi"
2023,"Troyes","Ligue 1","Ike Ugbo","CAN","FW,MF","23",1998,9.9,5,2,2,2,1,3,11,27.3,8,8,2,6,2,7,4,0,"https://fbref.com/en/players/8a53d24b/Ike-Ugbo"
2023,"Troyes","Ligue 1","Tanguy Zoukrou","FRA","DF","19",2003,5.7,14,7,8,6,0,10,14,71.4,4,18,11,7,2,16,24,0,"https://fbref.com/en/players/aefa3050/Tanguy-Zoukrou"
2023,"Udinese","Serie A","James Abankwah","IRL","DF","18",2004,0.7,1,1,0,1,0,0,0,NA,0,4,2,2,0,1,5,0,"https://fbref.com/en/players/4b7a9fcc/James-Abankwah"
2023,"Udinese","Serie A","Tolgay Arslan","GER","MF","31",1990,13.5,29,18,13,15,1,14,39,35.9,25,19,0,19,12,41,9,1,"https://fbref.com/en/players/963a328b/Tolgay-Arslan"
2023,"Udinese","Serie A","Rodrigo Becão","BRA","DF","26",1996,27.6,70,36,50,17,3,40,53,75.5,13,44,24,20,26,96,68,2,"https://fbref.com/en/players/19e4eab9/Rodrigo-Becao"
2023,"Udinese","Serie A","Beto","GNB","FW","24",1998,23.7,16,9,0,9,7,4,17,23.5,13,18,3,15,6,22,30,0,"https://fbref.com/en/players/ed5c0319/Beto"
2023,"Udinese","Serie A","Jaka Bijol","SVN","DF","23",1999,30.3,39,23,32,7,0,16,27,59.3,11,41,25,16,29,68,165,0,"https://fbref.com/en/players/6fdac234/Jaka-Bijol"
2023,"Udinese","Serie A","Leonardo Buta","POR","DF","20",2002,0.2,1,1,0,1,0,0,0,NA,0,0,0,0,0,1,0,0,"https://fbref.com/en/players/dee3d535/Leonardo-Buta"
2023,"Udinese","Serie A","Nicolò Cocetta","ITA","DF","18",2003,0.4,0,0,0,0,0,0,1,0,1,1,1,0,1,1,1,0,"https://fbref.com/en/players/1faa06d5/Nicolo-Cocetta"
2023,"Udinese","Serie A","Gerard Deulofeu","ESP","FW","28",1994,13.5,8,5,5,1,2,5,15,33.3,10,8,1,7,2,10,1,0,"https://fbref.com/en/players/39583cfd/Gerard-Deulofeu"
2023,"Udinese","Serie A","Festy Ebosele","IRL","DF","19",2002,4.6,15,10,8,7,0,4,10,40,6,5,0,5,2,17,5,0,"https://fbref.com/en/players/dbfa4f16/Festy-Ebosele"
2023,"Udinese","Serie A","Enzo Ebosse","CMR","DF","23",1999,10.3,15,9,11,4,0,9,13,69.2,4,27,6,21,11,26,29,0,"https://fbref.com/en/players/9ba7b4fa/Enzo-Ebosse"
2023,"Udinese","Serie A","Kingsley Ehizibue","NED","DF","27",1995,17.1,47,31,28,13,6,29,45,64.4,16,21,3,18,10,57,42,1,"https://fbref.com/en/players/76b2817e/Kingsley-Ehizibue"
2023,"Udinese","Serie A","Axel Guessand","FRA","DF","17",2004,0.9,2,1,2,0,0,1,2,50,1,1,0,1,2,4,3,0,"https://fbref.com/en/players/e04dca4a/Axel-Guessand"
2023,"Udinese","Serie A","Mato Jajalo","BIH","MF","34",1988,0.7,0,0,0,0,0,0,1,0,1,0,0,0,0,0,2,0,"https://fbref.com/en/players/8c65eb5f/Mato-Jajalo"
2023,"Udinese","Serie A","Sandi Lovrić","SVN","MF","24",1998,25.9,40,18,16,16,8,25,43,58.1,18,25,2,23,26,66,21,0,"https://fbref.com/en/players/966eea58/Sandi-Lovric"
2023,"Udinese","Serie A","Jean-Victor Makengo","FRA","MF","24",1998,8.9,16,13,7,7,2,5,9,55.6,4,8,2,6,9,25,3,0,"https://fbref.com/en/players/22bfb57e/Jean-Victor-Makengo"
2023,"Udinese","Serie A","Adam Masina","MAR","DF","28",1994,8.8,10,7,7,3,0,6,15,40,9,11,4,7,10,20,28,1,"https://fbref.com/en/players/de0f152c/Adam-Masina"
2023,"Udinese","Serie A","Ilija Nestorovski","MKD","FW,MF","32",1990,7.1,7,3,2,1,4,5,11,45.5,6,6,1,5,2,9,10,0,"https://fbref.com/en/players/b1236c63/Ilija-Nestorovski"
2023,"Udinese","Serie A","Bram Nuytinck","NED","DF","32",1990,4.3,7,4,3,4,0,4,8,50,4,6,6,0,5,12,22,0,"https://fbref.com/en/players/e33f36d5/Bram-Nuytinck"
2023,"Udinese","Serie A","Simone Pafundi","ITA","MF,FW","16",2006,0.9,8,5,1,5,2,2,4,50,2,0,0,0,1,9,0,0,"https://fbref.com/en/players/8daee720/Simone-Pafundi"
2023,"Udinese","Serie A","Roberto Pereyra","ARG","DF,MF","31",1991,31.3,36,20,21,12,3,16,44,36.4,28,20,5,15,16,52,28,0,"https://fbref.com/en/players/75f2c59f/Roberto-Pereyra"
2023,"Udinese","Serie A","Nehuén Pérez","ARG","DF","22",2000,31.3,77,40,54,20,3,39,55,70.9,16,53,23,30,35,112,106,1,"https://fbref.com/en/players/f7c491f1/Nehuen-Perez"
2023,"Udinese","Serie A","Lazar Samardzic","SRB","MF","20",2002,20.5,33,16,9,20,4,17,43,39.5,26,13,0,13,11,44,16,0,"https://fbref.com/en/players/217c93a1/Lazar-Samardzic"
2023,"Udinese","Serie A","Vivaldo Semedo","POR","FW,MF","17",2005,0.4,0,0,0,0,0,0,0,NA,0,1,0,1,0,0,1,0,"https://fbref.com/en/players/b6baba31/Vivaldo-Semedo"
2023,"Udinese","Serie A","Marco Silvestri","ITA","GK","31",1991,38,2,1,2,0,0,2,3,66.7,1,0,0,0,1,3,15,1,"https://fbref.com/en/players/0d422df7/Marco-Silvestri"
2023,"Udinese","Serie A","Brandon Soppy","FRA","DF","20",2002,1,1,1,0,1,0,0,0,NA,0,4,0,4,1,2,1,0,"https://fbref.com/en/players/28f66c2e/Brandon-Soppy"
2023,"Udinese","Serie A","Isaac Success","NGA","FW","26",1996,20.2,8,4,2,5,1,3,8,37.5,5,13,2,11,4,12,18,0,"https://fbref.com/en/players/f573a8bf/Isaac-Success"
2023,"Udinese","Serie A","Florian Thauvin","FRA","FW,MF","29",1993,6.1,2,1,0,2,0,2,13,15.4,11,5,0,5,2,4,2,0,"https://fbref.com/en/players/2b9fdeea/Florian-Thauvin"
2023,"Udinese","Serie A","Iyenoma Udogie","ITA","DF","19",2002,30,71,45,42,24,5,34,59,57.6,25,34,6,28,36,107,25,0,"https://fbref.com/en/players/7cd520e8/Iyenoma-Udogie"
2023,"Udinese","Serie A","Walace","BRA","MF","27",1995,35.4,82,39,42,31,9,41,90,45.6,49,47,12,35,51,133,51,1,"https://fbref.com/en/players/26db8853/Walace"
2023,"Udinese","Serie A","Marvin Zeegelaar","NED","DF","31",1990,3.9,8,4,6,2,0,3,4,75,1,2,0,2,3,11,5,0,"https://fbref.com/en/players/8abd0c03/Marvin-Zeegelaar"
2023,"Union Berlin","Bundesliga","Timo Baumgartl","GER","DF","26",1996,6.2,11,6,5,4,2,5,18,27.8,13,12,4,8,2,13,14,0,"https://fbref.com/en/players/bd7d2e6d/Timo-Baumgartl"
2023,"Union Berlin","Bundesliga","Sheraldo Becker","SUR","FW","27",1995,28.4,15,5,1,7,7,2,11,18.2,9,13,1,12,3,18,7,1,"https://fbref.com/en/players/8eb55dbb/Sheraldo-Becker"
2023,"Union Berlin","Bundesliga","Kevin Behrens","GER","FW","31",1991,17.1,11,7,4,4,3,4,18,22.2,14,18,3,15,5,16,25,0,"https://fbref.com/en/players/30ae134d/Kevin-Behrens"
2023,"Union Berlin","Bundesliga","Danilho Doekhi","NED","DF","24",1998,24.6,38,23,21,17,0,14,26,53.8,12,27,12,15,29,67,93,0,"https://fbref.com/en/players/f67c9d29/Danilho-Doekhi"
2023,"Union Berlin","Bundesliga","Niko Gießelmann","GER","DF","30",1991,14.5,21,11,9,9,3,13,31,41.9,18,17,5,12,9,30,28,0,"https://fbref.com/en/players/7242b495/Niko-Giesselmann"
2023,"Union Berlin","Bundesliga","Lennart Grill","GER","GK","23",1999,5,0,0,0,0,0,0,1,0,1,0,0,0,0,0,1,1,"https://fbref.com/en/players/37998008/Lennart-Grill"
2023,"Union Berlin","Bundesliga","Janik Haberer","GER","MF","28",1994,24.3,29,17,8,18,3,17,48,35.4,31,35,2,33,14,43,25,0,"https://fbref.com/en/players/70dcf94d/Janik-Haberer"
2023,"Union Berlin","Bundesliga","Genki Haraguchi","JPN","MF","31",1991,5.5,12,8,1,10,1,3,9,33.3,6,7,1,6,3,15,9,0,"https://fbref.com/en/players/f24ea523/Genki-Haraguchi"
2023,"Union Berlin","Bundesliga","Paul Jaeckel","GER","DF","24",1998,13.3,24,18,11,11,2,17,35,48.6,18,11,5,6,19,43,44,1,"https://fbref.com/en/players/a93b6f4e/Paul-Jaeckel"
2023,"Union Berlin","Bundesliga","Josip Juranović","CRO","DF","26",1995,10.4,9,7,5,2,2,7,18,38.9,11,9,3,6,6,15,22,1,"https://fbref.com/en/players/0a084b35/Josip-Juranovic"
2023,"Union Berlin","Bundesliga","Rani Khedira","GER","MF","28",1994,32,60,33,21,32,7,25,50,50,25,33,10,23,40,100,33,0,"https://fbref.com/en/players/59e4b92e/Rani-Khedira"
2023,"Union Berlin","Bundesliga","Robin Knoche","GER","DF","30",1992,31.9,45,29,29,12,4,24,47,51.1,23,35,18,17,38,83,140,0,"https://fbref.com/en/players/6bd5cd5d/Robin-Knoche"
2023,"Union Berlin","Bundesliga","Aïssa Laïdouni","TUN","MF","25",1996,9.7,14,7,6,8,0,5,17,29.4,12,22,4,18,9,23,3,0,"https://fbref.com/en/players/22798128/Aissa-Laidouni"
2023,"Union Berlin","Bundesliga","Diogo Leite","POR","DF","23",1999,25,35,20,21,14,0,21,34,61.8,13,23,14,9,26,61,99,1,"https://fbref.com/en/players/c4987edc/Diogo-Leite"
2023,"Union Berlin","Bundesliga","Jamie Leweling","GER","FW,MF","21",2001,2.9,5,3,2,2,1,3,5,60,2,3,0,3,1,6,0,0,"https://fbref.com/en/players/13fe7b69/Jamie-Leweling"
2023,"Union Berlin","Bundesliga","Sven Michel","GER","FW,MF","32",1990,5.5,9,5,1,5,3,4,8,50,4,5,1,4,0,9,4,0,"https://fbref.com/en/players/1e274a0a/Sven-Michel"
2023,"Union Berlin","Bundesliga","Levin Öztunalı","GER","MF","26",1996,0.1,0,0,0,0,0,0,1,0,1,0,0,0,0,0,0,0,"https://fbref.com/en/players/66385c46/Levin-Oztunali"
2023,"Union Berlin","Bundesliga","Miloš Pantović","SRB","MF","26",1996,2.3,4,2,4,0,0,3,5,60,2,3,0,3,0,4,5,0,"https://fbref.com/en/players/5dc15574/Milos-Pantovic"
2023,"Union Berlin","Bundesliga","Jordan Pefok","USA","FW","26",1996,15.1,15,7,3,4,8,2,17,11.8,15,17,5,12,4,19,15,0,"https://fbref.com/en/players/b684a484/Jordan-Pefok"
2023,"Union Berlin","Bundesliga","Tymoteusz Puchacz","POL","DF","23",1999,0.6,1,0,1,0,0,0,0,NA,0,0,0,0,0,1,1,0,"https://fbref.com/en/players/c68b1b13/Tymoteusz-Puchacz"
2023,"Union Berlin","Bundesliga","Jérôme Roussillon","FRA","DF","29",1993,10.6,16,9,6,8,2,8,12,66.7,4,7,2,5,4,20,22,0,"https://fbref.com/en/players/13203c45/Jerome-Roussillon"
2023,"Union Berlin","Bundesliga","Julian Ryerson","NOR","DF","24",1997,11.5,28,17,17,10,1,15,25,60,10,15,3,12,12,40,19,0,"https://fbref.com/en/players/009a4f60/Julian-Ryerson"
2023,"Union Berlin","Bundesliga","Frederik Rønnow","DEN","GK","29",1992,29,0,0,0,0,0,0,5,0,5,0,0,0,0,0,9,1,"https://fbref.com/en/players/a70b8345/Frederik-Ronnow"
2023,"Union Berlin","Bundesliga","András Schäfer","HUN","MF","23",1999,9.6,21,9,7,12,2,6,14,42.9,8,12,2,10,4,25,11,0,"https://fbref.com/en/players/049751d7/Andras-Schafer"
2023,"Union Berlin","Bundesliga","Paul Seguin","GER","MF","27",1995,7.7,17,8,9,4,4,8,18,44.4,10,6,0,6,6,23,7,0,"https://fbref.com/en/players/8872ed17/Paul-Seguin"
2023,"Union Berlin","Bundesliga","Tim Skarke","GER","DF,MF","25",1996,0.6,1,1,0,0,1,0,0,NA,0,1,0,1,0,1,0,0,"https://fbref.com/en/players/65857fdf/Tim-Skarke"
2023,"Union Berlin","Bundesliga","Morten Thorsby","NOR","MF","26",1996,9.3,22,10,9,11,2,13,21,61.9,8,11,5,6,3,25,20,0,"https://fbref.com/en/players/d1b49282/Morten-Thorsby"
2023,"Union Berlin","Bundesliga","Christopher Trimmel","AUT","DF","35",1987,20.1,31,16,16,12,3,20,31,64.5,11,14,1,13,25,56,48,0,"https://fbref.com/en/players/056d2d95/Christopher-Trimmel"
2023,"Valencia","La Liga","Domingos André Ribeiro Almeida","POR","MF","22",2000,28.2,66,42,23,32,11,26,57,45.6,31,26,0,26,20,86,16,1,"https://fbref.com/en/players/e6697917/Domingos-Andre-Ribeiro-Almeida"
2023,"Valencia","La Liga","Samu Castillejo","ESP","FW,MF","27",1995,15.1,21,12,8,9,4,8,40,20,32,21,2,19,9,30,2,0,"https://fbref.com/en/players/130a7a3f/Samu-Castillejo"
2023,"Valencia","La Liga","Edinson Cavani","URU","FW","35",1987,16.1,7,4,3,3,1,3,15,20,12,10,3,7,2,9,11,0,"https://fbref.com/en/players/527f063d/Edinson-Cavani"
2023,"Valencia","La Liga","Eray Cömert","SUI","DF","24",1998,18.6,35,23,24,10,1,17,33,51.5,16,23,8,15,29,64,76,1,"https://fbref.com/en/players/15937e17/Eray-Comert"
2023,"Valencia","La Liga","Thierry Correia","POR","DF","23",1999,22.3,71,52,46,22,3,31,54,57.4,23,25,2,23,24,95,54,2,"https://fbref.com/en/players/c78b352d/Thierry-Correia"
2023,"Valencia","La Liga","Mouctar Diakhaby","GUI","DF","25",1996,27.2,30,16,19,11,0,13,20,65,7,30,17,13,20,50,111,2,"https://fbref.com/en/players/d2110326/Mouctar-Diakhaby"
2023,"Valencia","La Liga","Hugo Duro","ESP","FW","22",1999,15.4,15,12,2,6,7,7,17,41.2,10,11,1,10,2,17,7,1,"https://fbref.com/en/players/37e103f8/Hugo-Duro"
2023,"Valencia","La Liga","Dimitri Foulquier","FRA","DF","29",1993,19.3,31,19,17,8,6,20,28,71.4,8,19,3,16,14,45,40,0,"https://fbref.com/en/players/45e17712/Dimitri-Foulquier"
2023,"Valencia","La Liga","Maxi Gómez","URU","FW","25",1996,1.2,0,0,0,0,0,0,0,NA,0,0,0,0,0,0,2,0,"https://fbref.com/en/players/4c2e9442/Maxi-Gomez"
2023,"Valencia","La Liga","Nicolás González","ESP","MF","20",2002,15.6,27,15,11,13,3,9,25,36,16,21,7,14,19,46,16,0,"https://fbref.com/en/players/2c56a792/Nicolas-Gonzalez"
2023,"Valencia","La Liga","Javier Guerra","ESP","MF","19",2003,6.7,16,13,7,4,5,9,20,45,11,8,1,7,11,27,9,0,"https://fbref.com/en/players/3828f130/Javier-Guerra"
2023,"Valencia","La Liga","Justin Kluivert","NED","FW,MF","23",1999,16.1,17,14,7,4,6,6,12,50,6,4,0,4,7,24,4,0,"https://fbref.com/en/players/4c3a6744/Justin-Kluivert"
2023,"Valencia","La Liga","Toni Lato","ESP","DF,MF","24",1997,10.2,23,11,9,12,2,9,21,42.9,12,10,1,9,6,29,14,0,"https://fbref.com/en/players/8e088e04/Toni-Lato"
2023,"Valencia","La Liga","José Luis Gayà","ESP","DF","27",1995,30.1,80,46,61,16,3,43,74,58.1,31,28,9,19,23,103,48,0,"https://fbref.com/en/players/b05e2dbd/Jose-Luis-Gaya"
2023,"Valencia","La Liga","Giorgi Mamardashvili","GEO","GK","21",2000,38,0,0,0,0,0,0,0,NA,0,0,0,0,1,1,11,4,"https://fbref.com/en/players/d4b73232/Giorgi-Mamardashvili"
2023,"Valencia","La Liga","Maranhão","BRA","FW,MF","25",1996,5,4,1,1,1,2,1,2,50,1,4,1,3,0,4,0,0,"https://fbref.com/en/players/ae86d473/Maranhao"
2023,"Valencia","La Liga","Alberto Marí","ESP","FW,MF","21",2001,1,0,0,0,0,0,0,2,0,2,0,0,0,0,0,1,0,"https://fbref.com/en/players/44330c36/Alberto-Mari"
2023,"Valencia","La Liga","Ilaix Moriba","GUI","MF","19",2003,11.2,35,16,14,17,4,14,24,58.3,10,11,1,10,4,39,12,0,"https://fbref.com/en/players/f4c69aa6/Ilaix-Moriba"
2023,"Valencia","La Liga","Cristhian Mosquera","COL","DF","18",2004,1.6,4,2,3,1,0,4,5,80,1,1,0,1,1,5,5,0,"https://fbref.com/en/players/dc1ce4f5/Cristhian-Mosquera"
2023,"Valencia","La Liga","Yunus Musah","USA","MF","19",2002,23.4,48,35,17,23,8,20,30,66.7,10,20,1,19,11,59,16,2,"https://fbref.com/en/players/b51b1b9c/Yunus-Musah"
2023,"Valencia","La Liga","Diego Noguerol","ESP","FW,MF","20",2002,5,2,2,1,1,0,2,15,13.3,13,9,0,9,3,5,5,0,"https://fbref.com/en/players/c487901c/Diego-Noguerol"
2023,"Valencia","La Liga","Cenk Özkacar","TUR","DF","21",2000,15.2,27,20,17,10,0,14,19,73.7,5,14,2,12,12,39,47,4,"https://fbref.com/en/players/9a93efc9/Cenk-Ozkacar"
2023,"Valencia","La Liga","Gabriel Paulista","BRA","DF","31",1990,16.7,17,9,13,4,0,13,19,68.4,6,22,14,8,32,49,79,2,"https://fbref.com/en/players/b7ca5c51/Gabriel-Paulista"
2023,"Valencia","La Liga","Francisco Perez","ESP","FW,MF","19",2002,1.6,1,1,1,0,0,0,3,0,3,0,0,0,0,1,1,0,"https://fbref.com/en/players/3d79a68c/Francisco-Perez"
2023,"Valencia","La Liga","Samuel","BRA","FW,MF","22",1999,32.1,66,43,17,37,12,26,72,36.1,46,34,0,34,18,84,16,0,"https://fbref.com/en/players/2a295d33/Samuel"
2023,"Valencia","La Liga","Carlos Soler","ESP","MF","25",1997,2.7,2,0,0,1,1,2,3,66.7,1,1,0,1,0,2,2,0,"https://fbref.com/en/players/fed17f5a/Carlos-Soler"
2023,"Valencia","La Liga","Jesus Vazquez","ESP","DF,MF","19",2003,3.4,13,8,9,1,3,6,11,54.5,5,4,0,4,1,14,8,0,"https://fbref.com/en/players/106c142c/Jesus-Vazquez"
2023,"Valencia","La Liga","Hugo Guillamón","","DF,MF","22",2000,18.1,NA,14,NA,NA,NA,NA,NA,NA,NA,NA,NA,NA,19,NA,NA,NA,"https://fbref.com/en/players/45d96179/Hugo-Guillamon"
2023,"Valladolid","La Liga","Álvaro Aceves","ESP","GK","19",2003,0.1,0,0,0,0,0,0,0,NA,0,0,0,0,0,0,0,0,"https://fbref.com/en/players/be6faae0/Alvaro-Aceves"
2023,"Valladolid","La Liga","Álvaro Aguado","ESP","MF","26",1996,21,27,15,13,11,3,15,25,60,10,16,4,12,13,40,15,0,"https://fbref.com/en/players/014aa7bd/Alvaro-Aguado"
2023,"Valladolid","La Liga","Babatunde Akinsola","NGA","FW","19",2003,0.1,1,1,0,0,1,0,0,NA,0,0,0,0,0,1,0,0,"https://fbref.com/en/players/733aab44/Babatunde-Akinsola"
2023,"Valladolid","La Liga","Selim Amallah","MAR","MF,FW","25",1996,3,15,9,7,8,0,5,8,62.5,3,2,0,2,5,20,2,0,"https://fbref.com/en/players/00eba9c9/Selim-Amallah"
2023,"Valladolid","La Liga","Anuar","MAR","MF,FW","27",1995,2.3,4,4,0,1,3,0,0,NA,0,5,2,3,3,7,3,0,"https://fbref.com/en/players/c93231dc/Anuar"
2023,"Valladolid","La Liga","Roberto Arroyo","ESP","MF","18",2003,0.2,1,1,0,1,0,1,1,100,0,0,0,0,0,1,0,0,"https://fbref.com/en/players/6091cf45/Roberto-Arroyo"
2023,"Valladolid","La Liga","Sergio Asenjo","ESP","GK","33",1989,10,0,0,0,0,0,0,0,NA,0,0,0,0,0,0,10,2,"https://fbref.com/en/players/9f0ea33f/Sergio-Asenjo"
2023,"Valladolid","La Liga","Sergio Escudero","ESP","DF","32",1989,16,33,19,21,8,4,15,35,42.9,20,26,6,20,26,59,46,0,"https://fbref.com/en/players/b0616e3d/Sergio-Escudero"
2023,"Valladolid","La Liga","Zouhair Feddal","MAR","DF","33",1989,4.2,4,2,1,3,0,3,4,75,1,9,9,0,5,9,27,0,"https://fbref.com/en/players/89151b16/Zouhair-Feddal"
2023,"Valladolid","La Liga","Joaquín Fernández","ESP","DF","26",1996,24,35,28,20,11,4,19,30,63.3,11,31,22,9,27,62,98,1,"https://fbref.com/en/players/b86a64b2/Joaquin-Fernandez"
2023,"Valladolid","La Liga","Iván Fresneda","ESP","DF","17",2004,19.4,48,34,31,13,4,29,47,61.7,18,32,8,24,15,63,60,0,"https://fbref.com/en/players/29d0f2ac/Ivan-Fresneda"
2023,"Valladolid","La Liga","Sékou Gassama","SEN","FW","27",1995,0.4,0,0,0,0,0,0,0,NA,0,0,0,0,0,0,0,0,"https://fbref.com/en/players/475a738b/Sekou-Gassama"
2023,"Valladolid","La Liga","Sergi Guardiola","ESP","FW","31",1991,5.6,12,7,6,5,1,2,4,50,2,6,0,6,2,14,7,0,"https://fbref.com/en/players/32974271/Sergi-Guardiola"
2023,"Valladolid","La Liga","Martin Hongla","CMR","DF,MF","24",1998,14.5,18,13,13,5,0,11,21,52.4,10,15,12,3,8,26,46,1,"https://fbref.com/en/players/b85bf253/Martin-Hongla"
2023,"Valladolid","La Liga","Kenedy","BRA","FW,DF","26",1996,3.1,6,2,3,3,0,2,4,50,2,2,0,2,1,7,0,0,"https://fbref.com/en/players/5eebbfdf/Kenedy"
2023,"Valladolid","La Liga","Cyle Larin","CAN","FW","27",1995,16.3,9,3,2,4,3,3,7,42.9,4,6,3,3,0,9,15,0,"https://fbref.com/en/players/e7af9060/Cyle-Larin"
2023,"Valladolid","La Liga","Sergio León","ESP","FW","33",1989,14.8,6,4,0,4,2,3,6,50,3,6,0,6,0,6,4,0,"https://fbref.com/en/players/0a0cc13c/Sergio-Leon"
2023,"Valladolid","La Liga","Darwin Machís","VEN","FW","29",1993,6.7,3,2,0,2,1,1,8,12.5,7,5,0,5,3,6,4,0,"https://fbref.com/en/players/ed6ea4d9/Darwin-Machis"
2023,"Valladolid","La Liga","Mickael Malsa","MTQ","MF","26",1995,0.8,2,2,1,1,0,1,4,25,3,1,1,0,2,4,3,0,"https://fbref.com/en/players/bbc19252/Mickael-Malsa"
2023,"Valladolid","La Liga","Jordi Masip","ESP","GK","33",1989,27.9,0,0,0,0,0,0,2,0,2,0,0,0,1,1,3,2,"https://fbref.com/en/players/8fae77ea/Jordi-Masip"
2023,"Valladolid","La Liga","Roque Mesa","ESP","MF","33",1989,18,27,15,16,10,1,12,38,31.6,26,16,4,12,13,40,18,0,"https://fbref.com/en/players/7c4243d4/Roque-Mesa"
2023,"Valladolid","La Liga","Monchu","ESP","MF","22",1999,22.6,50,29,20,21,9,19,46,41.3,27,28,11,17,18,68,22,1,"https://fbref.com/en/players/8ac501f5/Monchu"
2023,"Valladolid","La Liga","Juanjo Narváez","COL","MF,FW","27",1995,1.6,1,1,1,0,0,1,1,100,0,2,0,2,0,1,0,0,"https://fbref.com/en/players/485e4939/Juanjo-Narvaez"
2023,"Valladolid","La Liga","Lucas Olaza","URU","DF","28",1994,16.6,24,14,12,10,2,17,26,65.4,9,20,8,12,14,38,34,0,"https://fbref.com/en/players/4cee5954/Lucas-Olaza"
2023,"Valladolid","La Liga","Lucas Oliveira Rosa","BRA","DF","22",2000,10.3,39,18,23,10,6,12,20,60,8,12,2,10,15,54,24,0,"https://fbref.com/en/players/5132b92c/Lucas-Oliveira-Rosa"
2023,"Valladolid","La Liga","Kike Pérez","ESP","MF","25",1997,25.6,67,33,30,32,5,25,68,36.8,43,26,7,19,20,87,28,0,"https://fbref.com/en/players/237a3851/Kike-Perez"
2023,"Valladolid","La Liga","Luis Pérez","ESP","DF","27",1995,13.5,44,24,26,12,6,27,38,71.1,11,13,4,9,16,60,29,0,"https://fbref.com/en/players/b7c04927/Luis-Perez"
2023,"Valladolid","La Liga","Óscar Plano","ESP","FW,MF","31",1991,22.6,40,25,9,17,14,12,37,32.4,25,26,2,24,29,69,23,0,"https://fbref.com/en/players/7c388b20/Oscar-Plano"
2023,"Valladolid","La Liga","Gonzalo Plata","ECU","FW","21",2000,25.6,66,35,31,24,11,23,70,32.9,47,40,0,40,12,78,10,1,"https://fbref.com/en/players/54bcdeb0/Gonzalo-Plata"
2023,"Valladolid","La Liga","Manuel Pozo","ESP","FW","20",2001,0.2,0,0,0,0,0,0,0,NA,0,2,0,2,2,2,0,0,"https://fbref.com/en/players/35440884/Manuel-Pozo"
2023,"Valladolid","La Liga","Iván Sánchez","ESP","MF,FW","29",1992,12.8,20,14,8,8,4,10,27,37,17,14,1,13,8,28,4,0,"https://fbref.com/en/players/70107d4d/Ivan-Sanchez"
2023,"Valladolid","La Liga","Javi Sánchez","ESP","DF","25",1997,26.6,43,26,27,15,1,17,26,65.4,9,32,22,10,46,89,116,0,"https://fbref.com/en/players/60359288/Javi-Sanchez"
2023,"Valladolid","La Liga","David Torres","ESP","DF","19",2003,4.3,1,1,0,1,0,1,1,100,0,4,2,2,3,4,8,0,"https://fbref.com/en/players/381dbcfc/David-Torres"
2023,"Valladolid","La Liga","Toni Villa","ESP","MF","27",1995,1,6,3,2,3,1,4,9,44.4,5,0,0,0,0,6,0,0,"https://fbref.com/en/players/636eae97/Toni-Villa"
2023,"Valladolid","La Liga","Shon Weissman","ISR","FW","26",1996,8.3,2,1,1,1,0,0,4,0,4,8,0,8,1,3,7,0,"https://fbref.com/en/players/379dc075/Shon-Weissman"
2023,"Valladolid","La Liga","Jawad El Yamiq","MAR","DF","30",1992,17.9,17,11,10,7,0,6,11,54.5,5,27,19,8,37,54,101,0,"https://fbref.com/en/players/f6f6b6e8/Jawad-El-Yamiq"
2023,"Villarreal","La Liga","Raúl Albiol","ESP","DF","36",1985,23.5,25,17,17,6,2,14,18,77.8,4,17,13,4,14,39,111,0,"https://fbref.com/en/players/4bd414c1/Raul-Albiol"
2023,"Villarreal","La Liga","Alex Baena","ESP","MF,FW","21",2001,21.6,30,17,9,15,6,15,45,33.3,30,15,3,12,7,37,16,0,"https://fbref.com/en/players/518f2234/Alex-Baena"
2023,"Villarreal","La Liga","Étienne Capoue","FRA","MF","34",1988,21.7,21,12,6,13,2,10,18,55.6,8,12,5,7,19,40,20,1,"https://fbref.com/en/players/5acc4a10/Etienne-Capoue"
2023,"Villarreal","La Liga","Samuel Chukwueze","NGA","FW,MF","23",1999,26,14,7,7,2,5,7,23,30.4,16,13,0,13,12,26,16,0,"https://fbref.com/en/players/b8a642fc/Samuel-Chukwueze"
2023,"Villarreal","La Liga","Diego Collado","ESP","FW","21",2001,0.1,0,0,0,0,0,0,0,NA,0,0,0,0,0,0,0,0,"https://fbref.com/en/players/b3f62bfc/Diego-Collado"
2023,"Villarreal","La Liga","Francis Coquelin","FRA","MF","31",1991,8.3,18,13,7,9,2,7,7,100,0,8,2,6,9,27,7,0,"https://fbref.com/en/players/a6951bf8/Francis-Coquelin"
2023,"Villarreal","La Liga","Jorge Cuenca","ESP","DF","22",1999,5.6,9,7,7,2,0,4,7,57.1,3,10,8,2,6,15,44,0,"https://fbref.com/en/players/0abc51f2/Jorge-Cuenca"
2023,"Villarreal","La Liga","Arnaut Danjuma","NED","FW","25",1997,5.3,3,3,1,0,2,1,2,50,1,0,0,0,0,3,1,1,"https://fbref.com/en/players/f08490a6/Arnaut-Danjuma"
2023,"Villarreal","La Liga","Alberto Del Moral","ESP","MF","22",2000,0.1,0,0,0,0,0,0,0,NA,0,0,0,0,0,0,0,0,"https://fbref.com/en/players/84a85b48/Alberto-Del-Moral"
2023,"Villarreal","La Liga","Mamadou Fall","SEN","DF","19",2002,0.3,0,0,0,0,0,0,0,NA,0,1,0,1,0,0,1,0,"https://fbref.com/en/players/805a2a11/Mamadou-Fall"
2023,"Villarreal","La Liga","Kiko Femenía","ESP","DF","31",1991,12.6,18,9,14,3,1,13,18,72.2,5,15,6,9,20,38,22,0,"https://fbref.com/en/players/e5d01ecf/Kiko-Femenia"
2023,"Villarreal","La Liga","Juan Foyth","ARG","DF","24",1998,21.8,73,48,49,22,2,41,57,71.9,16,32,11,21,20,93,68,0,"https://fbref.com/en/players/6c7762c3/Juan-Foyth"
2023,"Villarreal","La Liga","Haissem Hassan","FRA","FW,MF","20",2002,0.6,0,0,0,0,0,0,2,0,2,0,0,0,1,1,0,0,"https://fbref.com/en/players/e0979e74/Haissem-Hassan"
2023,"Villarreal","La Liga","Nicolas Jackson","SEN","FW","21",2001,17.8,14,11,2,10,2,2,8,25,6,18,2,16,2,16,4,0,"https://fbref.com/en/players/9c36ed83/Nicolas-Jackson"
2023,"Villarreal","La Liga","Filip Jørgensen","DEN","GK","20",2002,2,0,0,0,0,0,0,1,0,1,0,0,0,0,0,0,0,"https://fbref.com/en/players/0107757e/Filip-Jorgensen"
2023,"Villarreal","La Liga","Giovani Lo Celso","ARG","MF,FW","26",1996,12.5,32,28,7,15,10,12,21,57.1,9,14,2,12,6,38,5,0,"https://fbref.com/en/players/d7553721/Giovani-Lo-Celso"
2023,"Villarreal","La Liga","José Luis Morales","ESP","FW,MF","35",1987,13.5,7,6,1,2,4,5,17,29.4,12,12,1,11,2,9,2,0,"https://fbref.com/en/players/4a478107/Jose-Luis-Morales"
2023,"Villarreal","La Liga","Aïssa Mandi","ALG","DF","30",1991,16.2,18,10,14,3,1,6,12,50,6,19,14,5,21,39,58,0,"https://fbref.com/en/players/fbd6378b/Aissa-Mandi"
2023,"Villarreal","La Liga","Johan Mojica","COL","DF","29",1992,7.1,13,9,9,3,1,5,9,55.6,4,8,3,5,4,17,14,1,"https://fbref.com/en/players/608f2092/Johan-Mojica"
2023,"Villarreal","La Liga","Alberto Moreno","ESP","DF","30",1992,14.4,23,12,10,10,3,11,24,45.8,13,12,1,11,23,46,26,0,"https://fbref.com/en/players/11b9265b/Alberto-Moreno"
2023,"Villarreal","La Liga","Gerard Moreno","ESP","FW","30",1992,13.7,11,6,0,6,5,3,6,50,3,6,2,4,5,16,10,0,"https://fbref.com/en/players/81f0781e/Gerard-Moreno"
2023,"Villarreal","La Liga","Manu Morlanes","ESP","MF","23",1999,1.8,3,2,2,1,0,3,3,100,0,3,2,1,1,4,2,0,"https://fbref.com/en/players/a0255c67/Manu-Morlanes"
2023,"Villarreal","La Liga","Fernando Niño","ESP","MF,FW","21",2000,0.2,0,0,0,0,0,0,0,NA,0,0,0,0,0,0,0,0,"https://fbref.com/en/players/81d5c497/Fernando-Nino"
2023,"Villarreal","La Liga","Daniel Parejo","ESP","MF","33",1989,36.5,71,40,32,23,16,30,75,40,45,40,12,28,29,100,31,2,"https://fbref.com/en/players/7460ca0d/Daniel-Parejo"
2023,"Villarreal","La Liga","Pascu","ESP","DF,FW","19",2003,0.1,0,0,0,0,0,0,0,NA,0,0,0,0,0,0,0,0,"https://fbref.com/en/players/a2d9cf74/Pascu"
2023,"Villarreal","La Liga","Alfonso Pedraza","ESP","DF","26",1996,18.1,35,26,20,10,5,19,29,65.5,10,19,1,18,18,53,31,0,"https://fbref.com/en/players/63f04c6c/Alfonso-Pedraza"
2023,"Villarreal","La Liga","Yeremi Pino","ESP","FW,MF","19",2002,27.2,62,38,25,20,17,21,56,37.5,35,41,4,37,15,77,36,0,"https://fbref.com/en/players/540ec57b/Yeremi-Pino"
2023,"Villarreal","La Liga","Pepe Reina","ESP","GK","39",1982,22,0,0,0,0,0,0,1,0,1,0,0,0,1,1,4,4,"https://fbref.com/en/players/e358587b/Pepe-Reina"
2023,"Villarreal","La Liga","Gerónimo Rulli","ARG","GK","30",1992,14,0,0,0,0,0,0,0,NA,0,1,0,1,1,1,6,2,"https://fbref.com/en/players/625c144a/Geronimo-Rulli"
2023,"Villarreal","La Liga","Ramón Terrats","ESP","MF","21",2000,9.1,15,10,3,8,4,9,17,52.9,8,11,4,7,8,23,6,2,"https://fbref.com/en/players/f36016a5/Ramon-Terrats"
2023,"Villarreal","La Liga","Pau Torres","ESP","DF","25",1997,33.9,43,25,25,13,5,23,36,63.9,13,36,27,9,13,56,146,3,"https://fbref.com/en/players/532e1e4f/Pau-Torres"
2023,"Villarreal","La Liga","Manu Trigueros","ESP","MF","30",1991,9.2,20,14,9,5,6,9,22,40.9,13,9,2,7,5,25,4,0,"https://fbref.com/en/players/963829d0/Manu-Trigueros"
2023,"Werder Bremen","Bundesliga","Felix Agu","GER","DF,FW","22",1999,0.5,1,0,0,1,0,0,0,NA,0,1,1,0,0,1,0,0,"https://fbref.com/en/players/cb6d81b3/Felix-Agu"
2023,"Werder Bremen","Bundesliga","Leonardo Bittencourt","GER","MF,DF","28",1993,18.1,53,28,20,25,8,25,62,40.3,37,13,0,13,10,63,15,0,"https://fbref.com/en/players/dc62fbee/Leonardo-Bittencourt"
2023,"Werder Bremen","Bundesliga","Lee Buchanan","ENG","DF,FW","21",2001,5.2,14,10,2,11,1,6,12,50,6,5,0,5,12,26,21,0,"https://fbref.com/en/players/45e95f21/Lee-Buchanan"
2023,"Werder Bremen","Bundesliga","Oliver Burke","SCO","FW,MF","25",1997,3,1,0,0,0,1,0,0,NA,0,2,0,2,0,1,0,0,"https://fbref.com/en/players/f631c17f/Oliver-Burke"
2023,"Werder Bremen","Bundesliga","Fabio Chiarodia","ITA","DF","17",2005,0.7,0,0,0,0,0,0,0,NA,0,1,0,1,2,2,4,0,"https://fbref.com/en/players/48780156/Fabio-Chiarodia"
2023,"Werder Bremen","Bundesliga","Eren Dinkçi","GER","FW,MF","20",2001,2.6,5,5,2,1,2,2,6,33.3,4,2,0,2,0,5,2,0,"https://fbref.com/en/players/4ccd8957/Eren-Dinkci"
2023,"Werder Bremen","Bundesliga","Marvin Ducksch","GER","FW","28",1994,31.7,8,3,2,4,2,3,16,18.8,13,13,2,11,9,17,41,1,"https://fbref.com/en/players/638a4d71/Marvin-Ducksch"
2023,"Werder Bremen","Bundesliga","Marco Friedl","AUT","DF","24",1998,28.8,62,46,40,22,0,41,68,60.3,27,46,17,29,58,120,127,1,"https://fbref.com/en/players/f86ad3f5/Marco-Friedl"
2023,"Werder Bremen","Bundesliga","Niclas Füllkrug","GER","FW","29",1993,27.5,9,4,0,6,3,3,13,23.1,10,13,4,9,1,10,24,0,"https://fbref.com/en/players/4f16405e/Niclas-Fullkrug"
2023,"Werder Bremen","Bundesliga","Christian Groß","GER","MF","33",1989,21,56,25,20,34,2,29,60,48.3,31,20,5,15,23,79,38,1,"https://fbref.com/en/players/14a7af33/Christian-Gross"
2023,"Werder Bremen","Bundesliga","Ilia Gruev","BUL","MF","22",2000,17.6,44,27,16,25,3,18,31,58.1,13,23,6,17,22,66,21,1,"https://fbref.com/en/players/1fc4f3d1/Ilia-Gruev"
2023,"Werder Bremen","Bundesliga","Anthony Jung","GER","DF,FW","30",1991,29.1,46,27,19,20,7,31,58,53.4,27,30,6,24,22,68,63,0,"https://fbref.com/en/players/de838f86/Anthony-Jung"
2023,"Werder Bremen","Bundesliga","Jean-Manuel Mbom","GER","MF","22",2000,0.1,0,0,0,0,0,0,1,0,1,0,0,0,0,0,0,0,"https://fbref.com/en/players/1a5d7cb9/Jean-Manuel-Mbom"
2023,"Werder Bremen","Bundesliga","Jiří Pavlenka","CZE","GK","30",1992,32.3,1,0,1,0,0,1,5,20,4,1,0,1,3,4,21,1,"https://fbref.com/en/players/0a1cb833/Jiri-Pavlenka"
2023,"Werder Bremen","Bundesliga","Maximilian Philipp","GER","FW,MF","28",1994,4.9,6,5,3,2,1,1,9,11.1,8,7,1,6,3,9,4,0,"https://fbref.com/en/players/061e8e23/Maximilian-Philipp"
2023,"Werder Bremen","Bundesliga","Amos Pieper","GER","DF","24",1998,21.7,46,28,25,19,2,24,40,60,16,23,11,12,30,76,94,1,"https://fbref.com/en/players/526ea7cc/Amos-Pieper"
2023,"Werder Bremen","Bundesliga","Nicolai Rapp","GER","MF,DF","25",1996,0.8,3,1,3,0,0,0,3,0,3,0,0,0,0,3,1,0,"https://fbref.com/en/players/c8b3a472/Nicolai-Rapp"
2023,"Werder Bremen","Bundesliga","Dikeni Salifou","TOG","MF","19",2003,0,0,0,0,0,0,0,0,NA,0,0,0,0,0,0,0,0,"https://fbref.com/en/players/e1830c52/Dikeni-Salifou"
2023,"Werder Bremen","Bundesliga","Romano Schmid","AUT","MF,FW","22",2000,16.9,24,15,5,13,6,10,22,45.5,12,21,3,18,7,31,12,0,"https://fbref.com/en/players/220ace7e/Romano-Schmid"
2023,"Werder Bremen","Bundesliga","Niklas Schmidt","GER","MF","24",1998,12.1,25,10,12,11,2,13,28,46.4,15,10,0,10,5,30,12,0,"https://fbref.com/en/players/b9ae8560/Niklas-Schmidt"
2023,"Werder Bremen","Bundesliga","Jens Stage","DEN","MF","25",1996,20.6,34,17,15,18,1,10,37,27,27,34,11,23,16,50,37,0,"https://fbref.com/en/players/1fffae99/Jens-Stage"
2023,"Werder Bremen","Bundesliga","Niklas Stark","GER","DF","27",1995,23.1,56,36,29,24,3,27,42,64.3,15,24,13,11,37,93,110,0,"https://fbref.com/en/players/aad48be9/Niklas-Stark"
2023,"Werder Bremen","Bundesliga","Miloš Veljković","SRB","DF","26",1995,25.2,30,19,17,13,0,18,29,62.1,11,32,16,16,33,63,103,0,"https://fbref.com/en/players/a5ae8f8e/Milos-Veljkovic"
2023,"Werder Bremen","Bundesliga","Mitchell Weiser","GER","DF,FW","28",1994,28,71,43,38,24,9,38,75,50.7,37,50,7,43,28,99,38,1,"https://fbref.com/en/players/30c220c3/Mitchell-Weiser"
2023,"Werder Bremen","Bundesliga","Michael Zetterer","GER","GK","27",1995,1.7,0,0,0,0,0,0,0,NA,0,0,0,0,0,0,1,0,"https://fbref.com/en/players/9b688ae1/Michael-Zetterer"
2023,"West Ham","Premier League","Nayef Aguerd","MAR","DF","26",1996,17.7,27,18,18,8,1,13,20,65,7,26,24,2,18,45,79,2,"https://fbref.com/en/players/288e1e13/Nayef-Aguerd"
2023,"West Ham","Premier League","Michail Antonio","JAM","FW","32",1990,20.3,14,7,1,8,5,3,12,25,9,13,5,8,5,19,9,0,"https://fbref.com/en/players/ac05f970/Michail-Antonio"
2023,"West Ham","Premier League","Alphonse Areola","FRA","GK","29",1993,3.4,0,0,0,0,0,0,0,NA,0,0,0,0,0,0,0,0,"https://fbref.com/en/players/2f965a72/Alphonse-Areola"
2023,"West Ham","Premier League","Saïd Benrahma","ALG","FW,MF","26",1995,23,25,15,11,7,7,11,27,40.7,16,23,1,22,9,34,13,0,"https://fbref.com/en/players/5a04fd92/Said-Benrahma"
2023,"West Ham","Premier League","Jarrod Bowen","ENG","FW,MF","25",1996,35.9,39,16,14,11,14,16,57,28.1,41,47,9,38,36,75,25,0,"https://fbref.com/en/players/79c84d1c/Jarrod-Bowen"
2023,"West Ham","Premier League","Maxwel Cornet","CIV","FW","25",1996,2.7,7,3,5,0,2,4,6,66.7,2,6,0,6,2,9,3,0,"https://fbref.com/en/players/beb391dd/Maxwel-Cornet"
2023,"West Ham","Premier League","Vladimír Coufal","CZE","DF","29",1992,23.7,58,31,37,15,6,36,51,70.6,15,24,6,18,38,96,70,0,"https://fbref.com/en/players/fdf3cb77/Vladimir-Coufal"
2023,"West Ham","Premier League","Conor Coventry","IRL","MF,FW","22",2000,0,0,0,0,0,0,0,0,NA,0,0,0,0,0,0,0,0,"https://fbref.com/en/players/a5ca9127/Conor-Coventry"
2023,"West Ham","Premier League","Aaron Cresswell","ENG","DF","32",1989,24.8,21,11,12,7,2,12,31,38.7,19,21,11,10,27,48,56,0,"https://fbref.com/en/players/4f974391/Aaron-Cresswell"
2023,"West Ham","Premier League","Craig Dawson","ENG","DF","32",1990,8,10,6,8,2,0,4,6,66.7,2,9,6,3,6,16,26,0,"https://fbref.com/en/players/3e9e06cb/Craig-Dawson"
2023,"West Ham","Premier League","Flynn Downes","ENG","MF","23",1999,8.5,16,9,4,10,2,6,12,50,6,15,2,13,7,23,6,0,"https://fbref.com/en/players/69fdb896/Flynn-Downes"
2023,"West Ham","Premier League","Łukasz Fabiański","POL","GK","37",1985,34.6,2,0,2,0,0,1,2,50,1,1,0,1,0,2,10,1,"https://fbref.com/en/players/9328b835/Lukasz-Fabianski"
2023,"West Ham","Premier League","Pablo Fornals","ESP","FW,MF","26",1996,16.7,30,15,9,12,9,13,34,38.2,21,16,2,14,14,44,9,0,"https://fbref.com/en/players/82927de4/Pablo-Fornals"
2023,"West Ham","Premier League","Danny Ings","ENG","FW","30",1992,8.6,9,8,0,4,5,5,14,35.7,9,8,2,6,3,12,5,0,"https://fbref.com/en/players/07802f7f/Danny-Ings"
2023,"West Ham","Premier League","Ben Johnson","ENG","DF","22",2000,9.6,20,14,12,4,4,12,18,66.7,6,12,4,8,9,29,28,1,"https://fbref.com/en/players/9319781b/Ben-Johnson"
2023,"West Ham","Premier League","Thilo Kehrer","GER","DF","25",1996,24.8,43,24,25,14,4,21,44,47.7,23,16,6,10,34,77,76,1,"https://fbref.com/en/players/51dbeea9/Thilo-Kehrer"
2023,"West Ham","Premier League","Manuel Lanzini","ARG","MF,FW","29",1993,2.8,2,2,1,1,0,2,6,33.3,4,2,0,2,2,4,0,0,"https://fbref.com/en/players/26f6dca8/Manuel-Lanzini"
2023,"West Ham","Premier League","Divin Mubama","ENG","FW","17",2004,0.4,1,1,1,0,0,0,0,NA,0,0,0,0,0,1,0,0,"https://fbref.com/en/players/92868cb5/Divin-Mubama"
2023,"West Ham","Premier League","Angelo Ogbonna","ITA","DF","34",1988,13.7,11,4,7,4,0,5,10,50,5,11,7,4,17,28,74,1,"https://fbref.com/en/players/74b2cd7e/Angelo-Ogbonna"
2023,"West Ham","Premier League","Emerson Palmieri","ITA","DF","27",1994,14.7,26,14,9,15,2,12,24,50,12,17,4,13,15,41,36,0,"https://fbref.com/en/players/e0bc6fdc/Emerson-Palmieri"
2023,"West Ham","Premier League","Lucas Paquetá","BRA","MF","24",1997,23.9,71,53,23,36,12,27,66,40.9,39,41,4,37,16,87,31,0,"https://fbref.com/en/players/9b6f7fd5/Lucas-Paqueta"
2023,"West Ham","Premier League","Declan Rice","ENG","MF","23",1999,36.4,79,38,44,31,4,31,50,62,19,45,15,30,63,142,58,0,"https://fbref.com/en/players/1c7012b8/Declan-Rice"
2023,"West Ham","Premier League","Gianluca Scamacca","ITA","FW","23",1999,10.3,10,5,1,3,6,2,2,100,0,3,0,3,4,14,5,0,"https://fbref.com/en/players/8790f988/Gianluca-Scamacca"
2023,"West Ham","Premier League","Tomáš Souček","CZE","MF","27",1995,31.3,77,37,41,29,7,28,58,48.3,30,42,17,25,53,130,71,3,"https://fbref.com/en/players/6613c819/Tomas-Soucek"
2023,"West Ham","Premier League","Kurt Zouma","FRA","DF","27",1994,22.1,9,4,4,5,0,5,8,62.5,3,17,14,3,30,39,120,1,"https://fbref.com/en/players/ce4246f5/Kurt-Zouma"
2023,"Wolfsburg","Bundesliga","Lukáš Ambros","CZE","MF","18",2004,0.2,1,0,1,0,0,1,4,25,3,1,0,1,0,1,2,1,"https://fbref.com/en/players/cd682b6b/Lukas-Ambros"
2023,"Wolfsburg","Bundesliga","Maximilian Arnold","GER","MF","28",1994,30.7,62,31,25,28,9,28,54,51.9,26,34,11,23,26,88,65,2,"https://fbref.com/en/players/86e119e0/Maximilian-Arnold"
2023,"Wolfsburg","Bundesliga","Ridle Baku","GER","DF,FW","24",1998,28.7,50,26,29,17,4,32,58,55.2,26,44,6,38,21,71,59,0,"https://fbref.com/en/players/442b56fa/Ridle-Baku"
2023,"Wolfsburg","Bundesliga","Sebastiaan Bornauw","BEL","DF","23",1999,21.4,29,17,17,10,2,16,22,72.7,6,27,12,15,31,60,83,1,"https://fbref.com/en/players/01834aa0/Sebastiaan-Bornauw"
2023,"Wolfsburg","Bundesliga","Josip Brekalo","CRO","MF,FW","24",1998,3,2,1,2,0,0,0,4,0,4,0,0,0,2,4,2,0,"https://fbref.com/en/players/d4a2533d/Josip-Brekalo"
2023,"Wolfsburg","Bundesliga","Koen Casteels","BEL","GK","30",1992,34,0,0,0,0,0,0,0,NA,0,0,0,0,1,1,10,1,"https://fbref.com/en/players/db401046/Koen-Casteels"
2023,"Wolfsburg","Bundesliga","Nicolas Cozza","FRA","DF","23",1999,1.1,3,3,1,2,0,2,3,66.7,1,3,1,2,0,3,0,0,"https://fbref.com/en/players/8f325097/Nicolas-Cozza"
2023,"Wolfsburg","Bundesliga","Kilian Fischer","GER","DF,FW","21",2000,5.6,9,6,3,4,2,6,11,54.5,5,6,0,6,5,14,18,0,"https://fbref.com/en/players/79f7302a/Kilian-Fischer"
2023,"Wolfsburg","Bundesliga","Bartol Franjić","CRO","MF","22",2000,2.5,4,2,2,2,0,0,2,0,2,4,1,3,5,9,4,0,"https://fbref.com/en/players/697dc00a/Bartol-Franjic"
2023,"Wolfsburg","Bundesliga","Yannick Gerhardt","GER","MF","28",1994,20.7,29,15,10,11,8,12,30,40,18,26,5,21,7,36,24,0,"https://fbref.com/en/players/62ab9184/Yannick-Gerhardt"
2023,"Wolfsburg","Bundesliga","Josuha Guilavogui","FRA","DF,MF","31",1990,13.1,18,11,7,10,1,6,17,35.3,11,19,13,6,23,41,52,0,"https://fbref.com/en/players/e6c43eec/Josuha-Guilavogui"
2023,"Wolfsburg","Bundesliga","Jakub Kamiński","POL","FW,DF","20",2002,22.9,36,25,15,13,8,20,40,50,20,37,2,35,8,44,15,0,"https://fbref.com/en/players/202b3b68/Jakub-Kaminski"
2023,"Wolfsburg","Bundesliga","Max Kruse","GER","MF,FW","34",1988,3,1,1,0,1,0,0,1,0,1,2,1,1,0,1,1,0,"https://fbref.com/en/players/f9446dcd/Max-Kruse"
2023,"Wolfsburg","Bundesliga","Maxence Lacroix","FRA","DF","22",2000,18.1,22,13,15,7,0,8,16,50,8,22,11,11,26,48,85,0,"https://fbref.com/en/players/277c49ed/Maxence-Lacroix"
2023,"Wolfsburg","Bundesliga","Omar Marmoush","EGY","FW","23",1999,16.4,NA,10,NA,NA,NA,NA,NA,NA,NA,NA,NA,NA,5,NA,NA,NA,"https://fbref.com/en/players/589449ec/Omar-Marmoush"
2023,"Wolfsburg","Bundesliga","Felix Nmecha","GER","MF","21",2000,20.4,41,24,11,23,7,16,34,47.1,18,26,10,16,25,66,31,0,"https://fbref.com/en/players/091c86e2/Felix-Nmecha"
2023,"Wolfsburg","Bundesliga","Lukas Nmecha","GER","FW","23",1998,10,5,3,0,2,3,3,3,100,0,5,1,4,3,8,4,0,"https://fbref.com/en/players/0cc5f4a5/Lukas-Nmecha"
2023,"Wolfsburg","Bundesliga","Paulo Otávio","BRA","DF","27",1994,22.7,72,46,46,17,9,44,66,66.7,22,42,6,36,30,102,70,1,"https://fbref.com/en/players/1cbe4984/Paulo-Otavio"
2023,"Wolfsburg","Bundesliga","Kevin Paredes","USA","FW,MF","19",2003,5.9,13,9,6,3,4,9,12,75,3,7,0,7,6,19,8,0,"https://fbref.com/en/players/5c50fdbc/Kevin-Paredes"
2023,"Wolfsburg","Bundesliga","Dženan Pejčinović","GER","FW","17",2005,0.1,0,0,0,0,0,0,0,NA,0,0,0,0,0,0,0,0,"https://fbref.com/en/players/80f252f6/Dzenan-Pejcinovic"
2023,"Wolfsburg","Bundesliga","Maximilian Philipp","GER","FW","28",1994,1.3,2,1,1,1,0,1,1,100,0,1,0,1,0,2,0,0,"https://fbref.com/en/players/061e8e23/Maximilian-Philipp"
2023,"Wolfsburg","Bundesliga","Jérôme Roussillon","FRA","MF,DF","29",1993,0.2,0,0,0,0,0,0,0,NA,0,0,0,0,0,0,0,0,"https://fbref.com/en/players/13203c45/Jerome-Roussillon"
2023,"Wolfsburg","Bundesliga","Mattias Svanberg","SWE","MF,FW","23",1999,20.4,25,16,8,16,1,10,30,33.3,20,27,5,22,21,46,25,1,"https://fbref.com/en/players/92d83c27/Mattias-Svanberg"
2023,"Wolfsburg","Bundesliga","Micky van de Ven","NED","DF","21",2001,33,45,30,26,18,1,28,39,71.8,11,42,24,18,26,71,108,2,"https://fbref.com/en/players/8fe2a392/Micky-van-de-Ven"
2023,"Wolfsburg","Bundesliga","Aster Vranckx","BEL","MF","19",2002,0.1,0,0,0,0,0,0,0,NA,0,0,0,0,0,0,1,0,"https://fbref.com/en/players/f86cd5df/Aster-Vranckx"
2023,"Wolfsburg","Bundesliga","Luca Waldschmidt","GER","FW,MF","26",1996,5.8,5,2,2,1,2,2,10,20,8,6,0,6,3,8,5,0,"https://fbref.com/en/players/e5a35ae9/Luca-Waldschmidt"
2023,"Wolfsburg","Bundesliga","Patrick Wimmer","AUT","FW,MF","21",2001,18.3,39,26,18,11,10,12,38,31.6,26,27,2,25,15,54,15,0,"https://fbref.com/en/players/cb11b429/Patrick-Wimmer"
2023,"Wolfsburg","Bundesliga","Jonas Wind","DEN","FW","23",1999,14.3,14,6,2,7,5,5,10,50,5,14,4,10,1,15,10,0,"https://fbref.com/en/players/2077ae86/Jonas-Wind"
2023,"Wolves","Premier League","Rayan Aït Nouri","ALG","DF","21",2001,12,33,20,25,7,1,9,15,60,6,3,0,3,9,42,28,0,"https://fbref.com/en/players/9b398aea/Rayan-Ait-Nouri"
2023,"Wolves","Premier League","Daniel Bentley","ENG","GK","29",1993,2,1,1,1,0,0,1,1,100,0,0,0,0,0,1,0,0,"https://fbref.com/en/players/68db6358/Daniel-Bentley"
2023,"Wolves","Premier League","Hugo Bueno","ESP","DF","19",2002,14.6,33,16,23,6,4,17,33,51.5,16,14,1,13,10,43,36,0,"https://fbref.com/en/players/bfc3b3a0/Hugo-Bueno"
2023,"Wolves","Premier League","Chem Campbell","WAL","FW,MF","19",2002,0.8,2,1,1,1,0,0,1,0,1,2,0,2,1,3,0,0,"https://fbref.com/en/players/6f711f67/Chem-Campbell"
2023,"Wolves","Premier League","Jonny Castro","ESP","DF","28",1994,14,34,15,23,10,1,18,37,48.6,19,26,5,21,14,48,28,2,"https://fbref.com/en/players/e28868f3/Jonny-Castro"
2023,"Wolves","Premier League","Nathan Collins","IRL","DF","21",2001,20.2,27,15,19,8,0,15,24,62.5,9,35,28,7,21,48,84,0,"https://fbref.com/en/players/a8c19eb8/Nathan-Collins"
2023,"Wolves","Premier League","Diego Costa","ESP","FW","33",1988,13.8,3,1,3,0,0,2,9,22.2,7,6,1,5,2,5,17,0,"https://fbref.com/en/players/a190d597/Diego-Costa"
2023,"Wolves","Premier League","Matheus Cunha","BRA","FW","23",1999,10.7,7,4,0,5,2,2,10,20,8,15,3,12,9,16,11,0,"https://fbref.com/en/players/dc62b55d/Matheus-Cunha"
2023,"Wolves","Premier League","Craig Dawson","ENG","DF","32",1990,15.7,9,6,6,3,0,4,7,57.1,3,31,23,8,12,21,74,2,"https://fbref.com/en/players/3e9e06cb/Craig-Dawson"
2023,"Wolves","Premier League","Leander Dendoncker","BEL","MF","27",1995,2.4,4,2,0,3,1,2,3,66.7,1,2,0,2,9,13,4,0,"https://fbref.com/en/players/5a7301ae/Leander-Dendoncker"
2023,"Wolves","Premier League","Morgan Gibbs-White","ENG","FW,MF","22",2000,2,3,1,3,0,0,2,3,66.7,1,2,0,2,1,4,3,0,"https://fbref.com/en/players/32f60ed8/Morgan-Gibbs-White"
2023,"Wolves","Premier League","João Gomes","BRA","MF","21",2001,7.3,29,13,14,14,1,13,23,56.5,10,12,3,9,4,33,11,0,"https://fbref.com/en/players/8b57ad2c/Joao-Gomes"
2023,"Wolves","Premier League","Toti Gomes","POR","DF","23",1999,10.9,15,9,11,4,0,9,13,69.2,4,16,8,8,11,26,51,0,"https://fbref.com/en/players/f0caab96/Toti-Gomes"
2023,"Wolves","Premier League","Gonçalo Guedes","POR","FW,MF","25",1996,7.9,8,6,4,3,1,5,8,62.5,3,4,0,4,1,9,2,0,"https://fbref.com/en/players/e6bc67d7/Goncalo-Guedes"
2023,"Wolves","Premier League","Hwang Hee-chan","KOR","FW,MF","26",1996,12.6,20,9,7,8,5,6,19,31.6,13,18,2,16,5,25,5,0,"https://fbref.com/en/players/169fd162/Hwang-Hee-chan"
2023,"Wolves","Premier League","Joseph Hodge","IRL","MF","19",2002,1.9,5,2,1,3,1,3,4,75,1,5,0,5,0,5,2,1,"https://fbref.com/en/players/bd8a5d95/Joseph-Hodge"
2023,"Wolves","Premier League","Raúl Jiménez","MEX","FW","31",1991,9.4,9,6,3,5,1,3,6,50,3,9,0,9,0,9,8,0,"https://fbref.com/en/players/b561db50/Raul-Jimenez"
2023,"Wolves","Premier League","Sasa Kalajdzic","AUT","FW","25",1997,0.5,0,0,0,0,0,0,0,NA,0,0,0,0,1,1,0,0,"https://fbref.com/en/players/15f24fe7/Sasa-Kalajdzic"
2023,"Wolves","Premier League","Max Kilman","ENG","DF","25",1997,36.7,36,20,26,9,1,16,30,53.3,14,70,42,28,19,55,164,1,"https://fbref.com/en/players/d0f72bf1/Max-Kilman"
2023,"Wolves","Premier League","Dexter Lembikisa","JAM","DF","18",2003,0.3,0,0,0,0,0,0,0,NA,0,0,0,0,0,0,0,0,"https://fbref.com/en/players/0bdda685/Dexter-Lembikisa"
2023,"Wolves","Premier League","Mario Lemina","GAB","MF","28",1993,14.4,38,24,22,13,3,20,38,52.6,18,26,8,18,14,52,24,1,"https://fbref.com/en/players/2b471f99/Mario-Lemina"
2023,"Wolves","Premier League","João Moutinho","POR","MF","35",1986,19.8,51,30,24,21,6,19,46,41.3,27,22,6,16,18,69,20,0,"https://fbref.com/en/players/f5a00fa4/Joao-Moutinho"
2023,"Wolves","Premier League","Pedro Neto","POR","FW,MF","22",2000,10.7,11,6,4,2,5,7,17,41.2,10,5,1,4,4,15,4,0,"https://fbref.com/en/players/7ba2eaa9/Pedro-Neto"
2023,"Wolves","Premier League","Rúben Neves","POR","MF","25",1997,33.5,79,43,31,33,15,32,74,43.2,42,59,22,37,50,129,85,1,"https://fbref.com/en/players/44bfb6c5/Ruben-Neves"
2023,"Wolves","Premier League","Matheus Nunes","POR","MF","23",1998,27.4,67,43,36,22,9,28,61,45.9,33,35,4,31,16,83,35,2,"https://fbref.com/en/players/e6af02e0/Matheus-Nunes"
2023,"Wolves","Premier League","Daniel Podence","POR","FW,MF","26",1995,19.7,27,17,13,9,5,6,31,19.4,25,19,0,19,7,34,6,0,"https://fbref.com/en/players/7fcc71d8/Daniel-Podence"
2023,"Wolves","Premier League","Connor Ronan","IRL","MF","24",1998,0,0,0,0,0,0,0,0,NA,0,0,0,0,0,0,0,0,"https://fbref.com/en/players/1b804500/Connor-Ronan"
2023,"Wolves","Premier League","José Sá","POR","GK","29",1993,36,1,0,1,0,0,1,1,100,0,0,0,0,0,1,10,6,"https://fbref.com/en/players/903b6e8b/Jose-Sa"
2023,"Wolves","Premier League","Pablo Sarabia","ESP","FW,MF","30",1992,8.5,12,6,4,5,3,6,15,40,9,7,0,7,2,14,4,0,"https://fbref.com/en/players/9744ff80/Pablo-Sarabia"
2023,"Wolves","Premier League","Nélson Semedo","POR","DF","28",1993,29.2,71,42,48,19,4,33,64,51.6,31,42,15,27,29,100,83,2,"https://fbref.com/en/players/d04b94db/Nelson-Semedo"
2023,"Wolves","Premier League","Adama Traoré","ESP","FW,MF","26",1996,16.6,14,7,7,4,3,4,9,44.4,5,8,1,7,3,17,17,0,"https://fbref.com/en/players/9a28eba4/Adama-Traore"
2023,"Wolves","Premier League","Boubacar Traoré","MLI","MF","20",2001,4.6,12,5,4,5,3,3,7,42.9,4,4,2,2,7,19,1,0,"https://fbref.com/en/players/999ceb5f/Boubacar-Traore"
2024,"Alavés","La Liga","Abdel Abqar","MAR","DF","25-081",1999,25.7,35,19,28,5,2,21,35,60,14,31,26,5,23,58,115,0,"https://fbref.com/en/players/2bc7f211/Abdel-Abqar"
2024,"Alavés","La Liga","Carlos Benavídez","URU","MF","26-061",1998,12.6,56,35,19,26,11,19,34,55.9,15,13,5,8,19,75,31,0,"https://fbref.com/en/players/9fb45456/Carlos-Benavidez"
2024,"Alavés","La Liga","Antonio Blanco","ESP","MF","23-312",2000,27,61,36,29,27,5,31,86,36,55,25,2,23,35,96,30,0,"https://fbref.com/en/players/506daeac/Antonio-Blanco"
2024,"Alavés","La Liga","Rubén Duarte","ESP","DF","28-225",1995,20.9,39,20,21,16,2,21,31,67.7,10,21,6,15,23,62,69,0,"https://fbref.com/en/players/1fe0492d/Ruben-Duarte"
2024,"Alavés","La Liga","Andoni Gorosabel","ESP","DF","27-300",1996,31.7,62,42,40,17,5,38,75,50.7,37,24,8,16,28,90,69,0,"https://fbref.com/en/players/6f5f82c0/Andoni-Gorosabel"
2024,"Alavés","La Liga","Ander Guevara","ESP","MF","26-328",1997,32.6,59,32,28,25,6,31,64,48.4,33,34,12,22,13,72,46,1,"https://fbref.com/en/players/8e48dc61/Ander-Guevara"
2024,"Alavés","La Liga","Jon Guridi","ESP","MF","29-092",1995,29.8,42,24,10,27,5,12,45,26.7,33,23,3,20,22,64,22,0,"https://fbref.com/en/players/4c0a6a48/Jon-Guridi"
2024,"Alavés","La Liga","Ianis Hagi","ROU","MF,FW","25-221",1998,8.9,17,12,2,14,1,5,12,41.7,7,8,0,8,5,22,4,0,"https://fbref.com/en/players/0127419a/Ianis-Hagi"
2024,"Alavés","La Liga","Jon Karrikaburu","ESP","MF,FW","21-254",2002,0.2,0,0,0,0,0,0,0,NA,0,0,0,0,0,0,0,0,"https://fbref.com/en/players/211589b8/Jon-Karrikaburu"
2024,"Alavés","La Liga","Kiké","ESP","FW,MF","34-187",1989,15.8,8,4,2,3,3,4,9,44.4,5,16,5,11,1,9,12,0,"https://fbref.com/en/players/e897d8ba/Kike"
2024,"Alavés","La Liga","Javi López","ESP","DF","22-150",2002,26.5,23,12,11,9,3,15,26,57.7,11,25,9,16,10,33,77,1,"https://fbref.com/en/players/e9ada8cf/Javi-Lopez"
2024,"Alavés","La Liga","Rafa Marín","ESP","DF","22-011",2002,27.1,32,20,23,9,0,14,27,51.9,13,34,21,13,33,65,129,2,"https://fbref.com/en/players/3239a8ed/Rafa-Marin"
2024,"Alavés","La Liga","Tomás Mendes","ESP","MF","19-191",2004,0.1,0,0,0,0,0,0,0,NA,0,0,0,0,0,0,0,0,"https://fbref.com/en/players/45f771db/Tomas-Mendes"
2024,"Alavés","La Liga","Miguel","ESP","FW,MF","24-270",1999,0.7,0,0,0,0,0,0,0,NA,0,2,0,2,0,0,0,0,"https://fbref.com/en/players/6763373d/Miguel"
2024,"Alavés","La Liga","Samuel Omorodion","ESP","FW","20-025",2004,21.3,6,3,1,4,1,0,4,0,4,11,2,9,1,7,14,0,"https://fbref.com/en/players/dc44b03c/Samuel-Omorodion"
2024,"Alavés","La Liga","Eneko Ortiz","ESP","DF","21-004",2003,0.2,0,0,0,0,0,0,0,NA,0,0,0,0,0,0,0,0,"https://fbref.com/en/players/dc5ea86b/Eneko-Ortiz"
2024,"Alavés","La Liga","Jesús Owono","EQG","GK","23-090",2001,4,0,0,0,0,0,0,0,NA,0,0,0,0,0,0,3,0,"https://fbref.com/en/players/d6e3d7fb/Jesus-Owono"
2024,"Alavés","La Liga","Joaquín Panichelli","ARG","FW,MF","21-236",2002,2.5,3,3,1,1,1,1,2,50,1,1,0,1,1,4,4,0,"https://fbref.com/en/players/ae14af56/Joaquin-Panichelli"
2024,"Alavés","La Liga","Victor Parada","ESP","FW,MF","22-056",2002,0,1,1,0,1,0,1,1,100,0,0,0,0,0,1,0,0,"https://fbref.com/en/players/8ca358c5/Victor-Parada"
2024,"Alavés","La Liga","Abderrahman Rebbach","ALG","FW,MF","25-293",1998,8,9,5,4,2,3,5,15,33.3,10,10,1,9,3,12,7,0,"https://fbref.com/en/players/9a796115/Abderrahman-Rebbach"
2024,"Alavés","La Liga","Luis Rioja","ESP","FW,MF","30-227",1993,27.8,27,19,10,12,5,14,43,32.6,29,28,1,27,16,43,28,0,"https://fbref.com/en/players/eb3dd471/Luis-Rioja"
2024,"Alavés","La Liga","Unai Ropero","ESP","MF","22-192",2001,0.1,0,0,0,0,0,0,0,NA,0,0,0,0,0,0,0,0,"https://fbref.com/en/players/7868c973/Unai-Ropero"
2024,"Alavés","La Liga","Aleksandar Sedlar","SRB","DF","32-169",1991,10.5,14,10,10,4,0,10,16,62.5,6,8,4,4,13,27,43,0,"https://fbref.com/en/players/a35134ae/Aleksandar-Sedlar"
2024,"Alavés","La Liga","Giuliano Simeone","ARG","FW","21-164",2002,7,7,5,2,3,2,5,17,29.4,12,10,0,10,5,12,3,0,"https://fbref.com/en/players/a6536561/Giuliano-Simeone"
2024,"Alavés","La Liga","Antonio Sivera","ESP","GK","27-293",1996,34,0,0,0,0,0,0,1,0,1,0,0,0,0,0,17,1,"https://fbref.com/en/players/9970da54/Antonio-Sivera"
2024,"Alavés","La Liga","Alex Sola","ESP","FW,MF","24-356",1999,14,27,15,11,9,7,14,26,53.8,12,18,2,16,11,38,16,0,"https://fbref.com/en/players/5fa714d5/Alex-Sola"
2024,"Alavés","La Liga","Mamadou Sylla","SEN","FW,MF","30-071",1994,0.2,0,0,0,0,0,0,0,NA,0,1,1,0,0,0,1,0,"https://fbref.com/en/players/e5ec95f8/Mamadou-Sylla"
2024,"Alavés","La Liga","Nahuel Tenaglia","ARG","DF","28-099",1996,12.7,29,19,22,4,3,16,28,57.1,12,14,8,6,12,41,59,0,"https://fbref.com/en/players/66654daa/Nahuel-Tenaglia"
2024,"Alavés","La Liga","Carlos Vicente","ESP","FW","25-037",1999,12.4,16,6,7,7,2,10,25,40,15,4,0,4,4,20,9,0,"https://fbref.com/en/players/90df343e/Carlos-Vicente"
2024,"Alavés","La Liga","Xeber","ESP","FW,MF","26-339",1997,3.4,5,5,3,2,0,3,7,42.9,4,2,1,1,1,6,2,0,"https://fbref.com/en/players/d2c8aacc/Xeber"
2024,"Almería","La Liga","Sergio Akieme","ESP","DF","26-166",1997,18.6,27,15,18,7,2,13,16,81.3,3,14,4,10,10,37,34,0,"https://fbref.com/en/players/06efa9dc/Sergio-Akieme"
2024,"Almería","La Liga","Sergio Arribas","ESP","MF,FW","22-243",2001,22.7,34,17,16,17,1,14,31,45.2,17,20,1,19,16,50,8,1,"https://fbref.com/en/players/1e465e70/Sergio-Arribas"
2024,"Almería","La Liga","Iddrisu Baba","GHA","MF","28-129",1996,15.9,46,26,27,18,1,17,39,43.6,22,20,6,14,11,57,27,2,"https://fbref.com/en/players/bfd381b3/Iddrisu-Baba"
2024,"Almería","La Liga","Srđan Babić","SRB","DF","28-038",1996,1,2,2,0,2,0,1,1,100,0,1,1,0,0,2,2,0,"https://fbref.com/en/players/075fe5a3/Srdjan-Babic"
2024,"Almería","La Liga","Léo Baptistão","BRA","FW","31-278",1992,20.4,25,16,12,8,5,9,25,36,16,13,1,12,11,36,22,0,"https://fbref.com/en/players/35f6db55/Leo-Baptistao"
2024,"Almería","La Liga","Juan Brandáriz","ESP","DF","25-089",1999,27,34,22,22,12,0,16,26,61.5,10,38,23,15,14,48,107,3,"https://fbref.com/en/players/2475cf9b/Juan-Brandariz"
2024,"Almería","La Liga","Álex Centelles","ESP","DF","26-204",1997,10.9,11,6,9,2,0,8,18,44.4,10,5,2,3,18,29,29,0,"https://fbref.com/en/players/ae852b7d/Alex-Centelles"
2024,"Almería","La Liga","Adri Embarba","ESP","FW,MF","32-023",1992,27.5,55,37,29,15,11,26,53,49.1,27,37,1,36,15,70,12,0,"https://fbref.com/en/players/db8f0eba/Adri-Embarba"
2024,"Almería","La Liga","Fernando","ESP","GK","33-355",1990,4,0,0,0,0,0,0,0,NA,0,1,0,1,0,0,2,0,"https://fbref.com/en/players/dabb2827/Fernando"
2024,"Almería","La Liga","Rachad Fettal","MAR","FW","19-135",2005,0.2,1,1,1,0,0,0,0,NA,0,0,0,0,0,1,0,0,"https://fbref.com/en/players/ae9a9b2d/Rachad-Fettal"
2024,"Almería","La Liga","Édgar González","ESP","DF,MF","27-059",1997,28,45,21,22,20,3,25,49,51,24,48,28,20,38,83,130,3,"https://fbref.com/en/players/49d028db/Edgar-Gonzalez"
2024,"Almería","La Liga","Luis Javier Suárez","COL","FW","26-180",1997,10.2,7,5,2,5,0,2,6,33.3,4,11,0,11,0,7,13,0,"https://fbref.com/en/players/eeba07f8/Luis-Javier-Suarez"
2024,"Almería","La Liga","Kaiky","BRA","DF","20-139",2004,5.8,7,4,6,0,1,3,6,50,3,9,7,2,3,10,29,1,"https://fbref.com/en/players/55634fb8/Kaiky"
2024,"Almería","La Liga","Ibrahima Koné","MLI","FW","24-349",1999,3.1,1,0,1,0,0,1,1,100,0,1,0,1,0,1,4,0,"https://fbref.com/en/players/04bb2b06/Ibrahima-Kone"
2024,"Almería","La Liga","Bruno Langa","MOZ","DF","26-212",1997,9.1,17,12,10,5,2,6,14,42.9,8,11,4,7,4,21,33,2,"https://fbref.com/en/players/72947847/Bruno-Langa"
2024,"Almería","La Liga","Lázaro","BRA","FW,MF","22-079",2002,3.2,4,1,2,0,2,2,8,25,6,4,0,4,1,5,1,0,"https://fbref.com/en/players/86ff856b/Lazaro"
2024,"Almería","La Liga","Dion Lopy","SEN","MF","22-118",2002,21.3,62,37,36,20,6,17,44,38.6,27,23,5,18,15,77,22,2,"https://fbref.com/en/players/64c14d49/Dion-Lopy"
2024,"Almería","La Liga","Anthony Lozano","HON","FW","31-035",1993,8.6,7,5,2,5,0,4,7,57.1,3,6,1,5,2,9,12,0,"https://fbref.com/en/players/38699c72/Anthony-Lozano"
2024,"Almería","La Liga","Diego Mariño","ESP","GK","34-021",1990,1,0,0,0,0,0,0,0,NA,0,0,0,0,0,0,1,0,"https://fbref.com/en/players/d9235a45/Diego-Marino"
2024,"Almería","La Liga","Luís Maximiano","POR","GK","25-146",1999,33,0,0,0,0,0,0,1,0,1,0,0,0,0,0,19,2,"https://fbref.com/en/players/3318286e/Luis-Maximiano"
2024,"Almería","La Liga","Gonzalo Melero","ESP","MF,FW","30-149",1994,12.3,14,8,7,5,2,7,19,36.8,12,12,4,8,4,18,11,0,"https://fbref.com/en/players/3902e91b/Gonzalo-Melero"
2024,"Almería","La Liga","Houboulang Mendes","GNB","DF","26-026",1998,4.4,16,13,11,5,0,8,16,50,8,4,2,2,1,17,17,1,"https://fbref.com/en/players/1545cf15/Houboulang-Mendes"
2024,"Almería","La Liga","Marko Milovanović","SRB","FW,MF","20-300",2003,3.4,4,4,1,3,0,2,4,50,2,2,0,2,0,4,5,0,"https://fbref.com/en/players/1fda2b14/Marko-Milovanovic"
2024,"Almería","La Liga","César Montes","MEX","DF","27-096",1997,19.9,22,13,13,9,0,9,18,50,9,21,9,12,11,33,94,0,"https://fbref.com/en/players/28e957d7/Cesar-Montes"
2024,"Almería","La Liga","Marcos Peña","ESP","MF","19-129",2005,4.9,19,14,12,7,0,6,12,50,6,9,3,6,13,32,8,0,"https://fbref.com/en/players/736c14ec/Marcos-Pena"
2024,"Almería","La Liga","Alejandro Pozo Pozo","ESP","DF,MF","25-098",1999,10.8,19,12,11,6,2,12,20,60,8,14,4,10,7,26,21,0,"https://fbref.com/en/players/3c16d927/Alejandro-Pozo-Pozo"
2024,"Almería","La Liga","Pubill","ESP","DF","20-345",2003,20.9,47,23,35,8,4,22,39,56.4,17,20,8,12,15,62,83,1,"https://fbref.com/en/players/365113c0/Pubill"
2024,"Almería","La Liga","Arnau Puigmal","ESP","FW,DF","23-141",2001,2.8,2,1,1,1,0,1,3,33.3,2,3,0,3,3,5,2,0,"https://fbref.com/en/players/39352da2/Arnau-Puigmal"
2024,"Almería","La Liga","Aleksandar Radovanović","SRB","DF","30-201",1993,6.3,8,7,7,1,0,6,6,100,0,8,8,0,11,19,48,0,"https://fbref.com/en/players/09507ffa/Aleksandar-Radovanovic"
2024,"Almería","La Liga","Largie Ramazani","BEL","FW,MF","23-093",2001,17.3,12,7,5,6,1,6,26,23.1,20,16,2,14,34,46,10,0,"https://fbref.com/en/players/cc9256ef/Largie-Ramazani"
2024,"Almería","La Liga","Lucas Robertone","ARG","MF","27-073",1997,26.5,61,33,28,23,10,25,50,50,25,43,9,34,51,112,43,0,"https://fbref.com/en/players/a8981944/Lucas-Robertone"
2024,"Almería","La Liga","Luka Romero","ARG","FW","19-194",2004,4.9,5,1,2,3,0,2,4,50,2,12,1,11,1,6,2,1,"https://fbref.com/en/players/ca6edaa0/Luka-Romero"
2024,"Almería","La Liga","Marciano Sanca","GNB","FW,MF","20-088",2004,0.5,0,0,0,0,0,0,0,NA,0,0,0,0,0,0,0,0,"https://fbref.com/en/players/39a938cb/Marciano-Sanca"
2024,"Almería","La Liga","Paco Sanz","ESP","DF","19-197",2004,0.3,0,0,0,0,0,0,1,0,1,0,0,0,0,0,4,0,"https://fbref.com/en/players/b7aa8fd8/Paco-Sanz"
2024,"Almería","La Liga","Jonathan Viera","ESP","MF","34-222",1989,10.1,19,9,6,9,4,10,19,52.6,9,4,0,4,4,23,1,0,"https://fbref.com/en/players/efa708aa/Jonathan-Viera"
2024,"Arsenal","Premier League","Mohamed Elneny","EGY","MF","31-324",1992,0.3,0,0,0,0,0,0,1,0,1,0,0,0,1,1,0,0,"https://fbref.com/en/players/47a34c4f/Mohamed-Elneny"
2024,"Arsenal","Premier League","Kai Havertz","GER","MF,FW","24-354",1999,29.3,35,15,7,21,7,14,39,35.9,25,26,1,25,20,55,22,0,"https://fbref.com/en/players/fed7cb61/Kai-Havertz"
2024,"Arsenal","Premier League","Gabriel Jesus","BRA","FW","27-057",1997,16.4,24,17,11,5,8,5,18,27.8,13,23,1,22,13,37,12,0,"https://fbref.com/en/players/b66315ae/Gabriel-Jesus"
2024,"Arsenal","Premier League","Jorginho","ITA","MF","32-162",1991,10.2,24,10,6,10,8,11,23,47.8,12,17,1,16,12,36,7,1,"https://fbref.com/en/players/45db685d/Jorginho"
2024,"Arsenal","Premier League","Jakub Kiwior","POL","DF","24-105",2000,10.5,20,12,11,8,1,14,19,73.7,5,11,3,8,8,28,28,1,"https://fbref.com/en/players/dc3e663e/Jakub-Kiwior"
2024,"Arsenal","Premier League","Gabriel Magalhães","BRA","DF","26-163",1997,33.8,48,28,24,22,2,17,22,77.3,5,44,33,11,31,79,100,1,"https://fbref.com/en/players/67ac5bb8/Gabriel-Magalhaes"
2024,"Arsenal","Premier League","Gabriel Martinelli","BRA","FW","22-347",2001,22.4,30,24,9,12,9,13,32,40.6,19,23,1,22,5,35,9,1,"https://fbref.com/en/players/48a5a5d6/Gabriel-Martinelli"
2024,"Arsenal","Premier League","Reiss Nelson","ENG","FW","24-172",1999,3,9,6,5,1,3,8,10,80,2,5,1,4,1,10,5,0,"https://fbref.com/en/players/c5bdb6e3/Reiss-Nelson"
2024,"Arsenal","Premier League","Eddie Nketiah","ENG","FW","25-000",1999,12,12,7,2,6,4,2,7,28.6,5,11,0,11,4,16,4,0,"https://fbref.com/en/players/a53649b7/Eddie-Nketiah"
2024,"Arsenal","Premier League","Ethan Nwaneri","ENG","FW","17-070",2007,0.2,0,0,0,0,0,0,0,NA,0,1,0,1,0,0,0,0,"https://fbref.com/en/players/7f94982c/Ethan-Nwaneri"
2024,"Arsenal","Premier League","Thomas Partey","GHA","MF,DF","30-352",1993,8.8,14,11,9,4,1,5,10,50,5,9,3,6,11,25,9,0,"https://fbref.com/en/players/529f49ab/Thomas-Partey"
2024,"Arsenal","Premier League","Aaron Ramsdale","ENG","GK","26-016",1998,6,0,0,0,0,0,0,0,NA,0,0,0,0,0,0,3,2,"https://fbref.com/en/players/466fb2c5/Aaron-Ramsdale"
2024,"Arsenal","Premier League","David Raya","ESP","GK","28-258",1995,32,1,1,1,0,0,1,1,100,0,0,0,0,0,1,8,5,"https://fbref.com/en/players/98ea5115/David-Raya"
2024,"Arsenal","Premier League","Declan Rice","ENG","MF","25-137",1999,35.8,83,51,37,38,8,32,57,56.1,25,37,11,26,44,127,52,0,"https://fbref.com/en/players/1c7012b8/Declan-Rice"
2024,"Arsenal","Premier League","Bukayo Saka","ENG","FW","22-268",2001,32.4,66,35,22,24,20,26,59,44.1,33,43,2,41,15,81,24,1,"https://fbref.com/en/players/bc7dc64d/Bukayo-Saka"
2024,"Arsenal","Premier League","William Saliba","FRA","DF","23-067",2001,38,41,26,28,12,1,20,27,74.1,7,32,17,15,29,70,81,3,"https://fbref.com/en/players/972aeb2a/William-Saliba"
2024,"Arsenal","Premier League","Emile Smith Rowe","ENG","MF","23-307",2000,3.9,4,1,2,2,0,2,4,50,2,3,1,2,3,7,1,0,"https://fbref.com/en/players/17695062/Emile-Smith-Rowe"
2024,"Arsenal","Premier League","Cédric Soares","POR","DF","32-273",1991,0.7,0,0,0,0,0,0,0,NA,0,0,0,0,0,0,0,0,"https://fbref.com/en/players/839c14e1/Cedric-Soares"
2024,"Arsenal","Premier League","Jurriën Timber","NED","DF","22-348",2001,0.8,2,2,1,1,0,0,0,NA,0,1,0,1,0,2,1,0,"https://fbref.com/en/players/41034650/Jurrien-Timber"
2024,"Arsenal","Premier League","Takehiro Tomiyasu","JPN","DF","25-207",1998,12.8,20,9,15,4,1,11,18,61.1,7,10,4,6,18,38,33,0,"https://fbref.com/en/players/b3af9be1/Takehiro-Tomiyasu"
2024,"Arsenal","Premier League","Leandro Trossard","BEL","FW,MF","29-178",1994,18.3,27,16,8,9,10,9,25,36,16,27,1,26,8,35,6,0,"https://fbref.com/en/players/38ceb24a/Leandro-Trossard"
2024,"Arsenal","Premier League","Fabio Vieira","POR","MF,FW","24-000",2000,3.3,3,2,2,0,1,3,3,100,0,0,0,0,2,5,2,0,"https://fbref.com/en/players/6412cc03/Fabio-Vieira"
2024,"Arsenal","Premier League","Ben White","ENG","DF","26-235",1997,33.2,48,28,20,22,6,26,58,44.8,32,48,22,26,32,80,77,1,"https://fbref.com/en/players/35e413f1/Ben-White"
2024,"Arsenal","Premier League","Oleksandr Zinchenko","UKR","DF","27-167",1996,19.1,50,30,19,24,7,35,52,67.3,17,18,3,15,20,70,26,2,"https://fbref.com/en/players/51cf8561/Oleksandr-Zinchenko"
2024,"Arsenal","Premier League","Martin Ødegaard","NOR","MF","25-165",1998,34.3,49,17,18,21,10,17,58,29.3,41,23,1,22,15,64,5,0,"https://fbref.com/en/players/79300479/Martin-Odegaard"
2024,"Aston Villa","Premier League","Cameron Archer","ENG","MF","22-314",2001,0.1,0,0,0,0,0,0,0,NA,0,0,0,0,0,0,0,0,"https://fbref.com/en/players/05e8ca6d/Cameron-Archer"
2024,"Aston Villa","Premier League","Leon Bailey","JAM","MF,FW","26-295",1997,23,13,7,7,4,2,5,20,25,15,18,1,17,9,22,6,0,"https://fbref.com/en/players/3a233281/Leon-Bailey"
2024,"Aston Villa","Premier League","Diego Carlos","BRA","DF","31-076",1993,20.2,27,16,22,4,1,13,21,61.9,8,24,19,5,13,40,78,3,"https://fbref.com/en/players/b4a014b1/Diego-Carlos"
2024,"Aston Villa","Premier League","Matty Cash","POL","DF","26-297",1997,23.8,54,31,24,24,6,29,59,49.2,30,35,14,21,18,72,59,0,"https://fbref.com/en/players/2389cdc2/Matty-Cash"
2024,"Aston Villa","Premier League","Calum Chambers","ENG","MF,DF","29-131",1995,1.7,3,0,3,0,0,0,1,0,1,2,1,1,2,5,4,0,"https://fbref.com/en/players/dc6f5bdd/Calum-Chambers"
2024,"Aston Villa","Premier League","Philippe Coutinho","BRA","MF,FW","31-353",1992,0.3,0,0,0,0,0,0,1,0,1,0,0,0,0,0,0,0,"https://fbref.com/en/players/0ef89a37/Philippe-Coutinho"
2024,"Aston Villa","Premier League","Leander Dendoncker","BEL","MF","29-045",1995,1.3,6,4,3,2,1,4,5,80,1,5,2,3,2,8,3,1,"https://fbref.com/en/players/5a7301ae/Leander-Dendoncker"
2024,"Aston Villa","Premier League","Moussa Diaby","FRA","FW,MF","24-328",1999,24.2,12,5,5,4,3,4,22,18.2,18,8,1,7,9,21,6,0,"https://fbref.com/en/players/aeed5c06/Moussa-Diaby"
2024,"Aston Villa","Premier League","Lucas Digne","FRA","DF","30-315",1993,26.8,47,19,35,9,3,25,44,56.8,19,20,2,18,26,73,67,0,"https://fbref.com/en/players/1b84dbe1/Lucas-Digne"
2024,"Aston Villa","Premier League","Jhon Durán","COL","FW,MF","20-169",2003,5.3,6,5,3,1,2,1,6,16.7,5,6,0,6,1,7,10,0,"https://fbref.com/en/players/414184f7/Jhon-Duran"
2024,"Aston Villa","Premier League","Tim Iroegbunam","ENG","MF","20-335",2003,1.8,7,5,4,2,1,4,9,44.4,5,3,0,3,2,9,3,0,"https://fbref.com/en/players/84c5ceea/Tim-Iroegbunam"
2024,"Aston Villa","Premier League","Boubacar Kamara","FRA","MF","24-189",1999,18.4,43,29,16,21,6,24,47,51.1,23,21,7,14,21,64,16,0,"https://fbref.com/en/players/cc77354e/Boubacar-Kamara"
2024,"Aston Villa","Premier League","Omari Kellyman","ENG","FW","18-258",2005,0.4,1,0,0,1,0,1,2,50,1,0,0,0,0,1,0,0,"https://fbref.com/en/players/aa888da7/Omari-Kellyman"
2024,"Aston Villa","Premier League","Kaine Kesler-Hayden","ENG","MF,DF","21-220",2002,0.1,0,0,0,0,0,0,0,NA,0,0,0,0,0,0,0,0,"https://fbref.com/en/players/9b066938/Kaine-Kesler-Hayden"
2024,"Aston Villa","Premier League","Ezri Konsa","ENG","DF","26-220",1997,34.1,54,32,28,23,3,23,27,85.2,4,36,20,16,28,82,73,3,"https://fbref.com/en/players/0313a347/Ezri-Konsa"
2024,"Aston Villa","Premier League","Clément Lenglet","FRA","DF","28-348",1995,12.8,13,9,7,5,1,7,13,53.8,6,19,11,8,7,20,47,1,"https://fbref.com/en/players/4f28a6ff/Clement-Lenglet"
2024,"Aston Villa","Premier League","Douglas Luiz","BRA","MF","26-021",1998,33.3,58,38,21,27,10,25,53,47.2,28,32,8,24,23,81,18,2,"https://fbref.com/en/players/6f7d826d/Douglas-Luiz"
2024,"Aston Villa","Premier League","Emiliano Martínez","ARG","GK","31-271",1992,33.5,0,0,0,0,0,0,0,NA,0,0,0,0,0,0,12,3,"https://fbref.com/en/players/7956236f/Emiliano-Martinez"
2024,"Aston Villa","Premier League","John McGinn","SCO","MF,FW","29-225",1994,33.3,59,35,18,34,7,32,77,41.6,45,33,4,29,21,80,21,0,"https://fbref.com/en/players/90f91999/John-McGinn"
2024,"Aston Villa","Premier League","Tyrone Mings","ENG","DF","31-078",1993,0.3,0,0,0,0,0,0,0,NA,0,0,0,0,1,1,1,0,"https://fbref.com/en/players/8397a50c/Tyrone-Mings"
2024,"Aston Villa","Premier League","Álex Moreno","ESP","DF","30-357",1993,11.5,18,12,18,0,0,12,19,63.2,7,11,2,9,13,31,37,0,"https://fbref.com/en/players/16e9d0ea/Alex-Moreno"
2024,"Aston Villa","Premier League","Finley Munroe","ENG","MF","19-112",2005,0,0,0,0,0,0,0,0,NA,0,0,0,0,0,0,0,0,"https://fbref.com/en/players/36625c27/Finley-Munroe"
2024,"Aston Villa","Premier League","Robin Olsen","SWE","GK","34-143",1990,4.5,0,0,0,0,0,0,0,NA,0,0,0,0,0,0,1,0,"https://fbref.com/en/players/e7ee38c3/Robin-Olsen"
2024,"Aston Villa","Premier League","Jaden Philogene Bidace","ENG","FW","22-112",2002,0,0,0,0,0,0,0,0,NA,0,0,0,0,0,0,0,0,"https://fbref.com/en/players/19f4d211/Jaden-Philogene-Bidace"
2024,"Aston Villa","Premier League","Jacob Ramsey","ENG","FW,MF","23-002",2001,9.5,16,8,7,6,3,5,15,33.3,10,15,2,13,3,19,8,0,"https://fbref.com/en/players/1544f145/Jacob-Ramsey"
2024,"Aston Villa","Premier League","Morgan Rogers","ENG","MF,FW","21-309",2002,7.1,8,1,3,2,3,2,11,18.2,9,11,0,11,3,11,11,0,"https://fbref.com/en/players/2e5915f1/Morgan-Rogers"
2024,"Aston Villa","Premier League","Youri Tielemans","BEL","MF,FW","27-023",1997,18,41,20,17,18,6,16,40,40,24,23,3,20,15,56,9,0,"https://fbref.com/en/players/56f7a928/Youri-Tielemans"
2024,"Aston Villa","Premier League","Pau Torres","ESP","DF","27-135",1997,27.4,29,18,17,11,1,14,30,46.7,16,28,12,16,14,43,75,0,"https://fbref.com/en/players/532e1e4f/Pau-Torres"
2024,"Aston Villa","Premier League","Bertrand Traoré","BFA","DF,FW","28-267",1995,0.1,1,1,1,0,0,0,0,NA,0,0,0,0,0,1,1,0,"https://fbref.com/en/players/c47541e0/Bertrand-Traore"
2024,"Aston Villa","Premier League","Ollie Watkins","ENG","FW","28-152",1995,35.7,12,7,0,5,7,5,11,45.5,6,26,4,22,4,16,20,0,"https://fbref.com/en/players/aed3a70f/Ollie-Watkins"
2024,"Aston Villa","Premier League","Nicolò Zaniolo","ITA","FW,MF","24-333",1999,9.3,19,9,10,7,2,9,17,52.9,8,13,0,13,1,20,11,0,"https://fbref.com/en/players/9907b1c8/Nicolo-Zaniolo"
2024,"Atalanta","Serie A","Mitchel Bakker","NED","DF","23-345",2000,4.2,7,3,6,1,0,2,12,16.7,10,5,0,5,3,10,6,0,"https://fbref.com/en/players/a8567629/Mitchel-Bakker"
2024,"Atalanta","Serie A","El Bilal Touré","MLI","FW","22-240",2001,4.2,1,1,0,1,0,0,1,0,1,0,0,0,1,2,2,0,"https://fbref.com/en/players/47c609d5/El-Bilal-Toure"
2024,"Atalanta","Serie A","Giovanni Bonfanti","ITA","DF","21-134",2003,1,4,2,2,2,0,2,3,66.7,1,1,1,0,1,5,1,0,"https://fbref.com/en/players/938d8a55/Giovanni-Bonfanti"
2024,"Atalanta","Serie A","Marco Carnesecchi","ITA","GK","23-334",2000,25.9,0,0,0,0,0,0,0,NA,0,0,0,0,0,0,20,3,"https://fbref.com/en/players/8ec56e62/Marco-Carnesecchi"
2024,"Atalanta","Serie A","Charles De Ketelaere","BEL","FW,MF","23-081",2001,21.7,31,20,3,12,16,8,18,44.4,10,29,2,27,7,38,6,0,"https://fbref.com/en/players/2ef7c612/Charles-De-Ketelaere"
2024,"Atalanta","Serie A","Berat Djimsiti","ALB","DF","31-101",1993,31.3,42,24,29,12,1,19,31,61.3,12,53,33,20,57,99,99,0,"https://fbref.com/en/players/6eee05f1/Berat-Djimsiti"
2024,"Atalanta","Serie A","Éderson","BRA","MF","24-328",1999,30.9,80,46,37,36,7,43,62,69.4,19,47,8,39,40,120,33,1,"https://fbref.com/en/players/a9202def/Ederson"
2024,"Atalanta","Serie A","Hans Hateboer","NED","DF","30-142",1994,12.3,12,5,8,2,2,5,15,33.3,10,21,7,14,4,16,21,0,"https://fbref.com/en/players/3b333ac3/Hans-Hateboer"
2024,"Atalanta","Serie A","Isak Hien","SWE","DF","25-138",1999,9.4,18,12,8,10,0,7,14,50,7,11,5,6,11,29,29,0,"https://fbref.com/en/players/12806697/Isak-Hien"
2024,"Atalanta","Serie A","Emil Holm","SWE","DF","24-017",2000,9.9,26,17,17,7,2,15,35,42.9,20,24,3,21,7,33,25,0,"https://fbref.com/en/players/c2357b65/Emil-Holm"
2024,"Atalanta","Serie A","Sead Kolašinac","BIH","DF","30-345",1993,24.2,44,32,23,19,2,30,49,61.2,19,22,9,13,21,65,47,0,"https://fbref.com/en/players/3935e52e/Sead-Kolasinac"
2024,"Atalanta","Serie A","Teun Koopmeiners","NED","MF","26-092",1998,28.2,39,24,12,22,5,17,50,34,33,33,3,30,10,49,34,0,"https://fbref.com/en/players/a26fb8aa/Teun-Koopmeiners"
2024,"Atalanta","Serie A","Ademola Lookman","NGA","FW,MF","26-223",1997,20.4,18,13,2,9,7,8,22,36.4,14,18,0,18,9,27,0,1,"https://fbref.com/en/players/7c104bb7/Ademola-Lookman"
2024,"Atalanta","Serie A","José Luis Palomino","ARG","DF","34-146",1990,0.3,2,1,1,1,0,1,1,100,0,2,1,1,1,3,6,0,"https://fbref.com/en/players/921f6058/Jose-Luis-Palomino"
2024,"Atalanta","Serie A","Leonardo Mendicino","ITA","MF","17-340",2006,0,0,0,0,0,0,0,0,NA,0,0,0,0,0,0,0,0,"https://fbref.com/en/players/dac2bed8/Leonardo-Mendicino"
2024,"Atalanta","Serie A","Aleksei Miranchuk","RUS","MF,FW","28-226",1995,12.7,12,6,6,4,2,5,13,38.5,8,6,1,5,2,14,5,1,"https://fbref.com/en/players/a9aa0d1d/Aleksei-Miranchuk"
2024,"Atalanta","Serie A","Luis Muriel","COL","FW,MF","33-044",1991,4.5,3,2,0,2,1,1,1,100,0,4,0,4,1,4,0,0,"https://fbref.com/en/players/eb2fe5b6/Luis-Muriel"
2024,"Atalanta","Serie A","Juan Musso","ARG","GK","30-024",1994,11,1,0,1,0,0,1,1,100,0,0,0,0,0,1,6,0,"https://fbref.com/en/players/a111cf41/Juan-Musso"
2024,"Atalanta","Serie A","Michel Ndary Adopo","FRA","MF","23-316",2000,1.2,4,3,0,3,1,1,1,100,0,0,0,0,0,4,2,1,"https://fbref.com/en/players/599d91d0/Michel-Ndary-Adopo"
2024,"Atalanta","Serie A","Mario Pašalić","CRO","MF,FW","29-111",1995,21.8,28,17,9,18,1,14,31,45.2,17,28,6,22,16,44,34,0,"https://fbref.com/en/players/e599253a/Mario-Pasalic"
2024,"Atalanta","Serie A","Marten de Roon","NED","MF,DF","33-062",1991,28.9,80,43,36,32,12,35,82,42.7,47,36,10,26,40,120,54,0,"https://fbref.com/en/players/2a1beb34/Marten-de-Roon"
2024,"Atalanta","Serie A","Francesco Rossi","ITA","GK","33-033",1991,0.1,0,0,0,0,0,0,0,NA,0,0,0,0,0,0,0,0,"https://fbref.com/en/players/7b5f516f/Francesco-Rossi"
2024,"Atalanta","Serie A","Matteo Ruggeri","ITA","DF","21-324",2002,26.2,27,14,13,7,7,14,28,50,14,42,3,39,22,49,42,0,"https://fbref.com/en/players/ae9898c5/Matteo-Ruggeri"
2024,"Atalanta","Serie A","Giorgio Scalvini","ITA","DF","20-171",2003,27.3,52,32,29,18,5,19,39,48.7,20,43,17,26,57,109,70,0,"https://fbref.com/en/players/1e9aa637/Giorgio-Scalvini"
2024,"Atalanta","Serie A","Gianluca Scamacca","ITA","FW","25-150",1999,15.8,15,9,4,5,6,7,14,50,7,7,1,6,4,19,8,0,"https://fbref.com/en/players/8790f988/Gianluca-Scamacca"
2024,"Atalanta","Serie A","Rafael Tolói","ITA","DF","33-233",1990,9.9,19,8,6,8,5,13,26,50,13,8,4,4,13,32,27,0,"https://fbref.com/en/players/c56dc39e/Rafael-Toloi"
2024,"Atalanta","Serie A","Duván Zapata","COL","FW","33-059",1991,1.2,0,0,0,0,0,0,1,0,1,0,0,0,0,0,1,0,"https://fbref.com/en/players/d3de9af0/Duvan-Zapata"
2024,"Atalanta","Serie A","Davide Zappacosta","ITA","DF","31-354",1992,20.7,30,20,15,10,5,16,34,47.1,18,29,4,25,5,35,19,0,"https://fbref.com/en/players/7fe90ccd/Davide-Zappacosta"
2024,"Atalanta","Serie A","Nadir Zortea","ITA","DF","24-346",1999,1.7,5,4,3,1,1,1,4,25,3,2,0,2,1,6,3,0,"https://fbref.com/en/players/82598b71/Nadir-Zortea"
2024,"Athletic Club","La Liga","Julen Agirrezabala","ESP","GK","23-156",2000,2.6,0,0,0,0,0,0,0,NA,0,0,0,0,0,0,0,0,"https://fbref.com/en/players/a2c1a8d3/Julen-Agirrezabala"
2024,"Athletic Club","La Liga","Yeray Álvarez","ESP","DF","29-127",1995,12.8,18,9,15,3,0,12,19,63.2,7,8,5,3,11,29,34,1,"https://fbref.com/en/players/3ecc11d8/Yeray-Alvarez"
2024,"Athletic Club","La Liga","Adu Ares","ESP","FW","22-231",2001,2.9,8,4,4,2,2,2,3,66.7,1,1,0,1,1,9,0,0,"https://fbref.com/en/players/a461f098/Adu-Ares"
2024,"Athletic Club","La Liga","Yuri Berchiche","ESP","DF","34-110",1990,21.4,33,25,13,14,6,19,33,57.6,14,28,9,19,20,53,62,0,"https://fbref.com/en/players/b6e50615/Yuri-Berchiche"
2024,"Athletic Club","La Liga","Álex Berenguer","ESP","FW","28-331",1995,17.7,23,14,9,9,5,7,24,29.2,17,23,0,23,5,28,13,0,"https://fbref.com/en/players/dc1c2fce/Alex-Berenguer"
2024,"Athletic Club","La Liga","Iñigo Ruiz de Galarreta","ESP","MF","30-298",1993,23.2,49,31,15,26,8,24,49,49,25,18,5,13,12,61,17,0,"https://fbref.com/en/players/91f7631f/Inigo-Ruiz-de-Galarreta"
2024,"Athletic Club","La Liga","Dani García","ESP","MF","34-006",1990,8.3,17,11,4,7,6,12,24,50,12,9,3,6,8,25,11,0,"https://fbref.com/en/players/240d3a0b/Dani-Garcia"
2024,"Athletic Club","La Liga","Raúl García","ESP","FW,MF","37-324",1986,4.7,9,6,2,4,3,4,9,44.4,5,10,1,9,3,12,9,0,"https://fbref.com/en/players/b418dbd4/Raul-Garcia"
2024,"Athletic Club","La Liga","Unai Gómez","ESP","MF","21-005",2003,9.7,12,10,2,6,4,5,10,50,5,13,2,11,2,14,9,0,"https://fbref.com/en/players/37db6cae/Unai-Gomez"
2024,"Athletic Club","La Liga","Gorka Guruzeta","ESP","FW","27-261",1996,24.6,34,23,6,25,3,9,30,30,21,36,2,34,17,51,23,0,"https://fbref.com/en/players/6b5ea2f4/Gorka-Guruzeta"
2024,"Athletic Club","La Liga","Ander Herrera","ESP","MF","34-290",1989,11.4,44,32,11,26,7,20,36,55.6,16,16,6,10,15,59,18,1,"https://fbref.com/en/players/436a9dd0/Ander-Herrera"
2024,"Athletic Club","La Liga","Imanol","ESP","DF","23-357",2000,5.8,7,5,1,5,1,5,18,27.8,13,6,0,6,7,14,15,0,"https://fbref.com/en/players/9e095d72/Imanol"
2024,"Athletic Club","La Liga","Mikel Jauregizar","ESP","MF","20-200",2003,1.7,0,0,0,0,0,0,6,0,6,5,0,5,0,0,2,0,"https://fbref.com/en/players/2f5c78ca/Mikel-Jauregizar"
2024,"Athletic Club","La Liga","Iñigo Lekue","ESP","DF","31-026",1993,22.2,40,22,25,10,5,27,53,50.9,26,24,6,18,15,55,50,0,"https://fbref.com/en/players/59b7d823/Inigo-Lekue"
2024,"Athletic Club","La Liga","Óscar de Marcos","ESP","DF","35-046",1989,25.1,56,39,26,24,6,42,71,59.2,29,28,6,22,15,71,44,0,"https://fbref.com/en/players/9f323c71/Oscar-de-Marcos"
2024,"Athletic Club","La Liga","Iker Muniain","ESP","MF,FW","31-163",1992,6.6,5,1,2,3,0,1,3,33.3,2,4,1,3,0,5,0,0,"https://fbref.com/en/players/c05dfb74/Iker-Muniain"
2024,"Athletic Club","La Liga","Peru Nolaskoain","ESP","DF,MF","25-218",1998,0.1,1,1,1,0,0,1,1,100,0,0,0,0,0,1,1,0,"https://fbref.com/en/players/857cb4f3/Peru-Nolaskoain"
2024,"Athletic Club","La Liga","Aingeru Olabarrieta","ESP","FW","18-198",2005,0.1,0,0,0,0,0,0,0,NA,0,0,0,0,0,0,0,0,"https://fbref.com/en/players/b7e92b0e/Aingeru-Olabarrieta"
2024,"Athletic Club","La Liga","Aitor Paredes","ESP","DF","24-031",2000,30,20,11,11,9,0,7,14,50,7,23,11,12,33,53,104,0,"https://fbref.com/en/players/b906757a/Aitor-Paredes"
2024,"Athletic Club","La Liga","Beñat Prados","ESP","MF,DF","23-112",2001,16.1,45,28,11,23,11,23,42,54.8,19,32,5,27,23,68,27,0,"https://fbref.com/en/players/1f60244a/Benat-Prados"
2024,"Athletic Club","La Liga","Oihan Sancet","ESP","MF","24-035",2000,21.9,19,11,3,10,6,8,21,38.1,13,5,1,4,10,29,5,0,"https://fbref.com/en/players/bdb624a3/Oihan-Sancet"
2024,"Athletic Club","La Liga","Unai Simón","ESP","GK","26-354",1997,35.4,2,1,1,1,0,2,3,66.7,1,0,0,0,1,3,9,0,"https://fbref.com/en/players/5dcf3e90/Unai-Simon"
2024,"Athletic Club","La Liga","Mikel Vesga","ESP","MF","31-009",1993,17,40,20,11,23,6,19,49,38.8,30,19,7,12,32,72,35,1,"https://fbref.com/en/players/b0fce72c/Mikel-Vesga"
2024,"Athletic Club","La Liga","Asier Villalibre","ESP","FW","26-243",1997,5.7,2,1,0,0,2,2,2,100,0,2,1,1,0,2,6,0,"https://fbref.com/en/players/57be54ec/Asier-Villalibre"
2024,"Athletic Club","La Liga","Daniel Vivian","ESP","DF","24-320",1999,32,42,28,29,11,2,28,45,62.2,17,49,25,24,31,73,104,0,"https://fbref.com/en/players/ab7bf91d/Daniel-Vivian"
2024,"Athletic Club","La Liga","Iñaki Williams","GHA","FW","29-350",1994,31.6,24,17,6,8,10,13,34,38.2,21,42,8,34,14,38,29,0,"https://fbref.com/en/players/6a99e0b1/Inaki-Williams"
2024,"Athletic Club","La Liga","Nico Williams","ESP","FW","21-323",2002,25.1,31,12,9,15,7,13,36,36.1,23,18,2,16,3,34,4,1,"https://fbref.com/en/players/afdc14d7/Nico-Williams"
2024,"Atlético Madrid","La Liga","César Azpilicueta","ESP","DF","34-276",1989,15.8,25,14,15,9,1,12,19,63.2,7,25,6,19,16,41,46,0,"https://fbref.com/en/players/53cad200/Cesar-Azpilicueta"
2024,"Atlético Madrid","La Liga","Pablo Barrios","ESP","MF","20-350",2003,17.3,45,25,15,29,1,19,40,47.5,21,20,3,17,28,73,24,2,"https://fbref.com/en/players/45736cec/Pablo-Barrios"
2024,"Atlético Madrid","La Liga","Yannick Carrasco","BEL","DF","30-269",1993,2.5,4,4,3,1,0,2,7,28.6,5,2,0,2,1,5,6,0,"https://fbref.com/en/players/de39485a/Yannick-Carrasco"
2024,"Atlético Madrid","La Liga","Ángel Correa","ARG","FW,MF","29-082",1995,17,22,15,3,11,8,5,17,29.4,12,13,0,13,2,24,6,0,"https://fbref.com/en/players/01eb744d/Angel-Correa"
2024,"Atlético Madrid","La Liga","Rodrigo De Paul","ARG","MF","30-006",1994,23.1,31,21,11,14,6,15,38,39.5,23,28,1,27,11,42,15,2,"https://fbref.com/en/players/162efffd/Rodrigo-De-Paul"
2024,"Atlético Madrid","La Liga","Javi Galán","ESP","DF","29-193",1994,1,5,4,2,2,1,4,5,80,1,1,0,1,1,6,3,0,"https://fbref.com/en/players/a4b00319/Javi-Galan"
2024,"Atlético Madrid","La Liga","Antoine Griezmann","FRA","FW,MF","33-070",1991,29.4,33,19,14,14,5,15,41,36.6,26,34,3,31,10,43,23,1,"https://fbref.com/en/players/df69b544/Antoine-Griezmann"
2024,"Atlético Madrid","La Liga","Mario Hermoso","ESP","DF","28-347",1995,28.4,46,25,29,13,4,28,51,54.9,23,27,9,18,30,76,93,0,"https://fbref.com/en/players/555f3a0b/Mario-Hermoso"
2024,"Atlético Madrid","La Liga","Salim El Jebari","MAR","MF","20-115",2004,0.1,1,0,0,1,0,0,0,NA,0,0,0,0,0,1,1,0,"https://fbref.com/en/players/d068118b/Salim-El-Jebari"
2024,"Atlético Madrid","La Liga","Koke","ESP","MF","32-143",1992,27.7,66,44,27,32,7,36,79,45.6,43,37,12,25,16,82,34,1,"https://fbref.com/en/players/55126f3b/Koke"
2024,"Atlético Madrid","La Liga","Thomas Lemar","FRA","MF","28-200",1995,1.8,3,1,2,1,0,1,2,50,1,0,0,0,0,3,0,0,"https://fbref.com/en/players/4dbd0916/Thomas-Lemar"
2024,"Atlético Madrid","La Liga","Samuel Lino","BRA","DF,MF","24-159",1999,23.1,61,34,32,17,12,35,70,50,35,37,1,36,14,75,27,0,"https://fbref.com/en/players/2a295d33/Samuel-Lino"
2024,"Atlético Madrid","La Liga","Marcos Llorente","ESP","MF,DF","29-121",1995,28.5,40,23,18,17,5,16,44,36.4,28,36,11,25,14,54,35,0,"https://fbref.com/en/players/02c15616/Marcos-Llorente"
2024,"Atlético Madrid","La Liga","Reinildo Mandava","MOZ","DF","30-130",1994,8.1,30,22,16,11,3,19,22,86.4,3,10,2,8,15,45,21,0,"https://fbref.com/en/players/c20bdcd7/Reinildo-Mandava"
2024,"Atlético Madrid","La Liga","José María Giménez","URU","DF","29-131",1995,14.7,18,10,10,7,1,5,16,31.3,11,16,12,4,10,28,95,0,"https://fbref.com/en/players/f0da930c/Jose-Maria-Gimenez"
2024,"Atlético Madrid","La Liga","Memphis","NED","FW","30-107",1994,9.9,5,2,0,3,2,3,6,50,3,2,0,2,1,6,0,0,"https://fbref.com/en/players/8f696594/Memphis"
2024,"Atlético Madrid","La Liga","Nahuel Molina","ARG","DF","26-054",1998,20.6,38,22,16,18,4,26,54,48.1,28,19,3,16,9,47,36,1,"https://fbref.com/en/players/23610943/Nahuel-Molina"
2024,"Atlético Madrid","La Liga","Álvaro Morata","ESP","FW","31-220",1992,21.2,16,10,4,7,5,3,5,60,2,18,3,15,1,17,26,0,"https://fbref.com/en/players/129af0db/Alvaro-Morata"
2024,"Atlético Madrid","La Liga","Saúl Ñíguez","ESP","MF","29-191",1994,15.3,64,39,29,29,6,30,49,61.2,19,36,9,27,14,78,56,0,"https://fbref.com/en/players/c14bc029/Saul-Niguez"
2024,"Atlético Madrid","La Liga","Jan Oblak","SVN","GK","31-144",1993,38,0,0,0,0,0,0,0,NA,0,0,0,0,0,0,10,0,"https://fbref.com/en/players/ee8508c0/Jan-Oblak"
2024,"Atlético Madrid","La Liga","Gabriel Paulista","BRA","DF","33-186",1990,4.5,7,5,4,3,0,3,4,75,1,5,3,2,4,11,27,0,"https://fbref.com/en/players/b7ca5c51/Gabriel-Paulista"
2024,"Atlético Madrid","La Liga","Abdellah Raihani","MAR","FW","20-117",2004,0.1,0,0,0,0,0,0,1,0,1,0,0,0,0,0,0,0,"https://fbref.com/en/players/16ec501b/Abdellah-Raihani"
2024,"Atlético Madrid","La Liga","Rodrigo Riquelme","ESP","DF,MF","24-058",2000,17,30,19,18,4,8,18,46,39.1,28,19,0,19,9,39,20,0,"https://fbref.com/en/players/65154df0/Rodrigo-Riquelme"
2024,"Atlético Madrid","La Liga","Stefan Savić","MNE","DF","33-143",1991,18.1,27,19,16,7,4,15,30,50,15,29,15,14,27,54,61,1,"https://fbref.com/en/players/f6ac68c1/Stefan-Savic"
2024,"Atlético Madrid","La Liga","Çağlar Söyüncü","TUR","DF","28-007",1996,1.3,1,1,1,0,0,0,0,NA,0,1,0,1,1,2,7,0,"https://fbref.com/en/players/21166ff4/Caglar-Soyuncu"
2024,"Atlético Madrid","La Liga","Arthur Vermeeren","BEL","MF","19-113",2005,1.8,1,0,0,1,0,0,1,0,1,5,0,5,6,7,2,0,"https://fbref.com/en/players/722494dc/Arthur-Vermeeren"
2024,"Atlético Madrid","La Liga","Axel Witsel","BEL","DF","35-139",1989,30.9,35,21,23,12,0,17,24,70.8,7,40,21,19,16,51,119,0,"https://fbref.com/en/players/5dfc6ad5/Axel-Witsel"
2024,"Augsburg","Bundesliga","Maximilian Bauer","GER","DF","24-111",2000,9,19,12,13,4,2,9,17,52.9,8,14,8,6,11,30,30,1,"https://fbref.com/en/players/44a20f0c/Maximilian-Bauer"
2024,"Augsburg","Bundesliga","Mergim Berisha","GER","FW","26-019",1998,1.4,0,0,0,0,0,0,0,NA,0,1,0,1,0,0,3,0,"https://fbref.com/en/players/eb6e14be/Mergim-Berisha"
2024,"Augsburg","Bundesliga","Pep Biel","ESP","MF,FW","27-268",1996,3.2,4,3,0,2,2,1,3,33.3,2,2,1,1,2,6,2,0,"https://fbref.com/en/players/1c59240b/Pep-Biel"
2024,"Augsburg","Bundesliga","Tim Breithaupt","GER","MF","22-113",2002,7,20,11,11,9,0,13,21,61.9,8,15,3,12,8,28,10,0,"https://fbref.com/en/players/ed98c321/Tim-Breithaupt"
2024,"Augsburg","Bundesliga","Irvin Cardona","FRA","MF,DF","26-296",1997,0.6,1,1,0,0,1,1,3,33.3,2,1,0,1,0,1,1,0,"https://fbref.com/en/players/5e080f73/Irvin-Cardona"
2024,"Augsburg","Bundesliga","Finn Dahmen","GER","GK","26-064",1998,31,1,0,1,0,0,1,3,33.3,2,0,0,0,0,1,17,5,"https://fbref.com/en/players/dee3013b/Finn-Dahmen"
2024,"Augsburg","Bundesliga","Ermedin Demirović","BIH","FW,MF","26-066",1998,31.9,24,14,5,16,3,12,40,30,28,28,2,26,11,35,26,0,"https://fbref.com/en/players/ed79b7d3/Ermedin-Demirovic"
2024,"Augsburg","Bundesliga","Niklas Dorsch","GER","MF","26-136",1998,15.4,35,24,13,21,1,13,33,39.4,20,15,9,6,16,51,27,0,"https://fbref.com/en/players/7f73bdf4/Niklas-Dorsch"
2024,"Augsburg","Bundesliga","Dion Drena Beljo","CRO","FW,MF","22-090",2002,6.5,0,0,0,0,0,0,2,0,2,8,1,7,1,1,4,0,"https://fbref.com/en/players/9a2e3a23/Dion-Drena-Beljo"
2024,"Augsburg","Bundesliga","Arne Engels","BEL","MF,DF","20-265",2003,15.6,33,18,15,14,4,12,29,41.4,17,23,1,22,15,48,21,0,"https://fbref.com/en/players/554bcc91/Arne-Engels"
2024,"Augsburg","Bundesliga","Ohis Felix Uduokhai","GER","DF","26-264",1997,32.5,37,21,18,14,5,16,25,64,9,45,35,10,46,83,178,2,"https://fbref.com/en/players/677da306/Ohis-Felix-Uduokhai"
2024,"Augsburg","Bundesliga","Jeffrey Gouweleeuw","NED","DF","32-325",1991,28.8,35,23,13,17,5,16,25,64,9,44,24,20,35,70,108,0,"https://fbref.com/en/players/1025db8e/Jeffrey-Gouweleeuw"
2024,"Augsburg","Bundesliga","Robert Gumny","POL","DF","25-361",1998,5.3,6,5,1,3,2,1,5,20,4,13,5,8,7,13,15,0,"https://fbref.com/en/players/1df0c0b9/Robert-Gumny"
2024,"Augsburg","Bundesliga","Iago","BRA","DF","27-068",1997,18,36,17,22,10,4,17,33,51.5,16,39,8,31,18,54,43,0,"https://fbref.com/en/players/054849d2/Iago"
2024,"Augsburg","Bundesliga","Kristijan Jakić","CRO","MF","27-016",1997,11.7,28,14,14,10,4,15,33,45.5,18,13,1,12,20,48,15,0,"https://fbref.com/en/players/a8ee54ad/Kristijan-Jakic"
2024,"Augsburg","Bundesliga","Fredrik Jensen","FIN","MF,FW","26-264",1997,14.9,23,11,9,8,6,14,28,50,14,30,1,29,12,35,21,0,"https://fbref.com/en/players/3eeb80e0/Fredrik-Jensen"
2024,"Augsburg","Bundesliga","Mert Kömür","GER","MF,DF","18-318",2005,1.3,3,3,3,0,0,3,5,60,2,0,0,0,0,3,1,0,"https://fbref.com/en/players/ec68a918/Mert-Komur"
2024,"Augsburg","Bundesliga","Tomáš Koubek","CZE","GK","31-278",1992,3,0,0,0,0,0,0,0,NA,0,0,0,0,0,0,1,1,"https://fbref.com/en/players/dc366c36/Tomas-Koubek"
2024,"Augsburg","Bundesliga","Mahmut Kücüksahin","","MF","20-053",2004,0,0,0,0,0,0,0,0,NA,0,0,0,0,0,0,0,0,"https://fbref.com/en/players/5c954071/Mahmut-Kucuksahin"
2024,"Augsburg","Bundesliga","Arne Maier","GER","MF","25-143",1999,11.1,14,9,5,8,1,5,14,35.7,9,19,2,17,6,20,11,0,"https://fbref.com/en/players/ab700320/Arne-Maier"
2024,"Augsburg","Bundesliga","Kevin Mbabu","SUI","DF","29-041",1995,22.7,51,39,25,18,8,23,40,57.5,17,29,9,20,24,75,48,0,"https://fbref.com/en/players/493924a7/Kevin-Mbabu"
2024,"Augsburg","Bundesliga","Nathanael Mbuku","FRA","FW","22-075",2002,0.1,0,0,0,0,0,0,0,NA,0,1,0,1,0,0,0,0,"https://fbref.com/en/players/46750e9c/Nathanael-Mbuku"
2024,"Augsburg","Bundesliga","Sven Michel","GER","FW,MF","33-320",1990,6.5,7,5,2,1,4,2,7,28.6,5,1,0,1,0,7,4,0,"https://fbref.com/en/players/1e274a0a/Sven-Michel"
2024,"Augsburg","Bundesliga","Masaya Okugawa","JPN","FW,DF","28-046",1996,0.4,0,0,0,0,0,0,0,NA,0,0,0,0,0,0,2,0,"https://fbref.com/en/players/63b9cc6d/Masaya-Okugawa"
2024,"Augsburg","Bundesliga","Mads Pedersen","DEN","DF","27-272",1996,19.8,64,39,31,27,6,24,44,54.5,20,20,3,17,19,83,46,0,"https://fbref.com/en/players/582a5247/Mads-Pedersen"
2024,"Augsburg","Bundesliga","Patric Pfeiffer","GER","DF","24-284",1999,5.7,11,7,6,4,1,5,6,83.3,1,10,6,4,11,22,21,0,"https://fbref.com/en/players/d07d0aeb/Patric-Pfeiffer"
2024,"Augsburg","Bundesliga","Elvis Rexhbeçaj","GER","MF","26-211",1997,22.1,30,19,14,13,3,18,36,50,18,32,7,25,20,50,20,0,"https://fbref.com/en/players/1ae836b1/Elvis-Rexhbecaj"
2024,"Augsburg","Bundesliga","Phillip Tietz","GER","FW","26-326",1997,26.5,23,14,7,13,3,6,15,40,9,17,3,14,6,29,35,0,"https://fbref.com/en/players/3397e7b5/Phillip-Tietz"
2024,"Augsburg","Bundesliga","Ruben Vargas","SUI","MF,FW","25-299",1998,21.8,23,10,6,10,7,10,25,40,15,19,4,15,7,30,17,0,"https://fbref.com/en/players/6ecbddf6/Ruben-Vargas"
2024,"Barcelona","La Liga","Marcos Alonso","ESP","DF","33-154",1990,2.8,5,3,2,3,0,3,4,75,1,2,0,2,4,9,6,0,"https://fbref.com/en/players/f4290206/Marcos-Alonso"
2024,"Barcelona","La Liga","Ronald Araújo","URU","DF","25-084",1999,22.2,27,22,11,15,1,12,17,70.6,5,20,11,9,12,39,66,2,"https://fbref.com/en/players/2bef2bca/Ronald-Araujo"
2024,"Barcelona","La Liga","Alejandro Balde","ESP","DF","20-225",2003,15.3,20,11,11,6,3,7,11,63.6,4,14,1,13,5,25,21,1,"https://fbref.com/en/players/5ccc9672/Alejandro-Balde"
2024,"Barcelona","La Liga","João Cancelo","POR","DF","30-003",1994,27.8,64,44,35,21,8,38,58,65.5,20,35,6,29,29,93,59,1,"https://fbref.com/en/players/bd6351cd/Joao-Cancelo"
2024,"Barcelona","La Liga","Marc Casado","ESP","MF","20-259",2003,0.2,1,1,1,0,0,1,1,100,0,0,0,0,1,2,2,0,"https://fbref.com/en/players/2ef08833/Marc-Casado"
2024,"Barcelona","La Liga","Andreas Christensen","DEN","DF,MF","28-050",1996,22,23,14,7,14,2,16,28,57.1,12,23,10,13,21,44,41,0,"https://fbref.com/en/players/1cb49278/Andreas-Christensen"
2024,"Barcelona","La Liga","Pau Cubarsí","ESP","DF","17-129",2007,17.3,22,14,18,3,1,13,18,72.2,5,20,16,4,12,34,65,0,"https://fbref.com/en/players/cc7888f3/Pau-Cubarsi"
2024,"Barcelona","La Liga","Abdessamad Ezzalzouli","MAR","FW,MF","22-165",2001,0.8,1,1,0,0,1,0,1,0,1,1,0,1,0,1,0,0,"https://fbref.com/en/players/bed68338/Abdessamad-Ezzalzouli"
2024,"Barcelona","La Liga","Ansu Fati","ESP","MF,FW","21-212",2002,0.6,0,0,0,0,0,0,1,0,1,0,0,0,0,0,0,0,"https://fbref.com/en/players/0ba976e4/Ansu-Fati"
2024,"Barcelona","La Liga","João Félix","POR","FW","24-202",1999,17.1,22,16,9,7,6,8,22,36.4,14,14,1,13,10,32,11,0,"https://fbref.com/en/players/8aafd64f/Joao-Felix"
2024,"Barcelona","La Liga","Héctor Fort","ESP","DF","17-302",2006,3.5,6,5,5,1,0,4,10,40,6,0,0,0,2,8,4,0,"https://fbref.com/en/players/2e31f3a6/Hector-Fort"
2024,"Barcelona","La Liga","Eric García","ESP","DF","23-142",2001,0.6,0,0,0,0,0,0,0,NA,0,1,1,0,0,0,0,0,"https://fbref.com/en/players/2bed3eab/Eric-Garcia"
2024,"Barcelona","La Liga","Gavi","ESP","MF,FW","19-299",2004,10.5,39,21,20,14,5,18,36,50,18,19,3,16,8,47,16,1,"https://fbref.com/en/players/19cae58d/Gavi"
2024,"Barcelona","La Liga","Marc Guiu","ESP","FW,MF","18-147",2006,0.8,1,0,0,1,0,0,0,NA,0,0,0,0,0,1,0,0,"https://fbref.com/en/players/d3d774cc/Marc-Guiu"
2024,"Barcelona","La Liga","İlkay Gündoğan","GER","MF","33-219",1990,33.3,32,22,14,16,2,12,39,30.8,27,19,4,15,21,53,18,1,"https://fbref.com/en/players/819b3158/Ilkay-Gundogan"
2024,"Barcelona","La Liga","Frenkie de Jong","NED","MF","27-018",1997,18.2,43,26,14,23,6,8,19,42.1,11,18,8,10,14,57,28,1,"https://fbref.com/en/players/1bacc518/Frenkie-de-Jong"
2024,"Barcelona","La Liga","Jules Koundé","FRA","DF","25-200",1998,32.2,37,23,22,10,5,28,51,54.9,23,32,12,20,25,62,83,5,"https://fbref.com/en/players/4d1666ff/Jules-Kounde"
2024,"Barcelona","La Liga","Robert Lewandowski","POL","FW","35-283",1988,30.6,8,5,0,6,2,4,12,33.3,8,13,4,9,9,17,18,0,"https://fbref.com/en/players/8d78e732/Robert-Lewandowski"
2024,"Barcelona","La Liga","Fermin López","ESP","MF,FW","21-019",2003,16.1,41,21,15,18,8,14,40,35,26,14,1,13,4,45,9,0,"https://fbref.com/en/players/c1fe5f0b/Fermin-Lopez"
2024,"Barcelona","La Liga","Iñigo Martínez","ESP","DF","33-013",1991,14.4,10,7,9,1,0,6,8,75,2,13,10,3,11,21,50,0,"https://fbref.com/en/players/3fc45c73/Inigo-Martinez"
2024,"Barcelona","La Liga","Pedri","ESP","MF,FW","21-187",2002,16.4,33,24,16,13,4,8,27,29.6,19,27,3,24,14,47,10,0,"https://fbref.com/en/players/0d9b2d31/Pedri"
2024,"Barcelona","La Liga","Iñaki Peña","ESP","GK","25-089",1999,10,0,0,0,0,0,0,1,0,1,0,0,0,0,0,5,1,"https://fbref.com/en/players/cc1c5035/Inaki-Pena"
2024,"Barcelona","La Liga","Raphinha","BRA","FW,MF","27-168",1996,15.2,14,8,6,6,2,4,18,22.2,14,17,1,16,13,27,11,0,"https://fbref.com/en/players/3423f250/Raphinha"
2024,"Barcelona","La Liga","Sergi Roberto","ESP","MF,DF","32-113",1992,9.6,15,10,4,10,1,3,11,27.3,8,7,2,5,8,23,7,1,"https://fbref.com/en/players/335fa267/Sergi-Roberto"
2024,"Barcelona","La Liga","Oriol Romeu","ESP","MF","32-249",1991,10.4,34,20,17,14,3,13,24,54.2,11,12,2,10,10,44,18,0,"https://fbref.com/en/players/4b511457/Oriol-Romeu"
2024,"Barcelona","La Liga","Vitor Roque","BRA","FW","19-092",2005,3.6,3,2,2,0,1,0,2,0,2,3,0,3,0,3,5,0,"https://fbref.com/en/players/cb00f1e6/Vitor-Roque"
2024,"Barcelona","La Liga","Marc-André ter Stegen","GER","GK","32-030",1992,28,0,0,0,0,0,0,0,NA,0,0,0,0,0,0,3,3,"https://fbref.com/en/players/6f51e382/Marc-Andre-ter-Stegen"
2024,"Barcelona","La Liga","Ferrán Torres","ESP","FW","24-091",2000,13.5,9,6,1,6,2,5,16,31.3,11,7,1,6,5,14,6,0,"https://fbref.com/en/players/9e1035f8/Ferran-Torres"
2024,"Barcelona","La Liga","Lamine Yamal","ESP","FW","16-322",2007,24.5,61,37,32,15,14,18,48,37.5,30,32,0,32,19,80,11,0,"https://fbref.com/en/players/82ec26c1/Lamine-Yamal"
2024,"Bayern Munich","Bundesliga","Jonathan Asp Jensen","DEN","FW","18-137",2006,0,0,0,0,0,0,0,0,NA,0,0,0,0,0,0,1,0,"https://fbref.com/en/players/25355bd8/Jonathan-Asp-Jensen"
2024,"Bayern Munich","Bundesliga","Sacha Boey","FRA","DF","23-260",2000,1.2,2,0,2,0,0,1,2,50,1,1,0,1,1,3,2,0,"https://fbref.com/en/players/6c8ddd52/Sacha-Boey"
2024,"Bayern Munich","Bundesliga","Kingsley Coman","FRA","FW","27-352",1996,12.4,12,7,5,3,4,9,17,52.9,8,15,1,14,2,14,5,0,"https://fbref.com/en/players/042e8a49/Kingsley-Coman"
2024,"Bayern Munich","Bundesliga","Alphonso Davies","CAN","DF","23-210",2000,22.9,47,24,29,13,5,30,53,56.6,23,30,4,26,26,73,49,1,"https://fbref.com/en/players/d781d855/Alphonso-Davies"
2024,"Bayern Munich","Bundesliga","Eric Dier","ENG","DF","30-136",1994,13,11,8,5,5,1,5,6,83.3,1,20,12,8,10,21,48,1,"https://fbref.com/en/players/ac861941/Eric-Dier"
2024,"Bayern Munich","Bundesliga","Serge Gnabry","GER","FW,MF","28-321",1995,4.8,8,5,0,5,3,2,13,15.4,11,5,0,5,3,11,2,0,"https://fbref.com/en/players/88e357ef/Serge-Gnabry"
2024,"Bayern Munich","Bundesliga","Leon Goretzka","GER","MF","29-114",1995,24.9,41,23,18,14,9,24,54,44.4,30,44,8,36,31,72,42,1,"https://fbref.com/en/players/cc86b9a3/Leon-Goretzka"
2024,"Bayern Munich","Bundesliga","Ryan Gravenberch","NED","FW","22-014",2002,0.1,0,0,0,0,0,0,0,NA,0,0,0,0,0,0,0,0,"https://fbref.com/en/players/b8e740fb/Ryan-Gravenberch"
2024,"Bayern Munich","Bundesliga","Raphaël Guerreiro","POR","DF,MF","30-160",1993,13.2,19,16,6,9,4,9,15,60,6,7,1,6,15,34,5,1,"https://fbref.com/en/players/048a1cbc/Raphael-Guerreiro"
2024,"Bayern Munich","Bundesliga","Harry Kane","ENG","FW","30-307",1993,31.5,13,9,4,4,5,6,18,33.3,12,12,4,8,6,19,14,0,"https://fbref.com/en/players/21a66f6a/Harry-Kane"
2024,"Bayern Munich","Bundesliga","Joshua Kimmich","GER","MF,DF","29-112",1995,24.2,45,33,25,15,5,26,39,66.7,13,32,4,28,14,59,28,1,"https://fbref.com/en/players/49296448/Joshua-Kimmich"
2024,"Bayern Munich","Bundesliga","Frans Krätzig","GER","DF","21-137",2003,0.6,2,0,2,0,0,1,2,50,1,0,0,0,0,2,0,0,"https://fbref.com/en/players/1fc08838/Frans-Kratzig"
2024,"Bayern Munich","Bundesliga","Konrad Laimer","AUT","DF,MF","27-003",1997,19.7,56,36,25,20,11,22,52,42.3,30,42,6,36,18,74,13,2,"https://fbref.com/en/players/c1b7847c/Konrad-Laimer"
2024,"Bayern Munich","Bundesliga","Matthijs de Ligt","NED","DF","24-292",1999,15.4,15,12,4,8,3,6,11,54.5,5,14,10,4,19,34,52,0,"https://fbref.com/en/players/d6e53a3a/Matthijs-de-Ligt"
2024,"Bayern Munich","Bundesliga","Eric Maxim Choupo-Moting","CMR","MF,FW","35-068",1989,8,17,12,8,5,4,6,14,42.9,8,5,0,5,7,24,7,0,"https://fbref.com/en/players/0e6bc38c/Eric-Maxim-Choupo-Moting"
2024,"Bayern Munich","Bundesliga","Noussair Mazraoui","MAR","DF","26-198",1997,13.3,32,21,14,11,7,13,21,61.9,8,14,1,13,20,52,27,1,"https://fbref.com/en/players/b74277a0/Noussair-Mazraoui"
2024,"Bayern Munich","Bundesliga","Kim Min-jae","KOR","DF","27-197",1996,21.9,37,24,21,11,5,12,24,50,12,29,19,10,45,82,70,2,"https://fbref.com/en/players/e0f8151c/Kim-Min-jae"
2024,"Bayern Munich","Bundesliga","Thomas Müller","GER","MF,FW","34-260",1989,18.4,26,16,5,10,11,13,35,37.1,22,22,0,22,3,29,6,0,"https://fbref.com/en/players/3c6089ab/Thomas-Muller"
2024,"Bayern Munich","Bundesliga","Jamal Musiala","GER","MF,FW","21-094",2003,19.5,40,25,9,21,10,14,36,38.9,22,25,1,24,16,56,5,0,"https://fbref.com/en/players/2c0558b8/Jamal-Musiala"
2024,"Bayern Munich","Bundesliga","Manuel Neuer","GER","GK","38-064",1986,22.8,1,1,1,0,0,0,0,NA,0,0,0,0,0,1,14,3,"https://fbref.com/en/players/8778c910/Manuel-Neuer"
2024,"Bayern Munich","Bundesliga","Aleksandar Pavlovic","GER","MF","20-027",2004,13.6,28,16,10,14,4,17,33,51.5,16,13,3,10,17,45,12,0,"https://fbref.com/en/players/2658c82f/Aleksandar-Pavlovic"
2024,"Bayern Munich","Bundesliga","Daniel Peretz","ISR","GK","23-325",2000,0.2,0,0,0,0,0,0,0,NA,0,0,0,0,0,0,0,0,"https://fbref.com/en/players/3f29b3ba/Daniel-Peretz"
2024,"Bayern Munich","Bundesliga","Matteo Perez Vinlöf","SWE","FW","18-164",2005,0.2,0,0,0,0,0,0,0,NA,0,0,0,0,1,1,0,0,"https://fbref.com/en/players/7c762839/Matteo-Perez-Vinlof"
2024,"Bayern Munich","Bundesliga","Leroy Sané","GER","FW","28-140",1996,23.7,15,8,6,6,3,4,19,21.1,15,12,0,12,7,22,3,0,"https://fbref.com/en/players/2b114be3/Leroy-Sane"
2024,"Bayern Munich","Bundesliga","Bouna Sarr","SEN","DF","32-120",1992,1.2,2,0,1,1,0,2,2,100,0,3,0,3,0,2,1,0,"https://fbref.com/en/players/1a4b9094/Bouna-Sarr"
2024,"Bayern Munich","Bundesliga","Mathys Tel","FRA","FW,MF","19-033",2005,11.7,12,2,3,4,5,4,6,66.7,2,11,0,11,6,18,6,0,"https://fbref.com/en/players/829aa60c/Mathys-Tel"
2024,"Bayern Munich","Bundesliga","Sven Ulreich","GER","GK","35-301",1988,11,1,0,1,0,0,1,1,100,0,0,0,0,0,1,3,2,"https://fbref.com/en/players/7d3e7da6/Sven-Ulreich"
2024,"Bayern Munich","Bundesliga","Dayot Upamecano","FRA","DF","25-216",1998,19.6,34,21,21,11,2,15,29,51.7,14,19,7,12,19,53,56,3,"https://fbref.com/en/players/d248cd8f/Dayot-Upamecano"
2024,"Bayern Munich","Bundesliga","Bryan Zaragoza","ESP","FW,MF","23-035",2001,2,4,4,2,1,1,3,3,100,0,0,0,0,2,6,0,0,"https://fbref.com/en/players/a96103b2/Bryan-Zaragoza"
2024,"Bayern Munich","Bundesliga","Lovro Zvonarek","CRO","FW,MF","19-022",2005,1.8,0,0,0,0,0,0,5,0,5,3,0,3,0,0,2,0,"https://fbref.com/en/players/253bd2b3/Lovro-Zvonarek"
2024,"Betis","La Liga","Abner","BRA","DF","24-003",2000,15.6,25,19,15,9,1,17,34,50,17,23,5,18,15,40,62,0,"https://fbref.com/en/players/7f9c5d2d/Abner"
2024,"Betis","La Liga","Paul Akouokou","CIV","MF","26-162",1997,0.3,5,3,0,2,3,3,3,100,0,3,1,2,1,6,1,0,"https://fbref.com/en/players/31f5b89b/Paul-Akouokou"
2024,"Betis","La Liga","Sergi Altimira","ESP","MF","22-279",2001,6.3,15,8,8,6,1,11,23,47.8,12,12,1,11,9,24,10,0,"https://fbref.com/en/players/94acdd4e/Sergi-Altimira"
2024,"Betis","La Liga","Ezequiel Ávila","ARG","FW","30-114",1994,3.3,2,1,0,2,0,1,3,33.3,2,2,0,2,1,3,4,0,"https://fbref.com/en/players/253a06b9/Ezequiel-Avila"
2024,"Betis","La Liga","Cédric Bakambu","COD","FW","33-049",1991,2.2,1,0,0,1,0,0,0,NA,0,2,0,2,0,1,0,0,"https://fbref.com/en/players/0af4dcf0/Cedric-Bakambu"
2024,"Betis","La Liga","Francisco Barbosa","ESP","GK","25-023",1999,3.5,1,0,1,0,0,1,1,100,0,0,0,0,0,1,2,1,"https://fbref.com/en/players/2ae958ab/Francisco-Barbosa"
2024,"Betis","La Liga","Marc Bartra","ESP","DF","33-136",1991,2.5,4,3,3,1,0,4,5,80,1,3,1,2,3,7,10,0,"https://fbref.com/en/players/b742cc0d/Marc-Bartra"
2024,"Betis","La Liga","Héctor Bellerín","ESP","DF","29-072",1995,19,34,22,14,16,4,20,53,37.7,33,13,5,8,22,56,40,1,"https://fbref.com/en/players/f874dd44/Hector-Bellerin"
2024,"Betis","La Liga","Claudio Bravo","CHI","GK","41-047",1983,7,0,0,0,0,0,0,1,0,1,0,0,0,0,0,2,0,"https://fbref.com/en/players/10072610/Claudio-Bravo"
2024,"Betis","La Liga","Pablo Busto","ESP","DF","18-258",2005,0.5,1,1,0,0,1,1,1,100,0,0,0,0,1,2,3,0,"https://fbref.com/en/players/da82ccb1/Pablo-Busto"
2024,"Betis","La Liga","Johnny Cardoso","USA","MF","22-253",2001,14.8,48,29,19,24,5,22,33,66.7,11,20,5,15,32,80,31,0,"https://fbref.com/en/players/7426f085/Johnny-Cardoso"
2024,"Betis","La Liga","William Carvalho","POR","MF","32-053",1992,7.6,20,12,11,7,2,10,16,62.5,6,8,1,7,8,28,9,1,"https://fbref.com/en/players/dee86451/William-Carvalho"
2024,"Betis","La Liga","Juan Cruz","ESP","FW","24-035",2000,0.8,0,0,0,0,0,0,1,0,1,0,0,0,0,0,0,0,"https://fbref.com/en/players/cc2dd8a5/Juan-Cruz"
2024,"Betis","La Liga","Assane Diao","ESP","FW","18-266",2005,11.6,20,12,5,9,6,6,17,35.3,11,22,4,18,7,27,7,0,"https://fbref.com/en/players/8ae7d0ec/Assane-Diao"
2024,"Betis","La Liga","Abdessamad Ezzalzouli","MAR","FW","22-165",2001,9.6,17,14,7,5,5,4,14,28.6,10,10,0,10,5,22,5,0,"https://fbref.com/en/players/bed68338/Abdessamad-Ezzalzouli"
2024,"Betis","La Liga","Nabil Fekir","FRA","MF,FW","30-317",1993,11.7,15,10,5,7,3,5,10,50,5,9,0,9,7,22,3,0,"https://fbref.com/en/players/bece776f/Nabil-Fekir"
2024,"Betis","La Liga","Luiz Felipe","ITA","DF","27-069",1997,4,7,3,5,2,0,4,5,80,1,10,4,6,4,11,16,0,"https://fbref.com/en/players/15d0c248/Luiz-Felipe"
2024,"Betis","La Liga","Pablo Fornals","ESP","FW,MF","28-098",1996,12.8,24,16,8,11,5,12,22,54.5,10,14,0,14,22,46,10,2,"https://fbref.com/en/players/82927de4/Pablo-Fornals"
2024,"Betis","La Liga","Andrés Guardado","MEX","MF","37-245",1986,5,17,12,5,9,3,7,14,50,7,4,2,2,6,23,5,0,"https://fbref.com/en/players/ef322658/Andres-Guardado"
2024,"Betis","La Liga","Luiz Henrique","BRA","FW","23-149",2001,6.8,15,11,4,10,1,9,14,64.3,5,11,0,11,5,20,8,0,"https://fbref.com/en/players/8059806f/Luiz-Henrique"
2024,"Betis","La Liga","Borja Iglesias","ESP","FW","31-134",1993,4.5,0,0,0,0,0,0,3,0,3,0,0,0,2,2,2,0,"https://fbref.com/en/players/75645f0e/Borja-Iglesias"
2024,"Betis","La Liga","Isco","ESP","MF","32-039",1992,25.8,41,27,15,21,5,14,38,36.8,24,19,1,18,10,51,7,0,"https://fbref.com/en/players/a0b4bb3e/Isco"
2024,"Betis","La Liga","Willian José","BRA","FW","32-189",1991,21.9,7,3,1,2,4,2,5,40,3,8,2,6,2,9,15,0,"https://fbref.com/en/players/d87e2cae/Willian-Jose"
2024,"Betis","La Liga","Juan Miranda","ESP","DF","24-132",2000,20.6,38,24,21,13,4,17,31,54.8,14,31,6,25,19,57,62,0,"https://fbref.com/en/players/ead61f73/Juan-Miranda"
2024,"Betis","La Liga","Sokratis Papastathopoulos","GRE","DF","35-356",1988,12.6,21,14,16,5,0,13,17,76.5,4,15,9,6,6,27,60,0,"https://fbref.com/en/players/b682dcf6/Sokratis-Papastathopoulos"
2024,"Betis","La Liga","Ayoze Pérez","ESP","FW","30-306",1993,25.5,59,32,16,33,10,21,49,42.9,28,42,4,38,22,81,18,0,"https://fbref.com/en/players/819aa8e7/Ayoze-Perez"
2024,"Betis","La Liga","Germán Pezzella","ARG","DF","32-338",1991,30.7,34,24,24,10,0,23,38,60.5,15,31,18,13,31,65,150,0,"https://fbref.com/en/players/8c725b43/German-Pezzella"
2024,"Betis","La Liga","Chadi Riad","MAR","DF","20-348",2003,24,35,24,17,18,0,17,27,63,10,23,14,9,23,58,108,0,"https://fbref.com/en/players/b3b9b8b8/Chadi-Riad"
2024,"Betis","La Liga","Marc Roca","ESP","MF","27-186",1996,22,52,36,17,29,6,30,53,56.6,23,29,6,23,17,69,23,1,"https://fbref.com/en/players/da27e268/Marc-Roca"
2024,"Betis","La Liga","Rodri","ESP","FW,MF","24-014",2000,11.7,17,10,6,7,4,8,21,38.1,13,11,0,11,8,25,2,0,"https://fbref.com/en/players/85bed4ee/Rodri"
2024,"Betis","La Liga","Guido Rodríguez","ARG","MF","30-048",1994,20.5,53,30,21,24,8,34,55,61.8,21,27,6,21,29,82,44,0,"https://fbref.com/en/players/34e393f2/Guido-Rodriguez"
2024,"Betis","La Liga","Aitor Ruibal","ESP","DF,FW","28-069",1996,11.3,46,27,28,13,5,32,59,54.2,27,12,1,11,14,60,33,1,"https://fbref.com/en/players/a55d8df5/Aitor-Ruibal"
2024,"Betis","La Liga","Youssouf Sabaly","SEN","DF","31-086",1993,11.6,16,11,12,3,1,8,12,66.7,4,6,3,3,11,27,27,0,"https://fbref.com/en/players/fbbb9269/Youssouf-Sabaly"
2024,"Betis","La Liga","Rui Silva","POR","GK","30-113",1994,27.5,0,0,0,0,0,0,3,0,3,0,0,0,1,1,13,1,"https://fbref.com/en/players/ea83bfa6/Rui-Silva"
2024,"Betis","La Liga","Ricardo Visus","ESP","DF","23-036",2001,1.8,2,2,1,1,0,2,2,100,0,2,2,0,2,4,9,1,"https://fbref.com/en/players/7016332f/Ricardo-Visus"
2024,"Bochum","Bundesliga","Christopher Antwi-Adjei","GHA","FW,MF","30-113",1994,13.5,21,12,10,6,5,12,22,54.5,10,13,2,11,2,23,11,1,"https://fbref.com/en/players/0a3f6cde/Christopher-Antwi-Adjei"
2024,"Bochum","Bundesliga","Takuma Asano","JPN","FW,MF","29-202",1994,22.1,17,6,2,9,6,7,23,30.4,16,17,3,14,4,21,11,0,"https://fbref.com/en/players/13ddc856/Takuma-Asano"
2024,"Bochum","Bundesliga","Bernardo","BRA","DF","29-016",1995,32.5,99,58,56,35,8,45,69,65.2,24,66,30,36,55,154,120,1,"https://fbref.com/en/players/17370b95/Bernardo"
2024,"Bochum","Bundesliga","Matúš Bero","SVK","MF,FW","28-267",1995,18.5,32,22,13,12,7,13,32,40.6,19,24,3,21,12,44,26,0,"https://fbref.com/en/players/b5e0af76/Matus-Bero"
2024,"Bochum","Bundesliga","Moritz Broschinski","GER","FW","23-250",2000,13.9,11,7,2,5,4,2,8,25,6,11,2,9,0,11,6,0,"https://fbref.com/en/players/bbd79358/Moritz-Broschinski"
2024,"Bochum","Bundesliga","Lukas Daschner","GER","MF,FW","25-242",1998,6,9,4,2,3,4,4,9,44.4,5,7,0,7,2,11,2,0,"https://fbref.com/en/players/93a8c4f9/Lukas-Daschner"
2024,"Bochum","Bundesliga","Philipp Förster","GER","MF,FW","29-116",1995,4.3,9,5,3,4,2,2,6,33.3,4,3,0,3,7,16,3,0,"https://fbref.com/en/players/76fa965f/Philipp-Forster"
2024,"Bochum","Bundesliga","Cristian Gamboa","CRC","DF","34-219",1989,13.2,24,18,12,11,1,14,33,42.4,19,20,7,13,15,39,34,1,"https://fbref.com/en/players/f27680d9/Cristian-Gamboa"
2024,"Bochum","Bundesliga","Philipp Hofmann","GER","FW","31-061",1993,17.5,10,5,4,5,1,4,7,57.1,3,11,2,9,4,14,17,0,"https://fbref.com/en/players/877bc844/Philipp-Hofmann"
2024,"Bochum","Bundesliga","Moritz-Broni Kwarteng","GHA","FW","26-032",1998,3.1,3,0,0,3,0,1,7,14.3,6,4,0,4,2,5,0,0,"https://fbref.com/en/players/1e2057aa/Moritz-Broni-Kwarteng"
2024,"Bochum","Bundesliga","Noah Loosli","SUI","DF","27-128",1997,3.8,10,7,6,4,0,7,14,50,7,7,1,6,7,17,18,0,"https://fbref.com/en/players/5dbfd101/Noah-Loosli"
2024,"Bochum","Bundesliga","Anthony Losilla","FRA","MF","38-081",1986,28.6,63,37,15,40,8,23,51,45.1,28,37,8,29,25,88,51,0,"https://fbref.com/en/players/07c7eb0c/Anthony-Losilla"
2024,"Bochum","Bundesliga","Andreas Luthe","GER","GK","37-081",1987,1,0,0,0,0,0,0,0,NA,0,0,0,0,0,0,1,0,"https://fbref.com/en/players/7fe12375/Andreas-Luthe"
2024,"Bochum","Bundesliga","Erhan Mašović","SRB","DF,MF","25-190",1998,24.7,64,40,37,22,5,37,70,52.9,33,32,10,22,25,89,75,2,"https://fbref.com/en/players/a396fb61/Erhan-Masovic"
2024,"Bochum","Bundesliga","Tim Oermann","GER","DF","20-237",2003,7.9,19,11,11,4,4,9,14,64.3,5,15,6,9,2,21,22,0,"https://fbref.com/en/players/57ec75bf/Tim-Oermann"
2024,"Bochum","Bundesliga","Ivan Ordets","UKR","DF","31-327",1992,20.9,19,14,11,6,2,10,17,58.8,7,41,29,12,31,50,130,0,"https://fbref.com/en/players/86c75897/Ivan-Ordets"
2024,"Bochum","Bundesliga","Patrick Osterhage","GER","MF","24-119",2000,20.7,38,26,14,23,1,17,36,47.2,19,36,9,27,27,65,32,1,"https://fbref.com/en/players/9662c9ec/Patrick-Osterhage"
2024,"Bochum","Bundesliga","Gonçalo Paciência","POR","FW,MF","29-303",1994,7.2,8,4,2,2,4,3,6,50,3,5,0,5,0,8,7,0,"https://fbref.com/en/players/962e54cb/Goncalo-Paciencia"
2024,"Bochum","Bundesliga","Felix Passlack","GER","DF","26-001",1998,10.7,21,14,9,10,2,14,24,58.3,10,13,2,11,10,31,21,0,"https://fbref.com/en/players/5c899683/Felix-Passlack"
2024,"Bochum","Bundesliga","Manuel Riemann","GER","GK","35-264",1988,33,2,1,2,0,0,2,4,50,2,0,0,0,1,3,25,1,"https://fbref.com/en/players/9f941969/Manuel-Riemann"
2024,"Bochum","Bundesliga","Keven Schlotterbeck","GER","DF","27-032",1997,24.3,42,22,26,14,2,25,30,83.3,5,33,23,10,33,75,104,2,"https://fbref.com/en/players/f6bdc830/Keven-Schlotterbeck"
2024,"Bochum","Bundesliga","Danilo Soares","BRA","DF","32-214",1991,3.9,10,6,5,3,2,5,8,62.5,3,6,0,6,7,17,11,0,"https://fbref.com/en/players/c05f2f8c/Danilo-Soares"
2024,"Bochum","Bundesliga","Kevin Stöger","AUT","MF","30-277",1993,29.6,49,30,21,21,7,25,63,39.7,38,46,4,42,19,68,18,0,"https://fbref.com/en/players/e5649a78/Kevin-Stoger"
2024,"Bochum","Bundesliga","Maximilian Wittek","GER","DF,FW","28-283",1995,11.9,23,17,9,11,3,13,21,61.9,8,12,1,11,18,41,23,0,"https://fbref.com/en/players/edb2712b/Maximilian-Wittek"
2024,"Bochum","Bundesliga","Simon Zoller","GER","FW,MF","32-339",1991,0.5,0,0,0,0,0,0,0,NA,0,1,0,1,0,0,0,0,"https://fbref.com/en/players/29f7cfd9/Simon-Zoller"
2024,"Bologna","Serie A","Michel Aebischer","SUI","MF","27-145",1997,24.8,35,20,9,20,6,15,34,44.1,19,28,6,22,12,47,22,0,"https://fbref.com/en/players/f9c927de/Michel-Aebischer"
2024,"Bologna","Serie A","Oussama El Azzouzi","MAR","MF","23-001",2001,6.1,12,7,4,5,3,7,14,50,7,8,2,6,6,18,12,0,"https://fbref.com/en/players/85f476cc/Oussama-El-Azzouzi"
2024,"Bologna","Serie A","Nicola Bagnolini","ITA","GK","20-077",2004,0.1,0,0,0,0,0,0,0,NA,0,0,0,0,0,0,0,0,"https://fbref.com/en/players/ad263695/Nicola-Bagnolini"
2024,"Bologna","Serie A","Victor Bernth Kristiansen","DEN","DF","21-166",2002,25.6,52,34,23,22,7,20,35,57.1,15,35,8,27,12,64,45,1,"https://fbref.com/en/players/505486d6/Victor-Bernth-Kristiansen"
2024,"Bologna","Serie A","Sam Beukema","NED","DF","25-195",1998,28.3,27,11,14,11,2,16,25,64,9,35,21,14,15,42,99,2,"https://fbref.com/en/players/de13cee5/Sam-Beukema"
2024,"Bologna","Serie A","Kevin Bonifazi","ITA","DF","28-011",1996,1,4,0,0,4,0,1,2,50,1,0,0,0,0,4,7,1,"https://fbref.com/en/players/fb77bfef/Kevin-Bonifazi"
2024,"Bologna","Serie A","Riccardo Calafiori","ITA","DF","22-011",2002,26.1,47,32,28,16,3,22,32,68.8,10,38,13,25,50,97,74,3,"https://fbref.com/en/players/aded8e6f/Riccardo-Calafiori"
2024,"Bologna","Serie A","Santiago Castro","ARG","FW","19-244",2004,2.7,2,1,0,1,1,1,3,33.3,2,1,0,1,1,3,1,0,"https://fbref.com/en/players/ee5565ae/Santiago-Castro"
2024,"Bologna","Serie A","Tommaso Corazza","ITA","DF","19-336",2004,2.2,10,4,9,1,0,4,9,44.4,5,2,0,2,5,15,3,0,"https://fbref.com/en/players/c1b9b13c/Tommaso-Corazza"
2024,"Bologna","Serie A","Lorenzo De Silvestri","ITA","DF","36-007",1988,7.5,10,8,5,2,3,4,7,57.1,3,9,4,5,6,16,27,0,"https://fbref.com/en/players/e74f0e59/Lorenzo-De-Silvestri"
2024,"Bologna","Serie A","Nicolás Domínguez","ARG","MF","25-337",1998,1.1,1,0,1,0,0,0,2,0,2,3,0,3,0,1,2,0,"https://fbref.com/en/players/20b3a502/Nicolas-Dominguez"
2024,"Bologna","Serie A","Giovanni Fabbian","ITA","MF,FW","21-137",2003,11.7,17,10,9,7,1,7,12,58.3,5,5,2,3,7,24,11,0,"https://fbref.com/en/players/f97f9188/Giovanni-Fabbian"
2024,"Bologna","Serie A","Lewis Ferguson","SCO","MF","24-280",1999,30.1,37,21,16,17,4,16,37,43.2,21,25,8,17,17,54,27,1,"https://fbref.com/en/players/ee64a822/Lewis-Ferguson"
2024,"Bologna","Serie A","Remo Freuler","SUI","MF","32-045",1992,29.2,78,50,41,32,5,38,69,55.1,31,37,9,28,36,114,53,2,"https://fbref.com/en/players/98d2c2c4/Remo-Freuler"
2024,"Bologna","Serie A","Sydney van Hooijdonk","NED","FW","24-114",2000,2.4,3,0,0,2,1,1,2,50,1,1,1,0,1,4,4,0,"https://fbref.com/en/players/5b418e15/Sydney-van-Hooijdonk"
2024,"Bologna","Serie A","Jesper Karlsson","SWE","FW","25-310",1998,3.8,3,3,2,1,0,2,8,25,6,4,0,4,4,7,1,0,"https://fbref.com/en/players/7952d0c2/Jesper-Karlsson"
2024,"Bologna","Serie A","Jhon Lucumí","COL","DF","25-339",1998,24.6,48,29,31,17,0,27,36,75,9,32,17,15,16,64,68,2,"https://fbref.com/en/players/80490d7f/Jhon-Lucumi"
2024,"Bologna","Serie A","Charalambos Lykogiannis","GRE","DF","30-221",1993,10,10,6,5,4,1,5,10,50,5,15,5,10,5,15,30,0,"https://fbref.com/en/players/5efc5389/Charalambos-Lykogiannis"
2024,"Bologna","Serie A","Nikola Moro","CRO","MF","26-079",1998,9.3,21,16,8,12,1,8,15,53.3,7,14,1,13,7,28,10,0,"https://fbref.com/en/players/ff579c7e/Nikola-Moro"
2024,"Bologna","Serie A","Dan Ndoye","SUI","FW,MF","23-218",2000,19.7,30,15,17,11,2,17,39,43.6,22,20,1,19,10,40,14,0,"https://fbref.com/en/players/8e697a8f/Dan-Ndoye"
2024,"Bologna","Serie A","Jens Odgaard","DEN","FW,MF","25-060",1999,4.8,4,4,1,1,2,1,3,33.3,2,9,0,9,1,5,3,0,"https://fbref.com/en/players/75374ee7/Jens-Odgaard"
2024,"Bologna","Serie A","Riccardo Orsolini","ITA","FW,MF","27-127",1997,19.9,23,14,13,4,6,9,30,30,21,25,3,22,8,31,19,1,"https://fbref.com/en/players/e14ec482/Riccardo-Orsolini"
2024,"Bologna","Serie A","Stefan Posch","AUT","DF","27-016",1997,26.8,77,46,35,38,4,49,88,55.7,39,27,8,19,18,95,72,0,"https://fbref.com/en/players/7f609bfc/Stefan-Posch"
2024,"Bologna","Serie A","Federico Ravaglia","ITA","GK","24-201",1999,5.9,0,0,0,0,0,0,0,NA,0,0,0,0,0,0,2,0,"https://fbref.com/en/players/6662d731/Federico-Ravaglia"
2024,"Bologna","Serie A","Alexis Saelemaekers","BEL","FW,MF","24-338",1999,21,32,22,13,14,5,12,27,44.4,15,13,1,12,13,45,10,1,"https://fbref.com/en/players/ee251371/Alexis-Saelemaekers"
2024,"Bologna","Serie A","Łukasz Skorupski","POL","GK","33-025",1991,32,2,2,2,0,0,2,3,66.7,1,0,0,0,1,3,11,3,"https://fbref.com/en/players/ab4449d6/Lukasz-Skorupski"
2024,"Bologna","Serie A","Kacper Urbanski","POL","MF,FW","19-266",2004,10.3,16,10,5,10,1,6,13,46.2,7,15,1,14,4,20,14,0,"https://fbref.com/en/players/2d9d9e42/Kacper-Urbanski"
2024,"Bologna","Serie A","Joshua Zirkzee","NED","FW","23-008",2001,30.7,32,20,8,15,9,13,24,54.2,11,25,2,23,3,35,36,0,"https://fbref.com/en/players/028e70b9/Joshua-Zirkzee"
2024,"Bournemouth","Premier League","Max Aarons","ENG","DF","24-147",2000,13.7,29,19,20,7,2,20,34,58.8,14,9,5,4,8,37,27,0,"https://fbref.com/en/players/774cf58b/Max-Aarons"
2024,"Bournemouth","Premier League","Tyler Adams","USA","MF","25-106",1999,1.3,4,3,1,3,0,2,3,66.7,1,2,0,2,4,8,2,0,"https://fbref.com/en/players/2b09d998/Tyler-Adams"
2024,"Bournemouth","Premier League","Jaidon Anthony","ENG","FW","24-181",1999,1.7,3,1,1,0,2,1,7,14.3,6,3,0,3,1,4,3,0,"https://fbref.com/en/players/e4238fb1/Jaidon-Anthony"
2024,"Bournemouth","Premier League","Philip Billing","DEN","MF","27-354",1996,15.5,33,16,7,22,4,9,27,33.3,18,31,5,26,20,53,28,1,"https://fbref.com/en/players/d328a254/Philip-Billing"
2024,"Bournemouth","Premier League","David Brooks","WAL","FW,MF","26-327",1997,3.1,5,4,2,1,2,2,4,50,2,3,0,3,2,7,2,0,"https://fbref.com/en/players/dc4cae05/David-Brooks"
2024,"Bournemouth","Premier League","Ryan Christie","SCO","MF","29-098",1995,32.3,86,44,34,35,17,39,92,42.4,53,52,11,41,52,138,53,1,"https://fbref.com/en/players/26ce2263/Ryan-Christie"
2024,"Bournemouth","Premier League","Lewis Cook","ENG","MF","27-117",1997,31,61,41,24,30,7,34,63,54,29,32,11,21,65,126,46,1,"https://fbref.com/en/players/2afc7272/Lewis-Cook"
2024,"Bournemouth","Premier League","Romain Faivre","FRA","MF,FW","25-321",1998,0.5,1,1,0,1,0,0,3,0,3,0,0,0,0,1,0,0,"https://fbref.com/en/players/745ca0a3/Romain-Faivre"
2024,"Bournemouth","Premier League","James Hill","ENG","DF","22-141",2002,0.8,3,2,1,2,0,1,1,100,0,3,2,1,3,6,8,0,"https://fbref.com/en/players/69942fb3/James-Hill"
2024,"Bournemouth","Premier League","Hamed Junior Traorè","CIV","MF","24-104",2000,0.5,1,0,1,0,0,1,3,33.3,2,3,0,3,0,1,0,0,"https://fbref.com/en/players/570bb4b9/Hamed-Junior-Traore"
2024,"Bournemouth","Premier League","Lloyd Kelly","ENG","DF","25-237",1998,17.3,24,19,10,9,5,14,25,56,11,22,12,10,13,37,67,0,"https://fbref.com/en/players/f31def1e/Lloyd-Kelly"
2024,"Bournemouth","Premier League","Milos Kerkez","HUN","DF","20-205",2003,21.9,47,26,31,13,3,30,42,71.4,12,31,11,20,20,67,60,2,"https://fbref.com/en/players/0ad53bdc/Milos-Kerkez"
2024,"Bournemouth","Premier League","Justin Kluivert","NED","MF,FW","25-025",1999,21.3,28,14,5,12,11,8,30,26.7,22,16,1,15,8,36,11,0,"https://fbref.com/en/players/4c3a6744/Justin-Kluivert"
2024,"Bournemouth","Premier League","Chris Mepham","WAL","DF","26-207",1997,6.9,12,11,9,3,0,9,14,64.3,5,13,6,7,7,19,30,1,"https://fbref.com/en/players/fed96827/Chris-Mepham"
2024,"Bournemouth","Premier League","Kieffer Moore","WAL","FW,MF","31-296",1992,1.2,0,0,0,0,0,0,0,NA,0,0,0,0,0,0,0,0,"https://fbref.com/en/players/01ce9e70/Kieffer-Moore"
2024,"Bournemouth","Premier League","Neto","BRA","GK","34-316",1989,32,0,0,0,0,0,0,0,NA,0,1,0,1,1,1,12,3,"https://fbref.com/en/players/a9dc785c/Neto"
2024,"Bournemouth","Premier League","Dango Ouattara","BFA","FW,DF","22-109",2002,13.7,45,27,22,11,12,19,34,55.9,15,18,3,15,22,67,35,0,"https://fbref.com/en/players/2f9e4435/Dango-Ouattara"
2024,"Bournemouth","Premier League","Ionuț Radu","ROU","GK","27-002",1997,2,0,0,0,0,0,0,0,NA,0,0,0,0,0,0,0,0,"https://fbref.com/en/players/67f649be/Ionut-Radu"
2024,"Bournemouth","Premier League","Joe Rothwell","ENG","MF","29-140",1995,4.3,7,2,4,2,1,2,8,25,6,4,2,2,3,10,2,0,"https://fbref.com/en/players/10a10454/Joe-Rothwell"
2024,"Bournemouth","Premier League","Dominic Sadi","ENG","FW","20-271",2003,0,0,0,0,0,0,0,0,NA,0,0,0,0,0,0,0,0,"https://fbref.com/en/players/54778940/Dominic-Sadi"
2024,"Bournemouth","Premier League","Alex Scott","ENG","MF","20-283",2003,11.3,24,15,8,10,6,12,28,42.9,16,14,4,10,12,36,18,2,"https://fbref.com/en/players/104d0bb8/Alex-Scott"
2024,"Bournemouth","Premier League","Antoine Semenyo","GHA","FW","24-144",2000,23.4,24,17,7,9,8,9,27,33.3,18,39,2,37,6,30,21,0,"https://fbref.com/en/players/efd2ec23/Antoine-Semenyo"
2024,"Bournemouth","Premier League","Marcos Senesi","ARG","DF","27-020",1997,24.9,55,32,28,23,4,24,56,42.9,32,50,23,27,35,90,109,1,"https://fbref.com/en/players/35141f4c/Marcos-Senesi"
2024,"Bournemouth","Premier League","Luis Sinisterra","COL","FW,MF","24-348",1999,7.8,23,12,9,10,4,9,16,56.3,7,18,0,18,8,31,4,0,"https://fbref.com/en/players/8e16dd48/Luis-Sinisterra"
2024,"Bournemouth","Premier League","Adam Smith","ENG","DF","33-031",1991,23.9,37,23,18,11,8,19,39,48.7,20,28,11,17,21,58,62,0,"https://fbref.com/en/players/20b104bc/Adam-Smith"
2024,"Bournemouth","Premier League","Dominic Solanke","ENG","FW","26-259",1997,36.9,23,11,3,13,7,10,29,34.5,19,24,5,19,7,30,43,0,"https://fbref.com/en/players/e77dc3b2/Dominic-Solanke"
2024,"Bournemouth","Premier League","Marcus Tavernier","ENG","FW","25-069",1999,23.5,53,34,25,22,6,26,48,54.2,22,31,3,28,5,58,23,0,"https://fbref.com/en/players/5c0da4a4/Marcus-Tavernier"
2024,"Bournemouth","Premier League","Mark Travers","IRL","GK","25-012",1999,4,0,0,0,0,0,0,0,NA,0,0,0,0,0,0,2,0,"https://fbref.com/en/players/fe558029/Mark-Travers"
2024,"Bournemouth","Premier League","Enes Ünal","TUR","FW,MF","27-020",1997,3.6,6,4,2,3,1,2,5,40,3,4,2,2,1,7,6,0,"https://fbref.com/en/players/f8eca1b6/Enes-Unal"
2024,"Bournemouth","Premier League","Illia Zabarnyi","UKR","DF","21-272",2002,37,59,32,29,29,1,23,50,46,27,53,34,19,33,92,143,4,"https://fbref.com/en/players/88968486/Illia-Zabarnyi"
2024,"Brentford","Premier League","Kristoffer Ajer","NOR","DF","26-043",1998,20.4,38,21,25,9,4,23,36,63.9,13,26,11,15,25,63,79,1,"https://fbref.com/en/players/a8c0acb7/Kristoffer-Ajer"
2024,"Brentford","Premier League","Shandon Baptiste","GRN","MF","26-052",1998,2.5,4,4,2,2,0,1,5,20,4,5,1,4,3,7,6,0,"https://fbref.com/en/players/2886c9b5/Shandon-Baptiste"
2024,"Brentford","Premier League","Nathan Collins","IRL","DF","23-030",2001,29.5,38,20,24,12,2,19,29,65.5,10,46,30,16,44,82,141,4,"https://fbref.com/en/players/a8c19eb8/Nathan-Collins"
2024,"Brentford","Premier League","Mikkel Damsgaard","DEN","MF","23-332",2000,9.4,29,17,13,9,7,14,40,35,26,23,1,22,11,40,10,1,"https://fbref.com/en/players/215f3907/Mikkel-Damsgaard"
2024,"Brentford","Premier League","Josh Dasilva","ENG","DF,FW","25-220",1998,0.3,2,1,0,1,1,0,0,NA,0,0,0,0,0,2,0,0,"https://fbref.com/en/players/60344e4f/Josh-Dasilva"
2024,"Brentford","Premier League","Mark Flekken","NED","GK","30-352",1993,36.5,1,1,1,0,0,1,5,20,4,1,0,1,0,1,17,1,"https://fbref.com/en/players/a92ab7be/Mark-Flekken"
2024,"Brentford","Premier League","Saman Ghoddos","IRN","DF","30-267",1993,8.2,28,19,19,7,2,17,31,54.8,14,9,2,7,5,33,12,0,"https://fbref.com/en/players/f7b1d4e0/Saman-Ghoddos"
2024,"Brentford","Premier League","Rico Henry","ENG","DF","26-327",1997,4.5,7,5,3,3,1,6,7,85.7,1,8,3,5,5,12,5,1,"https://fbref.com/en/players/8a3c1dc7/Rico-Henry"
2024,"Brentford","Premier League","Aaron Hickey","SCO","DF","21-355",2002,7.9,16,9,9,3,4,7,7,100,0,7,3,4,3,19,10,0,"https://fbref.com/en/players/1780bb4a/Aaron-Hickey"
2024,"Brentford","Premier League","Vitaly Janelt","GER","MF,DF","26-020",1998,33.9,63,38,29,25,9,32,64,50,32,35,9,26,36,99,64,3,"https://fbref.com/en/players/8449d35e/Vitaly-Janelt"
2024,"Brentford","Premier League","Mathias Jensen","DEN","MF","28-150",1996,24.5,54,32,25,22,7,26,95,27.4,69,41,6,35,23,77,25,1,"https://fbref.com/en/players/0f134faf/Mathias-Jensen"
2024,"Brentford","Premier League","Mathias Jørgensen","DEN","DF","34-037",1990,12.1,17,12,15,1,1,11,19,57.9,8,9,5,4,12,29,40,0,"https://fbref.com/en/players/0db5d2c8/Mathias-Jorgensen"
2024,"Brentford","Premier League","Keane Lewis-Potter","ENG","FW,DF","23-098",2001,16,17,7,5,11,1,7,15,46.7,8,10,2,8,7,24,23,0,"https://fbref.com/en/players/41f08ac8/Keane-Lewis-Potter"
2024,"Brentford","Premier League","Neal Maupay","FRA","FW","27-290",1996,14.7,10,7,4,5,1,3,13,23.1,10,11,0,11,2,12,3,0,"https://fbref.com/en/players/4bcf39f6/Neal-Maupay"
2024,"Brentford","Premier League","Bryan Mbeumo","CMR","FW","24-297",1999,21.8,15,10,6,6,3,5,19,26.3,14,26,2,24,7,22,13,0,"https://fbref.com/en/players/6afaebf2/Bryan-Mbeumo"
2024,"Brentford","Premier League","Ben Mee","ENG","DF","34-252",1989,14.1,26,15,12,12,2,17,22,77.3,5,21,13,8,13,39,63,1,"https://fbref.com/en/players/8df7a2fb/Ben-Mee"
2024,"Brentford","Premier League","Christian Nørgaard","DEN","MF","30-081",1994,27.8,81,50,42,31,8,32,87,36.8,55,48,6,42,54,135,50,0,"https://fbref.com/en/players/df0a4c90/Christian-Norgaard"
2024,"Brentford","Premier League","Michael Olakigbe","ENG","DF,FW","20-035",2004,0.7,3,0,2,1,0,2,4,50,2,7,0,7,1,4,0,1,"https://fbref.com/en/players/cdd70dc0/Michael-Olakigbe"
2024,"Brentford","Premier League","Frank Onyeka","NGA","MF","26-150",1998,12.9,37,24,9,23,5,16,29,55.2,13,15,7,8,23,60,17,0,"https://fbref.com/en/players/2944f86f/Frank-Onyeka"
2024,"Brentford","Premier League","Myles Peart-Harris","ENG","DF,MF","21-255",2002,0.1,0,0,0,0,0,0,0,NA,0,0,0,0,0,0,1,0,"https://fbref.com/en/players/ea1a5662/Myles-Peart-Harris"
2024,"Brentford","Premier League","Ethan Pinnock","JAM","DF","31-001",1993,28,35,23,22,13,0,9,20,45,11,40,24,16,43,78,170,3,"https://fbref.com/en/players/e541326e/Ethan-Pinnock"
2024,"Brentford","Premier League","Sergio Reguilón","ESP","DF","27-166",1996,12.4,45,20,26,18,1,24,40,60,16,23,6,17,16,61,41,1,"https://fbref.com/en/players/3353737a/Sergio-Reguilon"
2024,"Brentford","Premier League","Mads Roerslev","DEN","DF","24-341",1999,22.1,48,31,34,9,5,27,54,50,27,15,3,12,19,67,71,0,"https://fbref.com/en/players/57c94db2/Mads-Roerslev"
2024,"Brentford","Premier League","Kevin Schade","GER","FW,MF","22-185",2001,3.7,3,1,1,2,0,0,5,0,5,2,0,2,1,4,4,0,"https://fbref.com/en/players/52afb588/Kevin-Schade"
2024,"Brentford","Premier League","Thomas Strakosha","ALB","GK","29-072",1995,1.5,0,0,0,0,0,0,0,NA,0,0,0,0,0,0,0,0,"https://fbref.com/en/players/339fe0e8/Thomas-Strakosha"
2024,"Brentford","Premier League","Ivan Toney","ENG","FW","28-075",1996,16.1,15,5,2,7,6,6,14,42.9,8,5,1,4,10,25,18,0,"https://fbref.com/en/players/e09f279b/Ivan-Toney"
2024,"Brentford","Premier League","Yoane Wissa","COD","FW","27-270",1996,27.7,28,16,13,10,5,5,20,25,15,24,3,21,9,37,15,0,"https://fbref.com/en/players/2500cef9/Yoane-Wissa"
2024,"Brentford","Premier League","Yehor Yarmoliuk","UKR","MF","20-090",2004,7.6,17,11,6,8,3,7,17,41.2,10,17,4,13,6,23,5,0,"https://fbref.com/en/players/907a5d7c/Yehor-Yarmoliuk"
2024,"Brest","Ligue 1","Jordan Amavi","FRA","DF","30-082",1994,1,1,1,0,1,0,1,3,33.3,2,2,1,1,3,4,2,0,"https://fbref.com/en/players/22721b88/Jordan-Amavi"
2024,"Brest","Ligue 1","Marco Bizot","NED","GK","33-081",1991,32,0,0,0,0,0,0,1,0,1,0,0,0,0,0,18,3,"https://fbref.com/en/players/3d214e5f/Marco-Bizot"
2024,"Brest","Ligue 1","Bilal Brahimi","ALG","FW,MF","24-077",2000,2.5,0,0,0,0,0,0,3,0,3,3,0,3,0,0,0,0,"https://fbref.com/en/players/02bcaf8e/Bilal-Brahimi"
2024,"Brest","Ligue 1","Lilian Brassier","FRA","DF","24-210",1999,29.7,31,18,18,13,0,12,24,50,12,28,21,7,41,72,93,0,"https://fbref.com/en/players/5b146df3/Lilian-Brassier"
2024,"Brest","Ligue 1","Mahdi Camara","FRA","MF","25-335",1998,22.4,55,39,8,40,7,20,49,40.8,29,24,1,23,27,82,19,0,"https://fbref.com/en/players/8577e60a/Mahdi-Camara"
2024,"Brest","Ligue 1","Axel Camblan","FRA","FW","20-274",2003,1,3,1,0,2,1,2,4,50,2,2,0,2,0,3,0,0,"https://fbref.com/en/players/9f4a940f/Axel-Camblan"
2024,"Brest","Ligue 1","Brendan Chardonnet","FRA","DF","29-160",1994,33,57,34,33,22,2,32,63,50.8,31,58,34,24,53,110,139,3,"https://fbref.com/en/players/16aa7d4c/Brendan-Chardonnet"
2024,"Brest","Ligue 1","Grégoire Coudert","FRA","GK","25-057",1999,2,0,0,0,0,0,0,0,NA,0,0,0,0,0,0,0,0,"https://fbref.com/en/players/ca95200f/Gregoire-Coudert"
2024,"Brest","Ligue 1","Achraf Dari","MAR","DF,FW","25-024",1999,1.3,1,1,1,0,0,0,2,0,2,2,0,2,5,6,9,1,"https://fbref.com/en/players/5069b796/Achraf-Dari"
2024,"Brest","Ligue 1","Romain Del Castillo","FRA","FW","28-062",1996,27.7,46,29,14,18,14,18,70,25.7,52,33,1,32,9,55,8,0,"https://fbref.com/en/players/0be95d34/Romain-Del-Castillo"
2024,"Brest","Ligue 1","Karamoko Dembele","SCO","MF,FW","21-098",2003,0.2,0,0,0,0,0,0,0,NA,0,0,0,0,0,0,0,0,"https://fbref.com/en/players/7304f3b1/Karamoko-Dembele"
2024,"Brest","Ligue 1","Kamory Doumbia","MLI","MF","21-102",2003,9.8,28,18,8,10,10,10,29,34.5,19,14,0,14,9,37,6,0,"https://fbref.com/en/players/9226aa22/Kamory-Doumbia"
2024,"Brest","Ligue 1","Kenny Lala","MAD","DF","32-240",1991,33,78,51,39,28,11,30,56,53.6,26,27,6,21,28,106,75,1,"https://fbref.com/en/players/770d7eb8/Kenny-Lala"
2024,"Brest","Ligue 1","Julien Le Cardinal","FRA","DF","26-301",1997,5.3,19,11,11,7,1,8,12,66.7,4,6,3,3,13,32,26,0,"https://fbref.com/en/players/547a72ad/Julien-Le-Cardinal"
2024,"Brest","Ligue 1","Jérémy Le Douaron","FRA","FW","26-039",1998,18,21,10,7,9,5,11,26,42.3,15,14,1,13,2,23,10,0,"https://fbref.com/en/players/88c4d190/Jeremy-Le-Douaron"
2024,"Brest","Ligue 1","Adrien Lebeau","FRA","MF,FW","24-327",1999,0.6,0,0,0,0,0,0,3,0,3,2,1,1,0,0,1,0,"https://fbref.com/en/players/ca122e29/Adrien-Lebeau"
2024,"Brest","Ligue 1","Pierre Lees-Melou","FRA","MF","31-005",1993,28,96,67,51,41,4,49,129,38,80,61,11,50,43,139,64,3,"https://fbref.com/en/players/f5044e54/Pierre-Lees-Melou"
2024,"Brest","Ligue 1","Bradley Locko","FRA","DF","22-024",2002,32.9,97,55,57,34,6,47,80,58.8,33,28,1,27,40,137,69,0,"https://fbref.com/en/players/40221fa7/Bradley-Locko"
2024,"Brest","Ligue 1","Hugo Magnetti","FRA","MF","26-000",1998,26,49,27,18,26,5,24,58,41.4,34,19,1,18,18,67,18,0,"https://fbref.com/en/players/d4d35152/Hugo-Magnetti"
2024,"Brest","Ligue 1","Hianga Mananga Mbock","FRA","MF,FW","24-154",1999,0.1,1,0,0,0,1,1,2,50,1,0,0,0,1,2,0,0,"https://fbref.com/en/players/0f86995c/Hianga-Mananga-Mbock"
2024,"Brest","Ligue 1","Jonas Martin","FRA","MF","34-051",1990,13.4,43,27,17,24,2,21,36,58.3,15,16,2,14,9,52,28,2,"https://fbref.com/en/players/468fdbad/Jonas-Martin"
2024,"Brest","Ligue 1","Steve Mounié","BEN","FW","29-244",1994,19.7,8,7,0,3,5,3,11,27.3,8,13,3,10,2,10,18,0,"https://fbref.com/en/players/19ba6c6d/Steve-Mounie"
2024,"Brest","Ligue 1","Mathias Pereira Lage","POR","FW,MF","27-182",1996,13.2,21,15,7,8,6,7,28,25,21,14,5,9,10,31,13,0,"https://fbref.com/en/players/8846a40f/Mathias-Pereira-Lage"
2024,"Brest","Ligue 1","Martin Satriano","URU","FW","23-100",2001,20.7,24,16,6,13,5,10,25,40,15,19,7,12,7,31,28,0,"https://fbref.com/en/players/86383d0e/Martin-Satriano"
2024,"Brest","Ligue 1","Luc Zogbé","CIV","DF","19-067",2005,0.1,0,0,0,0,0,0,1,0,1,1,1,0,1,1,0,0,"https://fbref.com/en/players/3725b44f/Luc-Zogbe"
2024,"Brighton","Premier League","Simon Adingra","CIV","FW","22-150",2002,24.7,45,20,23,11,11,19,42,45.2,23,31,1,30,19,64,22,0,"https://fbref.com/en/players/4dcec659/Simon-Adingra"
2024,"Brighton","Premier League","Carlos Baleba","CMR","MF","20-148",2004,14.7,40,20,17,19,4,23,46,50,23,35,7,28,18,58,30,3,"https://fbref.com/en/players/a1390d2f/Carlos-Baleba"
2024,"Brighton","Premier League","Valentín Barco","ARG","DF,FW","19-312",2004,3.4,11,5,4,5,2,6,8,75,2,3,0,3,4,15,3,1,"https://fbref.com/en/players/b9f282ec/Valentin-Barco"
2024,"Brighton","Premier League","Benicio Boaitey","ENG","FW,DF","20-142",2004,0.4,0,0,0,0,0,0,1,0,1,1,0,1,0,0,2,0,"https://fbref.com/en/players/4c5835e6/Benicio-Boaitey"
2024,"Brighton","Premier League","Facundo Buonanotte","ARG","FW,MF","19-159",2004,15.2,42,22,13,22,7,14,44,31.8,30,22,3,19,8,50,5,0,"https://fbref.com/en/players/468a7a91/Facundo-Buonanotte"
2024,"Brighton","Premier League","Mahmoud Dahoud","GER","MF","28-150",1996,5,9,4,2,4,3,3,9,33.3,6,4,1,3,1,10,5,0,"https://fbref.com/en/players/db4ed67b/Mahmoud-Dahoud"
2024,"Brighton","Premier League","Lewis Dunk","ENG","DF","32-191",1991,31.9,27,14,17,9,1,13,36,36.1,23,49,37,12,31,58,90,1,"https://fbref.com/en/players/282f75f3/Lewis-Dunk"
2024,"Brighton","Premier League","Julio Enciso","PAR","MF,FW","20-128",2004,5.3,6,2,3,2,1,2,7,28.6,5,11,0,11,0,6,3,0,"https://fbref.com/en/players/9cfbad36/Julio-Enciso"
2024,"Brighton","Premier League","Pervis Estupiñán","ECU","DF","26-130",1998,13.8,26,13,12,11,3,14,30,46.7,16,14,4,10,21,47,20,0,"https://fbref.com/en/players/d38fdf53/Pervis-Estupinan"
2024,"Brighton","Premier League","Ansu Fati","ESP","MF,FW","21-212",2002,5.8,5,3,1,2,2,1,11,9.1,10,8,0,8,3,8,3,0,"https://fbref.com/en/players/0ba976e4/Ansu-Fati"
2024,"Brighton","Premier League","Evan Ferguson","IRL","FW","19-224",2004,15.2,14,6,4,7,3,5,14,35.7,9,10,3,7,2,16,8,0,"https://fbref.com/en/players/4596da74/Evan-Ferguson"
2024,"Brighton","Premier League","Billy Gilmour","SCO","MF","22-354",2001,23.6,26,16,14,10,2,11,35,31.4,24,23,9,14,11,37,14,1,"https://fbref.com/en/players/df10e27c/Billy-Gilmour"
2024,"Brighton","Premier League","Pascal Groß","GER","MF,DF","32-350",1991,34.6,70,46,33,21,16,31,72,43.1,41,41,8,33,22,92,32,3,"https://fbref.com/en/players/8aec0537/Pascal-Gross"
2024,"Brighton","Premier League","Jan Paul van Hecke","NED","DF","23-357",2000,26.3,47,26,25,19,3,27,45,60,18,49,27,22,30,77,76,4,"https://fbref.com/en/players/4fd08daa/Jan-Paul-van-Hecke"
2024,"Brighton","Premier League","Jack Hinshelwood","ENG","DF","19-049",2005,9.7,14,5,7,4,3,5,13,38.5,8,6,2,4,14,28,18,0,"https://fbref.com/en/players/e98211e7/Jack-Hinshelwood"
2024,"Brighton","Premier League","Igor","BRA","DF","26-113",1998,18.2,25,18,7,16,2,17,29,58.6,12,22,9,13,14,39,52,1,"https://fbref.com/en/players/a4e85758/Igor"
2024,"Brighton","Premier League","João Pedro","BRA","FW,MF","22-247",2001,22.7,31,14,10,13,8,14,24,58.3,10,15,2,13,11,42,28,0,"https://fbref.com/en/players/e8832875/Joao-Pedro"
2024,"Brighton","Premier League","Adam Lallana","ENG","MF,FW","36-020",1988,9.4,8,3,4,4,0,0,4,0,4,2,1,1,3,11,1,0,"https://fbref.com/en/players/99813635/Adam-Lallana"
2024,"Brighton","Premier League","Tariq Lamptey","GHA","DF,FW","23-243",2000,10.2,21,14,14,5,2,13,22,59.1,9,7,3,4,6,27,6,0,"https://fbref.com/en/players/f4e433d4/Tariq-Lamptey"
2024,"Brighton","Premier League","Solly March","ENG","FW,DF","29-315",1994,6.2,19,14,9,7,3,8,14,57.1,6,5,0,5,11,30,8,0,"https://fbref.com/en/players/bb5fbd2b/Solly-March"
2024,"Brighton","Premier League","James Milner","ENG","DF,MF","38-147",1986,8.6,20,14,9,10,1,9,14,64.3,5,9,0,9,8,28,16,0,"https://fbref.com/en/players/2f90f6b8/James-Milner"
2024,"Brighton","Premier League","Kaoru Mitoma","JPN","FW","27-010",1997,16.5,13,6,3,7,3,5,19,26.3,14,15,1,14,5,18,12,0,"https://fbref.com/en/players/74618572/Kaoru-Mitoma"
2024,"Brighton","Premier League","Jakub Moder","POL","MF,DF","25-053",1999,6.9,19,10,9,5,5,9,18,50,9,8,2,6,2,21,12,0,"https://fbref.com/en/players/f230bc30/Jakub-Moder"
2024,"Brighton","Premier League","Mark O'Mahony","IRL","FW","19-137",2005,0.7,1,0,1,0,0,1,2,50,1,2,1,1,0,1,1,0,"https://fbref.com/en/players/a3afdd69/Mark-OMahony"
2024,"Brighton","Premier League","Odeluga Offiah","ENG","DF","21-217",2002,1.4,1,0,1,0,0,1,1,100,0,0,0,0,1,2,0,0,"https://fbref.com/en/players/65c3efa2/Odeluga-Offiah"
2024,"Brighton","Premier League","Jason Steele","ENG","GK","33-286",1990,17,0,0,0,0,0,0,3,0,3,0,0,0,0,0,8,1,"https://fbref.com/en/players/28300a16/Jason-Steele"
2024,"Brighton","Premier League","Joël Veltman","NED","DF","32-136",1992,17.6,54,41,32,17,5,39,58,67.2,19,17,7,10,18,72,57,1,"https://fbref.com/en/players/dad4b285/Joel-Veltman"
2024,"Brighton","Premier League","Bart Verbruggen","NED","GK","21-286",2002,21,1,1,1,0,0,1,2,50,1,0,0,0,0,1,11,3,"https://fbref.com/en/players/cf134113/Bart-Verbruggen"
2024,"Brighton","Premier League","Adam Webster","ENG","DF","29-147",1995,12.7,14,12,8,5,1,6,18,33.3,12,16,12,4,16,30,43,1,"https://fbref.com/en/players/c40b6180/Adam-Webster"
2024,"Brighton","Premier League","Danny Welbeck","ENG","FW,MF","33-186",1990,18.8,35,17,9,17,9,10,17,58.8,7,12,0,12,9,44,17,1,"https://fbref.com/en/players/ce5143da/Danny-Welbeck"
2024,"Burnley","Premier League","Zeki Amdouni","SUI","FW","23-178",2000,21.7,27,18,1,15,11,7,25,28,18,23,10,13,9,36,10,0,"https://fbref.com/en/players/2ee5b0c9/Zeki-Amdouni"
2024,"Burnley","Premier League","Lorenz Assignon","TOG","DF","23-343",2000,13.7,35,17,18,13,4,14,27,51.9,13,22,7,15,19,54,43,1,"https://fbref.com/en/players/b026bbf6/Lorenz-Assignon"
2024,"Burnley","Premier League","Jóhann Berg Guðmundsson","ISL","MF,FW","33-216",1990,13.2,13,4,6,5,2,7,16,43.8,9,14,0,14,16,29,16,0,"https://fbref.com/en/players/f72293fc/Johann-Berg-Gudmundsson"
2024,"Burnley","Premier League","Sander Berge","NOR","MF","26-106",1998,33.4,76,46,35,36,5,34,58,58.6,24,49,20,29,23,99,60,2,"https://fbref.com/en/players/d0b6129f/Sander-Berge"
2024,"Burnley","Premier League","Jordan Beyer","GER","DF","24-011",2000,13.7,35,20,22,12,1,14,24,58.3,10,22,15,7,16,51,68,1,"https://fbref.com/en/players/9af1f9ff/Jordan-Beyer"
2024,"Burnley","Premier League","Josh Brownhill","ENG","MF","28-163",1995,25,61,35,23,28,10,27,37,73,10,33,8,25,34,95,40,1,"https://fbref.com/en/players/47369df8/Josh-Brownhill"
2024,"Burnley","Premier League","Jacob Bruun Larsen","DEN","MF,FW","25-254",1998,13.9,9,4,4,3,2,7,21,33.3,14,16,2,14,7,16,23,0,"https://fbref.com/en/players/4e204552/Jacob-Bruun-Larsen"
2024,"Burnley","Premier League","Jack Cork","ENG","MF","34-340",1989,0.3,2,0,0,2,0,1,3,33.3,2,0,0,0,1,3,1,0,"https://fbref.com/en/players/74e12f1e/Jack-Cork"
2024,"Burnley","Premier League","Josh Cullen","IRL","MF","28-053",1996,22.9,42,29,15,22,5,26,46,56.5,20,31,19,12,15,57,26,1,"https://fbref.com/en/players/f6d7d690/Josh-Cullen"
2024,"Burnley","Premier League","Ameen Al-Dakhil","BEL","DF","22-085",2002,11.7,12,5,4,7,1,1,10,10,9,13,6,7,12,24,38,2,"https://fbref.com/en/players/93e08bce/Ameen-Al-Dakhil"
2024,"Burnley","Premier League","David Datro Fofana","CIV","FW","21-160",2002,9.8,10,5,3,5,2,3,6,50,3,9,3,6,1,11,2,0,"https://fbref.com/en/players/e82900ef/David-Datro-Fofana"
2024,"Burnley","Premier League","Hannes Delcroix","BEL","DF","25-092",1999,6.5,10,6,6,4,0,3,4,75,1,9,3,6,9,19,26,0,"https://fbref.com/en/players/b737f944/Hannes-Delcroix"
2024,"Burnley","Premier League","Hjalmar Ekdal","SWE","DF","25-222",1998,4.9,4,2,2,2,0,2,4,50,2,10,5,5,6,10,21,0,"https://fbref.com/en/players/3d554589/Hjalmar-Ekdal"
2024,"Burnley","Premier League","Maxime Estève","FRA","DF","22-004",2002,14.5,27,10,15,12,0,18,32,56.3,14,21,10,11,27,54,56,0,"https://fbref.com/en/players/1a066e69/Maxime-Esteve"
2024,"Burnley","Premier League","Lyle Foster","RSA","FW,MF","23-270",2000,21.1,19,10,5,6,8,6,17,35.3,11,13,3,10,3,22,34,0,"https://fbref.com/en/players/f84a807c/Lyle-Foster"
2024,"Burnley","Premier League","Luca Koleosho","ITA","MF,FW","19-258",2004,10.8,7,4,2,5,0,2,10,20,8,13,0,13,2,9,0,0,"https://fbref.com/en/players/fc076f78/Luca-Koleosho"
2024,"Burnley","Premier League","Benson Manuel","BEL","MF,FW","27-063",1997,1.3,3,2,2,1,0,0,0,NA,0,1,0,1,0,3,0,0,"https://fbref.com/en/players/d7f99582/Benson-Manuel"
2024,"Burnley","Premier League","Han-Noah Massengo","FRA","MF,DF","22-328",2001,0.2,1,1,1,0,0,0,0,NA,0,1,0,1,0,1,0,0,"https://fbref.com/en/players/eba1e557/Han-Noah-Massengo"
2024,"Burnley","Premier League","Arijanet Muric","KVX","GK","25-205",1998,10,1,1,1,0,0,1,1,100,0,0,0,0,0,1,10,4,"https://fbref.com/en/players/99aa1a84/Arijanet-Muric"
2024,"Burnley","Premier League","Dara O'Shea","IRL","DF","25-087",1999,32.1,39,20,22,14,3,11,26,42.3,15,41,30,11,35,74,158,2,"https://fbref.com/en/players/1d042188/Dara-OShea"
2024,"Burnley","Premier League","Michael Obafemi","IRL","FW,MF","23-329",2000,0.2,0,0,0,0,0,0,0,NA,0,1,0,1,0,0,0,0,"https://fbref.com/en/players/caa1a7f0/Michael-Obafemi"
2024,"Burnley","Premier League","Wilson Odobert","FRA","MF,FW","19-184",2004,23.3,17,13,8,5,4,6,22,27.3,16,26,2,24,6,23,14,0,"https://fbref.com/en/players/35516eac/Wilson-Odobert"
2024,"Burnley","Premier League","Aaron Ramsey","ENG","MF,FW","21-130",2003,5.9,17,14,7,5,5,8,16,50,8,11,2,9,1,18,10,0,"https://fbref.com/en/players/e1618c22/Aaron-Ramsey"
2024,"Burnley","Premier League","Nathan Redmond","ENG","FW,MF","30-085",1994,1.6,2,1,0,0,2,1,4,25,3,1,0,1,0,2,3,0,"https://fbref.com/en/players/ab651565/Nathan-Redmond"
2024,"Burnley","Premier League","Connor Roberts","WAL","DF","28-250",1995,9.1,12,5,6,4,2,8,17,47.1,9,8,6,2,4,16,25,2,"https://fbref.com/en/players/24fae784/Connor-Roberts"
2024,"Burnley","Premier League","Jay Rodriguez","ENG","FW","34-306",1989,9.1,14,9,7,4,3,7,13,53.8,6,11,1,10,1,15,8,0,"https://fbref.com/en/players/4ab53cdb/Jay-Rodriguez"
2024,"Burnley","Premier League","Charlie Taylor","ENG","DF","30-255",1993,25.9,35,20,19,14,2,17,35,48.6,18,27,11,16,19,54,78,0,"https://fbref.com/en/players/cc2d7ad5/Charlie-Taylor"
2024,"Burnley","Premier League","James Trafford","ENG","GK","21-233",2002,28,2,1,2,0,0,2,2,100,0,0,0,0,1,3,18,1,"https://fbref.com/en/players/259fea27/James-Trafford"
2024,"Burnley","Premier League","Mike Trésor","BEL","FW,MF","25-002",1999,4.7,10,6,9,1,0,8,18,44.4,10,5,0,5,1,11,1,0,"https://fbref.com/en/players/b2a81fc6/Mike-Tresor"
2024,"Burnley","Premier League","Vitinho","BRA","DF,MF","24-312",1999,25.7,64,34,36,22,6,43,86,50,43,44,6,38,12,76,47,4,"https://fbref.com/en/players/9295dc1c/Vitinho"
2024,"Burnley","Premier League","Anass Zaroury","MAR","FW,MF","23-205",2000,1.7,1,0,1,0,0,0,4,0,4,2,0,2,0,1,1,1,"https://fbref.com/en/players/07d65234/Anass-Zaroury"
2024,"Cagliari","Serie A","Simone Aresti","ITA","GK","38-076",1986,0,0,0,0,0,0,0,0,NA,0,0,0,0,0,0,0,0,"https://fbref.com/en/players/a9eaccda/Simone-Aresti"
2024,"Cagliari","Serie A","Tommaso Augello","ITA","DF","29-274",1994,26.9,26,19,18,6,2,16,25,64,9,21,10,11,17,43,89,0,"https://fbref.com/en/players/3cd3b384/Tommaso-Augello"
2024,"Cagliari","Serie A","Paulo Azzi","BRA","DF,MF","29-320",1994,10.6,19,11,10,6,3,9,18,50,9,11,2,9,16,35,23,0,"https://fbref.com/en/players/967ac202/Paulo-Azzi"
2024,"Cagliari","Serie A","Alessandro Deiola","ITA","MF","28-303",1995,17.9,33,19,13,16,4,18,47,38.3,29,16,6,10,9,42,37,0,"https://fbref.com/en/players/7f267d66/Alessandro-Deiola"
2024,"Cagliari","Serie A","Alessandro Di Pardo","ITA","DF,MF","24-317",1999,4,4,1,3,0,1,0,3,0,3,9,2,7,5,9,7,0,"https://fbref.com/en/players/e0ce7038/Alessandro-Di-Pardo"
2024,"Cagliari","Serie A","Alberto Dossena","ITA","DF","25-230",1998,33.1,55,35,43,12,0,32,48,66.7,16,50,27,23,45,100,172,2,"https://fbref.com/en/players/61efb926/Alberto-Dossena"
2024,"Cagliari","Serie A","Gianluca Gaetano","ITA","FW,MF","24-025",2000,8.3,7,4,0,4,3,2,7,28.6,5,4,0,4,3,10,4,0,"https://fbref.com/en/players/3b387cc7/Gianluca-Gaetano"
2024,"Cagliari","Serie A","Edoardo Goldaniga","ITA","DF","30-210",1993,11.2,12,7,9,3,0,4,10,40,6,11,7,4,15,27,37,1,"https://fbref.com/en/players/4b029b31/Edoardo-Goldaniga"
2024,"Cagliari","Serie A","Pantelis Hatzidiakos","GRE","DF","27-133",1997,9.5,22,10,12,10,0,10,17,58.8,7,14,5,9,13,35,30,1,"https://fbref.com/en/players/78a3c38e/Pantelis-Hatzidiakos"
2024,"Cagliari","Serie A","Jakub Jankto","CZE","MF,FW","28-132",1996,9.7,12,9,9,1,2,8,20,40,12,5,1,4,5,17,20,0,"https://fbref.com/en/players/1ea5f91c/Jakub-Jankto"
2024,"Cagliari","Serie A","Gianluca Lapadula","PER","FW","34-113",1990,13.4,1,1,0,0,1,1,10,10,9,2,1,1,2,3,5,0,"https://fbref.com/en/players/2ead2809/Gianluca-Lapadula"
2024,"Cagliari","Serie A","Zito Luvumbo","ANG","FW,MF","22-082",2002,21.6,9,6,5,2,2,4,15,26.7,11,19,0,19,1,10,2,0,"https://fbref.com/en/players/b09e0873/Zito-Luvumbo"
2024,"Cagliari","Serie A","Antoine Makoumbou","CGO","MF","25-317",1998,30,41,24,21,15,5,15,30,50,15,23,4,19,16,57,27,2,"https://fbref.com/en/players/f37f3522/Antoine-Makoumbou"
2024,"Cagliari","Serie A","Marco Mancosu","ITA","MF,FW","35-282",1988,1.7,3,0,0,2,1,1,2,50,1,0,0,0,0,3,0,0,"https://fbref.com/en/players/2c3a6c21/Marco-Mancosu"
2024,"Cagliari","Serie A","Yerry Mina","COL","DF","29-250",1994,13.5,20,13,14,6,0,13,19,68.4,6,23,14,9,4,24,77,0,"https://fbref.com/en/players/6d5701f2/Yerry-Mina"
2024,"Cagliari","Serie A","Kingstone Mutandwa","ZAM","FW,MF","21-146",2003,0.4,1,0,1,0,0,1,4,25,3,1,0,1,0,1,2,0,"https://fbref.com/en/players/cbe32194/Kingstone-Mutandwa"
2024,"Cagliari","Serie A","Nahitan Nández","URU","MF,DF","28-154",1995,26,59,40,27,23,9,27,64,42.2,37,25,2,23,19,78,32,0,"https://fbref.com/en/players/95facda1/Nahitan-Nandez"
2024,"Cagliari","Serie A","Adam Obert","SVK","DF","21-281",2002,10.5,17,9,8,8,1,8,17,47.1,9,13,7,6,21,38,41,1,"https://fbref.com/en/players/aa25ce92/Adam-Obert"
2024,"Cagliari","Serie A","Gaetano Oristanio","ITA","FW,MF","21-245",2002,12.3,20,10,5,14,1,5,17,29.4,12,11,0,11,9,29,8,0,"https://fbref.com/en/players/5cfc74fc/Gaetano-Oristanio"
2024,"Cagliari","Serie A","Leonardo Pavoletti","ITA","FW","35-186",1988,7,1,1,0,0,1,0,1,0,1,2,1,1,0,1,7,0,"https://fbref.com/en/players/d37b0350/Leonardo-Pavoletti"
2024,"Cagliari","Serie A","Andrea Petagna","ITA","FW","28-335",1995,11.1,4,2,1,0,3,1,2,50,1,6,3,3,1,5,4,0,"https://fbref.com/en/players/03f946ed/Andrea-Petagna"
2024,"Cagliari","Serie A","Matteo Prati","ITA","MF","20-154",2003,21.9,45,25,15,27,3,26,42,61.9,16,29,6,23,15,60,26,1,"https://fbref.com/en/players/d8363914/Matteo-Prati"
2024,"Cagliari","Serie A","Boris Radunović","SRB","GK","28-004",1996,7,0,0,0,0,0,0,0,NA,0,0,0,0,1,1,1,2,"https://fbref.com/en/players/0dfce079/Boris-Radunovic"
2024,"Cagliari","Serie A","Simone Scuffet","ITA","GK","27-365",1996,31,1,0,1,0,0,1,2,50,1,1,0,1,1,2,9,0,"https://fbref.com/en/players/41bd99ea/Simone-Scuffet"
2024,"Cagliari","Serie A","Eldor Shomurodov","UZB","FW,MF","28-336",1995,10.4,11,4,2,6,3,6,10,60,4,5,0,5,4,15,4,0,"https://fbref.com/en/players/57469b2d/Eldor-Shomurodov"
2024,"Cagliari","Serie A","Ibrahim Sulemana","GHA","MF","21-008",2003,14.9,36,14,15,15,6,17,27,63,10,24,5,19,7,43,23,0,"https://fbref.com/en/players/230c3f3a/Ibrahim-Sulemana"
2024,"Cagliari","Serie A","Nicolas Viola","ITA","MF,FW","34-231",1989,13.4,13,9,2,8,3,7,17,41.2,10,9,0,9,2,15,6,0,"https://fbref.com/en/players/45392b06/Nicolas-Viola"
2024,"Cagliari","Serie A","Mateusz Wieteska","POL","DF","27-109",1997,10.7,14,11,9,3,2,3,10,30,7,10,5,5,14,28,48,0,"https://fbref.com/en/players/3ecc8c5f/Mateusz-Wieteska"
2024,"Cagliari","Serie A","Gabriele Zappa","ITA","DF","24-160",1999,28.5,54,31,29,16,9,29,41,70.7,12,29,5,24,20,74,75,2,"https://fbref.com/en/players/ca3db240/Gabriele-Zappa"
2024,"Celta Vigo","La Liga","Joseph Aidoo","GHA","DF","28-244",1995,4.5,8,3,6,2,0,4,8,50,4,3,1,2,4,12,28,0,"https://fbref.com/en/players/18abe173/Joseph-Aidoo"
2024,"Celta Vigo","La Liga","Tadeo Allende","ARG","MF,FW","25-100",1999,3.7,6,1,3,2,1,4,6,66.7,2,3,0,3,3,9,3,0,"https://fbref.com/en/players/75a66bed/Tadeo-Allende"
2024,"Celta Vigo","La Liga","Hugo Álvarez","ESP","MF,DF","20-333",2003,8.5,14,9,8,3,3,9,20,45,11,4,1,3,5,19,9,0,"https://fbref.com/en/players/6f392eb8/Hugo-Alvarez"
2024,"Celta Vigo","La Liga","Iago Aspas","ESP","FW","36-303",1987,30.1,11,6,4,6,1,1,15,6.7,14,23,3,20,10,21,8,0,"https://fbref.com/en/players/7dcf86f6/Iago-Aspas"
2024,"Celta Vigo","La Liga","Jonathan Bamba","CIV","MF,FW","28-065",1996,22,14,9,4,8,2,2,17,11.8,15,20,0,20,18,32,12,0,"https://fbref.com/en/players/b2bd0f6c/Jonathan-Bamba"
2024,"Celta Vigo","La Liga","Fran Beltrán","ESP","MF","25-117",1999,27,56,32,22,23,11,24,63,38.1,39,28,2,26,18,74,34,0,"https://fbref.com/en/players/ed5c5fa3/Fran-Beltran"
2024,"Celta Vigo","La Liga","Franco Cervi","ARG","MF,DF","30-004",1994,6.1,24,18,13,9,2,13,24,54.2,11,16,0,16,9,33,4,0,"https://fbref.com/en/players/5e1028e5/Franco-Cervi"
2024,"Celta Vigo","La Liga","Carlos Dominguez","ESP","DF","23-109",2001,17.6,33,21,17,9,7,23,37,62.2,14,24,12,12,22,55,78,0,"https://fbref.com/en/players/3521abfe/Carlos-Dominguez"
2024,"Celta Vigo","La Liga","Carlos Dotor","ESP","MF","23-076",2001,7.9,14,7,3,8,3,4,13,30.8,9,12,2,10,4,18,4,0,"https://fbref.com/en/players/daa2eab3/Carlos-Dotor"
2024,"Celta Vigo","La Liga","Anastasios Douvikas","GRE","FW","24-302",1999,10.1,15,7,2,6,7,3,8,37.5,5,6,3,3,2,17,9,0,"https://fbref.com/en/players/853ca71c/Anastasios-Douvikas"
2024,"Celta Vigo","La Liga","Vicente Guaita","ESP","GK","37-141",1987,26.7,1,1,1,0,0,1,2,50,1,0,0,0,0,1,9,1,"https://fbref.com/en/players/ab13a5aa/Vicente-Guaita"
2024,"Celta Vigo","La Liga","Luca de la Torre","USA","MF","26-007",1998,21.7,39,21,12,22,5,22,43,51.2,21,23,4,19,12,51,17,0,"https://fbref.com/en/players/e9241b40/Luca-de-la-Torre"
2024,"Celta Vigo","La Liga","Yoel Lago","ESP","DF","20-066",2004,1,2,0,2,0,0,0,0,NA,0,1,0,1,0,2,2,0,"https://fbref.com/en/players/edd4e7a5/Yoel-Lago"
2024,"Celta Vigo","La Liga","Javier Manquillo","ESP","DF,MF","30-025",1994,8.3,15,11,6,5,4,8,15,53.3,7,14,3,11,3,18,17,0,"https://fbref.com/en/players/758dd7f0/Javier-Manquillo"
2024,"Celta Vigo","La Liga","Óscar Mingueza","ESP","DF,MF","25-017",1999,33.3,62,38,44,11,7,37,80,46.3,43,38,7,31,17,79,49,2,"https://fbref.com/en/players/056269d7/Oscar-Mingueza"
2024,"Celta Vigo","La Liga","Unai Núñez","ESP","DF","27-121",1997,31.1,51,28,30,19,2,23,49,46.9,26,38,24,14,52,103,153,3,"https://fbref.com/en/players/be170419/Unai-Nunez"
2024,"Celta Vigo","La Liga","Carles Pérez","ESP","MF,DF","26-104",1998,8.6,13,5,6,5,2,7,18,38.9,11,14,1,13,5,18,8,0,"https://fbref.com/en/players/a8f21b9f/Carles-Perez"
2024,"Celta Vigo","La Liga","Mihailo Ristić","SRB","DF,MF","28-212",1995,9,15,9,9,6,0,9,12,75,3,9,2,7,10,25,23,0,"https://fbref.com/en/players/ea0aa7e0/Mihailo-Ristic"
2024,"Celta Vigo","La Liga","Damián Rodríguez","ESP","MF","21-074",2003,2.9,6,3,1,3,2,1,3,33.3,2,4,2,2,1,7,2,0,"https://fbref.com/en/players/22371dee/Damian-Rodriguez"
2024,"Celta Vigo","La Liga","Miguel Rodríguez","ESP","MF","21-031",2003,3.3,6,3,3,1,2,3,9,33.3,6,8,0,8,4,10,0,0,"https://fbref.com/en/players/958d67bb/Miguel-Rodriguez"
2024,"Celta Vigo","La Liga","Javier Rueda Garcia","ESP","DF","22-022",2002,0.2,NA,0,NA,NA,NA,NA,NA,NA,NA,NA,NA,NA,0,NA,NA,NA,"https://fbref.com/en/players/9ace87ba/Javier-Rueda-Garcia"
2024,"Celta Vigo","La Liga","Manu Sánchez","ESP","DF,MF","23-280",2000,19.7,54,28,21,25,8,31,55,56.4,24,23,3,20,19,73,65,0,"https://fbref.com/en/players/ffacd3d5/Manu-Sanchez"
2024,"Celta Vigo","La Liga","Jailson Siqueira","BRA","DF,MF","28-266",1995,10,27,18,22,5,0,13,24,54.2,11,13,5,8,12,39,32,0,"https://fbref.com/en/players/b4819112/Jailson-Siqueira"
2024,"Celta Vigo","La Liga","Hugo Sotelo","ESP","MF","20-163",2003,8,19,17,3,13,3,8,20,40,12,7,1,6,2,21,5,0,"https://fbref.com/en/players/3aa74860/Hugo-Sotelo"
2024,"Celta Vigo","La Liga","Carl Starfelt","SWE","DF","28-364",1995,24.6,36,30,30,5,1,19,28,67.9,9,35,28,7,34,70,159,2,"https://fbref.com/en/players/5cfec13d/Carl-Starfelt"
2024,"Celta Vigo","La Liga","Jørgen Strand Larsen","NOR","FW","24-114",2000,31.8,21,11,1,15,5,8,38,21.1,30,15,1,14,5,26,17,0,"https://fbref.com/en/players/f553b2b3/Jorgen-Strand-Larsen"
2024,"Celta Vigo","La Liga","Williot Swedberg","SWE","FW,MF","20-119",2004,4.9,9,4,3,6,0,5,8,62.5,3,11,1,10,0,9,4,0,"https://fbref.com/en/players/184fe4b2/Williot-Swedberg"
2024,"Celta Vigo","La Liga","Renato Tapia","PER","MF,DF","28-307",1995,14.9,41,29,19,19,3,14,25,56,11,31,7,24,21,62,50,1,"https://fbref.com/en/players/34269bdf/Renato-Tapia"
2024,"Celta Vigo","La Liga","Kevin Vázquez","ESP","DF","31-068",1993,7.8,15,13,7,7,1,12,21,57.1,9,11,3,8,5,20,25,0,"https://fbref.com/en/players/ee923664/Kevin-Vazquez"
2024,"Celta Vigo","La Liga","Gabriel Veiga","ESP","FW","22-003",2002,0.2,0,0,0,0,0,0,0,NA,0,0,0,0,0,0,0,0,"https://fbref.com/en/players/35a6e5c7/Gabriel-Veiga"
2024,"Celta Vigo","La Liga","Iván Villar","ESP","GK","26-326",1997,11.3,0,0,0,0,0,0,1,0,1,0,0,0,0,0,6,0,"https://fbref.com/en/players/cde52ef5/Ivan-Villar"
2024,"Chelsea","Premier League","Joshua Acheampong","ENG","DF","18-025",2006,0.1,0,0,0,0,0,0,0,NA,0,3,3,0,0,0,0,0,"https://fbref.com/en/players/b7e62e1d/Joshua-Acheampong"
2024,"Chelsea","Premier League","Benoît Badiashile","FRA","DF","23-065",2001,14.9,21,15,12,9,0,9,14,64.3,5,21,14,7,18,39,66,2,"https://fbref.com/en/players/06df8256/Benoit-Badiashile"
2024,"Chelsea","Premier League","Armando Broja","ALB","FW","22-263",2001,5,3,0,0,1,2,1,2,50,1,5,1,4,0,3,3,0,"https://fbref.com/en/players/97220da2/Armando-Broja"
2024,"Chelsea","Premier League","Mason Burstow","ENG","FW","20-300",2003,0.1,0,0,0,0,0,0,0,NA,0,0,0,0,0,0,0,0,"https://fbref.com/en/players/dab84ad2/Mason-Burstow"
2024,"Chelsea","Premier League","Moisés Caicedo","ECU","MF","22-210",2001,31.8,91,46,38,42,11,36,60,60,24,59,25,34,37,128,44,4,"https://fbref.com/en/players/16264a81/Moises-Caicedo"
2024,"Chelsea","Premier League","Cesare Casadei","ITA","FW,MF","21-141",2003,0.9,5,3,2,1,2,2,5,40,3,1,0,1,0,5,4,0,"https://fbref.com/en/players/fb920f3a/Cesare-Casadei"
2024,"Chelsea","Premier League","Trevoh Chalobah","ENG","DF","24-330",1999,10.6,16,12,10,2,4,10,15,66.7,5,8,7,1,8,24,51,0,"https://fbref.com/en/players/5515376c/Trevoh-Chalobah"
2024,"Chelsea","Premier League","Ben Chilwell","ENG","DF","27-161",1996,8.4,15,10,5,9,1,5,8,62.5,3,11,3,8,4,19,19,1,"https://fbref.com/en/players/d2424d1b/Ben-Chilwell"
2024,"Chelsea","Premier League","Carney Chukwuemeka","ENG","MF,FW","20-223",2003,2.5,6,4,3,3,0,1,3,33.3,2,1,1,0,0,6,1,0,"https://fbref.com/en/players/b2f9c73e/Carney-Chukwuemeka"
2024,"Chelsea","Premier League","Levi Colwill","ENG","DF","21-094",2003,20,48,30,26,17,5,26,34,76.5,8,28,10,18,26,74,66,0,"https://fbref.com/en/players/700783e7/Levi-Colwill"
2024,"Chelsea","Premier League","Marc Cucurella","ESP","DF","25-313",1998,19.8,62,38,36,21,5,34,64,53.1,30,36,13,23,22,84,48,0,"https://fbref.com/en/players/1daec722/Marc-Cucurella"
2024,"Chelsea","Premier League","Axel Disasi","FRA","DF","26-080",1998,28.7,33,19,20,10,3,23,30,76.7,7,26,19,7,18,51,102,2,"https://fbref.com/en/players/ad82197c/Axel-Disasi"
2024,"Chelsea","Premier League","Enzo Fernández","ARG","MF","23-134",2001,24.5,50,22,22,18,10,27,65,41.5,38,36,13,23,17,67,28,0,"https://fbref.com/en/players/5ff4ab71/Enzo-Fernandez"
2024,"Chelsea","Premier League","Conor Gallagher","ENG","MF","24-114",2000,34.8,85,52,37,31,17,33,77,42.9,44,50,11,39,43,128,34,0,"https://fbref.com/en/players/c2731c10/Conor-Gallagher"
2024,"Chelsea","Premier League","Alfie Gilchrist","ENG","DF","20-184",2003,2.3,4,0,4,0,0,2,5,40,3,6,3,3,3,7,11,0,"https://fbref.com/en/players/d91f104d/Alfie-Gilchrist"
2024,"Chelsea","Premier League","Malo Gusto","FRA","DF","21-011",2003,19.5,55,27,34,15,6,35,52,67.3,17,28,4,24,17,72,43,1,"https://fbref.com/en/players/d56b9520/Malo-Gusto"
2024,"Chelsea","Premier League","Nicolas Jackson","SEN","FW","22-345",2001,31.1,21,13,5,8,8,5,24,20.8,19,20,5,15,4,25,17,0,"https://fbref.com/en/players/9c36ed83/Nicolas-Jackson"
2024,"Chelsea","Premier League","Reece James","ENG","DF","24-174",1999,4.7,14,9,10,3,1,8,10,80,2,4,4,0,3,17,7,1,"https://fbref.com/en/players/1265a93a/Reece-James"
2024,"Chelsea","Premier League","Roméo Lavia","BEL","MF","20-145",2004,0.4,1,0,0,1,0,0,0,NA,0,0,0,0,0,1,1,0,"https://fbref.com/en/players/ecad9aa5/Romeo-Lavia"
2024,"Chelsea","Premier League","Ian Maatsen","NED","FW,MF","22-081",2002,2.3,3,2,1,1,1,0,4,0,4,4,0,4,3,6,10,0,"https://fbref.com/en/players/cab9634e/Ian-Maatsen"
2024,"Chelsea","Premier League","Noni Madueke","ENG","FW","22-081",2002,11.7,16,10,8,4,4,11,34,32.4,23,11,0,11,4,20,14,0,"https://fbref.com/en/players/bf34eebd/Noni-Madueke"
2024,"Chelsea","Premier League","Alex Matos","ENG","MF","19-240",2004,0,0,0,0,0,0,0,0,NA,0,0,0,0,0,0,0,0,"https://fbref.com/en/players/ed383e43/Alex-Matos"
2024,"Chelsea","Premier League","Mykhailo Mudryk","UKR","FW","23-146",2001,17.5,21,12,9,7,5,10,32,31.3,22,14,1,13,9,30,9,0,"https://fbref.com/en/players/049a888d/Mykhailo-Mudryk"
2024,"Chelsea","Premier League","Christopher Nkunku","FRA","FW,MF","26-198",1997,4.9,5,4,0,4,1,1,2,50,1,4,1,3,2,7,4,0,"https://fbref.com/en/players/7c56da38/Christopher-Nkunku"
2024,"Chelsea","Premier League","Cole Palmer","ENG","FW,MF","22-024",2002,29,23,12,9,6,8,8,19,42.1,11,20,2,18,20,43,13,2,"https://fbref.com/en/players/dc7f8a28/Cole-Palmer"
2024,"Chelsea","Premier League","Đorđe Petrović","SRB","GK","24-235",1999,22.1,0,0,0,0,0,0,0,NA,0,0,0,0,0,0,12,3,"https://fbref.com/en/players/0cf321c8/Djordje-Petrovic"
2024,"Chelsea","Premier League","Robert Sánchez","ESP","GK","26-194",1997,15.9,0,0,0,0,0,0,0,NA,0,0,0,0,0,0,11,3,"https://fbref.com/en/players/6a713852/Robert-Sanchez"
2024,"Chelsea","Premier League","Thiago Silva","BRA","DF","39-251",1984,28.1,29,15,22,6,1,20,34,58.8,14,33,24,9,26,55,153,4,"https://fbref.com/en/players/86e7deaf/Thiago-Silva"
2024,"Chelsea","Premier League","Raheem Sterling","ENG","FW,MF","29-174",1994,22,21,10,7,8,6,12,26,46.2,14,13,0,13,13,34,9,1,"https://fbref.com/en/players/b400bde0/Raheem-Sterling"
2024,"Chelsea","Premier League","Jimi Tauriainen","ENG","FW","20-083",2004,0,0,0,0,0,0,0,0,NA,0,0,0,0,0,0,0,0,"https://fbref.com/en/players/cac9e583/Jimi-Tauriainen"
2024,"Chelsea","Premier League","Lesley Ugochukwu","FRA","MF","20-065",2004,3.3,14,10,4,8,2,4,10,40,6,6,2,4,1,15,5,0,"https://fbref.com/en/players/1df4a109/Lesley-Ugochukwu"
2024,"Chelsea","Premier League","Deivid Washington","BRA","DF,FW","18-360",2005,0.1,1,1,1,0,0,0,1,0,1,0,0,0,0,1,0,0,"https://fbref.com/en/players/95bd120d/Deivid-Washington"
2024,"Clermont Foot","Ligue 1","Jim Allevinah","GAB","MF,DF","29-093",1995,20.7,30,18,11,14,5,14,35,40,21,20,3,17,13,43,30,0,"https://fbref.com/en/players/1956b948/Jim-Allevinah"
2024,"Clermont Foot","Ligue 1","Komnen Andrić","SRB","FW","28-334",1995,1.9,2,1,0,1,1,0,4,0,4,2,0,2,0,2,1,0,"https://fbref.com/en/players/af3ddb2e/Komnen-Andric"
2024,"Clermont Foot","Ligue 1","Yoël Armougom","FRA","DF,MF","25-360",1998,2.6,3,3,2,0,1,2,3,66.7,1,1,0,1,1,4,3,0,"https://fbref.com/en/players/9dd5da03/Yoel-Armougom"
2024,"Clermont Foot","Ligue 1","Abdellah Baallal","MAR","MF","19-205",2004,0,0,0,0,0,0,0,0,NA,0,1,0,1,0,0,0,0,"https://fbref.com/en/players/972183e0/Abdellah-Baallal"
2024,"Clermont Foot","Ligue 1","Jérémie Bela","ANG","MF,FW","31-052",1993,2.3,1,1,0,1,0,1,3,33.3,2,1,0,1,0,1,1,0,"https://fbref.com/en/players/5680bf3f/Jeremie-Bela"
2024,"Clermont Foot","Ligue 1","Neto Borges","BRA","DF","27-260",1996,28,48,24,25,18,5,28,63,44.4,35,28,6,22,57,105,84,0,"https://fbref.com/en/players/9f936061/Neto-Borges"
2024,"Clermont Foot","Ligue 1","Mohamed Bouchenna","FRA","MF,FW","17-350",2006,0.3,1,0,1,0,0,0,0,NA,0,0,0,0,0,1,0,0,"https://fbref.com/en/players/28e1d1ea/Mohamed-Bouchenna"
2024,"Clermont Foot","Ligue 1","Bilal Boutobba","FRA","FW,MF","25-275",1998,10.3,22,12,6,10,6,10,23,43.5,13,9,0,9,8,30,3,0,"https://fbref.com/en/players/e8a65bc8/Bilal-Boutobba"
2024,"Clermont Foot","Ligue 1","Maximiliano Caufriez","BEL","DF","27-104",1997,18.4,38,28,31,5,2,19,29,65.5,10,18,12,6,18,56,69,2,"https://fbref.com/en/players/c92c24f0/Maximiliano-Caufriez"
2024,"Clermont Foot","Ligue 1","Muhammed Cham","AUT","MF,FW","23-247",2000,28.4,25,14,10,13,2,11,27,40.7,16,20,2,18,8,33,5,1,"https://fbref.com/en/players/f527a32c/Muhammed-Cham"
2024,"Clermont Foot","Ligue 1","Mory Diaw","SEN","GK","30-343",1993,30,1,1,1,0,0,1,2,50,1,0,0,0,1,2,13,5,"https://fbref.com/en/players/f41a69e6/Mory-Diaw"
2024,"Clermont Foot","Ligue 1","Ilhan Fakili","FRA","MF,FW","18-131",2006,1,0,0,0,0,0,0,1,0,1,1,0,1,1,1,0,0,"https://fbref.com/en/players/eabef312/Ilhan-Fakili"
2024,"Clermont Foot","Ligue 1","Johan Gastien","FRA","MF","36-126",1988,25.1,43,22,18,21,4,23,81,28.4,58,31,9,22,36,79,24,4,"https://fbref.com/en/players/868eaba0/Johan-Gastien"
2024,"Clermont Foot","Ligue 1","Maxime Gonalons","FRA","MF","35-081",1989,14.4,47,33,14,27,6,25,57,43.9,32,18,3,15,20,67,11,0,"https://fbref.com/en/players/b8c1de25/Maxime-Gonalons"
2024,"Clermont Foot","Ligue 1","Jérémy Jacquet","FRA","DF","18-322",2005,2.8,4,3,4,0,0,3,3,100,0,7,3,4,6,10,10,0,"https://fbref.com/en/players/cef70c94/Jeremy-Jacquet"
2024,"Clermont Foot","Ligue 1","Habib Keita","MLI","MF","22-115",2002,14.2,34,19,14,15,5,17,28,60.7,11,27,10,17,29,63,30,0,"https://fbref.com/en/players/cc588cbe/Habib-Keita"
2024,"Clermont Foot","Ligue 1","Cheick Konaté","MLI","DF","20-058",2004,11.9,26,15,17,9,0,20,36,55.6,16,16,2,14,13,39,21,0,"https://fbref.com/en/players/6ce2cdf0/Cheick-Konate"
2024,"Clermont Foot","Ligue 1","Grejohn Kyei","FRA","FW","28-292",1995,11.4,6,4,2,2,2,2,3,66.7,1,5,1,4,1,7,10,0,"https://fbref.com/en/players/397ba086/Grejohn-Kyei"
2024,"Clermont Foot","Ligue 1","Joshua M'Bahia","CIV","MF","19-041",2005,0.2,0,0,0,0,0,0,0,NA,0,0,0,0,0,0,0,0,"https://fbref.com/en/players/f02067df/Joshua-MBahia"
2024,"Clermont Foot","Ligue 1","Yohann Magnin","FRA","MF","26-344",1997,18.7,49,31,12,32,5,22,47,46.8,25,38,13,25,19,68,26,1,"https://fbref.com/en/players/caa7aaea/Yohann-Magnin"
2024,"Clermont Foot","Ligue 1","Chrislain Matsima","FRA","DF","22-015",2002,13.1,18,11,11,7,0,10,18,55.6,8,14,10,4,13,31,74,1,"https://fbref.com/en/players/cf1ef7ec/Chrislain-Matsima"
2024,"Clermont Foot","Ligue 1","Aïman Maurer","MAR","MF,FW","19-248",2004,0.6,1,1,1,0,0,1,3,33.3,2,0,0,0,0,1,0,0,"https://fbref.com/en/players/87d31635/Aiman-Maurer"
2024,"Clermont Foot","Ligue 1","Massamba Ndiaye","SEN","GK","22-235",2001,4,0,0,0,0,0,0,0,NA,0,0,0,0,0,0,2,0,"https://fbref.com/en/players/315fe681/Massamba-Ndiaye"
2024,"Clermont Foot","Ligue 1","Shamar Nicholson","JAM","FW","27-075",1997,16.5,6,2,0,4,2,1,4,25,3,6,2,4,0,6,15,0,"https://fbref.com/en/players/e33fb79d/Shamar-Nicholson"
2024,"Clermont Foot","Ligue 1","Florent Ogier","FRA","DF","35-070",1989,10.5,19,9,13,6,0,11,18,61.1,7,25,19,6,9,28,35,3,"https://fbref.com/en/players/6993927b/Florent-Ogier"
2024,"Clermont Foot","Ligue 1","Andy Pelmard","FRA","DF","24-079",2000,33.2,51,38,41,9,1,32,40,80,8,37,20,17,33,84,99,2,"https://fbref.com/en/players/f18d7ab2/Andy-Pelmard"
2024,"Clermont Foot","Ligue 1","Elba Rashani","KVX","MF,FW","31-021",1993,13.1,30,18,4,17,9,11,24,45.8,13,17,3,14,12,42,15,0,"https://fbref.com/en/players/25749008/Elba-Rashani"
2024,"Clermont Foot","Ligue 1","Alidu Seidu","GHA","DF","23-361",2000,12.6,32,24,17,15,0,24,31,77.4,7,15,7,8,25,57,37,0,"https://fbref.com/en/players/cea59f02/Alidu-Seidu"
2024,"Clermont Foot","Ligue 1","Alan Virginius","FRA","FW","21-148",2003,10.4,9,5,4,4,1,4,11,36.4,7,7,0,7,3,12,7,0,"https://fbref.com/en/players/01becd60/Alan-Virginius"
2024,"Clermont Foot","Ligue 1","Mateusz Wieteska","POL","DF","27-109",1997,1.9,4,1,3,1,0,3,5,60,2,4,2,2,5,9,8,0,"https://fbref.com/en/players/3ecc8c5f/Mateusz-Wieteska"
2024,"Clermont Foot","Ligue 1","Mehdi Zeffane","ALG","DF,MF","32-011",1992,13.7,31,20,17,11,3,17,34,50,17,14,3,11,16,47,34,0,"https://fbref.com/en/players/c8c02ac7/Mehdi-Zeffane"
2024,"Crystal Palace","Premier League","Naouirou Ahamada","FRA","MF,FW","22-062",2002,3.9,13,9,5,6,2,8,17,47.1,9,3,0,3,2,15,4,0,"https://fbref.com/en/players/a6c58494/Naouirou-Ahamada"
2024,"Crystal Palace","Premier League","Joachim Andersen","DEN","DF","27-365",1996,37.9,56,35,33,21,2,29,39,74.4,10,33,18,15,41,97,207,1,"https://fbref.com/en/players/e34fc66d/Joachim-Andersen"
2024,"Crystal Palace","Premier League","Jordan Ayew","GHA","FW,MF","32-262",1991,28.3,65,36,23,28,14,21,42,50,21,43,2,41,16,81,15,0,"https://fbref.com/en/players/da052c14/Jordan-Ayew"
2024,"Crystal Palace","Premier League","Nathaniel Clyne","ENG","DF","33-055",1991,14.9,24,15,11,11,2,14,21,66.7,7,18,6,12,10,34,33,0,"https://fbref.com/en/players/0442183b/Nathaniel-Clyne"
2024,"Crystal Palace","Premier League","Cheick Doucouré","MLI","MF","24-143",2000,10.2,34,17,15,13,6,18,30,60,12,13,2,11,20,54,12,0,"https://fbref.com/en/players/ce4f40c7/Cheick-Doucoure"
2024,"Crystal Palace","Premier League","Odsonne Édouard","FRA","FW,MF","26-135",1998,17.3,24,12,8,8,8,4,19,21.1,15,17,1,16,6,30,19,0,"https://fbref.com/en/players/0562b7f1/Odsonne-Edouard"
2024,"Crystal Palace","Premier League","Eberechi Eze","ENG","MF,FW","25-336",1998,22.8,35,17,4,18,13,15,31,48.4,16,27,2,25,11,46,6,0,"https://fbref.com/en/players/ae4fc6a4/Eberechi-Eze"
2024,"Crystal Palace","Premier League","Matheus França","BRA","MF,FW","20-059",2004,2.6,3,3,2,1,0,1,7,14.3,6,4,0,4,1,4,1,0,"https://fbref.com/en/players/077faf72/Matheus-Franca"
2024,"Crystal Palace","Premier League","Marc Guéhi","ENG","DF","23-322",2000,22.5,28,19,21,7,0,14,24,58.3,10,22,17,5,18,46,89,1,"https://fbref.com/en/players/d0706b27/Marc-Guehi"
2024,"Crystal Palace","Premier League","Dean Henderson","ENG","GK","27-079",1997,18,1,1,1,0,0,1,2,50,1,0,0,0,0,1,8,2,"https://fbref.com/en/players/e5a76dfe/Dean-Henderson"
2024,"Crystal Palace","Premier League","Will Hughes","ENG","MF","29-043",1995,21,61,33,30,20,11,24,48,50,24,36,14,22,21,82,25,0,"https://fbref.com/en/players/a0666d3e/Will-Hughes"
2024,"Crystal Palace","Premier League","Sam Johnstone","ENG","GK","31-066",1993,20,1,0,1,0,0,1,1,100,0,0,0,0,1,2,5,0,"https://fbref.com/en/players/9e5708be/Sam-Johnstone"
2024,"Crystal Palace","Premier League","Jefferson Lerma","COL","MF,DF","29-218",1994,26.7,42,25,15,23,4,19,40,47.5,21,31,12,19,36,78,72,0,"https://fbref.com/en/players/9b5ce51a/Jefferson-Lerma"
2024,"Crystal Palace","Premier League","Jean-Philippe Mateta","FRA","FW","26-337",1997,25.4,22,15,4,11,7,6,10,60,4,13,4,9,4,26,14,0,"https://fbref.com/en/players/50e6dc35/Jean-Philippe-Mateta"
2024,"Crystal Palace","Premier League","Remi Matthews","ENG","GK","30-110",1994,0,0,0,0,0,0,0,0,NA,0,0,0,0,0,0,1,0,"https://fbref.com/en/players/27f4f772/Remi-Matthews"
2024,"Crystal Palace","Premier League","Tyrick Mitchell","ENG","DF,MF","24-272",1999,35.6,105,60,75,21,9,43,60,71.7,17,63,10,53,26,131,104,0,"https://fbref.com/en/players/5cbd1eb0/Tyrick-Mitchell"
2024,"Crystal Palace","Premier League","Daniel Muñoz","COL","DF,MF","28-004",1996,16,55,35,31,14,10,19,38,50,19,29,7,22,24,79,47,0,"https://fbref.com/en/players/778ef829/Daniel-Munoz"
2024,"Crystal Palace","Premier League","Michael Olise","FRA","FW,MF","22-170",2001,14.2,19,10,7,10,2,8,24,33.3,16,21,0,21,11,30,9,0,"https://fbref.com/en/players/c4486bac/Michael-Olise"
2024,"Crystal Palace","Premier League","David Ozoh","ENG","MF,DF","18-365",2005,1.7,10,6,3,6,1,5,6,83.3,1,2,0,2,0,10,2,0,"https://fbref.com/en/players/d00d45ab/David-Ozoh"
2024,"Crystal Palace","Premier League","Jesurun Rak Sakyi","ENG","MF,FW","21-238",2002,1.5,4,1,3,1,0,2,3,66.7,1,2,0,2,3,7,1,0,"https://fbref.com/en/players/45685411/Jesurun-Rak-Sakyi"
2024,"Crystal Palace","Premier League","Chris Richards","USA","DF,MF","24-063",2000,23.3,46,28,21,22,3,20,30,66.7,10,32,12,20,27,73,109,0,"https://fbref.com/en/players/0a3d6d2b/Chris-Richards"
2024,"Crystal Palace","Premier League","Jaïro Riedewald","NED","MF,FW","27-264",1996,2.6,9,3,2,4,3,3,6,50,3,0,0,0,2,11,2,0,"https://fbref.com/en/players/7a1f2c08/Jairo-Riedewald"
2024,"Crystal Palace","Premier League","Jeffrey Schlupp","GHA","FW,MF","31-159",1992,15,38,24,14,16,8,9,18,50,9,13,2,11,8,46,24,0,"https://fbref.com/en/players/3312f911/Jeffrey-Schlupp"
2024,"Crystal Palace","Premier League","James Tomkins","ENG","DF","35-062",1989,0.1,0,0,0,0,0,0,0,NA,0,0,0,0,1,1,0,0,"https://fbref.com/en/players/e7ca0439/James-Tomkins"
2024,"Crystal Palace","Premier League","Joel Ward","ENG","DF","34-214",1989,22,45,28,26,18,1,30,47,63.8,17,17,10,7,14,59,94,1,"https://fbref.com/en/players/8a7ff278/Joel-Ward"
2024,"Crystal Palace","Premier League","Adam Wharton","ENG","MF","19-363",2004,14.4,48,32,18,22,8,23,46,50,23,17,3,14,20,68,24,1,"https://fbref.com/en/players/4b542852/Adam-Wharton"
2024,"Cádiz","La Liga","Rubén Alcaraz","ESP","MF","33-029",1991,34.8,97,59,39,52,6,50,121,41.3,71,60,14,46,33,130,55,2,"https://fbref.com/en/players/036bba5f/Ruben-Alcaraz"
2024,"Cádiz","La Liga","Iván Alejo","ESP","MF","29-110",1995,18.8,40,23,23,11,6,17,57,29.8,40,20,0,20,7,47,17,0,"https://fbref.com/en/players/3d7e48ce/Ivan-Alejo"
2024,"Cádiz","La Liga","Isaac Carcelen","ESP","DF","31-037",1993,29,50,31,30,15,5,25,45,55.6,20,24,7,17,27,77,87,2,"https://fbref.com/en/players/c4b888df/Isaac-Carcelen"
2024,"Cádiz","La Liga","Víctor Chust","ESP","DF","24-086",2000,20.7,29,18,23,5,1,18,32,56.3,14,27,21,6,11,40,92,1,"https://fbref.com/en/players/ec1a731e/Victor-Chust"
2024,"Cádiz","La Liga","Moussa Diakité","MLI","MF","20-208",2003,0,0,0,0,0,0,0,0,NA,0,0,0,0,0,0,0,0,"https://fbref.com/en/players/d925b04e/Moussa-Diakite"
2024,"Cádiz","La Liga","Gonzalo Escalante","ARG","MF","31-064",1993,18.9,39,24,16,14,9,20,55,36.4,35,23,5,18,26,65,33,2,"https://fbref.com/en/players/3f79a1c8/Gonzalo-Escalante"
2024,"Cádiz","La Liga","Karl Etta","CMR","FW","20-150",2004,0.2,1,1,0,1,0,0,0,NA,0,0,0,0,0,1,0,0,"https://fbref.com/en/players/f0f499ea/Karl-Etta"
2024,"Cádiz","La Liga","Fali","ESP","DF","30-292",1993,28.3,41,26,29,11,1,21,36,58.3,15,38,24,14,27,68,120,0,"https://fbref.com/en/players/72a84002/Fali"
2024,"Cádiz","La Liga","Álex Fernández","ESP","MF","31-228",1992,14.3,19,9,10,9,0,11,22,50,11,17,5,12,15,34,30,0,"https://fbref.com/en/players/aa677a35/Alex-Fernandez"
2024,"Cádiz","La Liga","David Gil","ESP","GK","30-140",1994,4.1,0,0,0,0,0,0,1,0,1,0,0,0,0,0,3,0,"https://fbref.com/en/players/fea23125/David-Gil"
2024,"Cádiz","La Liga","Maxi Gómez","URU","FW","27-290",1996,12.9,6,4,2,3,1,3,5,60,2,8,3,5,3,9,3,0,"https://fbref.com/en/players/4c2e9442/Maxi-Gomez"
2024,"Cádiz","La Liga","Sergi Guardiola","ESP","FW,MF","33-001",1991,5.5,10,7,2,6,2,4,9,44.4,5,10,0,10,0,10,4,0,"https://fbref.com/en/players/32974271/Sergi-Guardiola"
2024,"Cádiz","La Liga","Javi Hernández","ESP","DF","26-028",1998,27.9,43,24,26,12,5,25,46,54.3,21,34,9,25,19,62,72,1,"https://fbref.com/en/players/9a76c2e9/Javi-Hernandez"
2024,"Cádiz","La Liga","Luis Hernández","ESP","DF","35-046",1989,8,7,3,4,3,0,4,8,50,4,3,2,1,8,15,25,0,"https://fbref.com/en/players/02d2c436/Luis-Hernandez"
2024,"Cádiz","La Liga","Juanmi","ESP","FW","31-010",1993,9.7,9,4,2,7,0,2,9,22.2,7,6,0,6,6,15,3,0,"https://fbref.com/en/players/84399660/Juanmi"
2024,"Cádiz","La Liga","Rominigue Kouamé","MLI","MF","27-165",1996,9.1,14,9,6,7,1,7,15,46.7,8,10,2,8,13,27,10,1,"https://fbref.com/en/players/86a2ba20/Rominigue-Kouame"
2024,"Cádiz","La Liga","Jeremías Ledesma","ARG","GK","31-107",1993,33.9,1,1,1,0,0,1,4,25,3,0,0,0,0,1,15,3,"https://fbref.com/en/players/6c4776b1/Jeremias-Ledesma"
2024,"Cádiz","La Liga","Lucas","BRA","DF","23-067",2001,17.1,47,27,32,11,4,32,55,58.2,23,27,4,23,17,64,45,0,"https://fbref.com/en/players/5d68f5b2/Lucas"
2024,"Cádiz","La Liga","Darwin Machís","VEN","MF","31-113",1993,8.7,23,14,7,9,7,13,24,54.2,11,8,1,7,4,27,2,0,"https://fbref.com/en/players/ed6ea4d9/Darwin-Machis"
2024,"Cádiz","La Liga","José Mari","ESP","MF,FW","36-176",1987,0.2,2,1,0,2,0,1,2,50,1,0,0,0,0,2,0,0,"https://fbref.com/en/players/6f4c734d/Jose-Mari"
2024,"Cádiz","La Liga","Roger Martí","ESP","FW","33-148",1991,15.1,12,6,1,9,2,2,7,28.6,5,16,1,15,7,19,4,0,"https://fbref.com/en/players/0ae4e09a/Roger-Marti"
2024,"Cádiz","La Liga","Mamadou Mbaye","SEN","DF","25-337",1998,3.2,6,3,3,3,0,2,5,40,3,10,7,3,5,11,26,0,"https://fbref.com/en/players/8aae94b9/Mamadou-Mbaye"
2024,"Cádiz","La Liga","Jorge Meré","ESP","DF","27-043",1997,7.5,8,7,6,2,0,4,7,57.1,3,5,3,2,8,16,33,0,"https://fbref.com/en/players/9f979eb2/Jorge-Mere"
2024,"Cádiz","La Liga","Roberto Navarro","ESP","MF,FW","22-048",2002,21,46,29,20,21,5,22,43,51.2,21,33,0,33,19,65,7,1,"https://fbref.com/en/players/c997b942/Roberto-Navarro"
2024,"Cádiz","La Liga","Álvaro Negredo","ESP","FW,MF","38-284",1985,0.6,0,0,0,0,0,0,0,NA,0,1,0,1,1,1,0,0,"https://fbref.com/en/players/63b0ca6b/Alvaro-Negredo"
2024,"Cádiz","La Liga","Brian Ocampo","URU","MF,FW","24-340",1999,2.8,4,3,1,3,0,2,5,40,3,4,0,4,3,7,0,0,"https://fbref.com/en/players/2e3995cd/Brian-Ocampo"
2024,"Cádiz","La Liga","Milutin Osmajić","MNE","MF","24-310",1999,0.1,0,0,0,0,0,0,0,NA,0,0,0,0,0,0,0,0,"https://fbref.com/en/players/375ed9d7/Milutin-Osmajic"
2024,"Cádiz","La Liga","Aiham Ousou","SYR","DF","24-142",2000,4.8,8,5,6,2,0,5,5,100,0,1,0,1,7,15,15,0,"https://fbref.com/en/players/2973a975/Aiham-Ousou"
2024,"Cádiz","La Liga","Chris Ramos","ESP","FW,MF","27-133",1997,29,28,15,9,15,4,8,27,29.6,19,23,7,16,9,37,44,0,"https://fbref.com/en/players/44e07fac/Chris-Ramos"
2024,"Cádiz","La Liga","Diadie Samassékou","MLI","MF","28-140",1996,1,5,3,2,2,1,5,6,83.3,1,0,0,0,3,8,1,0,"https://fbref.com/en/players/08593525/Diadie-Samassekou"
2024,"Cádiz","La Liga","Fede San Emeterio","ESP","MF","27-075",1997,1.7,3,2,2,1,0,1,4,25,3,3,2,1,2,5,1,0,"https://fbref.com/en/players/efecd633/Fede-San-Emeterio"
2024,"Cádiz","La Liga","Rubén Sobrino","ESP","MF,FW","31-364",1992,18.3,52,28,18,26,8,22,51,43.1,29,26,2,24,16,68,18,0,"https://fbref.com/en/players/19b776e9/Ruben-Sobrino"
2024,"Cádiz","La Liga","Borja Vázquez","ESP","FW","19-133",2005,0,1,0,1,0,0,1,1,100,0,0,0,0,0,1,1,0,"https://fbref.com/en/players/8c6d0e32/Borja-Vazquez"
2024,"Cádiz","La Liga","Joseba Zaldúa","ESP","DF","31-341",1992,7.8,20,12,17,2,1,13,21,61.9,8,6,4,2,2,22,20,0,"https://fbref.com/en/players/5ca20b7a/Joseba-Zaldua"
2024,"Darmstadt 98","Bundesliga","Asaf Arania","ISR","MF","18-224",2005,0.1,0,0,0,0,0,0,0,NA,0,0,0,0,0,0,0,0,"https://fbref.com/en/players/d61c07fd/Asaf-Arania"
2024,"Darmstadt 98","Bundesliga","Matthias Bader","GER","DF,MF","26-348",1997,20,51,25,32,11,8,33,65,50.8,32,22,4,18,25,76,20,0,"https://fbref.com/en/players/3489184e/Matthias-Bader"
2024,"Darmstadt 98","Bundesliga","Alexander Brunst","GER","GK","28-328",1995,3,0,0,0,0,0,0,2,0,2,0,0,0,0,0,2,1,"https://fbref.com/en/players/99219195/Alexander-Brunst"
2024,"Darmstadt 98","Bundesliga","Bartol Franjić","CRO","MF","24-137",2000,13.7,15,12,4,10,1,7,28,25,21,12,4,8,30,45,29,2,"https://fbref.com/en/players/697dc00a/Bartol-Franjic"
2024,"Darmstadt 98","Bundesliga","Klaus Gjasula","ALB","DF,MF","34-168",1989,15.1,44,22,18,25,1,17,30,56.7,13,26,14,12,19,63,42,2,"https://fbref.com/en/players/431c837b/Klaus-Gjasula"
2024,"Darmstadt 98","Bundesliga","Fabian Holland","GER","MF,DF","33-324",1990,20.4,47,26,18,21,8,20,37,54.1,17,22,12,10,24,71,29,0,"https://fbref.com/en/players/017018d1/Fabian-Holland"
2024,"Darmstadt 98","Bundesliga","Gerrit Holtmann","PHI","MF,FW","29-066",1995,4.4,8,5,3,4,1,7,10,70,3,7,0,7,2,10,4,1,"https://fbref.com/en/players/2979c05a/Gerrit-Holtmann"
2024,"Darmstadt 98","Bundesliga","Mathias Honsak","AUT","FW,MF","27-162",1996,11.3,14,7,7,6,1,6,20,30,14,14,2,12,8,22,25,0,"https://fbref.com/en/players/3dbdbb6a/Mathias-Honsak"
2024,"Darmstadt 98","Bundesliga","Fraser Hornby","SCO","FW,MF","24-260",1999,2.4,0,0,0,0,0,0,1,0,1,2,1,1,0,0,4,0,"https://fbref.com/en/players/29aee77c/Fraser-Hornby"
2024,"Darmstadt 98","Bundesliga","Thomas Isherwood","SWE","DF","26-123",1998,7.1,11,5,7,3,1,5,9,55.6,4,10,7,3,10,21,34,0,"https://fbref.com/en/players/2be28a0c/Thomas-Isherwood"
2024,"Darmstadt 98","Bundesliga","Julian Justvan","GER","MF,FW","26-058",1998,11.4,10,4,2,7,1,3,17,17.6,14,12,2,10,11,21,6,1,"https://fbref.com/en/players/ab1a72b4/Julian-Justvan"
2024,"Darmstadt 98","Bundesliga","Emir Karic","AUT","DF","26-356",1997,19.8,45,27,23,14,8,21,33,63.6,12,42,11,31,13,58,43,0,"https://fbref.com/en/players/7bbb0ac4/Emir-Karic"
2024,"Darmstadt 98","Bundesliga","Tobias Kempe","GER","MF","34-338",1989,15,20,13,9,8,3,8,24,33.3,16,16,4,12,9,29,12,0,"https://fbref.com/en/players/d7cdfd81/Tobias-Kempe"
2024,"Darmstadt 98","Bundesliga","Christoph Klarer","AUT","DF","23-351",2000,26.2,37,22,30,4,3,24,36,66.7,12,31,20,11,21,58,94,1,"https://fbref.com/en/players/144e8717/Christoph-Klarer"
2024,"Darmstadt 98","Bundesliga","Matej Maglica","CRO","DF","25-248",1998,18.9,35,21,25,10,0,22,36,61.1,14,29,11,18,22,57,92,5,"https://fbref.com/en/players/36cf2caf/Matej-Maglica"
2024,"Darmstadt 98","Bundesliga","Braydon Manu","GHA","MF","27-063",1997,1.9,2,0,0,1,1,0,0,NA,0,1,0,1,0,2,0,0,"https://fbref.com/en/players/e9a97974/Braydon-Manu"
2024,"Darmstadt 98","Bundesliga","Marvin Mehlem","GER","MF","26-262",1997,16.5,28,21,10,14,4,11,27,40.7,16,21,2,19,33,61,15,0,"https://fbref.com/en/players/10876d02/Marvin-Mehlem"
2024,"Darmstadt 98","Bundesliga","Andreas Müller","GER","MF","23-315",2000,3.9,14,9,8,5,1,4,9,44.4,5,5,2,3,4,18,5,0,"https://fbref.com/en/players/2244908c/Andreas-Muller"
2024,"Darmstadt 98","Bundesliga","Jannik Müller","GER","DF,MF","30-133",1994,12.6,33,16,21,9,3,16,27,59.3,11,24,12,12,17,50,39,1,"https://fbref.com/en/players/796a5f30/Jannik-Muller"
2024,"Darmstadt 98","Bundesliga","Fabian Nürnberger","GER","DF,MF","24-307",1999,16.8,29,22,22,6,1,22,41,53.7,19,11,1,10,17,46,26,0,"https://fbref.com/en/players/178018f9/Fabian-Nurnberger"
2024,"Darmstadt 98","Bundesliga","Luca Pfeiffer","GER","FW,MF","27-284",1996,18,11,6,2,6,3,5,11,45.5,6,5,1,4,2,13,21,0,"https://fbref.com/en/players/83e1f40e/Luca-Pfeiffer"
2024,"Darmstadt 98","Bundesliga","Sebastian Polter","GER","FW","33-059",1991,5,1,0,1,0,0,0,1,0,1,5,1,4,0,1,4,0,"https://fbref.com/en/players/3745e8bd/Sebastian-Polter"
2024,"Darmstadt 98","Bundesliga","Clemens Riedel","GER","DF","20-316",2003,8.4,22,13,16,5,1,15,24,62.5,9,11,3,8,11,33,26,0,"https://fbref.com/en/players/77cfae67/Clemens-Riedel"
2024,"Darmstadt 98","Bundesliga","Frank Ronstadt","GER","DF,MF","26-314",1997,0.8,1,0,0,1,0,0,1,0,1,1,0,1,1,2,3,0,"https://fbref.com/en/players/51d29173/Frank-Ronstadt"
2024,"Darmstadt 98","Bundesliga","Fabian Schnellhardt","GER","MF","30-139",1994,2.6,4,1,2,1,1,1,3,33.3,2,1,0,1,4,8,5,0,"https://fbref.com/en/players/8575037f/Fabian-Schnellhardt"
2024,"Darmstadt 98","Bundesliga","Marcel Schuhen","GER","GK","31-138",1993,31,1,0,1,0,0,1,3,33.3,2,0,0,0,2,3,11,4,"https://fbref.com/en/players/5fa2e0cf/Marcel-Schuhen"
2024,"Darmstadt 98","Bundesliga","Aaron Seydel","GER","FW","28-113",1996,6.9,3,2,0,2,1,0,3,0,3,8,2,6,1,4,9,0,"https://fbref.com/en/players/85b6462d/Aaron-Seydel"
2024,"Darmstadt 98","Bundesliga","Tim Skarke","GER","FW,DF","27-266",1996,26.7,26,16,12,10,4,10,28,35.7,18,25,2,23,6,32,20,0,"https://fbref.com/en/players/65857fdf/Tim-Skarke"
2024,"Darmstadt 98","Bundesliga","Filip Stojilković","SUI","FW,MF","24-147",2000,1.7,1,1,0,0,1,0,0,NA,0,0,0,0,0,1,1,0,"https://fbref.com/en/players/0cbe584d/Filip-Stojilkovic"
2024,"Darmstadt 98","Bundesliga","Fabio Torsiello","ITA","FW,DF","19-118",2005,1.7,1,0,1,0,0,1,8,12.5,7,1,0,1,1,2,1,0,"https://fbref.com/en/players/9b5d89b3/Fabio-Torsiello"
2024,"Darmstadt 98","Bundesliga","Oscar Vilhelmsson","SWE","FW,MF","20-241",2003,15.3,13,6,3,7,3,7,10,70,3,15,5,10,3,16,19,0,"https://fbref.com/en/players/e7f4869a/Oscar-Vilhelmsson"
2024,"Darmstadt 98","Bundesliga","Christoph Zimmermann","GER","DF","31-139",1993,13.6,33,21,26,7,0,19,39,48.7,20,21,14,7,21,54,66,1,"https://fbref.com/en/players/2d5f03bf/Christoph-Zimmermann"
2024,"Dortmund","Bundesliga","Karim Adeyemi","GER","FW,MF","22-133",2002,10.1,16,14,9,4,3,8,20,40,12,11,0,11,3,19,5,0,"https://fbref.com/en/players/501055d8/Karim-Adeyemi"
2024,"Dortmund","Bundesliga","Samuel Bamba","GER","FW","20-107",2004,0.5,1,1,1,0,0,1,2,50,1,0,0,0,0,1,1,0,"https://fbref.com/en/players/489d4867/Samuel-Bamba"
2024,"Dortmund","Bundesliga","Ramy Bensebaini","ALG","DF","29-044",1995,11.5,34,21,21,11,2,24,34,70.6,10,22,7,15,16,50,37,0,"https://fbref.com/en/players/378825c7/Ramy-Bensebaini"
2024,"Dortmund","Bundesliga","Hendry Blank","GER","DF","19-283",2004,0.5,1,0,1,0,0,1,1,100,0,1,0,1,0,1,4,0,"https://fbref.com/en/players/76abb354/Hendry-Blank"
2024,"Dortmund","Bundesliga","Julian Brandt","GER","MF,FW","28-028",1996,24.7,17,14,8,8,1,10,27,37,17,20,3,17,8,25,18,0,"https://fbref.com/en/players/a167537f/Julian-Brandt"
2024,"Dortmund","Bundesliga","Jamie Bynoe-Gittens","ENG","FW,MF","19-296",2004,11.8,14,7,6,7,1,2,17,11.8,15,11,2,9,4,18,7,0,"https://fbref.com/en/players/10745192/Jamie-Bynoe-Gittens"
2024,"Dortmund","Bundesliga","Emre Can","GER","MF,DF","30-139",1994,21.7,63,45,37,23,3,28,48,58.3,20,30,7,23,22,85,41,2,"https://fbref.com/en/players/a65ce836/Emre-Can"
2024,"Dortmund","Bundesliga","Julien Duranville","BEL","FW,MF","18-025",2006,0.1,1,0,0,1,0,1,1,100,0,0,0,0,0,1,0,0,"https://fbref.com/en/players/b06a7ae9/Julien-Duranville"
2024,"Dortmund","Bundesliga","Niclas Füllkrug","GER","FW","31-111",1993,24.6,7,2,1,6,0,2,8,25,6,17,4,13,2,9,25,0,"https://fbref.com/en/players/4f16405e/Niclas-Fullkrug"
2024,"Dortmund","Bundesliga","Sébastien Haller","CIV","FW","29-343",1994,4.4,1,0,0,1,0,1,1,100,0,4,1,3,0,1,7,0,"https://fbref.com/en/players/ba115a40/Sebastien-Haller"
2024,"Dortmund","Bundesliga","Thorgan Hazard","BEL","DF","31-062",1993,0.1,0,0,0,0,0,0,0,NA,0,0,0,0,0,0,0,0,"https://fbref.com/en/players/50871bcc/Thorgan-Hazard"
2024,"Dortmund","Bundesliga","Mats Hummels","GER","DF","35-166",1988,17.6,52,34,34,12,6,30,53,56.6,23,33,11,22,33,85,82,0,"https://fbref.com/en/players/05d548d8/Mats-Hummels"
2024,"Dortmund","Bundesliga","Gregor Kobel","SUI","GK","26-176",1997,26.3,0,0,0,0,0,0,1,0,1,0,0,0,0,0,11,0,"https://fbref.com/en/players/cd59b9df/Gregor-Kobel"
2024,"Dortmund","Bundesliga","Ian Maatsen","NED","DF","22-081",2002,14,30,22,15,9,6,16,30,53.3,14,22,4,18,13,43,26,0,"https://fbref.com/en/players/cab9634e/Ian-Maatsen"
2024,"Dortmund","Bundesliga","Donyell Malen","NED","FW,MF","25-142",1999,19.8,11,7,5,3,3,2,6,33.3,4,11,4,7,2,13,8,0,"https://fbref.com/en/players/116c35df/Donyell-Malen"
2024,"Dortmund","Bundesliga","Thomas Meunier","BEL","DF","32-261",1991,6.5,5,1,3,2,0,3,13,23.1,10,8,2,6,4,9,22,0,"https://fbref.com/en/players/e162b013/Thomas-Meunier"
2024,"Dortmund","Bundesliga","Alexander Meyer","GER","GK","33-047",1991,7.7,1,1,1,0,0,1,1,100,0,0,0,0,0,1,2,1,"https://fbref.com/en/players/b56dd813/Alexander-Meyer"
2024,"Dortmund","Bundesliga","Mateu Morey","ESP","DF","24-089",2000,1.2,2,2,1,1,0,2,4,50,2,3,1,2,1,3,3,0,"https://fbref.com/en/players/5fd5e542/Mateu-Morey"
2024,"Dortmund","Bundesliga","Youssoufa Moukoko","GER","FW","19-192",2004,6.9,4,1,2,2,0,3,7,42.9,4,4,1,3,2,6,4,0,"https://fbref.com/en/players/6ce43701/Youssoufa-Moukoko"
2024,"Dortmund","Bundesliga","Felix Nmecha","GER","MF","23-233",2000,11.3,19,13,7,8,4,11,22,50,11,18,5,13,11,30,19,0,"https://fbref.com/en/players/091c86e2/Felix-Nmecha"
2024,"Dortmund","Bundesliga","Salih Özcan","TUR","MF","26-140",1998,13.2,20,12,11,8,1,10,18,55.6,8,28,3,25,17,37,18,1,"https://fbref.com/en/players/15413fa5/Salih-Ozcan"
2024,"Dortmund","Bundesliga","Antonios Papadopoulos","GER","DF","24-263",1999,1.3,6,3,6,0,0,6,7,85.7,1,3,2,1,2,8,7,0,"https://fbref.com/en/players/13d23b29/Antonios-Papadopoulos"
2024,"Dortmund","Bundesliga","Ole Pohlmann","GER","MF","23-055",2001,0.6,1,0,0,1,0,1,2,50,1,0,0,0,0,1,1,0,"https://fbref.com/en/players/822b83e8/Ole-Pohlmann"
2024,"Dortmund","Bundesliga","Marco Reus","GER","MF,FW","34-365",1989,17.8,37,25,20,14,3,12,27,44.4,15,17,2,15,5,42,18,0,"https://fbref.com/en/players/36a3ff67/Marco-Reus"
2024,"Dortmund","Bundesliga","Gio Reyna","USA","MF,FW","21-199",2002,3.1,9,6,3,4,2,2,5,40,3,5,1,4,2,11,5,0,"https://fbref.com/en/players/7fa4e703/Gio-Reyna"
2024,"Dortmund","Bundesliga","Julian Ryerson","NOR","DF","26-195",1997,19.6,41,23,26,11,4,27,47,57.4,20,31,7,24,10,51,35,3,"https://fbref.com/en/players/009a4f60/Julian-Ryerson"
2024,"Dortmund","Bundesliga","Marcel Sabitzer","AUT","MF","30-074",1994,21.8,39,24,18,20,1,23,42,54.8,19,31,12,19,12,51,34,0,"https://fbref.com/en/players/e280527c/Marcel-Sabitzer"
2024,"Dortmund","Bundesliga","Jadon Sancho","ENG","FW,MF","24-066",2000,10.5,5,4,1,3,1,0,4,0,4,11,0,11,4,9,6,0,"https://fbref.com/en/players/dbf053da/Jadon-Sancho"
2024,"Dortmund","Bundesliga","Nico Schlotterbeck","GER","DF","24-181",1999,31.8,70,50,36,27,7,41,65,63.1,24,52,25,27,45,115,101,3,"https://fbref.com/en/players/34e12499/Nico-Schlotterbeck"
2024,"Dortmund","Bundesliga","Niklas Süle","GER","DF","28-270",1995,16.8,18,10,14,3,1,11,16,68.8,5,25,14,11,25,43,58,2,"https://fbref.com/en/players/e33c06cf/Niklas-Sule"
2024,"Dortmund","Bundesliga","Kjell-Arik Wätjen","GER","MF,FW","18-104",2006,1.2,3,2,2,1,0,2,5,40,3,1,1,0,0,3,3,0,"https://fbref.com/en/players/0e006cae/Kjell-Arik-Watjen"
2024,"Dortmund","Bundesliga","Marius Wolf","GER","DF","29-003",1995,13,20,12,8,11,1,11,23,47.8,12,12,2,10,8,28,20,0,"https://fbref.com/en/players/fa661778/Marius-Wolf"
2024,"Eint Frankfurt","Bundesliga","Paxten Aaronson","USA","MF","20-278",2003,1.1,2,2,1,1,0,1,1,100,0,2,0,2,0,2,0,0,"https://fbref.com/en/players/4cd41883/Paxten-Aaronson"
2024,"Eint Frankfurt","Bundesliga","Elias Baum","GER","DF,MF","18-217",2005,0.3,1,0,0,0,1,0,0,NA,0,3,2,1,0,1,1,0,"https://fbref.com/en/players/54d2b378/Elias-Baum"
2024,"Eint Frankfurt","Bundesliga","Donny van de Beek","NED","MF,FW","27-042",1997,4,8,3,3,3,2,3,7,42.9,4,5,1,4,3,11,1,0,"https://fbref.com/en/players/50dc94ce/Donny-van-de-Beek"
2024,"Eint Frankfurt","Bundesliga","Aurélio Buta","POR","DF,MF","27-110",1997,19.4,40,25,19,16,5,21,38,55.3,17,24,5,19,15,55,36,0,"https://fbref.com/en/players/b4705807/Aurelio-Buta"
2024,"Eint Frankfurt","Bundesliga","Fares Chaïbi","ALG","MF,FW","21-184",2002,21.2,27,17,7,12,8,8,18,44.4,10,37,1,36,5,32,19,0,"https://fbref.com/en/players/357103bd/Fares-Chaibi"
2024,"Eint Frankfurt","Bundesliga","Timothy Chandler","USA","MF,DF","34-062",1990,0.2,0,0,0,0,0,0,0,NA,0,0,0,0,0,0,0,0,"https://fbref.com/en/players/b3b7f5a6/Timothy-Chandler"
2024,"Eint Frankfurt","Bundesliga","Nnamdi Collins","GER","DF","20-141",2004,1,0,0,0,0,0,0,0,NA,0,0,0,0,2,2,4,0,"https://fbref.com/en/players/8eb5c94c/Nnamdi-Collins"
2024,"Eint Frankfurt","Bundesliga","Junior Dina Ebimbe","FRA","MF,DF","23-191",2000,21.7,44,29,15,17,12,18,41,43.9,23,28,7,21,9,53,39,1,"https://fbref.com/en/players/95bb6ddc/Junior-Dina-Ebimbe"
2024,"Eint Frankfurt","Bundesliga","Hugo Ekitike","FRA","FW","21-345",2002,8,11,7,3,6,2,4,6,66.7,2,10,0,10,2,13,4,0,"https://fbref.com/en/players/5b92d896/Hugo-Ekitike"
2024,"Eint Frankfurt","Bundesliga","Nacho Ferri","ESP","FW,MF","19-238",2004,0.8,3,3,1,2,0,2,3,66.7,1,0,0,0,0,3,2,0,"https://fbref.com/en/players/58468842/Nacho-Ferri"
2024,"Eint Frankfurt","Bundesliga","Mario Götze","GER","MF","31-362",1992,23,51,34,18,25,8,28,62,45.2,34,19,3,16,14,65,10,0,"https://fbref.com/en/players/9efa1d25/Mario-Gotze"
2024,"Eint Frankfurt","Bundesliga","Jens Grahl","GER","GK","35-251",1988,2,0,0,0,0,0,0,0,NA,0,0,0,0,0,0,3,0,"https://fbref.com/en/players/f26dee6b/Jens-Grahl"
2024,"Eint Frankfurt","Bundesliga","Makoto Hasebe","JPN","DF,MF","40-133",1984,2.4,4,2,2,2,0,3,6,50,3,2,1,1,2,6,5,0,"https://fbref.com/en/players/9ab16552/Makoto-Hasebe"
2024,"Eint Frankfurt","Bundesliga","Kristijan Jakić","CRO","MF,FW","27-016",1997,2.2,3,3,1,2,0,1,3,33.3,2,1,0,1,2,5,2,0,"https://fbref.com/en/players/a8ee54ad/Kristijan-Jakic"
2024,"Eint Frankfurt","Bundesliga","Sasa Kalajdzic","AUT","FW","26-328",1997,3.6,2,2,0,2,0,0,0,NA,0,2,2,0,2,4,6,0,"https://fbref.com/en/players/15f24fe7/Sasa-Kalajdzic"
2024,"Eint Frankfurt","Bundesliga","Ansgar Knauff","GER","MF,DF","22-141",2002,23.4,43,26,17,16,10,17,31,54.8,14,40,3,37,20,63,15,0,"https://fbref.com/en/players/19a967ab/Ansgar-Knauff"
2024,"Eint Frankfurt","Bundesliga","Robin Koch","GER","DF","27-318",1996,30.4,38,23,26,12,0,17,27,63,10,33,24,9,32,70,136,2,"https://fbref.com/en/players/ea6bc03a/Robin-Koch"
2024,"Eint Frankfurt","Bundesliga","Randal Kolo Muani","FRA","FW","25-177",1998,1.7,0,0,0,0,0,0,0,NA,0,0,0,0,0,0,1,0,"https://fbref.com/en/players/c0b3669f/Randal-Kolo-Muani"
2024,"Eint Frankfurt","Bundesliga","Hugo Larsson","SWE","MF","19-338",2004,21,32,18,18,10,4,15,28,53.6,13,34,7,27,29,61,30,1,"https://fbref.com/en/players/00c9a283/Hugo-Larsson"
2024,"Eint Frankfurt","Bundesliga","Christopher Lenz","GER","DF","29-251",1994,0.1,1,1,0,1,0,1,1,100,0,0,0,0,0,1,1,0,"https://fbref.com/en/players/bbd86530/Christopher-Lenz"
2024,"Eint Frankfurt","Bundesliga","Jesper Lindstrøm","DEN","FW","24-091",2000,0.9,1,1,1,0,0,0,0,NA,0,0,0,0,0,1,0,0,"https://fbref.com/en/players/37dc1a48/Jesper-Lindstrom"
2024,"Eint Frankfurt","Bundesliga","Omar Marmoush","EGY","FW,MF","25-113",1999,25.6,21,11,7,8,6,6,16,37.5,10,13,0,13,11,32,7,0,"https://fbref.com/en/players/0e0102eb/Omar-Marmoush"
2024,"Eint Frankfurt","Bundesliga","Jean Mattéo Bahoya","FRA","MF,FW","19-023",2005,2,3,1,0,3,0,1,4,25,3,2,0,2,1,4,1,0,"https://fbref.com/en/players/70d4c949/Jean-Matteo-Bahoya"
2024,"Eint Frankfurt","Bundesliga","Philipp Max","GER","DF","30-243",1993,15,26,17,6,18,2,19,26,73.1,7,18,1,17,7,33,18,2,"https://fbref.com/en/players/826e8b63/Philipp-Max"
2024,"Eint Frankfurt","Bundesliga","Marko Mladenović","SRB","MF","19-121",2005,0.1,0,0,0,0,0,0,0,NA,0,0,0,0,0,0,0,0,"https://fbref.com/en/players/6510ee8d/Marko-Mladenovic"
2024,"Eint Frankfurt","Bundesliga","Jessic Ngankam","GER","FW","23-315",2000,3.1,3,2,1,1,1,0,0,NA,0,0,0,0,0,3,1,0,"https://fbref.com/en/players/bc249af8/Jessic-Ngankam"
2024,"Eint Frankfurt","Bundesliga","Niels Nkounkou","FRA","DF,MF","23-211",2000,14.5,54,30,34,17,3,29,64,45.3,35,30,2,28,16,70,30,0,"https://fbref.com/en/players/f5b281e7/Niels-Nkounkou"
2024,"Eint Frankfurt","Bundesliga","Willian Pacho","ECU","DF","22-227",2001,33,62,37,38,23,1,31,53,58.5,22,51,22,29,47,109,152,2,"https://fbref.com/en/players/ecbe2839/Willian-Pacho"
2024,"Eint Frankfurt","Bundesliga","Jens Petter Hauge","NOR","MF,FW","24-231",1999,1.6,2,1,1,0,1,2,7,28.6,5,5,1,4,0,2,1,0,"https://fbref.com/en/players/12c35abe/Jens-Petter-Hauge"
2024,"Eint Frankfurt","Bundesliga","Sebastian Rode","GER","MF","33-232",1990,0.7,6,4,0,5,1,4,6,66.7,2,0,0,0,1,7,1,0,"https://fbref.com/en/players/e12b0b5b/Sebastian-Rode"
2024,"Eint Frankfurt","Bundesliga","Ellyes Skhiri","TUN","MF","29-020",1995,24.1,44,24,18,19,7,19,36,52.8,17,33,4,29,39,83,47,2,"https://fbref.com/en/players/c2211709/Ellyes-Skhiri"
2024,"Eint Frankfurt","Bundesliga","Hrvoje Smolčić","CRO","DF","23-287",2000,3.9,7,3,7,0,0,4,5,80,1,3,1,2,6,13,23,1,"https://fbref.com/en/players/c967f6b8/Hrvoje-Smolcic"
2024,"Eint Frankfurt","Bundesliga","Kevin Trapp","GER","GK","33-327",1990,32,0,0,0,0,0,0,0,NA,0,0,0,0,1,1,9,1,"https://fbref.com/en/players/ce17b5eb/Kevin-Trapp"
2024,"Eint Frankfurt","Bundesliga","Tuta","BRA","DF","24-331",1999,28.9,63,33,38,19,6,39,59,66.1,20,29,12,17,36,99,99,0,"https://fbref.com/en/players/35d64857/Tuta"
2024,"Empoli","Serie A","Tommaso Baldanzi","ITA","MF,FW","21-068",2003,8.3,4,2,1,1,2,3,10,30,7,7,0,7,2,6,0,0,"https://fbref.com/en/players/102e2599/Tommaso-Baldanzi"
2024,"Empoli","Serie A","Simone Bastoni","ITA","MF,DF","27-207",1996,8.3,22,13,12,7,3,11,22,50,11,8,0,8,11,33,18,0,"https://fbref.com/en/players/1ac232b8/Simone-Bastoni"
2024,"Empoli","Serie A","Bartosz Bereszyński","POL","DF","31-323",1992,19.6,41,25,25,13,3,24,40,60,16,22,10,12,21,62,52,0,"https://fbref.com/en/players/61b3978f/Bartosz-Bereszynski"
2024,"Empoli","Serie A","Etrit Berisha","ALB","GK","35-081",1989,14,0,0,0,0,0,0,1,0,1,0,0,0,0,0,7,1,"https://fbref.com/en/players/ee833569/Etrit-Berisha"
2024,"Empoli","Serie A","Liberato Cacace","NZL","DF","23-246",2000,21.2,40,24,24,13,3,24,38,63.2,14,23,6,17,19,59,56,0,"https://fbref.com/en/players/dd86e8e4/Liberato-Cacace"
2024,"Empoli","Serie A","Nicolò Cambiaghi","ITA","FW,MF","23-154",2000,28.4,51,39,15,20,16,16,35,45.7,19,26,1,25,14,65,8,0,"https://fbref.com/en/players/91ff775f/Nicolo-Cambiaghi"
2024,"Empoli","Serie A","Matteo Cancellieri","ITA","FW,MF","22-108",2002,19.9,35,22,12,16,7,13,36,36.1,23,19,0,19,6,41,18,0,"https://fbref.com/en/players/b6a1cdf9/Matteo-Cancellieri"
2024,"Empoli","Serie A","Elia Caprile","ITA","GK","22-279",2001,23,1,0,1,0,0,1,1,100,0,0,0,0,0,1,16,2,"https://fbref.com/en/players/97d7afbd/Elia-Caprile"
2024,"Empoli","Serie A","Francesco Caputo","ITA","FW","36-298",1987,14.1,2,0,0,0,2,0,1,0,1,4,0,4,1,3,3,0,"https://fbref.com/en/players/5bd72174/Francesco-Caputo"
2024,"Empoli","Serie A","Alberto Cerri","ITA","FW","28-044",1996,6.1,3,3,1,1,1,2,5,40,3,3,1,2,3,6,7,0,"https://fbref.com/en/players/1079c685/Alberto-Cerri"
2024,"Empoli","Serie A","Giacomo Corona","ITA","FW","20-096",2004,0.1,0,0,0,0,0,0,0,NA,0,0,0,0,0,0,0,0,"https://fbref.com/en/players/d9f83409/Giacomo-Corona"
2024,"Empoli","Serie A","Mattia Destro","ITA","FW,MF","33-071",1991,4.1,2,1,0,2,0,1,1,100,0,4,0,4,2,4,3,0,"https://fbref.com/en/players/d7d32194/Mattia-Destro"
2024,"Empoli","Serie A","Tyronne Ebuehi","NGA","DF","28-166",1995,12.2,14,9,9,5,0,7,11,63.6,4,9,4,5,6,20,27,1,"https://fbref.com/en/players/6af30900/Tyronne-Ebuehi"
2024,"Empoli","Serie A","Emmanuel Ekong","SWE","FW","21-340",2002,0.1,0,0,0,0,0,0,0,NA,0,0,0,0,0,0,0,0,"https://fbref.com/en/players/c20892ee/Emmanuel-Ekong"
2024,"Empoli","Serie A","Jacopo Fazzini","ITA","MF","21-075",2003,13.7,49,25,27,13,9,30,53,56.6,23,21,3,18,12,61,18,0,"https://fbref.com/en/players/06b08c45/Jacopo-Fazzini"
2024,"Empoli","Serie A","Alberto Grassi","ITA","MF","29-084",1995,20.1,30,18,13,13,4,10,26,38.5,16,26,11,15,41,71,37,0,"https://fbref.com/en/players/6cc97b6a/Alberto-Grassi"
2024,"Empoli","Serie A","Emmanuel Gyasi","GHA","DF,FW","30-140",1994,20.9,34,17,18,13,3,15,32,46.9,17,30,12,18,5,39,27,1,"https://fbref.com/en/players/f9758dae/Emmanuel-Gyasi"
2024,"Empoli","Serie A","Nicolas Haas","SUI","MF","28-128",1996,1,5,3,1,2,2,3,3,100,0,1,0,1,1,6,1,0,"https://fbref.com/en/players/fa449bba/Nicolas-Haas"
2024,"Empoli","Serie A","Liam Henderson","SCO","MF","28-035",1996,0.1,0,0,0,0,0,0,0,NA,0,0,0,0,0,0,0,0,"https://fbref.com/en/players/d7918b13/Liam-Henderson"
2024,"Empoli","Serie A","Ardian Ismajli","ALB","DF","27-243",1996,22.7,26,16,18,6,2,18,23,78.3,5,28,17,11,23,49,126,1,"https://fbref.com/en/players/6b635f5c/Ardian-Ismajli"
2024,"Empoli","Serie A","Viktor Kovalenko","UKR","MF","28-106",1996,6.8,5,2,2,2,1,2,8,25,6,12,2,10,1,6,7,0,"https://fbref.com/en/players/9d60028d/Viktor-Kovalenko"
2024,"Empoli","Serie A","Sebastiano Luperto","ITA","DF","27-267",1996,37.8,37,26,25,10,2,15,24,62.5,9,46,35,11,32,69,157,1,"https://fbref.com/en/players/997fff07/Sebastiano-Luperto"
2024,"Empoli","Serie A","Daniel Maldini","ITA","FW,MF","22-232",2001,2.9,4,2,0,2,2,2,2,100,0,5,0,5,2,6,2,0,"https://fbref.com/en/players/801831fe/Daniel-Maldini"
2024,"Empoli","Serie A","Youssef Maleh","MAR","MF","25-282",1998,28.9,74,48,30,36,8,23,52,44.2,29,62,7,55,25,99,29,0,"https://fbref.com/en/players/4c8845f7/Youssef-Maleh"
2024,"Empoli","Serie A","Răzvan Marin","ROU","MF","28-007",1996,20.2,40,22,13,23,4,19,29,65.5,10,16,4,12,6,46,30,2,"https://fbref.com/en/players/7fac99d4/Razvan-Marin"
2024,"Empoli","Serie A","M'Baye Niang","SEN","FW","29-163",1994,7.9,3,1,0,1,2,0,6,0,6,7,1,6,3,6,10,0,"https://fbref.com/en/players/2054d037/MBaye-Niang"
2024,"Empoli","Serie A","Samuele Perisan","ITA","GK","26-283",1997,1,0,0,0,0,0,0,0,NA,0,0,0,0,0,0,0,0,"https://fbref.com/en/players/00a17eba/Samuele-Perisan"
2024,"Empoli","Serie A","Giuseppe Pezzella","ITA","DF","26-183",1997,12.1,25,14,19,5,1,20,28,71.4,8,17,6,11,2,27,35,0,"https://fbref.com/en/players/149c5f5d/Giuseppe-Pezzella"
2024,"Empoli","Serie A","Roberto Piccoli","ITA","FW","23-124",2001,0.4,1,1,0,0,1,1,1,100,0,0,0,0,0,1,0,0,"https://fbref.com/en/players/1cadaf34/Roberto-Piccoli"
2024,"Empoli","Serie A","Filippo Ranocchia","ITA","MF,DF","23-016",2001,5.3,16,11,7,9,0,7,16,43.8,9,9,1,8,3,19,14,0,"https://fbref.com/en/players/d9ebed1c/Filippo-Ranocchia"
2024,"Empoli","Serie A","Steven Shpendi","ALB","FW,MF","21-011",2003,4.6,0,0,0,0,0,0,4,0,4,2,1,1,1,1,0,0,"https://fbref.com/en/players/fd987f24/Steven-Shpendi"
2024,"Empoli","Serie A","Andrea Sodero","ITA","MF","19-297",2004,0.1,0,0,0,0,0,0,0,NA,0,0,0,0,0,0,0,0,"https://fbref.com/en/players/364e2d13/Andrea-Sodero"
2024,"Empoli","Serie A","Sebastian Walukiewicz","POL","DF","24-055",2000,22.8,39,28,33,6,0,28,41,68.3,13,50,31,19,15,54,121,0,"https://fbref.com/en/players/217875a4/Sebastian-Walukiewicz"
2024,"Empoli","Serie A","Szymon Żurkowski","POL","MF","26-248",1997,9.6,15,6,5,8,2,5,15,33.3,10,5,1,4,6,21,11,0,"https://fbref.com/en/players/4e1d5e59/Szymon-Zurkowski"
2024,"Everton","Premier League","Beto","GNB","FW","26-120",1998,10.6,14,6,1,6,7,4,12,33.3,8,11,0,11,1,15,14,0,"https://fbref.com/en/players/ed5c0319/Beto"
2024,"Everton","Premier League","Jarrad Branthwaite","ENG","DF","21-338",2002,34.6,66,32,42,22,2,45,62,72.6,17,51,36,15,50,116,163,2,"https://fbref.com/en/players/c1949191/Jarrad-Branthwaite"
2024,"Everton","Premier League","Dominic Calvert-Lewin","ENG","FW","27-075",1997,24.1,13,6,2,6,5,2,15,13.3,13,14,4,10,4,17,38,0,"https://fbref.com/en/players/59e6e5bf/Dominic-Calvert-Lewin"
2024,"Everton","Premier League","Thomas Cannon","IRL","FW","21-154",2002,0,0,0,0,0,0,0,0,NA,0,0,0,0,0,0,0,0,"https://fbref.com/en/players/4506aec5/Thomas-Cannon"
2024,"Everton","Premier League","Youssef Chermiti","POR","FW","20-006",2004,2.3,3,2,2,1,0,1,5,20,4,4,1,3,1,4,2,0,"https://fbref.com/en/players/890f108d/Youssef-Chermiti"
2024,"Everton","Premier League","Séamus Coleman","IRL","DF","35-232",1988,7.4,17,14,10,3,4,11,16,68.8,5,12,4,8,7,24,26,1,"https://fbref.com/en/players/0420d84f/Seamus-Coleman"
2024,"Everton","Premier League","Arnaut Danjuma","NED","MF,FW","27-120",1997,6.6,6,4,2,3,1,1,4,25,3,4,0,4,3,9,0,0,"https://fbref.com/en/players/f08490a6/Arnaut-Danjuma"
2024,"Everton","Premier League","Lewis Dobbin","ENG","MF","21-148",2003,2.6,9,7,3,5,1,5,9,55.6,4,5,1,4,1,10,0,0,"https://fbref.com/en/players/e814e1cf/Lewis-Dobbin"
2024,"Everton","Premier League","Abdoulaye Doucouré","MLI","FW,MF","31-150",1993,29.2,43,27,20,14,9,18,46,39.1,28,23,3,20,15,58,19,0,"https://fbref.com/en/players/02b29014/Abdoulaye-Doucoure"
2024,"Everton","Premier League","Idrissa Gana Gueye","SEN","MF","34-247",1989,20.9,73,44,32,27,14,29,46,63,17,24,7,17,28,101,16,0,"https://fbref.com/en/players/72c812f3/Idrissa-Gana-Gueye"
2024,"Everton","Premier League","James Garner","ENG","MF","23-078",2001,33.4,83,44,32,38,13,35,82,42.7,47,45,14,31,45,128,47,1,"https://fbref.com/en/players/4e015693/James-Garner"
2024,"Everton","Premier League","Ben Godfrey","ENG","DF","26-136",1998,12.4,30,20,17,8,5,15,28,53.6,13,14,8,6,16,46,57,0,"https://fbref.com/en/players/9f7c837d/Ben-Godfrey"
2024,"Everton","Premier League","André Gomes","POR","MF,FW","30-305",1993,5.6,7,4,2,3,2,3,13,23.1,10,10,1,9,3,10,4,1,"https://fbref.com/en/players/1961b2aa/Andre-Gomes"
2024,"Everton","Premier League","Jack Harrison","ENG","MF,FW","27-192",1996,24.6,37,22,12,12,13,17,49,34.7,32,25,5,20,12,49,24,0,"https://fbref.com/en/players/aa849a12/Jack-Harrison"
2024,"Everton","Premier League","Alex Iwobi","NGA","MF","28-027",1996,1.6,2,0,1,0,1,2,3,66.7,1,2,0,2,1,3,0,0,"https://fbref.com/en/players/6ca5ec4b/Alex-Iwobi"
2024,"Everton","Premier League","Michael Keane","ENG","DF","31-140",1993,4.9,7,3,3,3,1,1,7,14.3,6,5,4,1,5,12,18,1,"https://fbref.com/en/players/c5b7c315/Michael-Keane"
2024,"Everton","Premier League","Neal Maupay","FRA","FW","27-290",1996,1.2,0,0,0,0,0,0,1,0,1,2,0,2,0,0,1,0,"https://fbref.com/en/players/4bcf39f6/Neal-Maupay"
2024,"Everton","Premier League","Dwight McNeil","ENG","MF,FW","24-190",1999,32.1,44,27,16,14,14,24,55,43.6,31,44,7,37,22,66,37,0,"https://fbref.com/en/players/fc15fb84/Dwight-McNeil"
2024,"Everton","Premier League","Vitaliy Mykolenko","UKR","DF","25-001",1999,27.4,69,38,46,21,2,41,66,62.1,25,36,11,25,36,105,92,0,"https://fbref.com/en/players/30d4a2e5/Vitaliy-Mykolenko"
2024,"Everton","Premier League","Amadou Onana","BEL","MF","22-288",2001,23.2,71,38,32,31,8,21,42,50,21,25,6,19,21,92,31,0,"https://fbref.com/en/players/828657ff/Amadou-Onana"
2024,"Everton","Premier League","Tyler Onyango","ENG","MF","21-087",2003,0,0,0,0,0,0,0,0,NA,0,0,0,0,0,0,0,0,"https://fbref.com/en/players/d86a1f3e/Tyler-Onyango"
2024,"Everton","Premier League","Nathan Patterson","SCO","DF","22-227",2001,11.2,34,24,21,11,2,14,37,37.8,23,14,3,11,9,43,33,0,"https://fbref.com/en/players/230f0471/Nathan-Patterson"
2024,"Everton","Premier League","Jordan Pickford","ENG","GK","30-084",1994,38,1,0,1,0,0,1,1,100,0,3,0,3,0,1,19,1,"https://fbref.com/en/players/4806ec67/Jordan-Pickford"
2024,"Everton","Premier League","James Tarkowski","ENG","DF","31-193",1992,38,61,42,46,14,1,27,48,56.3,21,82,56,26,56,117,191,2,"https://fbref.com/en/players/15ea812b/James-Tarkowski"
2024,"Everton","Premier League","Lewis Warrington","ENG","FW","21-233",2002,0,0,0,0,0,0,0,0,NA,0,0,0,0,0,0,0,0,"https://fbref.com/en/players/8e633970/Lewis-Warrington"
2024,"Everton","Premier League","Ashley Young","ENG","DF,MF","38-326",1985,25.3,53,38,28,19,6,30,54,55.6,24,24,6,18,22,75,50,3,"https://fbref.com/en/players/be927d03/Ashley-Young"
2024,"Fiorentina","Serie A","Lorenzo Amatucci","ITA","MF","20-115",2004,0.2,0,0,0,0,0,0,0,NA,0,0,0,0,0,0,0,0,"https://fbref.com/en/players/13b9e2fb/Lorenzo-Amatucci"
2024,"Fiorentina","Serie A","Antonín Barák","CZE","MF,FW","29-179",1994,8.9,6,2,1,3,2,3,7,42.9,4,5,0,5,2,8,3,0,"https://fbref.com/en/players/01efac19/Antonin-Barak"
2024,"Fiorentina","Serie A","Andrea Belotti","ITA","FW","30-162",1993,9.5,7,3,1,4,2,4,9,44.4,5,8,1,7,1,8,3,0,"https://fbref.com/en/players/d705ba44/Andrea-Belotti"
2024,"Fiorentina","Serie A","Lucas Beltrán","ARG","FW,MF","23-062",2001,18,26,14,4,17,5,11,20,55,9,28,3,25,2,28,11,0,"https://fbref.com/en/players/482d2bc3/Lucas-Beltran"
2024,"Fiorentina","Serie A","Cristiano Biraghi","ITA","DF","31-272",1992,25.2,46,28,20,23,3,28,50,56,22,28,4,24,14,60,39,0,"https://fbref.com/en/players/9e1577aa/Cristiano-Biraghi"
2024,"Fiorentina","Serie A","Giacomo Bonaventura","ITA","MF","34-282",1989,25.3,26,13,6,10,10,9,21,42.9,12,16,1,15,14,40,10,0,"https://fbref.com/en/players/d995ed27/Giacomo-Bonaventura"
2024,"Fiorentina","Serie A","Josip Brekalo","CRO","FW","25-342",1998,7.2,8,6,6,2,0,2,11,18.2,9,7,0,7,1,9,0,0,"https://fbref.com/en/players/d4a2533d/Josip-Brekalo"
2024,"Fiorentina","Serie A","Gaetano Castrovilli","ITA","FW,MF","27-103",1997,3.4,1,0,0,1,0,1,6,16.7,5,2,0,2,2,3,2,0,"https://fbref.com/en/players/0728bebe/Gaetano-Castrovilli"
2024,"Fiorentina","Serie A","Oliver Christensen","DEN","GK","25-069",1999,4,0,0,0,0,0,0,0,NA,0,0,0,0,0,0,1,0,"https://fbref.com/en/players/af104654/Oliver-Christensen"
2024,"Fiorentina","Serie A","Pietro Comuzzo","ITA","DF,FW","19-100",2005,0.5,1,1,1,0,0,1,1,100,0,1,0,1,1,2,2,0,"https://fbref.com/en/players/5e3ecc35/Pietro-Comuzzo"
2024,"Fiorentina","Serie A","Dodô","BRA","DF","25-195",1998,5.8,5,3,1,4,0,2,5,40,3,2,0,2,5,10,11,0,"https://fbref.com/en/players/b5f7d10b/Dodo"
2024,"Fiorentina","Serie A","Alfred Duncan","GHA","MF","31-081",1993,20.1,34,21,12,15,7,15,33,45.5,18,26,5,21,10,44,12,0,"https://fbref.com/en/players/528492ea/Alfred-Duncan"
2024,"Fiorentina","Serie A","Davide Faraoni","ITA","DF","32-218",1991,4.3,9,4,5,2,2,5,11,45.5,6,3,1,2,5,14,14,0,"https://fbref.com/en/players/aae9d04a/Davide-Faraoni"
2024,"Fiorentina","Serie A","Nicolás González","ARG","FW","26-054",1998,20.3,28,18,15,8,5,8,26,30.8,18,22,1,21,12,40,7,0,"https://fbref.com/en/players/2374aaca/Nicolas-Gonzalez"
2024,"Fiorentina","Serie A","Jonathan Ikone","FRA","FW","26-028",1998,18.5,22,11,7,9,6,10,17,58.8,7,12,0,12,2,24,8,0,"https://fbref.com/en/players/42eaa028/Jonathan-Ikone"
2024,"Fiorentina","Serie A","Gino Infantino","ARG","MF","21-011",2003,0.9,1,1,0,1,0,0,1,0,1,3,0,3,1,2,1,0,"https://fbref.com/en/players/546c7f68/Gino-Infantino"
2024,"Fiorentina","Serie A","Michael Kayode","ITA","DF","19-325",2004,21.9,50,29,24,15,11,32,45,71.1,13,24,12,12,17,67,45,2,"https://fbref.com/en/players/e19660a8/Michael-Kayode"
2024,"Fiorentina","Serie A","Christian Kouamé","CIV","FW","26-176",1997,11.8,10,2,6,4,0,4,8,50,4,16,0,16,2,12,10,0,"https://fbref.com/en/players/58e933d2/Christian-Kouame"
2024,"Fiorentina","Serie A","Maxime Lopez","FRA","MF","26-178",1997,7.9,18,9,5,10,3,6,12,50,6,3,1,2,2,20,6,0,"https://fbref.com/en/players/20094685/Maxime-Lopez"
2024,"Fiorentina","Serie A","Rolando Mandragora","ITA","MF","26-336",1997,17.6,26,11,8,13,5,10,22,45.5,12,14,3,11,9,35,18,1,"https://fbref.com/en/players/c7259b83/Rolando-Mandragora"
2024,"Fiorentina","Serie A","Lucas Martínez Quarta","ARG","DF","28-020",1996,24.5,68,45,38,26,4,34,48,70.8,14,37,14,23,28,96,65,4,"https://fbref.com/en/players/3ec3c1c9/Lucas-Martinez-Quarta"
2024,"Fiorentina","Serie A","Arthur Melo","BRA","MF","27-292",1996,22.1,45,30,17,24,4,26,42,61.9,16,27,3,24,18,63,8,0,"https://fbref.com/en/players/48b3dd60/Arthur-Melo"
2024,"Fiorentina","Serie A","Nikola Milenković","SRB","DF","26-231",1997,27.9,41,21,24,14,3,22,36,61.1,14,22,14,8,27,68,95,1,"https://fbref.com/en/players/bee704fc/Nikola-Milenkovic"
2024,"Fiorentina","Serie A","Yerry Mina","COL","DF,MF","29-250",1994,0.5,1,1,1,0,0,1,2,50,1,0,0,0,0,1,2,0,"https://fbref.com/en/players/6d5701f2/Yerry-Mina"
2024,"Fiorentina","Serie A","M'Bala Nzola","ANG","FW","27-286",1996,17.2,11,8,1,4,6,6,7,85.7,1,10,1,9,0,11,22,0,"https://fbref.com/en/players/a4948e67/MBala-Nzola"
2024,"Fiorentina","Serie A","Fabiano Parisi","ITA","DF","23-203",2000,16.2,30,15,11,12,7,15,26,57.7,11,21,5,16,17,47,26,0,"https://fbref.com/en/players/0967845b/Fabiano-Parisi"
2024,"Fiorentina","Serie A","Luca Ranieri","ITA","DF","25-037",1999,21.9,12,9,9,1,2,8,13,61.5,5,24,11,13,28,40,63,0,"https://fbref.com/en/players/8c63fae5/Luca-Ranieri"
2024,"Fiorentina","Serie A","Riccardo Sottil","ITA","FW","24-362",1999,12.3,10,5,5,1,4,3,8,37.5,5,12,0,12,2,12,2,0,"https://fbref.com/en/players/94816803/Riccardo-Sottil"
2024,"Fiorentina","Serie A","Pietro Terracciano","ITA","GK","34-083",1990,33,1,1,1,0,0,1,3,33.3,2,1,0,1,0,1,8,0,"https://fbref.com/en/players/e1b0a70d/Pietro-Terracciano"
2024,"Freiburg","Bundesliga","Junior Adamu","AUT","FW,MF","22-359",2001,1.2,5,1,1,2,2,1,2,50,1,1,0,1,0,5,2,0,"https://fbref.com/en/players/82e12fe7/Junior-Adamu"
2024,"Freiburg","Bundesliga","Noah Atubolu","GER","GK","22-005",2002,34,0,0,0,0,0,0,1,0,1,0,0,0,0,0,8,1,"https://fbref.com/en/players/dbd1b101/Noah-Atubolu"
2024,"Freiburg","Bundesliga","Maximilian Breunig","GER","FW","23-290",2000,0.1,0,0,0,0,0,0,0,NA,0,1,0,1,0,0,0,0,"https://fbref.com/en/players/1e37c986/Maximilian-Breunig"
2024,"Freiburg","Bundesliga","Ritsu Doan","JPN","DF,MF","25-349",1998,25,50,27,21,19,10,21,36,58.3,15,30,3,27,9,59,29,0,"https://fbref.com/en/players/d01bbb6f/Ritsu-Doan"
2024,"Freiburg","Bundesliga","Maximilian Eggestein","GER","MF","27-174",1996,32.4,49,24,25,19,5,15,36,41.7,21,53,19,34,28,77,40,1,"https://fbref.com/en/players/beb882a8/Maximilian-Eggestein"
2024,"Freiburg","Bundesliga","Matthias Ginter","GER","DF","30-132",1994,21.3,29,15,19,9,1,16,29,55.2,13,40,26,14,16,45,93,0,"https://fbref.com/en/players/f521b80a/Matthias-Ginter"
2024,"Freiburg","Bundesliga","Michael Gregoritsch","AUT","FW","30-042",1994,18.7,16,12,8,5,3,2,14,14.3,12,17,4,13,9,25,27,0,"https://fbref.com/en/players/8e235926/Michael-Gregoritsch"
2024,"Freiburg","Bundesliga","Vincenzo Grifo","ITA","MF,FW","31-053",1993,25.8,31,20,14,11,6,14,31,45.2,17,22,1,21,15,46,20,0,"https://fbref.com/en/players/54e4866f/Vincenzo-Grifo"
2024,"Freiburg","Bundesliga","Manuel Gulde","GER","DF","33-108",1991,22.7,37,23,23,13,1,17,23,73.9,6,24,14,10,25,62,82,0,"https://fbref.com/en/players/25ab9c9c/Manuel-Gulde"
2024,"Freiburg","Bundesliga","Christian Günter","GER","DF","31-092",1993,11.8,20,12,9,11,0,7,18,38.9,11,9,3,6,2,22,16,0,"https://fbref.com/en/players/8593f88c/Christian-Gunter"
2024,"Freiburg","Bundesliga","Nicolas Höfler","GER","MF","34-082",1990,25.9,63,40,36,20,7,22,49,44.9,27,30,16,14,31,94,45,0,"https://fbref.com/en/players/5d8e331f/Nicolas-Hofler"
2024,"Freiburg","Bundesliga","Lucas Höler","GER","FW,MF","29-325",1994,25.6,32,24,14,10,8,4,23,17.4,19,19,4,15,15,47,35,0,"https://fbref.com/en/players/ca618d23/Lucas-Holer"
2024,"Freiburg","Bundesliga","Yannik Keitel","GER","DF,MF","24-105",2000,10.2,20,15,14,5,1,10,15,66.7,5,17,8,9,12,32,44,3,"https://fbref.com/en/players/d2c580ce/Yannik-Keitel"
2024,"Freiburg","Bundesliga","Lukas Kübler","GER","DF","31-274",1992,20.5,50,24,35,13,2,26,42,61.9,16,36,14,22,37,87,57,1,"https://fbref.com/en/players/2a29eb9b/Lukas-Kubler"
2024,"Freiburg","Bundesliga","Philipp Lienhart","AUT","DF","27-324",1996,14.1,20,13,14,5,1,13,23,56.5,10,18,11,7,14,34,51,0,"https://fbref.com/en/players/302527b2/Philipp-Lienhart"
2024,"Freiburg","Bundesliga","Jordy Makengo","FRA","DF","22-301",2001,11.4,17,11,11,5,1,6,10,60,4,16,4,12,11,28,37,0,"https://fbref.com/en/players/14b09c41/Jordy-Makengo"
2024,"Freiburg","Bundesliga","Florent Muslija","KVX","MF,FW","25-329",1998,1.2,5,4,3,2,0,2,5,40,3,1,0,1,0,5,2,0,"https://fbref.com/en/players/ae961785/Florent-Muslija"
2024,"Freiburg","Bundesliga","Maximilian Philipp","GER","FW,MF","30-090",1994,3.6,8,5,4,4,0,1,6,16.7,5,7,0,7,1,9,3,0,"https://fbref.com/en/players/061e8e23/Maximilian-Philipp"
2024,"Freiburg","Bundesliga","Merlin Röhl","GER","MF,FW","21-330",2002,16.4,21,13,10,9,2,8,21,38.1,13,27,3,24,9,30,22,0,"https://fbref.com/en/players/1f2c7b55/Merlin-Rohl"
2024,"Freiburg","Bundesliga","Fabian Rüdlin","GER","MF","27-138",1997,0.1,1,0,0,0,1,0,0,NA,0,0,0,0,0,1,0,0,"https://fbref.com/en/players/96cfb5e2/Fabian-Rudlin"
2024,"Freiburg","Bundesliga","Roland Sallai","HUN","MF,FW","27-008",1997,20.4,17,10,5,5,7,8,20,40,12,21,1,20,6,23,23,0,"https://fbref.com/en/players/bf075f6b/Roland-Sallai"
2024,"Freiburg","Bundesliga","Kenneth Schmidt","GER","DF","21-362",2002,0.8,2,2,2,0,0,2,4,50,2,1,0,1,1,3,2,0,"https://fbref.com/en/players/7d31f1cb/Kenneth-Schmidt"
2024,"Freiburg","Bundesliga","Kiliann Sildillia","FRA","DF","22-014",2002,20.1,43,19,28,8,7,26,42,61.9,16,33,15,18,22,65,64,0,"https://fbref.com/en/players/313254a3/Kiliann-Sildillia"
2024,"Freiburg","Bundesliga","Attila Szalai","HUN","DF","26-131",1998,1.1,1,1,1,0,0,1,2,50,1,5,2,3,1,2,11,1,"https://fbref.com/en/players/50ff205b/Attila-Szalai"
2024,"Freiburg","Bundesliga","Noah Weißhaupt","GER","DF,FW","22-253",2001,8.4,9,4,6,0,3,5,11,45.5,6,8,1,7,8,17,12,0,"https://fbref.com/en/players/dd676a97/Noah-Weisshaupt"
2024,"Frosinone","Serie A","Jaime Báez","URU","FW,MF","29-035",1995,5.6,4,1,0,2,2,0,7,0,7,5,0,5,4,8,1,0,"https://fbref.com/en/players/dfd24c07/Jaime-Baez"
2024,"Frosinone","Serie A","Enzo Barrenechea","ARG","MF","23-008",2001,31.2,65,42,28,29,8,28,70,40,42,47,12,35,27,92,61,2,"https://fbref.com/en/players/6caffe81/Enzo-Barrenechea"
2024,"Frosinone","Serie A","Kevin Bonifazi","ITA","DF","28-011",1996,3.4,5,3,2,3,0,2,3,66.7,1,1,0,1,3,8,9,0,"https://fbref.com/en/players/fb77bfef/Kevin-Bonifazi"
2024,"Frosinone","Serie A","Gennaro Borrelli","ITA","FW","24-081",2000,0.3,0,0,0,0,0,0,0,NA,0,0,0,0,0,0,0,0,"https://fbref.com/en/players/04c4edc1/Gennaro-Borrelli"
2024,"Frosinone","Serie A","Mehdi Bourabia","MAR","MF","32-297",1991,2.2,5,4,1,4,0,2,4,50,2,3,0,3,0,5,4,0,"https://fbref.com/en/players/0d077b88/Mehdi-Bourabia"
2024,"Frosinone","Serie A","Marco Brescianini","ITA","MF","24-131",2000,25.8,28,13,13,12,3,9,25,36,16,22,5,17,10,38,37,0,"https://fbref.com/en/players/dfd56738/Marco-Brescianini"
2024,"Frosinone","Serie A","Luigi Canotto","ITA","FW","30-011",1994,0.2,0,0,0,0,0,0,0,NA,0,0,0,0,0,0,0,0,"https://fbref.com/en/players/911080b1/Luigi-Canotto"
2024,"Frosinone","Serie A","Giuseppe Caso","ITA","FW,MF","25-173",1998,4.6,4,3,2,0,2,2,3,66.7,1,0,0,0,0,4,0,0,"https://fbref.com/en/players/099a2de5/Giuseppe-Caso"
2024,"Frosinone","Serie A","Michele Cerofolini","ITA","GK","25-147",1999,7.5,0,0,0,0,0,0,0,NA,0,0,0,0,0,0,5,1,"https://fbref.com/en/players/efdeaff3/Michele-Cerofolini"
2024,"Frosinone","Serie A","Walid Cheddira","MAR","FW","26-129",1998,23.6,12,7,1,8,3,4,8,50,4,6,1,5,5,17,10,0,"https://fbref.com/en/players/0545a08e/Walid-Cheddira"
2024,"Frosinone","Serie A","Marvin Cuni","ALB","FW","22-325",2001,5.9,8,3,1,3,4,3,4,75,1,10,1,9,1,9,0,0,"https://fbref.com/en/players/1d45fd81/Marvin-Cuni"
2024,"Frosinone","Serie A","Luca Garritano","ITA","MF,DF","30-109",1994,5.4,10,5,7,2,1,5,15,33.3,10,13,0,13,4,14,8,1,"https://fbref.com/en/players/1ceeae3e/Luca-Garritano"
2024,"Frosinone","Serie A","Francesco Gelli","ITA","MF,DF","27-228",1996,17.3,19,13,8,4,7,10,24,41.7,14,19,3,16,11,30,27,1,"https://fbref.com/en/players/986693ed/Francesco-Gelli"
2024,"Frosinone","Serie A","Farés Ghedjemis","FRA","FW,MF","21-267",2002,2,2,0,1,0,1,0,2,0,2,2,0,2,1,3,2,0,"https://fbref.com/en/players/14aac43e/Fares-Ghedjemis"
2024,"Frosinone","Serie A","Abdou Harroui","NED","MF,FW","26-138",1998,11.3,23,11,11,11,1,8,16,50,8,19,3,16,5,28,8,0,"https://fbref.com/en/players/65fd099c/Abdou-Harroui"
2024,"Frosinone","Serie A","Arijon Ibrahimović","GER","FW,DF","18-171",2005,5.3,7,6,4,2,1,1,9,11.1,8,4,0,4,1,8,3,0,"https://fbref.com/en/players/f5c4fd91/Arijon-Ibrahimovic"
2024,"Frosinone","Serie A","Kaio Jorge","BRA","FW","22-127",2002,9,6,4,0,1,5,3,4,75,1,6,0,6,1,7,0,0,"https://fbref.com/en/players/0cf465f2/Kaio-Jorge"
2024,"Frosinone","Serie A","Giorgi Kvernadze","GEO","FW,DF","21-113",2003,0.7,3,0,2,0,1,2,2,100,0,1,0,1,1,4,0,0,"https://fbref.com/en/players/70006831/Giorgi-Kvernadze"
2024,"Frosinone","Serie A","Pol Lirola","ESP","DF","26-291",1997,17.1,30,18,14,15,1,17,35,48.6,18,12,1,11,19,49,41,1,"https://fbref.com/en/players/ff800ed8/Pol-Lirola"
2024,"Frosinone","Serie A","Karlo Lulić","CRO","MF","28-020",1996,0.2,0,0,0,0,0,0,0,NA,0,1,0,1,1,1,0,0,"https://fbref.com/en/players/5dde403b/Karlo-Lulic"
2024,"Frosinone","Serie A","Mateus Lusuardi","BRA","DF","20-143",2004,2.4,2,1,1,1,0,1,3,33.3,2,4,2,2,4,6,8,0,"https://fbref.com/en/players/0704d719/Mateus-Lusuardi"
2024,"Frosinone","Serie A","Riccardo Marchizza","ITA","DF","26-065",1998,12.8,7,6,4,3,0,3,13,23.1,10,10,2,8,7,14,33,0,"https://fbref.com/en/players/91d0fabf/Riccardo-Marchizza"
2024,"Frosinone","Serie A","Luca Mazzitelli","ITA","MF","28-197",1995,24.6,45,23,15,24,6,26,49,53.1,23,23,7,16,19,64,62,0,"https://fbref.com/en/players/dc61b402/Luca-Mazzitelli"
2024,"Frosinone","Serie A","Ilario Monterisi","ITA","DF","22-163",2001,16.3,23,13,14,7,2,12,26,46.2,14,22,18,4,8,31,63,0,"https://fbref.com/en/players/31b252fc/Ilario-Monterisi"
2024,"Frosinone","Serie A","Caleb Okoli","ITA","DF","22-322",2001,32.4,56,34,33,22,1,29,44,65.9,15,48,32,16,29,85,156,4,"https://fbref.com/en/players/8ec109e6/Caleb-Okoli"
2024,"Frosinone","Serie A","Anthony Oyono","GAB","DF","23-048",2001,13.3,37,26,21,14,2,23,34,67.6,11,17,3,14,9,46,32,0,"https://fbref.com/en/players/68b7e72e/Anthony-Oyono"
2024,"Frosinone","Serie A","Reinier","BRA","MF,FW","22-132",2002,11.8,21,10,6,12,3,5,17,29.4,12,24,4,20,10,31,5,0,"https://fbref.com/en/players/6b21b7b5/Reinier"
2024,"Frosinone","Serie A","Simone Romagnoli","ITA","DF","34-111",1990,30.2,35,15,23,11,1,15,20,75,5,51,36,15,29,64,147,0,"https://fbref.com/en/players/09899de8/Simone-Romagnoli"
2024,"Frosinone","Serie A","Demba Seck","SEN","FW,MF","23-110",2001,3.3,7,4,2,3,2,4,5,80,1,3,0,3,1,8,1,0,"https://fbref.com/en/players/16463a79/Demba-Seck"
2024,"Frosinone","Serie A","Matìas Soulé","ARG","FW,MF","21-045",2003,34.7,41,27,12,14,15,19,40,47.5,21,38,4,34,18,59,9,0,"https://fbref.com/en/players/c13ddd3e/Matias-Soule"
2024,"Frosinone","Serie A","Przemysław Szymiński","POL","MF","29-341",1994,0.1,0,0,0,0,0,0,0,NA,0,1,1,0,0,0,0,0,"https://fbref.com/en/players/9b3099d6/Przemyslaw-Szyminski"
2024,"Frosinone","Serie A","Stefano Turati","ITA","GK","22-268",2001,30.5,0,0,0,0,0,0,0,NA,0,0,0,0,0,0,6,3,"https://fbref.com/en/players/bf168004/Stefano-Turati"
2024,"Frosinone","Serie A","Emanuele Valeri","ITA","DF","25-175",1998,13.1,19,16,10,5,4,10,21,47.6,11,14,3,11,9,28,22,0,"https://fbref.com/en/players/ec52b661/Emanuele-Valeri"
2024,"Frosinone","Serie A","Nadir Zortea","ITA","DF","24-346",1999,14,21,14,8,13,0,10,22,45.5,12,13,5,8,4,25,29,1,"https://fbref.com/en/players/82598b71/Nadir-Zortea"
2024,"Fulham","Premier League","Tosin Adarabioyo","ENG","DF","26-249",1997,18,21,11,16,5,0,12,21,57.1,9,16,11,5,25,46,80,0,"https://fbref.com/en/players/c81d773d/Tosin-Adarabioyo"
2024,"Fulham","Premier League","Fodé Ballo-Touré","SEN","DF,MF","27-148",1997,0.8,4,2,1,3,0,1,2,50,1,1,0,1,3,7,2,0,"https://fbref.com/en/players/f449640d/Fode-Ballo-Toure"
2024,"Fulham","Premier League","Calvin Bassey","NGA","DF","24-151",1999,25.6,49,29,33,15,1,21,29,72.4,8,32,11,21,28,77,84,4,"https://fbref.com/en/players/a36524bf/Calvin-Bassey"
2024,"Fulham","Premier League","Armando Broja","ALB","FW","22-263",2001,1,0,0,0,0,0,0,0,NA,0,1,0,1,0,0,0,0,"https://fbref.com/en/players/97220da2/Armando-Broja"
2024,"Fulham","Premier League","Tom Cairney","SCO","MF","33-131",1991,16.5,24,16,10,12,2,13,25,52,12,16,4,12,13,37,6,0,"https://fbref.com/en/players/a8748947/Tom-Cairney"
2024,"Fulham","Premier League","Timothy Castagne","BEL","DF","28-177",1995,29.3,49,24,23,16,10,26,44,59.1,18,38,10,28,38,87,69,1,"https://fbref.com/en/players/197640fd/Timothy-Castagne"
2024,"Fulham","Premier League","Issa Diop","FRA","DF","27-142",1997,15.8,30,16,23,5,2,15,20,75,5,28,19,9,17,47,80,1,"https://fbref.com/en/players/a712ca2b/Issa-Diop"
2024,"Fulham","Premier League","Luke Harris","WAL","MF","19-057",2005,0.8,1,1,1,0,0,0,1,0,1,0,0,0,0,1,0,0,"https://fbref.com/en/players/8c3078cd/Luke-Harris"
2024,"Fulham","Premier League","Alex Iwobi","NGA","FW,MF","28-027",1996,24.4,29,18,12,15,2,12,25,48,13,16,0,16,14,43,9,0,"https://fbref.com/en/players/6ca5ec4b/Alex-Iwobi"
2024,"Fulham","Premier League","Raúl Jiménez","MEX","FW","33-025",1991,15.5,18,12,4,8,6,7,20,35,13,11,3,8,4,22,13,0,"https://fbref.com/en/players/b561db50/Raul-Jimenez"
2024,"Fulham","Premier League","Bernd Leno","GER","GK","32-087",1992,38,0,0,0,0,0,0,0,NA,0,0,0,0,0,0,14,1,"https://fbref.com/en/players/2628fd2b/Bernd-Leno"
2024,"Fulham","Premier League","Saša Lukić","SRB","MF","27-291",1996,12.5,33,19,9,17,7,18,39,46.2,21,18,5,13,16,49,19,1,"https://fbref.com/en/players/c6e8cf1f/Sasa-Lukic"
2024,"Fulham","Premier League","Aleksandar Mitrović","SRB","FW","29-257",1994,0.4,0,0,0,0,0,0,0,NA,0,0,0,0,0,0,0,0,"https://fbref.com/en/players/3925dbd6/Aleksandar-Mitrovic"
2024,"Fulham","Premier League","Rodrigo Muniz","BRA","FW","23-026",2001,17.7,7,3,1,5,1,1,6,16.7,5,9,3,6,6,13,20,0,"https://fbref.com/en/players/a755db8c/Rodrigo-Muniz"
2024,"Fulham","Premier League","João Palhinha","POR","MF","28-326",1995,30,152,75,80,60,12,103,152,67.8,49,57,9,48,46,198,58,0,"https://fbref.com/en/players/a78ff07f/Joao-Palhinha"
2024,"Fulham","Premier League","Andreas Pereira","BRA","MF","28-150",1996,29,25,12,4,12,9,11,41,26.8,30,16,2,14,4,29,12,0,"https://fbref.com/en/players/6639e500/Andreas-Pereira"
2024,"Fulham","Premier League","Tim Ream","USA","DF","36-238",1987,16.7,20,9,13,5,2,9,18,50,9,23,15,8,25,45,61,2,"https://fbref.com/en/players/28b40c9c/Tim-Ream"
2024,"Fulham","Premier League","Harrison Reed","ENG","MF","29-124",1995,14.7,29,18,9,17,3,13,31,41.9,18,19,9,10,11,40,24,0,"https://fbref.com/en/players/803ae100/Harrison-Reed"
2024,"Fulham","Premier League","Bobby Reid","JAM","FW","31-118",1993,15.8,22,14,5,15,2,4,16,25,12,24,2,22,5,27,14,0,"https://fbref.com/en/players/0f7533cd/Bobby-Reid"
2024,"Fulham","Premier League","Antonee Robinson","USA","DF","26-296",1997,36.3,93,58,60,26,7,52,110,47.3,58,56,8,48,80,173,117,3,"https://fbref.com/en/players/289601e6/Antonee-Robinson"
2024,"Fulham","Premier League","Kenny Tete","NED","DF","28-234",1995,9.6,27,17,19,6,2,11,19,57.9,8,10,3,7,16,43,35,0,"https://fbref.com/en/players/77d7c96f/Kenny-Tete"
2024,"Fulham","Premier League","Adama Traoré","ESP","FW,MF","28-126",1996,4.2,4,3,1,2,1,3,6,50,3,2,0,2,1,5,2,0,"https://fbref.com/en/players/9a28eba4/Adama-Traore"
2024,"Fulham","Premier League","Carlos Vinícius","BRA","FW","29-066",1995,3.5,3,2,0,1,2,0,4,0,4,4,0,4,0,3,1,0,"https://fbref.com/en/players/8b529245/Carlos-Vinicius"
2024,"Fulham","Premier League","Willian","BRA","FW","35-295",1988,22.8,18,11,6,7,5,3,21,14.3,18,13,0,13,9,27,12,1,"https://fbref.com/en/players/8b9ebd03/Willian"
2024,"Fulham","Premier League","Harry Wilson","WAL","FW","27-069",1997,18,21,14,9,8,4,11,28,39.3,17,27,3,24,10,31,12,0,"https://fbref.com/en/players/c6dc9ecd/Harry-Wilson"
2024,"Genoa","Serie A","David Akpan Ankeye","NGA","FW","22-106",2002,0.6,1,0,0,1,0,0,1,0,1,1,0,1,0,1,0,0,"https://fbref.com/en/players/8c4b95af/David-Akpan-Ankeye"
2024,"Genoa","Serie A","Milan Badelj","CRO","MF","35-095",1989,28.2,51,27,23,24,4,24,61,39.3,37,45,13,32,50,101,54,1,"https://fbref.com/en/players/e8c930bb/Milan-Badelj"
2024,"Genoa","Serie A","Mattia Bani","ITA","DF","30-172",1993,25.6,26,10,18,7,1,11,22,50,11,51,31,20,22,48,116,1,"https://fbref.com/en/players/0821331c/Mattia-Bani"
2024,"Genoa","Serie A","Davide Biraschi","ITA","DF","29-333",1994,1,3,3,1,2,0,1,3,33.3,2,0,0,0,2,5,5,0,"https://fbref.com/en/players/64cd167d/Davide-Biraschi"
2024,"Genoa","Serie A","Emil Bohinen","NOR","MF","25-079",1999,0.6,1,1,0,1,0,0,0,NA,0,1,0,1,0,1,3,0,"https://fbref.com/en/players/c83c203f/Emil-Bohinen"
2024,"Genoa","Serie A","Giorgio Cittadini","ITA","DF","22-042",2002,1.2,5,4,4,1,0,3,3,100,0,1,0,1,3,8,5,0,"https://fbref.com/en/players/e4ba67f2/Giorgio-Cittadini"
2024,"Genoa","Serie A","Koni De Winter","BEL","DF","21-353",2002,26.4,44,25,26,13,5,21,31,67.7,10,30,10,20,21,65,78,0,"https://fbref.com/en/players/f4797849/Koni-De-Winter"
2024,"Genoa","Serie A","Radu Drăgușin","ROU","DF","22-117",2002,19,16,11,9,6,1,8,9,88.9,1,18,12,6,21,37,87,3,"https://fbref.com/en/players/620922ed/Radu-Dragusin"
2024,"Genoa","Serie A","Caleb Ekuban","GHA","FW","30-068",1994,12.6,8,4,2,4,2,5,9,55.6,4,11,3,8,1,9,7,0,"https://fbref.com/en/players/7afbd2c3/Caleb-Ekuban"
2024,"Genoa","Serie A","Seydou Fini","ITA","DF,FW","17-363",2006,0.4,0,0,0,0,0,0,0,NA,0,0,0,0,0,0,0,0,"https://fbref.com/en/players/6411925d/Seydou-Fini"
2024,"Genoa","Serie A","Morten Frendrup","DEN","MF","23-053",2001,34.9,133,72,47,70,16,55,91,60.4,36,55,14,41,51,184,42,1,"https://fbref.com/en/players/f4d60499/Morten-Frendrup"
2024,"Genoa","Serie A","Pablo Galdames Millán","CHI","MF,DF","27-152",1996,0.1,0,0,0,0,0,0,0,NA,0,1,0,1,0,0,0,0,"https://fbref.com/en/players/dd403465/Pablo-Galdames-Millan"
2024,"Genoa","Serie A","Albert Guðmundsson","ISL","FW,MF","26-350",1997,33.5,23,10,8,10,5,12,44,27.3,32,15,2,13,11,34,13,0,"https://fbref.com/en/players/b79858d5/Albert-Gudmundsson"
2024,"Genoa","Serie A","Ridgeciano Haps","SUR","DF","30-353",1993,8.6,7,6,3,2,2,5,8,62.5,3,3,0,3,6,13,11,1,"https://fbref.com/en/players/c8d7131c/Ridgeciano-Haps"
2024,"Genoa","Serie A","Silvan Hefti","SUI","MF,DF","26-218",1997,1.3,6,1,2,3,1,4,7,57.1,3,2,0,2,0,6,1,0,"https://fbref.com/en/players/f8342731/Silvan-Hefti"
2024,"Genoa","Serie A","Filip Jagiełło","POL","MF","26-296",1997,0.4,0,0,0,0,0,0,1,0,1,1,1,0,1,1,0,0,"https://fbref.com/en/players/4cdcbc14/Filip-Jagiello"
2024,"Genoa","Serie A","Berkan Kutlu","TUR","MF","26-126",1998,2.2,6,4,5,1,0,3,6,50,3,3,0,3,4,10,5,0,"https://fbref.com/en/players/794364d7/Berkan-Kutlu"
2024,"Genoa","Serie A","Nicola Leali","ITA","GK","31-103",1993,2,0,0,0,0,0,0,0,NA,0,0,0,0,0,0,0,0,"https://fbref.com/en/players/5f9970a0/Nicola-Leali"
2024,"Genoa","Serie A","Ruslan Malinovskyi","UKR","MF","31-026",1993,17.2,35,20,18,11,6,17,41,41.5,24,22,8,14,5,40,16,0,"https://fbref.com/en/players/48d5bd33/Ruslan-Malinovskyi"
2024,"Genoa","Serie A","Aarón Martín","ESP","DF","27-038",1997,15.3,21,10,7,10,4,9,22,40.9,13,12,4,8,9,30,15,0,"https://fbref.com/en/players/2f3e911a/Aaron-Martin"
2024,"Genoa","Serie A","Josep Martinez","ESP","GK","26-003",1998,36,0,0,0,0,0,0,0,NA,0,0,0,0,1,1,21,3,"https://fbref.com/en/players/11d8aff0/Josep-Martinez"
2024,"Genoa","Serie A","Alan Matturro","URU","DF","19-232",2004,1.2,1,1,1,0,0,1,1,100,0,6,3,3,2,3,4,0,"https://fbref.com/en/players/547c0119/Alan-Matturro"
2024,"Genoa","Serie A","Junior Messias","BRA","MF,DF","33-017",1991,11.7,26,20,19,5,2,8,19,42.1,11,9,1,8,5,31,22,0,"https://fbref.com/en/players/f49c4ae9/Junior-Messias"
2024,"Genoa","Serie A","Christos Papadopoulos","GRE","FW","19-211",2004,0,0,0,0,0,0,0,1,0,1,0,0,0,0,0,0,0,"https://fbref.com/en/players/e19bc88c/Christos-Papadopoulos"
2024,"Genoa","Serie A","George Pușcaș","ROU","FW","28-052",1996,2.1,0,0,0,0,0,0,3,0,3,1,0,1,0,0,1,0,"https://fbref.com/en/players/c23c8e0d/George-Puscas"
2024,"Genoa","Serie A","Mateo Retegui","ITA","FW","25-031",1999,24.6,17,9,7,8,2,6,20,30,14,18,2,16,0,17,30,0,"https://fbref.com/en/players/e7695e6c/Mateo-Retegui"
2024,"Genoa","Serie A","Stefano Sabelli","ITA","DF","31-138",1993,27,50,24,28,19,3,15,46,32.6,31,27,6,21,23,73,35,0,"https://fbref.com/en/players/0ccac09c/Stefano-Sabelli"
2024,"Genoa","Serie A","Daniele Sommariva","ITA","GK","26-317",1997,0.1,0,0,0,0,0,0,0,NA,0,0,0,0,0,0,0,0,"https://fbref.com/en/players/a8e7f7e9/Daniele-Sommariva"
2024,"Genoa","Serie A","Djed Spence","ENG","DF","23-295",2000,9.5,16,10,12,4,0,8,10,80,2,20,5,15,8,24,28,0,"https://fbref.com/en/players/9bc9a519/Djed-Spence"
2024,"Genoa","Serie A","Kevin Strootman","NED","MF","34-107",1990,13.4,34,19,13,18,3,15,31,48.4,16,20,6,14,7,41,22,0,"https://fbref.com/en/players/ef2e5e1a/Kevin-Strootman"
2024,"Genoa","Serie A","Morten Thorsby","NOR","MF","28-025",1996,12.9,19,11,9,8,2,7,14,50,7,21,5,16,4,23,20,0,"https://fbref.com/en/players/d1b49282/Morten-Thorsby"
2024,"Genoa","Serie A","Johan Vásquez","MEX","DF","25-221",1998,31.7,51,33,38,11,2,32,50,64,18,50,26,24,45,96,113,0,"https://fbref.com/en/players/5eaed77a/Johan-Vasquez"
2024,"Genoa","Serie A","Vitinha","POR","FW,MF","24-076",2000,3.2,2,2,1,0,1,1,2,50,1,2,0,2,0,2,2,0,"https://fbref.com/en/players/74d4cec6/Vitinha"
2024,"Genoa","Serie A","Alessandro Vogliacco","ITA","DF","25-259",1998,13,23,15,14,8,1,12,15,80,3,16,10,6,30,53,40,1,"https://fbref.com/en/players/6841f107/Alessandro-Vogliacco"
2024,"Getafe","La Liga","Nabil Aberdin","FRA","DF","21-281",2002,2,0,0,0,0,0,0,1,0,1,0,0,0,0,0,4,0,"https://fbref.com/en/players/cadfa7d1/Nabil-Aberdin"
2024,"Getafe","La Liga","Omar Alderete","PAR","DF","27-156",1996,24.4,28,21,15,13,0,19,35,54.3,16,30,18,12,13,41,111,0,"https://fbref.com/en/players/bb08bce9/Omar-Alderete"
2024,"Getafe","La Liga","Carles Aleñá","ESP","MF","26-146",1998,11.3,24,8,7,14,3,10,24,41.7,14,14,3,11,4,28,13,0,"https://fbref.com/en/players/6c811eb7/Carles-Alena"
2024,"Getafe","La Liga","Gastón Álvarez","URU","DF","24-067",2000,28.2,68,37,43,20,5,37,57,64.9,20,40,11,29,35,103,80,0,"https://fbref.com/en/players/852ddfb8/Gaston-Alvarez"
2024,"Getafe","La Liga","Fabrizio Angileri","ARG","DF,MF","30-076",1994,1.8,1,1,1,0,0,1,3,33.3,2,0,0,0,4,5,8,0,"https://fbref.com/en/players/fdd26d71/Fabrizio-Angileri"
2024,"Getafe","La Liga","Mauro Arambarri","URU","MF","28-243",1995,3.8,6,2,3,2,1,1,6,16.7,5,1,0,1,2,8,7,0,"https://fbref.com/en/players/58afe001/Mauro-Arambarri"
2024,"Getafe","La Liga","Carmona","ESP","DF,MF","22-122",2002,14.6,30,21,13,14,3,9,28,32.1,19,15,2,13,21,51,25,0,"https://fbref.com/en/players/2dce876a/Carmona"
2024,"Getafe","La Liga","Djené","TOG","DF,MF","32-151",1991,27.6,34,19,18,13,3,15,26,57.7,11,31,15,16,23,57,70,0,"https://fbref.com/en/players/a4971d84/Djene"
2024,"Getafe","La Liga","Domingos Duarte","POR","DF","29-081",1995,10.1,7,4,6,0,1,5,7,71.4,2,7,5,2,8,15,27,0,"https://fbref.com/en/players/93090f69/Domingos-Duarte"
2024,"Getafe","La Liga","Daniel Fuzato","BRA","GK","26-331",1997,0.1,0,0,0,0,0,0,0,NA,0,0,0,0,0,0,1,0,"https://fbref.com/en/players/82328faf/Daniel-Fuzato"
2024,"Getafe","La Liga","Santiago García","","FW","22-275",2001,0.3,1,0,0,0,1,1,1,100,0,0,0,0,0,1,0,0,"https://fbref.com/en/players/b4b4d0a6/Santiago-Garcia"
2024,"Getafe","La Liga","Mason Greenwood","ENG","MF,FW","22-242",2001,29.6,11,6,3,5,3,4,21,19,17,9,0,9,4,15,4,0,"https://fbref.com/en/players/58eee997/Mason-Greenwood"
2024,"Getafe","La Liga","Iglesias","ESP","DF,FW","25-332",1998,15.7,41,22,25,11,5,21,33,63.6,12,18,7,11,16,57,53,0,"https://fbref.com/en/players/974322dc/Iglesias"
2024,"Getafe","La Liga","Jordi","ESP","MF,DF","23-146",2001,6.4,16,11,3,11,2,7,15,46.7,8,7,2,5,8,24,7,0,"https://fbref.com/en/players/5556d20b/Jordi"
2024,"Getafe","La Liga","Jeremy Jorge","ESP","FW","21-111",2003,0,0,0,0,0,0,0,0,NA,0,0,0,0,0,0,0,0,"https://fbref.com/en/players/454d07c9/Jeremy-Jorge"
2024,"Getafe","La Liga","Juanmi Latasa","ESP","FW","23-068",2001,17.3,9,7,0,6,3,1,11,9.1,10,9,0,9,4,13,21,0,"https://fbref.com/en/players/2bea832e/Juanmi-Latasa"
2024,"Getafe","La Liga","Anthony Lozano","HON","MF,FW","31-035",1993,1,0,0,0,0,0,0,1,0,1,0,0,0,0,0,1,0,"https://fbref.com/en/players/38699c72/Anthony-Lozano"
2024,"Getafe","La Liga","Nemanja Maksimović","SRB","MF","29-125",1995,36.3,65,43,26,31,8,23,41,56.1,18,56,23,33,46,111,61,0,"https://fbref.com/en/players/00b28772/Nemanja-Maksimovic"
2024,"Getafe","La Liga","Jaime Mata","ESP","FW,MF","35-219",1988,19.9,24,15,12,8,4,11,26,42.3,15,18,1,17,17,41,31,0,"https://fbref.com/en/players/02319ad7/Jaime-Mata"
2024,"Getafe","La Liga","Borja Mayoral","ESP","FW","27-055",1997,23.9,9,5,2,2,5,5,22,22.7,17,7,0,7,4,13,16,0,"https://fbref.com/en/players/64e8ed6d/Borja-Mayoral"
2024,"Getafe","La Liga","Luis Milla","ESP","MF","29-236",1994,23.5,57,33,19,28,10,28,47,59.6,19,20,1,19,32,89,10,0,"https://fbref.com/en/players/19c36442/Luis-Milla"
2024,"Getafe","La Liga","Stefan Mitrović","SRB","DF","34-008",1990,7.8,9,3,7,2,0,4,8,50,4,3,2,1,6,15,26,0,"https://fbref.com/en/players/e6777e6b/Stefan-Mitrovic"
2024,"Getafe","La Liga","Ilaix Moriba","GUI","MF,FW","21-132",2003,6.7,20,11,3,11,6,4,9,44.4,5,3,1,2,4,24,10,0,"https://fbref.com/en/players/f4c69aa6/Ilaix-Moriba"
2024,"Getafe","La Liga","Portu","ESP","FW","32-009",1992,1.1,5,3,4,0,1,5,6,83.3,1,0,0,0,0,5,0,0,"https://fbref.com/en/players/1bda5842/Portu"
2024,"Getafe","La Liga","Diego Rico","ESP","DF","31-097",1993,28.2,64,48,32,23,9,41,76,53.9,35,25,8,17,41,105,76,0,"https://fbref.com/en/players/d9ba39fc/Diego-Rico"
2024,"Getafe","La Liga","Alberto Risco","ESP","MF","18-274",2005,1.5,2,2,1,1,0,0,4,0,4,0,0,0,0,2,1,0,"https://fbref.com/en/players/36286814/Alberto-Risco"
2024,"Getafe","La Liga","Gorka Rivera Alonso","ESP","DF","19-303",2004,0,0,0,0,0,0,0,0,NA,0,0,0,0,0,0,0,0,"https://fbref.com/en/players/f1124008/Gorka-Rivera-Alonso"
2024,"Getafe","La Liga","Óscar Rodríguez Arnaiz","ESP","MF,FW","25-337",1998,10.7,24,13,2,15,7,9,15,60,6,12,1,11,5,29,5,0,"https://fbref.com/en/players/19709006/Oscar-Rodriguez-Arnaiz"
2024,"Getafe","La Liga","Jesús Santiago","ESP","MF","20-005",2004,7.3,17,8,8,5,4,4,7,57.1,3,3,0,3,0,17,8,0,"https://fbref.com/en/players/bc49fd34/Jesus-Santiago"
2024,"Getafe","La Liga","David Soria","ESP","GK","31-056",1993,37.9,0,0,0,0,0,0,2,0,2,0,0,0,0,0,21,6,"https://fbref.com/en/players/8f8c6934/David-Soria"
2024,"Getafe","La Liga","Damián Suárez","URU","DF","36-033",1988,14.4,36,21,16,16,4,26,45,57.8,19,13,3,10,10,46,31,0,"https://fbref.com/en/players/ba5004e1/Damian-Suarez"
2024,"Getafe","La Liga","Yassin Tallal","ESP","FW","19-027",2005,0,0,0,0,0,0,0,0,NA,0,0,0,0,0,0,0,0,"https://fbref.com/en/players/8388ba65/Yassin-Tallal"
2024,"Getafe","La Liga","Enes Ünal","TUR","FW,MF","27-020",1997,1.6,0,0,0,0,0,0,0,NA,0,1,0,1,0,0,2,0,"https://fbref.com/en/players/f8eca1b6/Enes-Unal"
2024,"Girona","La Liga","Daley Blind","NED","DF","34-082",1990,33,47,21,33,13,1,29,47,61.7,18,37,19,18,21,68,113,0,"https://fbref.com/en/players/691bef82/Daley-Blind"
2024,"Girona","La Liga","Silvi Clúa","ESP","MF","19-122",2005,0,2,0,2,0,0,2,2,100,0,1,0,1,0,2,0,0,"https://fbref.com/en/players/b793dea2/Silvi-Clua"
2024,"Girona","La Liga","Yan Couto","BRA","DF,FW","21-362",2002,24.9,45,34,25,14,6,20,40,50,20,14,2,12,10,55,31,1,"https://fbref.com/en/players/1944818c/Yan-Couto"
2024,"Girona","La Liga","Artem Dovbyk","UKR","FW","26-344",1997,28.7,4,3,2,1,1,0,2,0,2,8,1,7,0,4,17,0,"https://fbref.com/en/players/5b847bb0/Artem-Dovbyk"
2024,"Girona","La Liga","Bernardo Espinosa","COL","DF","34-324",1989,0,1,1,1,0,0,1,1,100,0,0,0,0,0,1,2,0,"https://fbref.com/en/players/4242011c/Bernardo-Espinosa"
2024,"Girona","La Liga","Valery Fernández","ESP","MF,FW","24-189",1999,5.6,11,9,4,7,0,6,8,75,2,6,1,5,1,12,4,0,"https://fbref.com/en/players/4acd733a/Valery-Fernandez"
2024,"Girona","La Liga","Aleix García","ESP","MF","26-337",1997,35.5,49,28,17,26,6,28,54,51.9,26,45,17,28,36,85,53,3,"https://fbref.com/en/players/a10361d2/Aleix-Garcia"
2024,"Girona","La Liga","Eric García","ESP","DF","23-142",2001,29.3,55,37,34,18,3,34,49,69.4,15,36,18,18,30,85,79,2,"https://fbref.com/en/players/2bed3eab/Eric-Garcia"
2024,"Girona","La Liga","Jastin García","ESP","FW","20-136",2004,0.4,1,0,0,0,1,0,0,NA,0,0,0,0,0,1,1,0,"https://fbref.com/en/players/0302f7b4/Jastin-Garcia"
2024,"Girona","La Liga","Paulo Gazzaniga","ARG","GK","32-149",1992,38,2,2,2,0,0,2,4,50,2,0,0,0,0,2,12,1,"https://fbref.com/en/players/63d17038/Paulo-Gazzaniga"
2024,"Girona","La Liga","Miguel Gutiérrez","ESP","DF","22-308",2001,33.7,29,18,11,14,4,13,35,37.1,22,27,11,16,22,51,66,2,"https://fbref.com/en/players/7e98cff1/Miguel-Gutierrez"
2024,"Girona","La Liga","Yangel Herrera","VEN","MF","26-137",1998,23.4,64,37,28,30,6,30,56,53.6,26,30,8,22,24,88,45,1,"https://fbref.com/en/players/5083a734/Yangel-Herrera"
2024,"Girona","La Liga","Juanpe","ESP","DF","33-030",1991,8.3,11,8,8,3,0,9,10,90,1,17,11,6,7,18,50,1,"https://fbref.com/en/players/1633fc8a/Juanpe"
2024,"Girona","La Liga","Ibrahima Kebe","MLI","MF","23-302",2000,0.1,1,1,0,1,0,0,0,NA,0,1,0,1,1,2,0,0,"https://fbref.com/en/players/047759a0/Ibrahima-Kebe"
2024,"Girona","La Liga","David López","ESP","DF","34-234",1989,21.8,33,20,21,12,0,17,22,77.3,5,28,19,9,20,53,63,4,"https://fbref.com/en/players/f03f284b/David-Lopez"
2024,"Girona","La Liga","Iván Martín","ESP","MF","25-106",1999,30.3,44,25,22,15,7,22,57,38.6,35,25,3,22,21,65,14,0,"https://fbref.com/en/players/ae48c5cb/Ivan-Martin"
2024,"Girona","La Liga","Arnau Martinez","ESP","DF","21-035",2003,13.8,25,16,17,6,2,15,32,46.9,17,15,5,10,10,35,41,3,"https://fbref.com/en/players/c3e66ffe/Arnau-Martinez"
2024,"Girona","La Liga","Portu","ESP","MF,FW","32-009",1992,13.2,18,13,3,10,5,3,18,16.7,15,9,1,8,4,22,6,0,"https://fbref.com/en/players/1bda5842/Portu"
2024,"Girona","La Liga","Sávio","BRA","FW,MF","20-050",2004,33.1,42,25,14,22,6,16,28,57.1,12,34,0,34,18,60,11,1,"https://fbref.com/en/players/fe6e7156/Savio"
2024,"Girona","La Liga","Jhon Solis","COL","MF","19-240",2004,4.3,10,8,4,5,1,4,12,33.3,8,8,3,5,8,18,7,1,"https://fbref.com/en/players/1282939a/Jhon-Solis"
2024,"Girona","La Liga","Cristhian Stuani","URU","FW","37-231",1986,8.9,14,11,4,6,4,4,7,57.1,3,9,2,7,5,19,13,0,"https://fbref.com/en/players/220c11f1/Cristhian-Stuani"
2024,"Girona","La Liga","Pablo Torre","ESP","MF,FW","21-057",2003,7.8,5,2,0,5,0,4,10,40,6,10,2,8,4,9,6,1,"https://fbref.com/en/players/04e531b6/Pablo-Torre"
2024,"Girona","La Liga","Viktor Tsyhankov","UKR","MF,FW","26-197",1997,22.8,29,20,11,13,5,14,26,53.8,12,18,1,17,12,41,24,0,"https://fbref.com/en/players/f7e87032/Viktor-Tsyhankov"
2024,"Girona","La Liga","Toni Villa","ESP","FW","29-144",1995,0.1,0,0,0,0,0,0,0,NA,0,0,0,0,0,0,0,0,"https://fbref.com/en/players/636eae97/Toni-Villa"
2024,"Girona","La Liga","Antal Yaakobishvili","HUN","DF","19-323",2004,0.7,2,1,1,1,0,1,1,100,0,0,0,0,3,5,3,0,"https://fbref.com/en/players/cd59a7e6/Antal-Yaakobishvili"
2024,"Gladbach","Bundesliga","Yvandro Borges Sanches","LUX","MF,FW","20-006",2004,0.2,0,0,0,0,0,0,0,NA,0,0,0,0,0,0,0,0,"https://fbref.com/en/players/36578017/Yvandro-Borges-Sanches"
2024,"Gladbach","Bundesliga","Fabio Chiarodia","ITA","DF","18-360",2005,1.7,8,5,5,1,2,5,7,71.4,2,2,1,1,3,11,9,0,"https://fbref.com/en/players/48780156/Fabio-Chiarodia"
2024,"Gladbach","Bundesliga","Tomáš Čvančara","CZE","FW","23-291",2000,10,4,3,0,2,2,1,3,33.3,2,5,1,4,2,6,8,0,"https://fbref.com/en/players/298c8aa1/Tomas-Cvancara"
2024,"Gladbach","Bundesliga","Nico Elvedi","SUI","DF","27-243",1996,27.6,33,18,22,10,1,18,24,75,6,40,25,15,43,76,150,2,"https://fbref.com/en/players/48035304/Nico-Elvedi"
2024,"Gladbach","Bundesliga","Marvin Friedrich","GER","DF","28-169",1995,17.4,23,15,16,6,1,12,20,60,8,28,20,8,17,40,87,0,"https://fbref.com/en/players/b77f44a4/Marvin-Friedrich"
2024,"Gladbach","Bundesliga","Shiō Fukuda","JPN","FW,MF","20-052",2004,0.4,2,0,1,1,0,1,2,50,1,0,0,0,1,3,0,0,"https://fbref.com/en/players/056a8552/Shio-Fukuda"
2024,"Gladbach","Bundesliga","Robin Hack","GER","FW,MF","25-277",1998,15,15,8,6,7,2,4,17,23.5,13,16,0,16,14,29,21,0,"https://fbref.com/en/players/0174ba21/Robin-Hack"
2024,"Gladbach","Bundesliga","Patrick Herrmann","GER","FW,DF","33-108",1991,1,4,4,2,1,1,2,2,100,0,1,0,1,1,5,2,0,"https://fbref.com/en/players/dfb6490a/Patrick-Herrmann"
2024,"Gladbach","Bundesliga","Franck Honorat","FRA","DF,FW","27-293",1996,26.1,25,13,13,10,2,11,20,55,9,22,3,19,9,34,35,1,"https://fbref.com/en/players/db7849ca/Franck-Honorat"
2024,"Gladbach","Bundesliga","Ko Itakura","JPN","DF,MF","27-124",1997,17.7,34,21,17,15,2,16,26,61.5,10,32,18,14,22,56,62,0,"https://fbref.com/en/players/97d545ae/Ko-Itakura"
2024,"Gladbach","Bundesliga","Tony Jantschke","GER","DF,MF","34-053",1990,0.3,1,1,1,0,0,1,1,100,0,2,2,0,1,2,4,0,"https://fbref.com/en/players/34b54da7/Tony-Jantschke"
2024,"Gladbach","Bundesliga","Manu Koné","FRA","MF","23-013",2001,17.3,45,26,20,20,5,17,25,68,8,22,1,21,15,60,16,1,"https://fbref.com/en/players/86574238/Manu-Kone"
2024,"Gladbach","Bundesliga","Christoph Kramer","GER","MF","33-101",1991,2.8,10,5,5,5,0,2,14,14.3,12,7,1,6,4,14,6,0,"https://fbref.com/en/players/496aeede/Christoph-Kramer"
2024,"Gladbach","Bundesliga","Stefan Lainer","AUT","DF,MF","31-277",1992,8.3,23,16,15,8,0,14,24,58.3,10,13,6,7,5,28,28,0,"https://fbref.com/en/players/4aea5077/Stefan-Lainer"
2024,"Gladbach","Bundesliga","Nathan N'Goumou","FRA","FW,MF","24-077",2000,15.4,37,22,17,18,2,16,34,47.1,18,22,0,22,5,42,17,1,"https://fbref.com/en/players/e110ea4b/Nathan-NGoumou"
2024,"Gladbach","Bundesliga","Luca Netz","GER","DF","21-015",2003,24.7,38,22,19,16,3,23,43,53.5,20,36,10,26,22,60,76,1,"https://fbref.com/en/players/e79269bd/Luca-Netz"
2024,"Gladbach","Bundesliga","Florian Neuhaus","GER","MF","27-075",1997,13.6,15,12,7,8,0,8,26,30.8,18,8,6,2,14,29,8,0,"https://fbref.com/en/players/36a59ba4/Florian-Neuhaus"
2024,"Gladbach","Bundesliga","Moritz Nicolas","GER","GK","26-222",1997,27,1,0,1,0,0,1,3,33.3,2,0,0,0,0,1,12,5,"https://fbref.com/en/players/226ddf9d/Moritz-Nicolas"
2024,"Gladbach","Bundesliga","Jonas Omlin","SUI","GK","30-141",1994,7,1,0,1,0,0,1,1,100,0,0,0,0,0,1,3,0,"https://fbref.com/en/players/c631f952/Jonas-Omlin"
2024,"Gladbach","Bundesliga","Jordan Pefok","USA","FW","28-034",1996,15.8,10,4,0,8,2,3,8,37.5,5,12,3,9,5,15,28,0,"https://fbref.com/en/players/b684a484/Jordan-Pefok"
2024,"Gladbach","Bundesliga","Alassane Pléa","FRA","FW,MF","31-081",1993,21.3,17,7,5,8,4,7,15,46.7,8,11,0,11,2,19,6,0,"https://fbref.com/en/players/bc6bd723/Alassane-Plea"
2024,"Gladbach","Bundesliga","Grant Ranos","ARM","MF,FW","20-315",2003,0.5,1,0,0,0,1,0,0,NA,0,0,0,0,0,1,0,0,"https://fbref.com/en/players/0ee6ea6a/Grant-Ranos"
2024,"Gladbach","Bundesliga","Rocco Reitz","GER","MF","22-001",2002,23.7,61,36,28,29,4,28,55,50.9,27,61,20,41,44,105,31,1,"https://fbref.com/en/players/cc971106/Rocco-Reitz"
2024,"Gladbach","Bundesliga","Joe Scally","USA","DF","21-151",2002,24.8,41,28,21,17,3,23,40,57.5,17,31,11,20,18,59,78,2,"https://fbref.com/en/players/236f02cd/Joe-Scally"
2024,"Gladbach","Bundesliga","Lukas Ullrich","GER","DF,FW","20-075",2004,0.5,1,0,1,0,0,1,4,25,3,0,0,0,0,1,1,0,"https://fbref.com/en/players/d646c218/Lukas-Ullrich"
2024,"Gladbach","Bundesliga","Julian Weigl","GER","MF","28-265",1995,30.7,66,40,28,32,6,41,67,61.2,26,47,14,33,48,114,61,1,"https://fbref.com/en/players/346d51d9/Julian-Weigl"
2024,"Gladbach","Bundesliga","Maximilian Wöber","AUT","DF","26-116",1998,23,66,31,40,25,1,31,53,58.5,22,47,26,21,38,104,111,0,"https://fbref.com/en/players/4b803b3c/Maximilian-Wober"
2024,"Granada","La Liga","Miguel Ángel Rubio","ESP","DF","26-080",1998,17.3,20,12,14,6,0,14,21,66.7,7,31,18,13,28,48,74,2,"https://fbref.com/en/players/56cafd0a/Miguel-Angel-Rubio"
2024,"Granada","La Liga","Matias Arezo","URU","FW","21-191",2002,4.1,7,3,2,5,0,1,5,20,4,4,1,3,1,8,4,0,"https://fbref.com/en/players/484ebdb0/Matias-Arezo"
2024,"Granada","La Liga","Augusto Batalla","ARG","GK","28-030",1996,17,0,0,0,0,0,0,1,0,1,0,0,0,0,0,10,2,"https://fbref.com/en/players/fc627681/Augusto-Batalla"
2024,"Granada","La Liga","Adri Bosch","ESP","DF","22-356",2001,0.3,1,1,1,0,0,0,0,NA,0,0,0,0,0,1,1,0,"https://fbref.com/en/players/cb1e5807/Adri-Bosch"
2024,"Granada","La Liga","Lucas Boyé","ARG","FW","28-092",1996,28.2,50,25,14,25,11,14,34,41.2,20,35,5,30,10,60,46,0,"https://fbref.com/en/players/d49f3e6b/Lucas-Boye"
2024,"Granada","La Liga","Brau","ESP","DF","22-155",2001,0.3,1,0,1,0,0,1,1,100,0,0,0,0,0,1,2,0,"https://fbref.com/en/players/3e707ad4/Brau"
2024,"Granada","La Liga","José Callejón","ESP","MF,FW","37-109",1987,8.9,13,6,10,3,0,8,22,36.4,14,7,1,6,5,18,10,0,"https://fbref.com/en/players/78841da9/Jose-Callejon"
2024,"Granada","La Liga","Álvaro Carreras","ESP","MF,FW","21-068",2003,5.3,13,8,8,4,1,5,11,45.5,6,5,1,4,7,20,9,1,"https://fbref.com/en/players/33a68b9b/Alvaro-Carreras"
2024,"Granada","La Liga","Theo Corbeanu","CAN","MF,FW","22-013",2002,2,5,2,2,3,0,1,3,33.3,2,3,0,3,3,8,2,0,"https://fbref.com/en/players/25b82f9a/Theo-Corbeanu"
2024,"Granada","La Liga","Víctor Díaz","ESP","DF,MF","35-353",1988,1.8,5,3,2,3,0,1,3,33.3,2,1,0,1,1,6,8,0,"https://fbref.com/en/players/3624ce4c/Victor-Diaz"
2024,"Granada","La Liga","Famara Diedhiou","SEN","FW,MF","31-167",1992,1,1,1,0,1,0,0,1,0,1,0,0,0,0,1,2,0,"https://fbref.com/en/players/e447352c/Famara-Diedhiou"
2024,"Granada","La Liga","Raúl Fernández","ESP","GK","36-078",1988,3.1,0,0,0,0,0,0,1,0,1,0,0,0,0,0,1,2,"https://fbref.com/en/players/6fb59070/Raul-Fernandez"
2024,"Granada","La Liga","André Ferreira","POR","GK","28-001",1996,14.9,0,0,0,0,0,0,1,0,1,0,0,0,0,0,9,2,"https://fbref.com/en/players/12c6cbef/Andre-Ferreira"
2024,"Granada","La Liga","Gerard Gumbau","ESP","MF","29-164",1994,29.7,55,34,21,30,4,23,62,37.1,39,24,5,19,25,80,30,2,"https://fbref.com/en/players/ac454a4f/Gerard-Gumbau"
2024,"Granada","La Liga","Martin Hongla","CMR","MF,DF","26-075",1998,6.2,7,3,2,5,0,3,9,33.3,6,6,3,3,6,13,13,1,"https://fbref.com/en/players/b85bf253/Martin-Hongla"
2024,"Granada","La Liga","Kamil Jóźwiak","POL","MF","26-038",1998,6.3,13,10,4,6,3,9,17,52.9,8,4,0,4,2,15,6,0,"https://fbref.com/en/players/bd4e3824/Kamil-Jozwiak"
2024,"Granada","La Liga","Wilson Manafá","POR","DF,MF","29-312",1994,2.7,6,4,3,2,1,4,7,57.1,3,1,0,1,1,7,4,1,"https://fbref.com/en/players/e27fdbca/Wilson-Manafa"
2024,"Granada","La Liga","Faitout Maouassa","FRA","DF,MF","25-329",1998,2.5,8,5,6,1,1,4,5,80,1,6,0,6,1,9,3,0,"https://fbref.com/en/players/e54a9890/Faitout-Maouassa"
2024,"Granada","La Liga","Marc Martínez","ESP","GK","34-056",1990,3,0,0,0,0,0,0,1,0,1,0,0,0,0,0,1,0,"https://fbref.com/en/players/3496ff67/Marc-Martinez"
2024,"Granada","La Liga","Óscar Melendo","ESP","MF,FW","26-281",1997,12.5,14,6,4,10,0,4,12,33.3,8,13,0,13,5,19,4,1,"https://fbref.com/en/players/379652be/Oscar-Melendo"
2024,"Granada","La Liga","Bruno Méndez","URU","DF","24-263",1999,14.8,36,17,19,12,5,21,37,56.8,16,24,6,18,26,62,45,0,"https://fbref.com/en/players/66017b9d/Bruno-Mendez"
2024,"Granada","La Liga","Ignasi Miquel","ESP","DF","31-245",1992,33.2,47,30,39,6,2,23,40,57.5,17,32,16,16,45,92,132,4,"https://fbref.com/en/players/174f09a6/Ignasi-Miquel"
2024,"Granada","La Liga","Carlos Neva","ESP","DF","27-353",1996,35,32,21,22,9,1,17,40,42.5,23,39,14,25,30,62,108,2,"https://fbref.com/en/players/8d47bb39/Carlos-Neva"
2024,"Granada","La Liga","Samuel Omorodion","ESP","FW","20-025",2004,0.9,1,1,0,1,0,1,1,100,0,0,0,0,0,1,0,0,"https://fbref.com/en/players/dc44b03c/Samuel-Omorodion"
2024,"Granada","La Liga","Facundo Pellistri","URU","MF,FW","22-162",2001,13.7,29,19,12,10,7,6,21,28.6,15,18,0,18,4,33,7,0,"https://fbref.com/en/players/ac7e7b1c/Facundo-Pellistri"
2024,"Granada","La Liga","Alberto Perea","ESP","MF,FW","33-163",1990,0,0,0,0,0,0,0,2,0,2,0,0,0,0,0,0,0,"https://fbref.com/en/players/5496cc91/Alberto-Perea"
2024,"Granada","La Liga","Njegoš Petrović","SRB","MF,FW","24-317",1999,1.7,5,2,4,1,0,2,3,66.7,1,2,0,2,1,6,3,0,"https://fbref.com/en/players/0cb29e91/Njegos-Petrovic"
2024,"Granada","La Liga","Kamil Piątkowski","POL","DF","23-344",2000,5.6,18,10,16,1,1,10,14,71.4,4,6,5,1,8,26,28,1,"https://fbref.com/en/players/2cf496fb/Kamil-Piatkowski"
2024,"Granada","La Liga","Antonio Puertas","ESP","MF,FW","32-099",1992,8.1,12,8,6,5,1,6,15,40,9,5,0,5,6,18,4,0,"https://fbref.com/en/players/c77a8043/Antonio-Puertas"
2024,"Granada","La Liga","Sergio Rodelas","ESP","FW,DF","19-181",2004,1.4,3,2,1,0,2,0,3,0,3,0,0,0,0,3,0,0,"https://fbref.com/en/players/2c9e6bc3/Sergio-Rodelas"
2024,"Granada","La Liga","Sergio Ruiz","ESP","MF","29-166",1994,27.7,83,46,43,36,4,38,84,45.2,46,24,6,18,28,111,43,1,"https://fbref.com/en/players/1f423a54/Sergio-Ruiz"
2024,"Granada","La Liga","Pablo Saenz","","FW","",NA,0.2,NA,3,NA,NA,NA,NA,NA,NA,NA,NA,NA,NA,0,NA,NA,NA,"https://fbref.com/en/players/2f9ef1a8/Pablo-Saenz"
2024,"Granada","La Liga","Ricard Sánchez","ESP","DF","24-098",2000,25.5,29,18,15,8,6,12,24,50,12,32,4,28,13,42,64,0,"https://fbref.com/en/players/fce521d7/Ricard-Sanchez"
2024,"Granada","La Liga","Alberto Soro","ESP","MF","25-082",1999,0.1,0,0,0,0,0,0,0,NA,0,0,0,0,0,0,0,0,"https://fbref.com/en/players/452c3055/Alberto-Soro"
2024,"Granada","La Liga","Raúl Torrente","ESP","DF","22-262",2001,13.9,29,16,20,9,0,17,22,77.3,5,16,10,6,11,40,68,2,"https://fbref.com/en/players/4d753a3f/Raul-Torrente"
2024,"Granada","La Liga","Myrto Uzuni","ALB","FW","28-365",1995,27.2,18,14,8,7,3,6,27,22.2,21,19,3,16,4,22,7,0,"https://fbref.com/en/players/01da7812/Myrto-Uzuni"
2024,"Granada","La Liga","Jesús Vallejo","ESP","DF","27-146",1997,1.2,3,1,1,2,0,2,2,100,0,3,2,1,0,3,1,1,"https://fbref.com/en/players/c2111b45/Jesus-Vallejo"
2024,"Granada","La Liga","Gonzalo Villar","ESP","MF","26-068",1998,20,51,33,26,20,5,26,41,63.4,15,32,10,22,6,57,26,1,"https://fbref.com/en/players/bdc74a8f/Gonzalo-Villar"
2024,"Granada","La Liga","Shon Weissman","ISR","FW","28-106",1996,0.9,1,1,0,0,1,1,4,25,3,3,0,3,0,1,1,0,"https://fbref.com/en/players/379dc075/Shon-Weissman"
2024,"Granada","La Liga","Bryan Zaragoza","ESP","MF,FW","23-035",2001,18.2,18,9,8,6,4,8,23,34.8,15,9,0,9,3,21,3,0,"https://fbref.com/en/players/a96103b2/Bryan-Zaragoza"
2024,"Heidenheim","Bundesliga","Adrian Beck","GER","MF,FW","26-356",1997,10.8,22,13,8,12,2,9,24,37.5,15,17,0,17,4,26,15,0,"https://fbref.com/en/players/616c09f5/Adrian-Beck"
2024,"Heidenheim","Bundesliga","Jan-Niklas Beste","GER","FW,MF","25-147",1999,28.9,77,49,35,24,18,28,55,50.9,27,48,1,47,18,95,31,0,"https://fbref.com/en/players/57382429/Jan-Niklas-Beste"
2024,"Heidenheim","Bundesliga","Marnon Busch","GER","DF","29-174",1994,6.6,11,9,6,3,2,7,12,58.3,5,9,2,7,10,21,12,0,"https://fbref.com/en/players/c38767ab/Marnon-Busch"
2024,"Heidenheim","Bundesliga","Eren Dinkçi","GER","FW,MF","22-169",2001,29.4,32,18,16,13,3,19,48,39.6,29,40,4,36,12,44,21,0,"https://fbref.com/en/players/4ccd8957/Eren-Dinkci"
2024,"Heidenheim","Bundesliga","Nikola Dovedan","AUT","MF,FW","29-329",1994,7.3,14,9,2,10,2,5,25,20,20,9,0,9,1,15,3,0,"https://fbref.com/en/players/57d9f511/Nikola-Dovedan"
2024,"Heidenheim","Bundesliga","Jonas Föhrenbach","GER","DF","28-125",1996,31,44,24,24,14,6,19,36,52.8,17,34,19,15,31,75,70,0,"https://fbref.com/en/players/1b4be8eb/Jonas-Fohrenbach"
2024,"Heidenheim","Bundesliga","Benedikt Gimber","GER","DF","27-101",1997,22.5,40,24,25,14,1,19,35,54.3,16,27,17,10,16,56,101,1,"https://fbref.com/en/players/e5f76710/Benedikt-Gimber"
2024,"Heidenheim","Bundesliga","Thomas Keller","GER","MF,FW","24-299",1999,0,0,0,0,0,0,0,0,NA,0,0,0,0,0,0,0,0,"https://fbref.com/en/players/285c7011/Thomas-Keller"
2024,"Heidenheim","Bundesliga","Tim Kleindienst","GER","FW","28-273",1995,31.9,21,12,6,11,4,7,25,28,18,32,8,24,12,33,58,0,"https://fbref.com/en/players/258a6f4d/Tim-Kleindienst"
2024,"Heidenheim","Bundesliga","Christian Kühlwetter","GER","MF","28-039",1996,0.1,0,0,0,0,0,0,0,NA,0,0,0,0,0,0,0,0,"https://fbref.com/en/players/2a73f18d/Christian-Kuhlwetter"
2024,"Heidenheim","Bundesliga","Patrick Mainka","GER","DF","29-206",1994,34,85,49,58,24,3,38,74,51.4,36,66,32,34,49,134,158,1,"https://fbref.com/en/players/dd9caa07/Patrick-Mainka"
2024,"Heidenheim","Bundesliga","Lennard Maloney","USA","MF","24-235",1999,25.4,43,26,14,24,5,25,59,42.4,34,33,9,24,25,68,88,0,"https://fbref.com/en/players/75402e99/Lennard-Maloney"
2024,"Heidenheim","Bundesliga","Kevin Müller","GER","GK","33-076",1991,34,3,0,3,0,0,3,5,60,2,0,0,0,0,3,6,1,"https://fbref.com/en/players/f256f213/Kevin-Muller"
2024,"Heidenheim","Bundesliga","Florian Pick","GER","MF,FW","28-265",1995,3.6,4,4,3,0,1,2,3,66.7,1,2,0,2,2,6,2,0,"https://fbref.com/en/players/00e36323/Florian-Pick"
2024,"Heidenheim","Bundesliga","Marvin Pieringer","GER","MF,FW","24-239",1999,16.8,19,12,5,11,3,8,20,40,12,28,4,24,12,31,21,0,"https://fbref.com/en/players/11407d95/Marvin-Pieringer"
2024,"Heidenheim","Bundesliga","Stefan Schimmer","GER","MF,FW","30-032",1994,1.7,1,1,0,1,0,0,3,0,3,2,0,2,1,2,6,0,"https://fbref.com/en/players/395bbb60/Stefan-Schimmer"
2024,"Heidenheim","Bundesliga","Jan Schöppner","GER","MF","24-353",1999,22.2,48,26,26,20,2,21,42,50,21,37,7,30,26,74,57,0,"https://fbref.com/en/players/932bfcac/Jan-Schoppner"
2024,"Heidenheim","Bundesliga","Kevin Sessa","GER","MF,FW","23-329",2000,11.2,17,10,9,6,2,7,16,43.8,9,12,1,11,4,21,17,0,"https://fbref.com/en/players/fd82af8c/Kevin-Sessa"
2024,"Heidenheim","Bundesliga","Tim Siersleben","GER","DF","24-082",2000,10.1,27,11,21,6,0,8,20,40,12,16,10,6,21,48,29,1,"https://fbref.com/en/players/f761c901/Tim-Siersleben"
2024,"Heidenheim","Bundesliga","Norman Theuerkauf","GER","MF,DF","37-127",1987,14,24,16,13,7,4,13,22,59.1,9,16,6,10,14,38,21,0,"https://fbref.com/en/players/0cbf4c54/Norman-Theuerkauf"
2024,"Heidenheim","Bundesliga","Denis Thomalla","GER","MF,FW","31-288",1992,5,9,6,4,4,1,5,11,45.5,6,3,2,1,4,13,13,0,"https://fbref.com/en/players/b9ac6e0e/Denis-Thomalla"
2024,"Heidenheim","Bundesliga","Omar Traoré","GER","DF","26-116",1998,27.5,60,33,33,21,6,32,56,57.1,24,32,7,25,40,100,54,1,"https://fbref.com/en/players/f44e8a73/Omar-Traore"
2024,"Hellas Verona","Serie A","Bruno Amione","ARG","DF","22-148",2002,6.4,11,3,9,2,0,4,5,80,1,4,2,2,9,20,19,2,"https://fbref.com/en/players/2df7cc43/Bruno-Amione"
2024,"Hellas Verona","Serie A","Daniel Bandeira","POR","MF","24-049",2000,5,6,5,1,4,1,3,7,42.9,4,3,0,3,3,9,9,0,"https://fbref.com/en/players/56fca564/Daniel-Bandeira"
2024,"Hellas Verona","Serie A","Reda Belahyane","FRA","MF","19-364",2004,1,1,1,0,1,0,1,1,100,0,0,0,0,1,2,0,0,"https://fbref.com/en/players/705a1642/Reda-Belahyane"
2024,"Hellas Verona","Serie A","Federico Bonazzoli","ITA","FW,MF","27-009",1997,11.3,4,1,1,3,0,1,8,12.5,7,9,1,8,3,7,3,0,"https://fbref.com/en/players/bf57eaab/Federico-Bonazzoli"
2024,"Hellas Verona","Serie A","Fabien Centonze","FRA","DF","28-135",1996,7.5,14,8,10,4,0,5,10,50,5,14,2,12,10,24,18,0,"https://fbref.com/en/players/3c6bbbab/Fabien-Centonze"
2024,"Hellas Verona","Serie A","Charlys","BRA","MF","20-101",2004,0.3,0,0,0,0,0,0,0,NA,0,0,0,0,1,1,0,0,"https://fbref.com/en/players/eff9c9ea/Charlys"
2024,"Hellas Verona","Serie A","Alphadjo Cissè","ITA","FW","17-221",2006,0.1,0,0,0,0,0,0,0,NA,0,0,0,0,0,0,0,0,"https://fbref.com/en/players/d079becb/Alphadjo-Cisse"
2024,"Hellas Verona","Serie A","Diego Coppola","ITA","DF","20-154",2003,18.2,36,22,25,9,2,20,33,60.6,13,26,9,17,27,63,89,1,"https://fbref.com/en/players/22ae86f9/Diego-Coppola"
2024,"Hellas Verona","Serie A","Juan Cruz","ARG","FW,MF","24-316",1999,1.2,2,2,0,0,2,0,0,NA,0,1,0,1,1,3,0,0,"https://fbref.com/en/players/72f5b81f/Juan-Cruz"
2024,"Hellas Verona","Serie A","Juan David Cabal","COL","DF","23-143",2001,16.6,36,27,19,14,3,18,29,62.1,11,30,9,21,26,62,55,2,"https://fbref.com/en/players/ef6eef89/Juan-David-Cabal"
2024,"Hellas Verona","Serie A","Paweł Dawidowicz","POL","DF","29-010",1995,23.8,53,30,33,18,2,17,29,58.6,12,17,9,8,24,77,114,1,"https://fbref.com/en/players/16bb656a/Pawel-Dawidowicz"
2024,"Hellas Verona","Serie A","Josh Doig","SCO","DF","22-012",2002,9.2,16,9,9,7,0,13,17,76.5,4,12,3,9,4,20,17,1,"https://fbref.com/en/players/2f69d881/Josh-Doig"
2024,"Hellas Verona","Serie A","Ondrej Duda","SVK","MF","29-177",1994,27.3,59,39,17,35,7,31,52,59.6,21,29,12,17,26,85,21,0,"https://fbref.com/en/players/79ca3e23/Ondrej-Duda"
2024,"Hellas Verona","Serie A","Davide Faraoni","ITA","DF","32-218",1991,6.7,13,10,5,6,2,7,10,70,3,9,5,4,6,19,21,0,"https://fbref.com/en/players/aae9d04a/Davide-Faraoni"
2024,"Hellas Verona","Serie A","Michael Folorunsho","ITA","MF,FW","26-113",1998,30.9,50,28,21,22,7,23,57,40.4,34,45,12,33,17,67,44,2,"https://fbref.com/en/players/c391a179/Michael-Folorunsho"
2024,"Hellas Verona","Serie A","Thomas Henry","FRA","FW","29-253",1994,3.7,0,0,0,0,0,0,0,NA,0,0,0,0,0,0,5,0,"https://fbref.com/en/players/9ef42479/Thomas-Henry"
2024,"Hellas Verona","Serie A","Isak Hien","SWE","DF","25-138",1999,9.6,17,10,10,7,0,10,19,52.6,9,12,5,7,7,24,33,1,"https://fbref.com/en/players/12806697/Isak-Hien"
2024,"Hellas Verona","Serie A","Martin Hongla","CMR","MF","26-075",1998,12,24,13,9,13,2,8,11,72.7,3,8,3,5,7,31,24,0,"https://fbref.com/en/players/b85bf253/Martin-Hongla"
2024,"Hellas Verona","Serie A","Yayah Kallon","SLE","FW","22-335",2001,0,0,0,0,0,0,0,0,NA,0,0,0,0,0,0,0,0,"https://fbref.com/en/players/f95f49d2/Yayah-Kallon"
2024,"Hellas Verona","Serie A","Darko Lazović","SRB","FW,MF","33-258",1990,21.4,26,16,11,6,9,16,31,51.6,15,10,1,9,6,32,14,0,"https://fbref.com/en/players/5128bde4/Darko-Lazovic"
2024,"Hellas Verona","Serie A","Giangiacomo Magnani","ITA","DF","28-239",1995,27.2,33,18,23,10,0,15,25,60,10,50,28,22,45,78,118,0,"https://fbref.com/en/players/cce9f582/Giangiacomo-Magnani"
2024,"Hellas Verona","Serie A","Jordi Mboula","ESP","FW,MF","25-075",1999,3.4,4,4,1,2,1,4,7,57.1,3,4,1,3,1,5,0,0,"https://fbref.com/en/players/4887118d/Jordi-Mboula"
2024,"Hellas Verona","Serie A","Stefan Mitrović","SRB","FW,MF","21-289",2002,4.3,6,3,0,5,1,2,5,40,3,6,1,5,0,6,4,0,"https://fbref.com/en/players/232b3da4/Stefan-Mitrovic"
2024,"Hellas Verona","Serie A","Lorenzo Montipò","ITA","GK","28-100",1996,37,1,1,1,0,0,1,3,33.3,2,0,0,0,0,1,25,2,"https://fbref.com/en/players/c1d95617/Lorenzo-Montipo"
2024,"Hellas Verona","Serie A","Cyril Ngonge","BEL","FW,MF","24-004",2000,15.9,14,9,5,3,6,5,14,35.7,9,7,1,6,4,18,10,0,"https://fbref.com/en/players/2b8360f1/Cyril-Ngonge"
2024,"Hellas Verona","Serie A","Tijjani Noslin","NED","FW,MF","24-328",1999,14.9,18,8,5,7,6,6,16,37.5,10,17,2,15,2,20,14,0,"https://fbref.com/en/players/2f067cf2/Tijjani-Noslin"
2024,"Hellas Verona","Serie A","Simone Perilli","ITA","GK","29-144",1995,1,0,0,0,0,0,0,0,NA,0,0,0,0,0,0,0,0,"https://fbref.com/en/players/b9e11c1d/Simone-Perilli"
2024,"Hellas Verona","Serie A","Riccardo Saponara","ITA","FW,MF","32-161",1991,3.8,3,1,2,0,1,1,7,14.3,6,4,0,4,0,3,2,0,"https://fbref.com/en/players/3bb7af3b/Riccardo-Saponara"
2024,"Hellas Verona","Serie A","Suat Serdar","GER","MF","27-049",1997,18.4,51,39,24,23,4,22,45,48.9,23,29,7,22,20,71,25,1,"https://fbref.com/en/players/b3325a30/Suat-Serdar"
2024,"Hellas Verona","Serie A","Tomáš Suslov","SVK","MF,FW","21-358",2002,23.2,42,30,11,22,9,15,47,31.9,32,15,0,15,6,48,8,0,"https://fbref.com/en/players/83fe71b8/Tomas-Suslov"
2024,"Hellas Verona","Serie A","Karol Świderski","POL","FW,MF","27-128",1997,5.6,7,3,1,3,3,2,3,66.7,1,6,4,2,1,8,8,0,"https://fbref.com/en/players/41723204/Karol-Swiderski"
2024,"Hellas Verona","Serie A","Elayis Tavsan","NED","MF,FW","23-030",2001,0.6,0,0,0,0,0,0,1,0,1,0,0,0,0,0,1,0,"https://fbref.com/en/players/928143e7/Elayis-Tavsan"
2024,"Hellas Verona","Serie A","Jackson Tchatchoua","CMR","DF","22-259",2001,19.2,39,26,25,12,2,23,48,47.9,25,17,7,10,23,62,49,2,"https://fbref.com/en/players/aeca7743/Jackson-Tchatchoua"
2024,"Hellas Verona","Serie A","Filippo Terracciano","ITA","DF","21-112",2003,14.4,30,19,23,6,1,17,31,54.8,14,24,6,18,20,50,17,0,"https://fbref.com/en/players/5cbb5ad6/Filippo-Terracciano"
2024,"Hellas Verona","Serie A","Rúben Vinagre","POR","DF,FW","25-051",1999,3.1,4,2,1,1,2,3,4,75,1,6,3,3,1,5,4,0,"https://fbref.com/en/players/b937e490/Ruben-Vinagre"
2024,"Hellas Verona","Serie A","Milan Đurić","BIH","FW","34-008",1990,13.4,1,0,0,0,1,0,3,0,3,0,0,0,1,2,13,0,"https://fbref.com/en/players/405f6586/Milan-Djuric"
2024,"Hoffenheim","Bundesliga","Kevin Akpoguma","NGA","DF","29-041",1995,12.2,35,18,22,12,1,26,35,74.3,9,28,8,20,18,53,32,0,"https://fbref.com/en/players/6ec6fde0/Kevin-Akpoguma"
2024,"Hoffenheim","Bundesliga","Oliver Baumann","GER","GK","33-363",1990,34,1,1,1,0,0,1,2,50,1,0,0,0,0,1,19,2,"https://fbref.com/en/players/47064058/Oliver-Baumann"
2024,"Hoffenheim","Bundesliga","Ihlas Bebou","TOG","FW,DF","30-037",1994,18.2,22,12,10,8,4,8,16,50,8,13,2,11,14,36,15,0,"https://fbref.com/en/players/a53b661f/Ihlas-Bebou"
2024,"Hoffenheim","Bundesliga","Maximilian Beier","GER","FW,MF","21-226",2002,26.9,20,12,5,11,4,4,19,21.1,15,21,1,20,9,29,12,0,"https://fbref.com/en/players/5db45ee5/Maximilian-Beier"
2024,"Hoffenheim","Bundesliga","Mergim Berisha","GER","FW","26-019",1998,1.6,0,0,0,0,0,0,0,NA,0,2,1,1,0,0,0,0,"https://fbref.com/en/players/eb6e14be/Mergim-Berisha"
2024,"Hoffenheim","Bundesliga","Tom Bischof","GER","MF,FW","18-337",2005,2,8,4,6,1,1,2,9,22.2,7,3,0,3,1,9,2,0,"https://fbref.com/en/players/07d3bfec/Tom-Bischof"
2024,"Hoffenheim","Bundesliga","John Brooks","USA","DF","31-123",1993,17.1,28,15,17,10,1,15,30,50,15,29,17,12,27,55,109,1,"https://fbref.com/en/players/e27da244/John-Brooks"
2024,"Hoffenheim","Bundesliga","Marius Bülter","GER","DF,FW","31-062",1993,15,18,11,9,5,4,12,23,52.2,11,17,3,14,10,28,20,0,"https://fbref.com/en/players/ab5b7dc1/Marius-Bulter"
2024,"Hoffenheim","Bundesliga","Bambasé Conté","GER","MF,FW","20-328",2003,0.5,3,3,2,0,1,1,1,100,0,0,0,0,0,3,0,0,"https://fbref.com/en/players/33b38f49/Bambase-Conte"
2024,"Hoffenheim","Bundesliga","Tim Drexler","GER","DF","19-085",2005,6.4,16,9,12,4,0,8,17,47.1,9,12,8,4,8,24,14,0,"https://fbref.com/en/players/0911b4fc/Tim-Drexler"
2024,"Hoffenheim","Bundesliga","Dennis Geiger","GER","MF","25-355",1998,0.7,1,0,1,0,0,0,0,NA,0,1,1,0,0,1,0,0,"https://fbref.com/en/players/37f606f0/Dennis-Geiger"
2024,"Hoffenheim","Bundesliga","Florian Grillitsch","AUT","DF,MF","28-297",1995,25.5,54,28,31,19,4,22,54,40.7,32,41,20,21,52,106,90,2,"https://fbref.com/en/players/ffbbc83b/Florian-Grillitsch"
2024,"Hoffenheim","Bundesliga","David Jurásek","CZE","DF","23-297",2000,5.5,14,11,13,1,0,7,17,41.2,10,7,2,5,3,17,22,1,"https://fbref.com/en/players/d7a03bf3/David-Jurasek"
2024,"Hoffenheim","Bundesliga","Julian Justvan","GER","FW,MF","26-058",1998,0.5,1,0,1,0,0,1,2,50,1,1,0,1,0,1,0,0,"https://fbref.com/en/players/ab1a72b4/Julian-Justvan"
2024,"Hoffenheim","Bundesliga","Ozan Kabak","TUR","DF","24-066",2000,25.4,48,35,32,14,2,19,33,57.6,14,43,21,22,46,94,106,2,"https://fbref.com/en/players/2d61d13a/Ozan-Kabak"
2024,"Hoffenheim","Bundesliga","Pavel Kadeřábek","CZE","DF,FW","32-035",1992,26.8,31,19,10,15,6,18,40,45,22,22,8,14,23,54,68,0,"https://fbref.com/en/players/79c90e45/Pavel-Kaderabek"
2024,"Hoffenheim","Bundesliga","Andrej Kramarić","CRO","MF,FW","32-346",1991,24.4,11,2,5,4,2,6,13,46.2,7,14,2,12,10,21,12,2,"https://fbref.com/en/players/603cb947/Andrej-Kramaric"
2024,"Hoffenheim","Bundesliga","Max Moerstedt","GER","DF,FW","",NA,0.1,0,0,0,0,0,0,1,0,1,0,0,0,0,0,0,0,"https://fbref.com/en/players/710045fb/Max-Moerstedt"
2024,"Hoffenheim","Bundesliga","Stanley N'Soki","FRA","DF","25-051",1999,7,21,10,12,8,1,17,29,58.6,12,13,2,11,8,29,33,0,"https://fbref.com/en/players/61590953/Stanley-NSoki"
2024,"Hoffenheim","Bundesliga","Kasim Nuhu","GHA","DF","28-343",1995,0.1,0,0,0,0,0,0,0,NA,0,0,0,0,0,0,0,0,"https://fbref.com/en/players/93a50d2c/Kasim-Nuhu"
2024,"Hoffenheim","Bundesliga","Finn Ole Becker","GER","MF","23-357",2000,6.7,10,9,8,2,0,4,17,23.5,13,9,1,8,1,11,10,0,"https://fbref.com/en/players/dd2e62da/Finn-Ole-Becker"
2024,"Hoffenheim","Bundesliga","Grischa Prömel","GER","MF","29-142",1995,23.8,32,18,11,15,6,14,32,43.8,18,22,6,16,22,54,36,0,"https://fbref.com/en/players/924f9191/Grischa-Promel"
2024,"Hoffenheim","Bundesliga","Diadie Samassékou","MLI","MF","28-140",1996,0,0,0,0,0,0,0,0,NA,0,0,0,0,1,1,0,0,"https://fbref.com/en/players/08593525/Diadie-Samassekou"
2024,"Hoffenheim","Bundesliga","Robert Skov","DEN","DF,FW","28-010",1996,14,24,16,15,8,1,17,36,47.2,19,17,4,13,10,34,23,1,"https://fbref.com/en/players/ff98492b/Robert-Skov"
2024,"Hoffenheim","Bundesliga","Anton Stach","GER","MF","25-197",1998,25.8,73,42,40,27,6,33,63,52.4,30,38,12,26,72,145,67,1,"https://fbref.com/en/players/0f59a7bf/Anton-Stach"
2024,"Hoffenheim","Bundesliga","Angelo Stiller","GER","MF","23-056",2001,0.9,0,0,0,0,0,0,1,0,1,2,0,2,0,0,3,0,"https://fbref.com/en/players/3b1ed320/Angelo-Stiller"
2024,"Hoffenheim","Bundesliga","Attila Szalai","HUN","DF","26-131",1998,3.2,3,1,3,0,0,1,4,25,3,6,2,4,1,4,7,0,"https://fbref.com/en/players/50ff205b/Attila-Szalai"
2024,"Hoffenheim","Bundesliga","Umut Tohumcu","GER","MF","19-293",2004,11.2,16,12,9,7,0,6,19,31.6,13,11,1,10,6,22,12,0,"https://fbref.com/en/players/e547d3cf/Umut-Tohumcu"
2024,"Hoffenheim","Bundesliga","Kevin Vogt","GER","DF","32-250",1991,14.7,14,10,7,7,0,8,13,61.5,5,16,13,3,9,23,54,0,"https://fbref.com/en/players/1d8e9add/Kevin-Vogt"
2024,"Hoffenheim","Bundesliga","Wout Weghorst","NED","FW","31-297",1992,22,13,6,4,7,2,9,15,60,6,25,8,17,6,19,24,0,"https://fbref.com/en/players/c4e87b8b/Wout-Weghorst"
2024,"Inter","Serie A","Francesco Acerbi","ITA","DF","36-110",1988,26.5,22,13,16,6,0,11,14,78.6,3,20,13,7,32,54,77,1,"https://fbref.com/en/players/b96b595c/Francesco-Acerbi"
2024,"Inter","Serie A","Lucien Agoume","FRA","MF","22-111",2002,0.1,0,0,0,0,0,0,0,NA,0,0,0,0,0,0,0,0,"https://fbref.com/en/players/8bc8829a/Lucien-Agoume"
2024,"Inter","Serie A","Ebenezer Akinsanmiro","NGA","MF","19-187",2004,0.2,0,0,0,0,0,0,1,0,1,0,0,0,0,0,0,0,"https://fbref.com/en/players/3ad34015/Ebenezer-Akinsanmiro"
2024,"Inter","Serie A","Marko Arnautović","AUT","FW","35-041",1989,8.9,10,4,3,5,2,4,7,57.1,3,8,1,7,5,15,5,0,"https://fbref.com/en/players/00459419/Marko-Arnautovic"
2024,"Inter","Serie A","Kristjan Asllani","ALB","MF","22-082",2002,8.7,7,2,3,4,0,2,11,18.2,9,9,3,6,11,18,8,0,"https://fbref.com/en/players/0fdcef0e/Kristjan-Asllani"
2024,"Inter","Serie A","Emil Audero","ITA","GK","27-133",1997,3.7,0,0,0,0,0,0,0,NA,0,0,0,0,0,0,1,0,"https://fbref.com/en/players/649b01d8/Emil-Audero"
2024,"Inter","Serie A","Carlos Augusto","BRA","DF","25-144",1999,19.2,29,21,20,9,0,15,22,68.2,7,20,8,12,16,45,52,0,"https://fbref.com/en/players/8d3cd59d/Carlos-Augusto"
2024,"Inter","Serie A","Yann Aurel Bisseck","GER","DF","23-183",2000,10,14,6,10,3,1,6,9,66.7,3,10,7,3,5,19,23,0,"https://fbref.com/en/players/3963c25b/Yann-Aurel-Bisseck"
2024,"Inter","Serie A","Nicolò Barella","ITA","MF","27-113",1997,31.6,46,30,17,20,9,19,63,30.2,44,31,1,30,10,56,12,1,"https://fbref.com/en/players/6928979a/Nicolo-Barella"
2024,"Inter","Serie A","Alessandro Bastoni","ITA","DF","25-047",1999,25.2,46,33,31,12,3,26,40,65,14,25,11,14,23,69,48,1,"https://fbref.com/en/players/75b86fb3/Alessandro-Bastoni"
2024,"Inter","Serie A","Tajon Buchanan","CAN","DF","25-112",1999,1.8,1,1,0,0,1,1,2,50,1,1,0,1,0,1,4,0,"https://fbref.com/en/players/3aca6420/Tajon-Buchanan"
2024,"Inter","Serie A","Hakan Çalhanoğlu","TUR","MF","30-112",1994,28.4,66,33,29,29,8,32,49,65.3,17,29,13,16,24,90,22,0,"https://fbref.com/en/players/cd0fa27b/Hakan-Calhanoglu"
2024,"Inter","Serie A","Juan Cuadrado","COL","DF","36-004",1988,3,4,3,2,2,0,3,5,60,2,6,1,5,1,5,2,0,"https://fbref.com/en/players/0ab1f153/Juan-Cuadrado"
2024,"Inter","Serie A","Matteo Darmian","ITA","DF","34-180",1989,26.7,48,22,23,15,10,20,53,37.7,33,27,11,16,13,61,55,0,"https://fbref.com/en/players/96e0490d/Matteo-Darmian"
2024,"Inter","Serie A","Raffaele Di Gennaro","ITA","GK","30-240",1993,0.3,0,0,0,0,0,0,0,NA,0,0,0,0,0,0,0,0,"https://fbref.com/en/players/7a4050d5/Raffaele-Di-Gennaro"
2024,"Inter","Serie A","Federico Dimarco","ITA","DF","26-202",1997,23.1,42,25,19,14,9,17,35,48.6,18,18,3,15,9,51,34,1,"https://fbref.com/en/players/970b8574/Federico-Dimarco"
2024,"Inter","Serie A","Denzel Dumfries","NED","DF","28-042",1996,18.2,22,13,9,11,2,9,23,39.1,14,15,6,9,12,34,33,1,"https://fbref.com/en/players/481c9ece/Denzel-Dumfries"
2024,"Inter","Serie A","Davide Frattesi","ITA","MF","24-221",1999,10.6,10,6,3,7,0,4,8,50,4,9,3,6,5,15,19,0,"https://fbref.com/en/players/2a7d27c1/Davide-Frattesi"
2024,"Inter","Serie A","Davy Klaassen","NED","MF","31-099",1993,2.3,4,2,0,4,0,1,3,33.3,2,5,1,4,3,7,4,0,"https://fbref.com/en/players/15fd5593/Davy-Klaassen"
2024,"Inter","Serie A","Lautaro Martínez","ARG","FW","26-282",1997,29.5,22,16,4,13,5,4,19,21.1,15,30,1,29,20,42,10,0,"https://fbref.com/en/players/f7036e1c/Lautaro-Martinez"
2024,"Inter","Serie A","Henrikh Mkhitaryan","ARM","MF","35-130",1989,30.9,62,34,18,35,9,24,49,49,25,23,4,19,29,91,43,0,"https://fbref.com/en/players/dd0daf32/Henrikh-Mkhitaryan"
2024,"Inter","Serie A","Benjamin Pavard","FRA","DF","28-063",1996,18.6,34,21,21,11,2,20,24,83.3,4,25,15,10,32,66,44,1,"https://fbref.com/en/players/45a03961/Benjamin-Pavard"
2024,"Inter","Serie A","Alexis Sánchez","CHI","FW,MF","35-163",1988,8.5,7,6,0,5,2,1,4,25,3,4,1,3,1,8,3,0,"https://fbref.com/en/players/2c0f8e9e/Alexis-Sanchez"
2024,"Inter","Serie A","Stefano Sensi","ITA","MF","28-299",1995,0.5,1,1,0,1,0,1,3,33.3,2,1,0,1,1,2,0,0,"https://fbref.com/en/players/b70bde8f/Stefano-Sensi"
2024,"Inter","Serie A","Yann Sommer","SUI","GK","35-165",1988,34,2,1,2,0,0,2,2,100,0,1,0,1,0,2,7,1,"https://fbref.com/en/players/420c18a1/Yann-Sommer"
2024,"Inter","Serie A","Marcus Thuram","FRA","FW","26-298",1997,29.9,23,15,9,9,5,4,13,30.8,9,26,3,23,4,27,19,0,"https://fbref.com/en/players/6f8cd6d0/Marcus-Thuram"
2024,"Inter","Serie A","Stefan de Vrij","NED","DF","32-115",1992,17.6,18,13,13,4,1,8,15,53.3,7,22,10,12,24,42,51,0,"https://fbref.com/en/players/d0d8dd44/Stefan-de-Vrij"
2024,"Juventus","Serie A","Carlos Alcaraz","ARG","MF","21-182",2002,4.2,6,6,0,6,0,5,10,50,5,5,2,3,5,11,4,0,"https://fbref.com/en/players/4abac767/Carlos-Alcaraz"
2024,"Juventus","Serie A","Gleison Bremer","BRA","DF","27-073",1997,35.9,58,42,32,21,5,21,29,72.4,8,45,27,18,40,98,147,0,"https://fbref.com/en/players/5fd5ed86/Gleison-Bremer"
2024,"Juventus","Serie A","Andrea Cambiaso","ITA","DF,FW","24-100",2000,26.4,47,30,23,15,9,25,43,58.1,18,28,3,25,11,58,26,1,"https://fbref.com/en/players/247ed022/Andrea-Cambiaso"
2024,"Juventus","Serie A","Leonardo Cerri","ITA","DF","21-087",2003,0.1,0,0,0,0,0,0,0,NA,0,0,0,0,0,0,0,0,"https://fbref.com/en/players/58e08f40/Leonardo-Cerri"
2024,"Juventus","Serie A","Federico Chiesa","ITA","FW","26-218",1997,24.4,20,10,7,6,7,3,13,23.1,10,17,1,16,6,26,4,0,"https://fbref.com/en/players/b0f7e36c/Federico-Chiesa"
2024,"Juventus","Serie A","Danilo","BRA","DF","32-320",1991,27.2,60,36,38,18,4,32,48,66.7,16,34,15,19,37,97,94,0,"https://fbref.com/en/players/94b2001f/Danilo"
2024,"Juventus","Serie A","Mattia De Sciglio","ITA","DF","31-223",1992,0.5,0,0,0,0,0,0,0,NA,0,1,0,1,1,1,2,0,"https://fbref.com/en/players/ae4e2852/Mattia-De-Sciglio"
2024,"Juventus","Serie A","Tiago Djaló","POR","DF","24-051",2000,0.2,0,0,0,0,0,0,0,NA,0,1,0,1,0,0,1,0,"https://fbref.com/en/players/b2336681/Tiago-Djalo"
2024,"Juventus","Serie A","Nicolò Fagioli","ITA","MF","23-108",2001,4.9,5,3,1,3,1,3,7,42.9,4,3,0,3,4,9,1,0,"https://fbref.com/en/players/366be751/Nicolo-Fagioli"
2024,"Juventus","Serie A","Federico Gatti","ITA","DF","25-341",1998,29.3,33,19,16,16,1,19,24,79.2,5,26,15,11,19,52,90,1,"https://fbref.com/en/players/18dd3219/Federico-Gatti"
2024,"Juventus","Serie A","Dean Huijsen","ESP","DF","19-046",2005,0.1,0,0,0,0,0,0,0,NA,0,0,0,0,0,0,1,0,"https://fbref.com/en/players/87278bce/Dean-Huijsen"
2024,"Juventus","Serie A","Samuel Iling-Junior","ENG","DF,MF","20-239",2003,9,23,13,9,11,3,11,18,61.1,7,17,5,12,6,29,19,0,"https://fbref.com/en/players/ba492306/Samuel-Iling-Junior"
2024,"Juventus","Serie A","Moise Kean","ITA","FW","24-092",2000,7.3,7,4,3,2,2,1,3,33.3,2,4,1,3,2,9,5,0,"https://fbref.com/en/players/3d50bcdb/Moise-Kean"
2024,"Juventus","Serie A","Filip Kostić","SRB","DF","31-211",1992,20.2,37,23,20,13,4,17,33,51.5,16,29,8,21,9,46,43,0,"https://fbref.com/en/players/b1cd37e6/Filip-Kostic"
2024,"Juventus","Serie A","Manuel Locatelli","ITA","MF","26-143",1998,33.4,69,43,24,35,10,31,58,53.4,27,43,17,26,25,94,65,0,"https://fbref.com/en/players/a8a874f1/Manuel-Locatelli"
2024,"Juventus","Serie A","Weston McKennie","USA","MF,DF","25-276",1998,28.8,48,29,31,11,6,17,27,63,10,28,7,21,18,66,69,0,"https://fbref.com/en/players/01c3aff5/Weston-McKennie"
2024,"Juventus","Serie A","Arkadiusz Milik","POL","FW","30-092",1994,10.2,9,5,2,5,2,3,5,60,2,7,1,6,5,14,3,0,"https://fbref.com/en/players/85613cf0/Arkadiusz-Milik"
2024,"Juventus","Serie A","Fabio Miretti","ITA","MF","20-301",2003,12.3,18,14,6,8,4,10,26,38.5,16,10,1,9,7,25,6,0,"https://fbref.com/en/players/34693494/Fabio-Miretti"
2024,"Juventus","Serie A","Hans Nicolussi Caviglia","ITA","MF","23-347",2000,3,5,2,1,3,1,4,6,66.7,2,5,1,4,0,5,2,0,"https://fbref.com/en/players/b136c945/Hans-Nicolussi-Caviglia"
2024,"Juventus","Serie A","Joseph Nonge","BEL","MF","19-015",2005,0.3,0,0,0,0,0,0,0,NA,0,0,0,0,0,0,1,0,"https://fbref.com/en/players/23d73767/Joseph-Nonge"
2024,"Juventus","Serie A","Mattia Perin","ITA","GK","31-202",1992,2.5,0,0,0,0,0,0,0,NA,0,0,0,0,0,0,1,0,"https://fbref.com/en/players/4c62d0c8/Mattia-Perin"
2024,"Juventus","Serie A","Carlo Pinsoglio","ITA","GK","34-075",1990,0.5,0,0,0,0,0,0,0,NA,0,0,0,0,0,0,0,0,"https://fbref.com/en/players/f6a06749/Carlo-Pinsoglio"
2024,"Juventus","Serie A","Paul Pogba","FRA","MF","31-076",1993,0.6,1,1,0,1,0,1,1,100,0,0,0,0,1,2,1,0,"https://fbref.com/en/players/867239d3/Paul-Pogba"
2024,"Juventus","Serie A","Adrien Rabiot","FRA","MF","29-057",1995,29.5,58,39,22,30,6,30,45,66.7,15,26,6,20,25,83,34,0,"https://fbref.com/en/players/8794e251/Adrien-Rabiot"
2024,"Juventus","Serie A","Daniele Rugani","ITA","DF","29-306",1994,13.2,11,9,7,3,1,4,5,80,1,11,4,7,9,20,42,0,"https://fbref.com/en/players/14b8fcdf/Daniele-Rugani"
2024,"Juventus","Serie A","Alex Sandro","BRA","DF","33-125",1991,8,13,7,7,6,0,4,5,80,1,13,7,6,15,28,23,0,"https://fbref.com/en/players/0d82903c/Alex-Sandro"
2024,"Juventus","Serie A","Nikola Sekulov","ITA","FW","22-102",2002,0.1,0,0,0,0,0,0,0,NA,0,0,0,0,0,0,0,0,"https://fbref.com/en/players/b2e08cb6/Nikola-Sekulov"
2024,"Juventus","Serie A","Wojciech Szczęsny","POL","GK","34-042",1990,35,0,0,0,0,0,0,0,NA,0,0,0,0,1,1,11,2,"https://fbref.com/en/players/01b8a2b2/Wojciech-Szczesny"
2024,"Juventus","Serie A","Dušan Vlahović","SRB","FW","24-123",2000,25.6,9,5,0,6,3,4,11,36.4,7,4,2,2,1,10,11,0,"https://fbref.com/en/players/79443529/Dusan-Vlahovic"
2024,"Juventus","Serie A","Timothy Weah","USA","DF,FW","24-098",2000,14,27,20,16,8,3,15,20,75,5,12,1,11,5,32,15,0,"https://fbref.com/en/players/8eec784d/Timothy-Weah"
2024,"Juventus","Serie A","Kenan Yıldız","TUR","FW,DF","19-026",2005,10.6,13,9,5,6,2,4,8,50,4,6,0,6,1,14,4,0,"https://fbref.com/en/players/d8cda243/Kenan-Yildiz"
2024,"Köln","Bundesliga","Sargis Adamyan","ARM","FW,MF","31-007",1993,8.9,14,9,2,9,3,6,11,54.5,5,16,1,15,5,19,7,0,"https://fbref.com/en/players/22919e97/Sargis-Adamyan"
2024,"Köln","Bundesliga","Faride Alidou","GER","FW,MF","22-317",2001,14.2,10,4,3,6,1,4,18,22.2,14,23,2,21,8,18,15,1,"https://fbref.com/en/players/00f518d8/Faride-Alidou"
2024,"Köln","Bundesliga","Rasmus Carstensen","DEN","DF,FW","23-232",2000,18.4,47,22,23,20,4,31,56,55.4,25,38,9,29,20,67,50,2,"https://fbref.com/en/players/64d7f629/Rasmus-Carstensen"
2024,"Köln","Bundesliga","Julian Chabot","GER","DF","26-108",1998,30,59,42,40,17,2,35,59,59.3,24,66,43,23,45,104,145,0,"https://fbref.com/en/players/ae7058f9/Julian-Chabot"
2024,"Köln","Bundesliga","Jacob Christensen","DEN","MF","22-340",2001,2.4,10,6,7,3,0,4,7,57.1,3,8,2,6,4,14,4,0,"https://fbref.com/en/players/324ff0da/Jacob-Christensen"
2024,"Köln","Bundesliga","Justin Diehl","GER","FW,MF","19-185",2004,1.9,0,0,0,0,0,0,0,NA,0,1,1,0,0,0,0,1,"https://fbref.com/en/players/d82a310a/Justin-Diehl"
2024,"Köln","Bundesliga","Florian Dietz","GER","FW,MF","25-301",1998,0.8,0,0,0,0,0,0,0,NA,0,1,0,1,0,0,0,0,"https://fbref.com/en/players/8779ddf8/Florian-Dietz"
2024,"Köln","Bundesliga","Damion Downs","GER","FW,MF","19-329",2004,2,1,1,1,0,0,1,2,50,1,1,0,1,0,1,1,0,"https://fbref.com/en/players/640134d6/Damion-Downs"
2024,"Köln","Bundesliga","Max Finkgräfe","GER","DF,FW","20-064",2004,19.5,65,39,40,25,0,39,74,52.7,35,35,10,25,22,87,39,0,"https://fbref.com/en/players/7ebd0896/Max-Finkgrafe"
2024,"Köln","Bundesliga","Dominique Heintz","GER","DF","30-289",1993,6.3,12,5,6,6,0,8,12,66.7,4,6,1,5,3,15,28,0,"https://fbref.com/en/players/699fb8db/Dominique-Heintz"
2024,"Köln","Bundesliga","Timo Hübers","GER","DF","27-315",1996,30.9,68,47,51,14,3,49,80,61.3,31,54,28,26,63,131,168,1,"https://fbref.com/en/players/94302c52/Timo-Hubers"
2024,"Köln","Bundesliga","Denis Huseinbasic","GER","MF","22-332",2001,18.1,38,18,17,15,6,20,31,64.5,11,26,1,25,13,51,14,0,"https://fbref.com/en/players/b116c6e3/Denis-Huseinbasic"
2024,"Köln","Bundesliga","Florian Kainz","AUT","MF,FW","31-219",1992,24.4,28,20,8,13,7,17,39,43.6,22,20,6,14,13,41,23,1,"https://fbref.com/en/players/94c18565/Florian-Kainz"
2024,"Köln","Bundesliga","Luca Kilian","GER","DF","24-272",1999,7.1,16,9,15,1,0,9,14,64.3,5,12,5,7,7,23,28,0,"https://fbref.com/en/players/610aa1e9/Luca-Kilian"
2024,"Köln","Bundesliga","Dejan Ljubicic","AUT","MF,FW","26-235",1997,22.8,43,27,20,18,5,20,43,46.5,23,22,2,20,18,61,11,0,"https://fbref.com/en/players/c455a2b2/Dejan-Ljubicic"
2024,"Köln","Bundesliga","Linton Maina","GER","FW,MF","24-342",1999,21.1,18,15,11,5,2,9,28,32.1,19,12,1,11,6,24,12,0,"https://fbref.com/en/players/e5d85da8/Linton-Maina"
2024,"Köln","Bundesliga","Eric Martel","GER","MF","22-031",2002,27.3,70,43,32,34,4,37,67,55.2,30,65,19,46,43,113,80,0,"https://fbref.com/en/players/92a16062/Eric-Martel"
2024,"Köln","Bundesliga","Mathias Olesen","LUX","MF,FW","23-070",2001,1.2,0,0,0,0,0,0,0,NA,0,0,0,0,2,2,2,0,"https://fbref.com/en/players/86adbcc7/Mathias-Olesen"
2024,"Köln","Bundesliga","Leart Paqarada","KVX","DF","29-235",1994,11.9,21,11,9,9,3,11,22,50,11,17,5,12,10,31,30,1,"https://fbref.com/en/players/82bfc14d/Leart-Paqarada"
2024,"Köln","Bundesliga","Benno Schmitz","GER","DF","29-195",1994,12.8,27,15,20,7,0,17,34,50,17,19,4,15,7,34,29,0,"https://fbref.com/en/players/ad00b1a8/Benno-Schmitz"
2024,"Köln","Bundesliga","Marvin Schwäbe","GER","GK","29-035",1995,34,1,0,1,0,0,1,1,100,0,0,0,0,0,1,10,1,"https://fbref.com/en/players/87436846/Marvin-Schwabe"
2024,"Köln","Bundesliga","Davie Selke","GER","FW","29-131",1995,14.1,4,2,1,3,0,0,2,0,2,5,3,2,0,4,20,0,"https://fbref.com/en/players/1238a3f9/Davie-Selke"
2024,"Köln","Bundesliga","Jan Thielmann","GER","FW,DF","22-004",2002,17.5,28,18,13,9,6,12,24,50,12,31,6,25,8,36,28,0,"https://fbref.com/en/players/fd53759d/Jan-Thielmann"
2024,"Köln","Bundesliga","Steffen Tigges","GER","FW","25-304",1998,8.1,10,6,4,5,1,3,7,42.9,4,4,2,2,1,11,12,0,"https://fbref.com/en/players/6b8887c2/Steffen-Tigges"
2024,"Köln","Bundesliga","Mark Uth","GER","MF,FW","32-280",1991,4.1,8,4,2,3,3,4,12,33.3,8,6,0,6,1,9,2,0,"https://fbref.com/en/players/a3ddb1b9/Mark-Uth"
2024,"Köln","Bundesliga","Luca Waldschmidt","GER","MF,FW","28-011",1996,12.7,19,12,4,12,3,5,16,31.3,11,18,3,15,6,25,8,1,"https://fbref.com/en/players/e5a35ae9/Luca-Waldschmidt"
2024,"Las Palmas","La Liga","Julian Araujo","MEX","DF","22-291",2001,16.2,41,22,29,7,5,23,33,69.7,10,23,16,7,10,51,52,1,"https://fbref.com/en/players/8f4541c2/Julian-Araujo"
2024,"Las Palmas","La Liga","José Campaña","ESP","MF","30-365",1993,1.9,2,2,1,1,0,0,2,0,2,3,2,1,2,4,3,0,"https://fbref.com/en/players/61220da2/Jose-Campana"
2024,"Las Palmas","La Liga","Marc Cardona","ESP","FW","28-327",1995,8,9,8,3,4,2,1,12,8.3,11,5,0,5,2,11,7,0,"https://fbref.com/en/players/b92b456a/Marc-Cardona"
2024,"Las Palmas","La Liga","Sergi Cardona","ESP","DF","24-327",1999,31.3,90,55,52,29,9,55,96,57.3,41,45,7,38,46,136,102,0,"https://fbref.com/en/players/74e90475/Sergi-Cardona"
2024,"Las Palmas","La Liga","Saúl Coco","EQG","DF","25-111",1999,25.5,32,19,25,7,0,11,18,61.1,7,27,15,12,20,52,120,3,"https://fbref.com/en/players/d0ee1652/Saul-Coco"
2024,"Las Palmas","La Liga","Eric Curbelo","ESP","DF,MF","30-137",1994,1.1,4,3,2,2,0,3,4,75,1,3,1,2,2,6,5,1,"https://fbref.com/en/players/34e39a18/Eric-Curbelo"
2024,"Las Palmas","La Liga","Aarón Escandell","ESP","GK","28-246",1995,1.7,0,0,0,0,0,0,0,NA,0,0,0,0,0,0,1,1,"https://fbref.com/en/players/67669ce7/Aaron-Escandell"
2024,"Las Palmas","La Liga","Francisco Jesús Crespo García","ESP","FW","27-306",1996,5.6,12,8,3,6,3,6,18,33.3,12,4,0,4,2,14,5,0,"https://fbref.com/en/players/8c4e56cb/Francisco-Jesus-Crespo-Garcia"
2024,"Las Palmas","La Liga","Fabio González","ESP","MF","27-108",1997,1.4,2,2,2,0,0,1,2,50,1,2,0,2,0,2,0,0,"https://fbref.com/en/players/5418d47c/Fabio-Gonzalez"
2024,"Las Palmas","La Liga","Iñaki González","ESP","MF","19-308",2004,0.1,1,0,1,0,0,0,0,NA,0,0,0,0,0,1,1,0,"https://fbref.com/en/players/63787ec5/Inaki-Gonzalez"
2024,"Las Palmas","La Liga","Munir El Haddadi","MAR","FW","28-272",1995,27.2,40,27,18,17,5,17,38,44.7,21,27,1,26,11,51,16,0,"https://fbref.com/en/players/8696bc90/Munir-El-Haddadi"
2024,"Las Palmas","La Liga","Cristian Herrera","ESP","FW,MF","33-078",1991,1.8,1,1,0,1,0,1,2,50,1,1,0,1,0,1,2,0,"https://fbref.com/en/players/f814e5d3/Cristian-Herrera"
2024,"Las Palmas","La Liga","Juan Herzog","ESP","DF","21-017",2003,3.2,6,5,5,1,0,3,6,50,3,4,1,3,2,8,17,0,"https://fbref.com/en/players/3a18abe2/Juan-Herzog"
2024,"Las Palmas","La Liga","Sory Kaba","GUI","FW","28-307",1995,8,2,0,0,2,0,0,5,0,5,6,0,6,0,2,9,0,"https://fbref.com/en/players/d29202c2/Sory-Kaba"
2024,"Las Palmas","La Liga","Álvaro Lemos","ESP","DF","31-061",1993,2.8,4,1,1,3,0,0,2,0,2,3,1,2,2,6,4,0,"https://fbref.com/en/players/31d45cc8/Alvaro-Lemos"
2024,"Las Palmas","La Liga","Enzo Loiodice","FRA","MF","23-185",2000,19.9,62,35,15,34,13,20,42,47.6,22,20,2,18,12,74,16,1,"https://fbref.com/en/players/6bca20fe/Enzo-Loiodice"
2024,"Las Palmas","La Liga","Mika Màrmol","ESP","DF","21-333",2002,35.3,70,42,44,24,2,35,53,66,18,39,19,20,44,114,147,2,"https://fbref.com/en/players/e7630876/Mika-Marmol"
2024,"Las Palmas","La Liga","Marvin","ESP","FW,DF","23-332",2000,20.6,39,25,18,17,4,18,36,50,18,28,2,26,14,53,18,1,"https://fbref.com/en/players/efaefda0/Marvin"
2024,"Las Palmas","La Liga","Omenuke Mfulu","COD","MF,FW","30-071",1994,0.9,4,3,3,1,0,0,1,0,1,1,1,0,2,6,5,0,"https://fbref.com/en/players/bdc14559/Omenuke-Mfulu"
2024,"Las Palmas","La Liga","Alberto Moleiro","ESP","FW,MF","20-243",2003,20,15,6,4,7,4,6,30,20,24,11,0,11,7,22,10,0,"https://fbref.com/en/players/c2c8897d/Alberto-Moleiro"
2024,"Las Palmas","La Liga","Javier Muñoz","ESP","MF","29-092",1995,29.3,42,23,14,22,6,16,44,36.4,28,40,4,36,20,62,29,1,"https://fbref.com/en/players/ec7c84c2/Javier-Munoz"
2024,"Las Palmas","La Liga","Máximo Perrone","ARG","MF","21-144",2003,18,42,21,17,22,3,19,39,48.7,20,27,4,23,24,66,21,0,"https://fbref.com/en/players/53552942/Maximo-Perrone"
2024,"Las Palmas","La Liga","Benito Ramírez","ESP","FW,MF","28-324",1995,4.3,5,3,2,3,0,3,6,50,3,7,1,6,3,8,0,0,"https://fbref.com/en/players/db714daf/Benito-Ramirez"
2024,"Las Palmas","La Liga","Sandro Ramírez","ESP","FW","28-326",1995,20.1,12,8,4,6,2,6,15,40,9,13,1,12,4,16,14,1,"https://fbref.com/en/players/833fb62e/Sandro-Ramirez"
2024,"Las Palmas","La Liga","Kirian Rodríguez","ESP","MF","28-086",1996,35.7,52,32,22,25,5,24,67,35.8,43,39,3,36,28,80,23,1,"https://fbref.com/en/players/9b130479/Kirian-Rodriguez"
2024,"Las Palmas","La Liga","Daley Sinkgraven","NED","DF","28-331",1995,4.3,11,5,6,5,0,2,8,25,6,5,3,2,6,17,9,0,"https://fbref.com/en/players/73000a79/Daley-Sinkgraven"
2024,"Las Palmas","La Liga","Álex Suárez","ESP","DF","31-073",1993,28.5,53,36,33,15,5,31,37,83.8,6,33,14,19,18,71,84,0,"https://fbref.com/en/players/9c137b36/Alex-Suarez"
2024,"Las Palmas","La Liga","Álvaro Vallés","ESP","GK","26-310",1997,36.3,3,2,3,0,0,3,8,37.5,5,0,0,0,0,3,40,1,"https://fbref.com/en/players/0166a73e/Alvaro-Valles"
2024,"Las Palmas","La Liga","Jonathan Viera","ESP","MF,FW","34-222",1989,6.9,6,3,1,2,3,1,9,11.1,8,0,0,0,0,6,1,0,"https://fbref.com/en/players/efa708aa/Jonathan-Viera"
2024,"Lazio","Serie A","Luis Alberto","ESP","MF","31-245",1992,25.7,35,20,16,12,7,15,53,28.3,38,34,4,30,7,42,13,0,"https://fbref.com/en/players/5294a83f/Luis-Alberto"
2024,"Lazio","Serie A","Felipe Anderson","BRA","FW,MF","31-045",1993,30.8,78,45,32,33,13,34,90,37.8,56,45,3,42,27,105,23,0,"https://fbref.com/en/players/9f1893b9/Felipe-Anderson"
2024,"Lazio","Serie A","Nicolò Casale","ITA","DF","26-106",1998,17.3,15,9,13,2,0,6,15,40,9,19,16,3,12,27,61,0,"https://fbref.com/en/players/3f5f38fb/Nicolo-Casale"
2024,"Lazio","Serie A","Valentín Castellanos","ARG","FW","25-240",1998,18.7,22,10,1,12,9,6,20,30,14,22,2,20,2,24,18,0,"https://fbref.com/en/players/da76bab4/Valentin-Castellanos"
2024,"Lazio","Serie A","Danilo Cataldi","ITA","MF","29-298",1994,15.1,24,12,7,16,1,8,18,44.4,10,15,7,8,17,41,19,1,"https://fbref.com/en/players/ba3d3bea/Danilo-Cataldi"
2024,"Lazio","Serie A","Mario Gila","ESP","DF","23-275",2000,20.1,32,14,23,8,1,19,34,55.9,15,27,14,13,20,52,69,0,"https://fbref.com/en/players/9c435456/Mario-Gila"
2024,"Lazio","Serie A","Mattéo Guendouzi","FRA","MF","25-046",1999,26.3,34,15,11,18,5,21,49,42.9,28,24,6,18,21,55,24,1,"https://fbref.com/en/players/5ea8ef20/Matteo-Guendouzi"
2024,"Lazio","Serie A","Elseid Hysaj","ALB","DF","30-100",1994,13.3,24,14,8,13,3,15,24,62.5,9,16,6,10,17,41,31,0,"https://fbref.com/en/players/2f3452eb/Elseid-Hysaj"
2024,"Lazio","Serie A","Ciro Immobile","ITA","FW","34-100",1990,18.4,11,9,2,5,4,3,14,21.4,11,9,3,6,5,16,11,0,"https://fbref.com/en/players/4431aed2/Ciro-Immobile"
2024,"Lazio","Serie A","Gustav Isaksen","DEN","FW","23-041",2001,11.9,4,3,2,1,1,1,9,11.1,8,11,1,10,4,8,4,0,"https://fbref.com/en/players/5715bb71/Gustav-Isaksen"
2024,"Lazio","Serie A","Daichi Kamada","JPN","MF","27-299",1996,17.2,53,36,22,22,9,28,52,53.8,24,24,5,19,18,71,7,0,"https://fbref.com/en/players/15b287da/Daichi-Kamada"
2024,"Lazio","Serie A","Manuel Lazzari","ITA","DF","30-183",1993,18.6,26,18,13,10,3,18,28,64.3,10,20,4,16,12,38,37,1,"https://fbref.com/en/players/02caf6e0/Manuel-Lazzari"
2024,"Lazio","Serie A","Christos Mandas","GRE","GK","22-256",2001,8,0,0,0,0,0,0,1,0,1,0,0,0,1,1,3,1,"https://fbref.com/en/players/f794e9ab/Christos-Mandas"
2024,"Lazio","Serie A","Adam Marušić","MNE","DF","31-226",1992,34.4,45,31,24,19,2,27,49,55.1,22,27,7,20,29,74,63,2,"https://fbref.com/en/players/d4535821/Adam-Marusic"
2024,"Lazio","Serie A","Patric","ESP","DF","31-043",1993,17.9,13,8,10,3,0,8,18,44.4,10,15,9,6,6,19,44,0,"https://fbref.com/en/players/f7223718/Patric"
2024,"Lazio","Serie A","Pedro","ESP","FW,MF","36-307",1987,9.1,16,12,5,7,4,3,12,25,9,16,2,14,3,19,1,0,"https://fbref.com/en/players/3ca7254a/Pedro"
2024,"Lazio","Serie A","Luca Pellegrini","ITA","DF","25-084",1999,8.7,18,13,7,10,1,9,17,52.9,8,7,3,4,9,27,20,0,"https://fbref.com/en/players/3b61c9ec/Luca-Pellegrini"
2024,"Lazio","Serie A","Ivan Provedel","ITA","GK","30-074",1994,30,1,0,1,0,0,1,3,33.3,2,0,0,0,0,1,12,1,"https://fbref.com/en/players/277da414/Ivan-Provedel"
2024,"Lazio","Serie A","Alessio Romagnoli","ITA","DF","29-139",1995,26.8,25,18,14,11,0,16,24,66.7,8,29,17,12,29,54,115,0,"https://fbref.com/en/players/3ead85f9/Alessio-Romagnoli"
2024,"Lazio","Serie A","Nicolò Rovella","ITA","MF","22-178",2001,14.6,46,28,25,17,4,16,36,44.4,20,27,6,21,23,69,29,0,"https://fbref.com/en/players/e58cbfd5/Nicolo-Rovella"
2024,"Lazio","Serie A","Matías Vecino","URU","MF","32-280",1991,12.8,32,17,12,20,0,20,31,64.5,11,17,5,12,12,44,21,0,"https://fbref.com/en/players/44ac04e9/Matias-Vecino"
2024,"Lazio","Serie A","Mattia Zaccagni","ITA","FW,MF","28-349",1995,21.7,27,16,11,15,1,9,21,42.9,12,26,2,24,21,48,15,0,"https://fbref.com/en/players/d85c238b/Mattia-Zaccagni"
2024,"Le Havre","Ligue 1","Nabil Alioui","FRA","MF,FW","25-102",1999,11.2,3,2,2,1,0,2,4,50,2,6,1,5,3,6,4,0,"https://fbref.com/en/players/b386310a/Nabil-Alioui"
2024,"Le Havre","Ligue 1","André Ayew","GHA","FW","34-165",1989,12.3,15,11,7,6,2,6,9,66.7,3,8,3,5,2,17,11,0,"https://fbref.com/en/players/5dbefa9d/Andre-Ayew"
2024,"Le Havre","Ligue 1","Josué Casimir","FRA","FW,DF","22-249",2001,22.4,31,18,14,14,3,7,18,38.9,11,23,2,21,13,44,25,0,"https://fbref.com/en/players/481f76cf/Josue-Casimir"
2024,"Le Havre","Ligue 1","Alois Confais","FRA","MF,FW","27-266",1996,0.1,2,2,1,1,0,1,1,100,0,0,0,0,0,2,0,0,"https://fbref.com/en/players/535b0343/Alois-Confais"
2024,"Le Havre","Ligue 1","Arthur Desmas","FRA","GK","30-053",1994,33,0,0,0,0,0,0,2,0,2,0,0,0,0,0,13,1,"https://fbref.com/en/players/e8c5dd4d/Arthur-Desmas"
2024,"Le Havre","Ligue 1","Simon Ebonog","CMR","MF","19-288",2004,0.2,1,1,0,1,0,1,1,100,0,1,1,0,0,1,1,0,"https://fbref.com/en/players/12f9a649/Simon-Ebonog"
2024,"Le Havre","Ligue 1","Mathieu Gorgelin","FRA","GK","33-299",1990,1,0,0,0,0,0,0,0,NA,0,0,0,0,0,0,0,0,"https://fbref.com/en/players/4d3e9033/Mathieu-Gorgelin"
2024,"Le Havre","Ligue 1","Samuel Grandsir","FRA","MF,FW","27-290",1996,6.7,16,12,5,9,2,8,18,44.4,10,4,0,4,3,19,3,1,"https://fbref.com/en/players/d2448564/Samuel-Grandsir"
2024,"Le Havre","Ligue 1","Oualid El Hajjam","MAR","DF,MF","33-101",1991,4.4,8,7,5,2,1,2,9,22.2,7,5,1,4,6,14,10,0,"https://fbref.com/en/players/9f29c204/Oualid-El-Hajjam"
2024,"Le Havre","Ligue 1","Antoine Joujou","FRA","FW,MF","21-079",2003,8.7,20,12,7,7,6,11,21,52.4,10,11,2,9,7,27,5,0,"https://fbref.com/en/players/f9124307/Antoine-Joujou"
2024,"Le Havre","Ligue 1","Yassine Kechta","MAR","MF","22-095",2002,20.5,46,24,24,19,3,31,73,42.5,42,20,3,17,23,69,16,1,"https://fbref.com/en/players/abefc3af/Yassine-Kechta"
2024,"Le Havre","Ligue 1","Daler Kuzyaev","RUS","MF","31-136",1993,23.2,34,19,11,13,10,15,43,34.9,28,18,5,13,22,56,18,1,"https://fbref.com/en/players/d4e93bab/Daler-Kuzyaev"
2024,"Le Havre","Ligue 1","Mohamed Lamine Bayo","GUI","FW","25-361",1998,15.4,13,5,2,5,6,2,10,20,8,8,1,7,2,15,11,0,"https://fbref.com/en/players/01870104/Mohamed-Lamine-Bayo"
2024,"Le Havre","Ligue 1","Gautier Lloris","FRA","DF","28-317",1995,30.9,50,28,40,9,1,28,42,66.7,14,50,30,20,32,82,142,1,"https://fbref.com/en/players/ac89503b/Gautier-Lloris"
2024,"Le Havre","Ligue 1","Andy Logbo","FRA","FW","20-024",2004,2.8,0,0,0,0,0,0,3,0,3,7,3,4,0,0,2,0,"https://fbref.com/en/players/daa11a4f/Andy-Logbo"
2024,"Le Havre","Ligue 1","Nolan Mbemba","CGO","MF","29-101",1995,0.2,2,1,0,1,1,1,2,50,1,0,0,0,0,2,0,0,"https://fbref.com/en/players/6c9642ae/Nolan-Mbemba"
2024,"Le Havre","Ligue 1","Rassoul Ndiaye","SEN","MF,FW","22-171",2001,5.8,25,17,8,16,1,12,24,50,12,2,1,1,4,29,5,0,"https://fbref.com/en/players/36f65bdf/Rassoul-Ndiaye"
2024,"Le Havre","Ligue 1","Loïc Nego","HUN","DF,MF","33-136",1991,17.3,37,26,21,12,4,18,30,60,12,12,2,10,16,53,17,0,"https://fbref.com/en/players/c3b6fa1e/Loic-Nego"
2024,"Le Havre","Ligue 1","Steve Ngoura","FRA","FW,MF","19-098",2005,2.5,2,1,1,1,0,1,4,25,3,0,0,0,0,2,3,0,"https://fbref.com/en/players/731f1f5a/Steve-Ngoura"
2024,"Le Havre","Ligue 1","Christopher Operi","FRA","DF","27-031",1997,27.2,55,36,37,15,3,32,59,54.2,27,45,7,38,35,90,68,1,"https://fbref.com/en/players/914bb955/Christopher-Operi"
2024,"Le Havre","Ligue 1","Emmanuel Sabbi","USA","FW,MF","26-158",1997,17.6,38,19,15,15,8,16,39,41,23,26,2,24,19,57,7,0,"https://fbref.com/en/players/2e1b7c83/Emmanuel-Sabbi"
2024,"Le Havre","Ligue 1","Yoann Salmier","GUF","DF","31-191",1992,17.4,22,10,13,6,3,13,20,65,7,21,15,6,21,43,57,0,"https://fbref.com/en/players/c3725db2/Yoann-Salmier"
2024,"Le Havre","Ligue 1","Arouna Sangante","SEN","DF","22-048",2002,29.9,53,33,27,23,3,24,40,60,16,35,18,17,66,119,93,2,"https://fbref.com/en/players/17bb562c/Arouna-Sangante"
2024,"Le Havre","Ligue 1","Issa Soumaré","SEN","FW,MF","23-233",2000,2.6,2,0,2,0,0,0,4,0,4,0,0,0,0,2,2,0,"https://fbref.com/en/players/1d8aa290/Issa-Soumare"
2024,"Le Havre","Ligue 1","Oussama Targhalline","MAR","MF","22-010",2002,11.4,23,11,16,7,0,15,25,60,10,9,3,6,20,43,14,2,"https://fbref.com/en/players/abd56820/Oussama-Targhalline"
2024,"Le Havre","Ligue 1","Abdoulaye Touré","GUI","MF","30-088",1994,25.4,47,28,22,22,3,30,60,50,30,30,8,22,25,72,33,0,"https://fbref.com/en/players/ef7cd87a/Abdoulaye-Toure"
2024,"Le Havre","Ligue 1","Etienne Youte Kinkoue","FRA","DF","22-137",2002,21.6,15,9,13,2,0,7,11,63.6,4,21,16,5,44,59,104,0,"https://fbref.com/en/players/12a4e38c/Etienne-Youte-Kinkoue"
2024,"Lecce","Serie A","Pontus Almqvist","SWE","FW,MF","24-325",1999,23.4,45,29,16,22,7,23,51,45.1,28,21,2,19,14,59,10,0,"https://fbref.com/en/players/0917188a/Pontus-Almqvist"
2024,"Lecce","Serie A","Lameck Banda","ZAM","FW","23-122",2001,15,27,23,11,12,4,7,21,33.3,14,18,0,18,3,30,7,0,"https://fbref.com/en/players/8a6de8c7/Lameck-Banda"
2024,"Lecce","Serie A","Federico Baschirotto","ITA","DF","27-253",1996,36.6,21,12,16,5,0,8,15,53.3,7,42,26,16,23,44,144,1,"https://fbref.com/en/players/5a08ee41/Federico-Baschirotto"
2024,"Lecce","Serie A","Medon Berisha","ALB","FW,MF","20-222",2003,2.3,3,1,3,0,0,0,2,0,2,2,2,0,1,4,0,0,"https://fbref.com/en/players/9d376bef/Medon-Berisha"
2024,"Lecce","Serie A","Alexis Blin","FRA","MF","27-257",1996,18.2,33,19,11,19,3,15,43,34.9,28,16,2,14,22,55,39,0,"https://fbref.com/en/players/c69ef855/Alexis-Blin"
2024,"Lecce","Serie A","Rareș-Cătălin Burnete","ROU","FW","20-120",2004,0.1,0,0,0,0,0,0,0,NA,0,0,0,0,0,0,0,0,"https://fbref.com/en/players/7c4b4e36/Rares-Catalin-Burnete"
2024,"Lecce","Serie A","Jeppe Corfitzen","DEN","FW","19-153",2004,0.1,1,0,0,1,0,1,1,100,0,0,0,0,0,1,0,0,"https://fbref.com/en/players/3f7e5a98/Jeppe-Corfitzen"
2024,"Lecce","Serie A","Federico Di Francesco","ITA","FW,MF","29-351",1994,0.2,1,0,0,1,0,0,0,NA,0,0,0,0,0,1,0,0,"https://fbref.com/en/players/1fca9171/Federico-Di-Francesco"
2024,"Lecce","Serie A","Patrick Dorgu","DEN","DF,MF","19-217",2004,17.4,43,22,22,17,4,22,34,64.7,12,16,5,11,9,52,45,2,"https://fbref.com/en/players/e6536124/Patrick-Dorgu"
2024,"Lecce","Serie A","Wladimiro Falcone","ITA","GK","29-048",1995,38,0,0,0,0,0,0,0,NA,0,1,0,1,1,1,21,2,"https://fbref.com/en/players/9f5a610b/Wladimiro-Falcone"
2024,"Lecce","Serie A","Antonino Gallo","ITA","DF","24-146",2000,27.7,43,27,31,11,1,31,49,63.3,18,34,9,25,25,68,67,0,"https://fbref.com/en/players/c74d63ac/Antonino-Gallo"
2024,"Lecce","Serie A","Valentin Gendrey","FRA","DF","23-344",2000,33.8,55,33,35,16,4,30,46,65.2,16,40,11,29,35,90,99,0,"https://fbref.com/en/players/822ed0ec/Valentin-Gendrey"
2024,"Lecce","Serie A","Joan Gonzàlez","ESP","MF","22-119",2002,14.3,31,18,16,12,3,17,28,60.7,11,20,3,17,5,36,9,0,"https://fbref.com/en/players/f025eade/Joan-Gonzalez"
2024,"Lecce","Serie A","Mohamed Kaba","FRA","MF","22-216",2001,15.3,39,23,15,16,8,17,34,50,17,22,4,18,12,51,13,0,"https://fbref.com/en/players/517cfb19/Mohamed-Kaba"
2024,"Lecce","Serie A","Nikola Krstović","MNE","FW","24-055",2000,26.4,17,6,3,9,5,6,10,60,4,12,4,8,4,21,22,0,"https://fbref.com/en/players/473803c9/Nikola-Krstovic"
2024,"Lecce","Serie A","Marcin Listkowski","POL","FW","26-110",1998,0.1,0,0,0,0,0,0,0,NA,0,0,0,0,0,0,0,0,"https://fbref.com/en/players/a3695ac2/Marcin-Listkowski"
2024,"Lecce","Serie A","Remi Oudin","FRA","MF,FW","27-194",1996,20.2,26,14,12,12,2,12,19,63.2,7,13,1,12,20,46,22,0,"https://fbref.com/en/players/ea02beaf/Remi-Oudin"
2024,"Lecce","Serie A","Roberto Piccoli","ITA","FW","23-124",2001,15.3,10,6,3,5,2,1,4,25,3,17,1,16,4,14,16,0,"https://fbref.com/en/players/1cadaf34/Roberto-Piccoli"
2024,"Lecce","Serie A","Santiago Pierotti","ARG","MF,FW","23-057",2001,2.2,8,8,2,5,1,2,8,25,6,5,0,5,1,9,0,0,"https://fbref.com/en/players/ec315772/Santiago-Pierotti"
2024,"Lecce","Serie A","Marin Pongračić","CRO","DF","26-262",1997,35.8,43,30,22,20,1,19,25,76,6,37,26,11,51,94,130,1,"https://fbref.com/en/players/2a6cd437/Marin-Pongracic"
2024,"Lecce","Serie A","Hamza Rafia","TUN","MF","25-058",1999,13.4,44,31,13,27,4,13,30,43.3,17,27,1,26,11,55,13,0,"https://fbref.com/en/players/6b587d3d/Hamza-Rafia"
2024,"Lecce","Serie A","Ylber Ramadani","ALB","MF","28-048",1996,33,68,41,32,29,7,37,96,38.5,59,54,13,41,44,112,44,0,"https://fbref.com/en/players/ef3c876b/Ylber-Ramadani"
2024,"Lecce","Serie A","Nicola Sansone","ITA","FW,MF","32-263",1991,8.5,11,6,6,2,3,5,16,31.3,11,7,1,6,4,15,5,2,"https://fbref.com/en/players/7eb97a8e/Nicola-Sansone"
2024,"Lecce","Serie A","Gabriel Strefezza","BRA","FW","27-042",1997,12.4,24,17,8,7,9,14,20,70,6,17,0,17,7,31,11,0,"https://fbref.com/en/players/ac4a4508/Gabriel-Strefezza"
2024,"Lecce","Serie A","Ahmed Touba","ALG","DF","26-079",1998,3.1,6,4,3,3,0,3,4,75,1,4,3,1,7,13,20,0,"https://fbref.com/en/players/f25de136/Ahmed-Touba"
2024,"Lecce","Serie A","Lorenzo Venuti","ITA","DF","29-048",1995,4,6,4,5,1,0,6,10,60,4,4,3,1,5,11,14,0,"https://fbref.com/en/players/983ff2c7/Lorenzo-Venuti"
2024,"Lens","Ligue 1","Salis Abdul Samed","GHA","MF","24-065",2000,16.9,21,14,8,10,3,8,18,44.4,10,12,1,11,12,33,18,0,"https://fbref.com/en/players/82464ce3/Salis-Abdul-Samed"
2024,"Lens","Ligue 1","Ruben Aguilar","FRA","DF","31-034",1993,21.4,53,31,27,23,3,27,45,60,18,35,5,30,26,79,46,0,"https://fbref.com/en/players/3dd738a1/Ruben-Aguilar"
2024,"Lens","Ligue 1","Neil El Aynaoui","FRA","MF","22-333",2001,17.4,37,20,13,20,4,20,46,43.5,26,20,6,14,32,69,21,1,"https://fbref.com/en/players/17e1261b/Neil-El-Aynaoui"
2024,"Lens","Ligue 1","Jhoanner Chávez","ECU","DF","22-035",2002,5.3,6,5,2,2,2,3,9,33.3,6,2,0,2,5,11,11,0,"https://fbref.com/en/players/649b57e9/Jhoanner-Chavez"
2024,"Lens","Ligue 1","Oscar Cortés","COL","FW,MF","20-179",2003,0.5,0,0,0,0,0,0,0,NA,0,1,0,1,0,0,0,0,"https://fbref.com/en/players/d2c12fe0/Oscar-Cortes"
2024,"Lens","Ligue 1","David Pereira da Costa","POR","MF","23-146",2001,16.6,18,10,5,12,1,10,23,43.5,13,21,4,17,16,34,8,1,"https://fbref.com/en/players/59948ef7/David-Pereira-da-Costa"
2024,"Lens","Ligue 1","Kevin Danso","AUT","DF","25-254",1998,29.5,24,14,12,11,1,15,30,50,15,43,30,13,23,47,115,1,"https://fbref.com/en/players/6e33125f/Kevin-Danso"
2024,"Lens","Ligue 1","Andy Diouf","FRA","MF","21-013",2003,14.6,28,19,12,11,5,14,22,63.6,8,13,3,10,3,31,5,1,"https://fbref.com/en/players/9b5237b1/Andy-Diouf"
2024,"Lens","Ligue 1","Przemysław Frankowski","POL","DF","29-048",1995,24.4,60,39,25,26,9,31,74,41.9,43,30,7,23,25,85,36,0,"https://fbref.com/en/players/00a8d210/Przemyslaw-Frankowski"
2024,"Lens","Ligue 1","Angelo Fulgini","FRA","MF","27-284",1996,15.3,23,14,6,13,4,11,19,57.9,8,22,1,21,8,31,11,0,"https://fbref.com/en/players/4b96c347/Angelo-Fulgini"
2024,"Lens","Ligue 1","Jonathan Gradit","FRA","DF","31-188",1992,23.5,32,20,15,14,3,19,35,54.3,16,30,17,13,37,69,61,0,"https://fbref.com/en/players/06c48679/Jonathan-Gradit"
2024,"Lens","Ligue 1","Morgan Guilavogui","GUI","FW,MF","26-081",1998,6.3,21,10,4,12,5,5,11,45.5,6,11,2,9,4,25,7,0,"https://fbref.com/en/players/79b51257/Morgan-Guilavogui"
2024,"Lens","Ligue 1","Massadio Haïdara","MLI","DF","31-180",1992,8.2,9,8,5,3,1,4,6,66.7,2,7,2,5,11,20,32,3,"https://fbref.com/en/players/5167c97e/Massadio-Haidara"
2024,"Lens","Ligue 1","Julien Le Cardinal","FRA","DF","26-301",1997,0.6,6,2,4,2,0,4,9,44.4,5,2,1,1,0,6,0,0,"https://fbref.com/en/players/547a72ad/Julien-Le-Cardinal"
2024,"Lens","Ligue 1","Jean-Louis Leca","FRA","GK","38-252",1985,1,0,0,0,0,0,0,0,NA,0,0,0,0,0,0,1,0,"https://fbref.com/en/players/edbe46dc/Jean-Louis-Leca"
2024,"Lens","Ligue 1","Deiver Machado","COL","DF","30-271",1993,12.5,24,18,10,10,4,15,20,75,5,13,2,11,7,31,8,0,"https://fbref.com/en/players/b3f8bdef/Deiver-Machado"
2024,"Lens","Ligue 1","Faitout Maouassa","FRA","MF,DF","25-329",1998,0.8,1,1,1,0,0,1,1,100,0,1,0,1,0,1,3,0,"https://fbref.com/en/players/e54a9890/Faitout-Maouassa"
2024,"Lens","Ligue 1","Facundo Medina","ARG","DF","25-002",1999,30.2,64,38,25,31,8,44,69,63.8,25,38,13,25,24,88,59,2,"https://fbref.com/en/players/6f5ec8bb/Facundo-Medina"
2024,"Lens","Ligue 1","Nampalys Mendy","SEN","MF","31-342",1992,11.7,29,18,10,13,6,16,20,80,4,11,4,7,14,43,14,1,"https://fbref.com/en/players/1598599e/Nampalys-Mendy"
2024,"Lens","Ligue 1","Wesley Saïd","FRA","FW,MF","29-041",1995,11.3,8,4,1,2,5,2,9,22.2,7,4,0,4,4,12,3,0,"https://fbref.com/en/players/90fcf472/Wesley-Said"
2024,"Lens","Ligue 1","Brice Samba","FRA","GK","30-035",1994,33,1,1,1,0,0,1,1,100,0,0,0,0,0,1,10,3,"https://fbref.com/en/players/60d90c55/Brice-Samba"
2024,"Lens","Ligue 1","Ayanda Sishuba","BEL","MF,FW","19-118",2005,0.7,3,1,0,2,1,1,2,50,1,1,0,1,0,3,0,0,"https://fbref.com/en/players/6fd76804/Ayanda-Sishuba"
2024,"Lens","Ligue 1","Florian Sotoca","FRA","MF,FW","33-218",1990,28.9,33,22,9,21,3,17,38,44.7,21,41,4,37,20,53,34,0,"https://fbref.com/en/players/7a42d0df/Florian-Sotoca"
2024,"Lens","Ligue 1","Stijn Spierings","NED","MF","28-079",1996,1.3,1,0,0,1,0,1,1,100,0,2,1,1,2,3,1,0,"https://fbref.com/en/players/a08985b8/Stijn-Spierings"
2024,"Lens","Ligue 1","Adrien Thomasson","FRA","MF","30-172",1993,13.3,25,14,4,16,5,11,34,32.4,23,14,0,14,9,34,10,1,"https://fbref.com/en/players/c76b7567/Adrien-Thomasson"
2024,"Lens","Ligue 1","Elye Wahi","FRA","FW","21-149",2003,18.8,6,4,1,3,2,2,10,20,8,5,1,4,3,9,3,0,"https://fbref.com/en/players/0d7b6576/Elye-Wahi"
2024,"Lens","Ligue 1","Abduqodir Xusanov","UZB","DF","20-091",2004,9,21,12,13,8,0,9,17,52.9,8,13,8,5,13,34,32,2,"https://fbref.com/en/players/d17ce930/Abduqodir-Xusanov"
2024,"Leverkusen","Bundesliga","Amine Adli","MAR","MF,FW","24-020",2000,10,16,7,2,10,4,7,17,41.2,10,10,2,8,6,22,5,0,"https://fbref.com/en/players/dcfb17f4/Amine-Adli"
2024,"Leverkusen","Bundesliga","Nadiem Amiri","GER","MF","27-216",1996,1,4,2,0,3,1,0,3,0,3,0,0,0,0,4,1,0,"https://fbref.com/en/players/555d5edd/Nadiem-Amiri"
2024,"Leverkusen","Bundesliga","Robert Andrich","GER","MF,DF","29-251",1994,18.8,30,18,8,14,8,13,24,54.2,11,15,4,11,20,50,17,0,"https://fbref.com/en/players/e0b113a7/Robert-Andrich"
2024,"Leverkusen","Bundesliga","Arthur","BRA","DF","21-074",2003,2,4,3,2,0,2,2,2,100,0,1,1,0,0,4,7,0,"https://fbref.com/en/players/8a958856/Arthur"
2024,"Leverkusen","Bundesliga","Victor Boniface","NGA","FW","23-159",2000,17.2,6,4,0,1,5,1,4,25,3,6,1,5,0,6,13,0,"https://fbref.com/en/players/b146275b/Victor-Boniface"
2024,"Leverkusen","Bundesliga","Jeremie Frimpong","NED","DF","23-172",2000,25,26,17,12,7,7,8,20,40,12,26,0,26,7,33,17,0,"https://fbref.com/en/players/74f2e748/Jeremie-Frimpong"
2024,"Leverkusen","Bundesliga","Álex Grimaldo","ESP","DF","28-253",1995,30.9,45,24,26,10,9,30,55,54.5,25,32,7,25,22,67,41,0,"https://fbref.com/en/players/b1f4086c/Alex-Grimaldo"
2024,"Leverkusen","Bundesliga","Piero Hincapié","ECU","DF","22-142",2002,16.5,35,22,14,17,4,13,17,76.5,4,18,7,11,13,48,43,0,"https://fbref.com/en/players/0c7a48f8/Piero-Hincapie"
2024,"Leverkusen","Bundesliga","Adam Hložek","CZE","MF,FW","21-310",2002,5.1,10,4,2,4,4,3,7,42.9,4,4,1,3,2,12,1,0,"https://fbref.com/en/players/5521f419/Adam-Hlozek"
2024,"Leverkusen","Bundesliga","Jonas Hofmann","GER","MF","31-321",1992,24.5,20,14,6,9,5,10,24,41.7,14,18,0,18,8,28,6,0,"https://fbref.com/en/players/2903a856/Jonas-Hofmann"
2024,"Leverkusen","Bundesliga","Lukáš Hrádecký","FIN","GK","34-188",1989,33,0,0,0,0,0,0,1,0,1,1,0,1,0,0,10,2,"https://fbref.com/en/players/ad3389d5/Lukas-Hradecky"
2024,"Leverkusen","Bundesliga","Borja Iglesias","ESP","FW","31-134",1993,2.8,1,0,0,1,0,0,1,0,1,2,0,2,1,2,1,0,"https://fbref.com/en/players/75645f0e/Borja-Iglesias"
2024,"Leverkusen","Bundesliga","Odilon Kossonou","CIV","DF","23-147",2001,20.1,30,20,11,12,7,15,26,57.7,11,27,3,24,27,57,43,1,"https://fbref.com/en/players/1f3afdcb/Odilon-Kossonou"
2024,"Leverkusen","Bundesliga","Matej Kovar","CZE","GK","24-013",2000,1,0,0,0,0,0,0,0,NA,0,0,0,0,0,0,0,0,"https://fbref.com/en/players/bc67a0e1/Matej-Kovar"
2024,"Leverkusen","Bundesliga","Noah Mbamba","BEL","MF","19-146",2005,0.2,0,0,0,0,0,0,0,NA,0,0,0,0,1,1,0,0,"https://fbref.com/en/players/e75129bd/Noah-Mbamba"
2024,"Leverkusen","Bundesliga","Exequiel Palacios","ARG","MF","25-238",1998,20.3,60,34,28,26,6,26,53,49.1,27,24,0,24,29,89,20,2,"https://fbref.com/en/players/e82adcab/Exequiel-Palacios"
2024,"Leverkusen","Bundesliga","Gustavo Puerta","COL","DF,MF","20-312",2003,0.5,5,3,2,2,1,1,2,50,1,2,0,2,0,5,0,0,"https://fbref.com/en/players/2c08cab0/Gustavo-Puerta"
2024,"Leverkusen","Bundesliga","Patrik Schick","CZE","FW","28-127",1996,11.8,6,4,0,3,3,1,5,20,4,2,0,2,1,7,7,0,"https://fbref.com/en/players/5d4f7d61/Patrik-Schick"
2024,"Leverkusen","Bundesliga","Josip Stanišić","CRO","DF","24-058",2000,14,38,20,19,13,6,22,33,66.7,11,18,3,15,9,47,26,0,"https://fbref.com/en/players/7ed08d5c/Josip-Stanisic"
2024,"Leverkusen","Bundesliga","Jonathan Tah","GER","DF","28-109",1996,29.2,19,9,10,7,2,5,16,31.3,11,28,23,5,23,42,97,1,"https://fbref.com/en/players/bd142efb/Jonathan-Tah"
2024,"Leverkusen","Bundesliga","Edmond Tapsoba","BFA","DF","25-118",1999,23.2,34,25,17,15,2,17,24,70.8,7,21,10,11,24,58,52,3,"https://fbref.com/en/players/a73c8f95/Edmond-Tapsoba"
2024,"Leverkusen","Bundesliga","Nathan Tella","NGA","DF,MF","24-330",1999,9.1,13,8,6,5,2,5,10,50,5,10,0,10,3,16,8,0,"https://fbref.com/en/players/f1e94cd6/Nathan-Tella"
2024,"Leverkusen","Bundesliga","Florian Wirtz","GER","MF","21-027",2003,26.4,27,18,7,14,6,9,29,31,20,36,2,34,9,36,3,0,"https://fbref.com/en/players/e7fcf289/Florian-Wirtz"
2024,"Leverkusen","Bundesliga","Granit Xhaka","SUI","MF","31-246",1992,31.3,29,21,11,14,4,9,30,30,21,29,8,21,19,48,42,0,"https://fbref.com/en/players/e61b8aee/Granit-Xhaka"
2024,"Lille","Ligue 1","Benjamin André","FRA","MF","33-301",1990,28.6,89,49,39,45,5,43,81,53.1,38,34,5,29,35,124,60,0,"https://fbref.com/en/players/ef9c1c95/Benjamin-Andre"
2024,"Lille","Ligue 1","Hákon Arnar Haraldsson","ISL","FW,MF","21-050",2003,14.3,12,8,4,7,1,5,21,23.8,16,7,2,5,3,15,5,0,"https://fbref.com/en/players/e2ae54db/Hakon-Arnar-Haraldsson"
2024,"Lille","Ligue 1","Carlos Baleba","CMR","MF","20-148",2004,0.7,6,2,1,4,1,3,4,75,1,0,0,0,2,8,0,0,"https://fbref.com/en/players/a1390d2f/Carlos-Baleba"
2024,"Lille","Ligue 1","Nabil Bentaleb","ALG","MF","29-188",1994,21.9,49,32,29,18,2,22,43,51.2,21,33,12,21,37,86,33,0,"https://fbref.com/en/players/3189f61a/Nabil-Bentaleb"
2024,"Lille","Ligue 1","Ayyoub Bouaddi","FRA","MF","16-241",2007,1.5,6,2,6,0,0,2,5,40,3,2,0,2,1,7,3,0,"https://fbref.com/en/players/8006228f/Ayyoub-Bouaddi"
2024,"Lille","Ligue 1","Rémy Cabella","FRA","FW,MF","34-083",1990,16.4,54,36,19,20,15,20,54,37,34,32,0,32,5,59,5,0,"https://fbref.com/en/players/148e136f/Remy-Cabella"
2024,"Lille","Ligue 1","Ivan Cavaleiro","POR","FW","30-225",1993,8.6,10,6,3,4,3,7,20,35,13,9,2,7,5,15,6,0,"https://fbref.com/en/players/979b811d/Ivan-Cavaleiro"
2024,"Lille","Ligue 1","Lucas Chevalier","FRA","GK","22-206",2001,33,3,0,3,0,0,3,4,75,1,1,0,1,0,3,11,2,"https://fbref.com/en/players/b3d76d84/Lucas-Chevalier"
2024,"Lille","Ligue 1","Trévis Dago","CIV","FW,MF","19-130",2005,0.3,0,0,0,0,0,0,0,NA,0,0,0,0,1,1,0,0,"https://fbref.com/en/players/011b2a32/Trevis-Dago"
2024,"Lille","Ligue 1","Jonathan David","CAN","FW","24-137",2000,29.2,26,15,6,13,7,8,26,30.8,18,16,0,16,9,35,4,0,"https://fbref.com/en/players/ce50fd99/Jonathan-David"
2024,"Lille","Ligue 1","Bafodé Diakité","FRA","DF","23-145",2001,18.8,29,20,12,15,2,24,32,75,8,16,8,8,21,50,49,1,"https://fbref.com/en/players/1bfb6fef/Bafode-Diakite"
2024,"Lille","Ligue 1","Ichem Ferrah","FRA","FW","18-250",2005,0,0,0,0,0,0,0,0,NA,0,0,0,0,0,0,0,0,"https://fbref.com/en/players/307581ff/Ichem-Ferrah"
2024,"Lille","Ligue 1","Tiago Fonseca Morais","POR","FW","20-270",2003,0.5,1,1,0,1,0,0,0,NA,0,0,0,0,1,2,0,0,"https://fbref.com/en/players/a951ca82/Tiago-Fonseca-Morais"
2024,"Lille","Ligue 1","Angel Gomes","ENG","MF","23-273",2000,28.6,26,13,4,15,7,14,32,43.8,18,23,6,17,18,44,28,1,"https://fbref.com/en/players/645a3363/Angel-Gomes"
2024,"Lille","Ligue 1","Gabriel Gudmundsson","SWE","DF,FW","25-031",1999,14.1,22,16,7,13,2,12,20,60,8,14,3,11,15,37,25,0,"https://fbref.com/en/players/d5d22a58/Gabriel-Gudmundsson"
2024,"Lille","Ligue 1","Andrej Ilic","SRB","FW","24-057",2000,0.1,0,0,0,0,0,0,0,NA,0,0,0,0,0,0,0,0,"https://fbref.com/en/players/cd2cb5bb/Andrej-Ilic"
2024,"Lille","Ligue 1","Ismaily","BRA","DF","34-140",1990,27.4,72,47,34,25,13,31,60,51.7,29,33,6,27,32,104,77,0,"https://fbref.com/en/players/cf182add/Ismaily"
2024,"Lille","Ligue 1","Aaron Malouda","FRA","FW","18-182",2005,0,0,0,0,0,0,0,0,NA,0,0,0,0,0,0,0,0,"https://fbref.com/en/players/4fe2648c/Aaron-Malouda"
2024,"Lille","Ligue 1","Vito Mannone","ITA","GK","36-089",1988,1,0,0,0,0,0,0,0,NA,0,0,0,0,0,0,0,0,"https://fbref.com/en/players/c4173f1a/Vito-Mannone"
2024,"Lille","Ligue 1","Ignacio Miramon","ARG","MF","20-353",2003,0.4,1,0,0,1,0,0,1,0,1,1,0,1,0,1,0,0,"https://fbref.com/en/players/e43a4083/Ignacio-Miramon"
2024,"Lille","Ligue 1","Adam Ounas","ALG","FW","27-201",1996,4.6,4,3,2,2,0,2,7,28.6,5,2,0,2,6,10,1,0,"https://fbref.com/en/players/ed90babd/Adam-Ounas"
2024,"Lille","Ligue 1","Alexsandro Ribeiro","BRA","DF","24-295",1999,24.7,32,22,24,8,0,16,31,51.6,15,25,15,10,35,67,116,5,"https://fbref.com/en/players/102c9665/Alexsandro-Ribeiro"
2024,"Lille","Ligue 1","Tiago santos","POR","DF","21-312",2002,26.3,63,42,31,19,13,30,52,57.7,22,24,5,19,15,78,37,0,"https://fbref.com/en/players/3eeebc87/Tiago-santos"
2024,"Lille","Ligue 1","Samuel Umtiti","FRA","DF","30-198",1993,2.1,1,1,0,1,0,1,4,25,3,0,0,0,2,3,4,0,"https://fbref.com/en/players/3eed9821/Samuel-Umtiti"
2024,"Lille","Ligue 1","Alan Virginius","FRA","FW","21-148",2003,0.8,1,1,1,0,0,0,1,0,1,0,0,0,0,1,0,0,"https://fbref.com/en/players/01becd60/Alan-Virginius"
2024,"Lille","Ligue 1","Yusuf Yazıcı","TUR","MF,FW","27-122",1997,14.6,19,11,6,9,4,4,15,26.7,11,10,1,9,5,24,5,0,"https://fbref.com/en/players/f5c8b425/Yusuf-Yazici"
2024,"Lille","Ligue 1","Leny Yoro","FRA","DF","18-199",2005,29.7,36,25,27,7,2,17,31,54.8,14,20,14,6,36,72,97,1,"https://fbref.com/en/players/6763f716/Leny-Yoro"
2024,"Lille","Ligue 1","Edon Zhegrova","KVX","FW","25-060",1999,25.4,32,18,9,15,8,14,36,38.9,22,17,1,16,8,40,8,0,"https://fbref.com/en/players/34a88e3e/Edon-Zhegrova"
2024,"Liverpool","Premier League","Thiago Alcántara","ESP","MF","33-049",1991,0.1,0,0,0,0,0,0,0,NA,0,0,0,0,0,0,0,0,"https://fbref.com/en/players/77e84962/Thiago-Alcantara"
2024,"Liverpool","Premier League","Trent Alexander-Arnold","ENG","DF","25-236",1998,23.9,39,26,26,11,2,27,87,31,60,22,2,20,31,70,48,5,"https://fbref.com/en/players/cd1acf9d/Trent-Alexander-Arnold"
2024,"Liverpool","Premier League","Alisson","BRA","GK","31-241",1992,28,0,0,0,0,0,0,1,0,1,0,0,0,0,0,11,4,"https://fbref.com/en/players/7a2e46a8/Alisson"
2024,"Liverpool","Premier League","Stefan Bajcetic","ESP","MF","19-221",2004,0.3,4,1,3,1,0,3,5,60,2,0,0,0,0,4,0,0,"https://fbref.com/en/players/32e8417f/Stefan-Bajcetic"
2024,"Liverpool","Premier League","Owen Beck","WAL","DF","21-295",2002,0.1,2,1,1,1,0,0,0,NA,0,0,0,0,0,2,1,0,"https://fbref.com/en/players/a011a1e9/Owen-Beck"
2024,"Liverpool","Premier League","Conor Bradley","NIR","DF","20-326",2003,8.4,33,25,14,12,7,24,38,63.2,14,17,1,16,10,43,14,0,"https://fbref.com/en/players/bbd67769/Conor-Bradley"
2024,"Liverpool","Premier League","Bobby Clark","ENG","MF","19-113",2005,1,2,1,1,1,0,1,5,20,4,6,2,4,1,3,1,0,"https://fbref.com/en/players/73341ace/Bobby-Clark"
2024,"Liverpool","Premier League","Jayden Danns","ENG","FW","18-135",2006,0.1,0,0,0,0,0,0,0,NA,0,0,0,0,0,0,0,0,"https://fbref.com/en/players/003cf4d1/Jayden-Danns"
2024,"Liverpool","Premier League","Luis Díaz","COL","FW","27-138",1997,29.2,35,25,5,17,13,7,30,23.3,23,15,0,15,3,38,8,0,"https://fbref.com/en/players/4a1a9578/Luis-Diaz"
2024,"Liverpool","Premier League","Ben Doak","SCO","FW","18-201",2005,0.2,0,0,0,0,0,0,0,NA,0,0,0,0,0,0,0,0,"https://fbref.com/en/players/733f1a7d/Ben-Doak"
2024,"Liverpool","Premier League","Harvey Elliott","ENG","MF,FW","21-056",2003,15,27,17,8,14,5,10,31,32.3,21,27,0,27,6,33,7,0,"https://fbref.com/en/players/b9e1436c/Harvey-Elliott"
2024,"Liverpool","Premier League","Wataru Endo","JPN","MF","31-111",1993,19.1,48,28,11,31,6,20,61,32.8,41,24,2,22,20,68,31,3,"https://fbref.com/en/players/c149016b/Wataru-Endo"
2024,"Liverpool","Premier League","Cody Gakpo","NED","FW,MF","25-023",1999,18.3,27,17,8,14,5,8,25,32,17,21,4,17,14,41,7,0,"https://fbref.com/en/players/1971591f/Cody-Gakpo"
2024,"Liverpool","Premier League","Joe Gomez","ENG","DF","27-007",1997,19.8,47,31,24,16,7,30,63,47.6,33,26,4,22,19,66,50,2,"https://fbref.com/en/players/7a11550b/Joe-Gomez"
2024,"Liverpool","Premier League","Kaide Gordon","ENG","FW","19-238",2004,0,0,0,0,0,0,0,0,NA,0,0,0,0,0,0,0,0,"https://fbref.com/en/players/19a9cb70/Kaide-Gordon"
2024,"Liverpool","Premier League","Ryan Gravenberch","NED","MF","22-014",2002,12.5,26,12,5,13,8,12,29,41.4,17,20,2,18,14,40,11,0,"https://fbref.com/en/players/b8e740fb/Ryan-Gravenberch"
2024,"Liverpool","Premier League","Curtis Jones","ENG","MF","23-121",2001,13,27,14,12,12,3,10,23,43.5,13,22,0,22,7,34,8,0,"https://fbref.com/en/players/4fb9c88f/Curtis-Jones"
2024,"Liverpool","Premier League","Diogo Jota","POR","FW","27-178",1996,12.7,23,13,6,13,4,10,23,43.5,13,9,1,8,7,30,4,0,"https://fbref.com/en/players/178ae8f8/Diogo-Jota"
2024,"Liverpool","Premier League","Caoimhín Kelleher","IRL","GK","25-189",1998,10,0,0,0,0,0,0,0,NA,0,0,0,0,0,0,4,1,"https://fbref.com/en/players/62d7ef38/Caoimhin-Kelleher"
2024,"Liverpool","Premier League","Ibrahima Konaté","FRA","DF","25-005",1999,17.5,36,22,22,13,1,18,24,75,6,18,12,6,20,56,51,1,"https://fbref.com/en/players/5ed9b537/Ibrahima-Konate"
2024,"Liverpool","Premier League","Alexis Mac Allister","ARG","MF","25-158",1998,28.9,99,55,35,50,14,59,125,47.2,66,65,8,57,35,134,25,1,"https://fbref.com/en/players/83d074ff/Alexis-Mac-Allister"
2024,"Liverpool","Premier League","Joël Matip","CMR","DF","32-296",1991,8.7,12,6,7,4,1,8,12,66.7,4,16,12,4,9,21,43,0,"https://fbref.com/en/players/b217ef29/Joel-Matip"
2024,"Liverpool","Premier League","James McConnell","ENG","MF","19-260",2004,0,0,0,0,0,0,0,0,NA,0,1,0,1,1,1,0,0,"https://fbref.com/en/players/bf973eeb/James-McConnell"
2024,"Liverpool","Premier League","Darwin Núñez","URU","FW","24-341",1999,22.7,22,12,2,10,10,11,23,47.8,12,18,6,12,3,25,9,0,"https://fbref.com/en/players/4d77b365/Darwin-Nunez"
2024,"Liverpool","Premier League","Jarell Quansah","ENG","DF","21-122",2003,13.2,25,22,17,7,1,14,20,70,6,16,8,8,17,42,39,1,"https://fbref.com/en/players/4125cb98/Jarell-Quansah"
2024,"Liverpool","Premier League","Andrew Robertson","SCO","DF","30-080",1994,18.8,35,24,21,11,3,26,43,60.5,17,20,6,14,13,48,40,0,"https://fbref.com/en/players/2e4f5f03/Andrew-Robertson"
2024,"Liverpool","Premier League","Mohamed Salah","EGY","FW","31-350",1992,28.2,17,11,1,8,8,6,21,28.6,15,19,1,18,2,19,1,0,"https://fbref.com/en/players/e342ad68/Mohamed-Salah"
2024,"Liverpool","Premier League","Dominik Szoboszlai","HUN","MF","23-218",2000,23.4,32,19,12,12,8,16,50,32,34,37,2,35,15,47,16,1,"https://fbref.com/en/players/934e1968/Dominik-Szoboszlai"
2024,"Liverpool","Premier League","Kostas Tsimikas","GRE","DF","28-018",1996,7.5,19,13,9,6,4,9,15,60,6,9,1,8,6,25,10,0,"https://fbref.com/en/players/f315ca93/Kostas-Tsimikas"
2024,"Liverpool","Premier League","Virgil van Dijk","NED","DF","32-327",1991,35.3,40,23,24,13,3,12,14,85.7,2,47,34,13,39,79,144,0,"https://fbref.com/en/players/e06683ca/Virgil-van-Dijk"
2024,"Lorient","Ligue 1","Laurent Abergel","FRA","MF","31-119",1993,31.8,85,52,43,34,8,38,96,39.6,58,29,6,23,61,146,61,3,"https://fbref.com/en/players/31626657/Laurent-Abergel"
2024,"Lorient","Ligue 1","Nathaniel Adjei","GHA","DF","21-283",2002,13.8,13,9,8,3,2,6,7,85.7,1,15,8,7,18,31,64,1,"https://fbref.com/en/players/c55de1f5/Nathaniel-Adjei"
2024,"Lorient","Ligue 1","Tosin Aiyegun","BEN","MF,FW","25-339",1998,10,6,4,2,3,1,3,9,33.3,6,4,1,3,2,8,8,0,"https://fbref.com/en/players/9c4f39b3/Tosin-Aiyegun"
2024,"Lorient","Ligue 1","Tiemoué Bakayoko","FRA","MF","29-287",1994,14.6,34,17,14,17,3,15,28,53.6,13,10,4,6,26,60,15,1,"https://fbref.com/en/players/59bf127b/Tiemoue-Bakayoko"
2024,"Lorient","Ligue 1","Mohamed Bamba","CIV","FW","22-172",2001,12.6,14,9,3,8,3,4,10,40,6,7,1,6,2,16,3,0,"https://fbref.com/en/players/d469252b/Mohamed-Bamba"
2024,"Lorient","Ligue 1","Badredine Bouanani","ALG","MF","19-174",2004,4.9,4,2,1,1,2,2,4,50,2,3,0,3,2,6,3,0,"https://fbref.com/en/players/0400dd2f/Badredine-Bouanani"
2024,"Lorient","Ligue 1","Gino Caoki","FRA","MF","19-318",2004,0.1,0,0,0,0,0,0,1,0,1,0,0,0,0,0,0,0,"https://fbref.com/en/players/a26d3da7/Gino-Caoki"
2024,"Lorient","Ligue 1","Igor Carioca","BRA","DF,MF","27-283",1996,2.9,8,6,6,1,1,4,6,66.7,2,0,0,0,3,11,6,0,"https://fbref.com/en/players/e3e32fbb/Igor-Carioca"
2024,"Lorient","Ligue 1","Bamba Dieng","SEN","FW","24-068",2000,6.1,3,3,0,3,0,1,3,33.3,2,3,0,3,0,3,7,0,"https://fbref.com/en/players/40774c6b/Bamba-Dieng"
2024,"Lorient","Ligue 1","Siriné Doucouré","MLI","FW","22-052",2002,4.7,8,6,0,4,4,3,3,100,0,4,0,4,1,9,6,0,"https://fbref.com/en/players/92d90c8f/Sirine-Doucoure"
2024,"Lorient","Ligue 1","Romain Faivre","FRA","MF,FW","25-321",1998,16.1,13,6,5,4,4,6,15,40,9,6,1,5,7,20,3,1,"https://fbref.com/en/players/745ca0a3/Romain-Faivre"
2024,"Lorient","Ligue 1","Adrian Grbić","AUT","FW","27-300",1996,0.3,0,0,0,0,0,0,0,NA,0,0,0,0,0,0,0,0,"https://fbref.com/en/players/4a987ffa/Adrian-Grbic"
2024,"Lorient","Ligue 1","Bonke Innocent","NGA","MF","28-131",1996,2.3,6,4,2,2,2,2,9,22.2,7,2,1,1,4,10,2,0,"https://fbref.com/en/players/546bb36e/Bonke-Innocent"
2024,"Lorient","Ligue 1","Eli Junior Kroupi","FRA","FW,MF","17-342",2006,12,7,4,2,2,3,1,9,11.1,8,6,0,6,10,17,5,0,"https://fbref.com/en/players/b2fe86e5/Eli-Junior-Kroupi"
2024,"Lorient","Ligue 1","Gedeon Kalulu","COD","DF","26-275",1997,10.8,23,17,13,8,2,12,22,54.5,10,18,2,16,5,28,30,0,"https://fbref.com/en/players/dd211559/Gedeon-Kalulu"
2024,"Lorient","Ligue 1","Ayman Kari","FRA","MF","19-193",2004,9.9,18,14,9,9,0,12,19,63.2,7,19,2,17,6,24,9,1,"https://fbref.com/en/players/0e8d7b6c/Ayman-Kari"
2024,"Lorient","Ligue 1","Panos Katseris","GRE","DF","22-330",2001,11.6,26,20,16,8,2,16,25,64,9,20,4,16,8,34,18,0,"https://fbref.com/en/players/c1597cf7/Panos-Katseris"
2024,"Lorient","Ligue 1","Ibrahima Koné","MLI","FW","24-349",1999,0.4,0,0,0,0,0,0,1,0,1,0,0,0,0,0,0,0,"https://fbref.com/en/players/04bb2b06/Ibrahima-Kone"
2024,"Lorient","Ligue 1","Julien Laporte","FRA","DF","30-208",1993,20.2,23,14,15,7,1,16,36,44.4,20,36,26,10,11,34,116,1,"https://fbref.com/en/players/f066022d/Julien-Laporte"
2024,"Lorient","Ligue 1","Théo Le Bris","FRA","DF,MF","21-242",2002,16.8,35,22,25,7,3,19,40,47.5,21,24,3,21,12,47,42,0,"https://fbref.com/en/players/afe39ca8/Theo-Le-Bris"
2024,"Lorient","Ligue 1","Vincent Le Goff","FRA","DF,MF","34-228",1989,6,5,0,4,0,1,4,8,50,4,11,3,8,3,8,10,0,"https://fbref.com/en/players/2321ea6e/Vincent-Le-Goff"
2024,"Lorient","Ligue 1","Imran Louza","MAR","MF","25-029",1999,9.6,13,7,2,8,3,2,8,25,6,8,1,7,9,22,4,0,"https://fbref.com/en/players/e1df6989/Imran-Louza"
2024,"Lorient","Ligue 1","Jean-Victor Makengo","FRA","MF,FW","25-353",1998,5.3,5,4,3,2,0,2,6,33.3,4,12,1,11,8,13,5,0,"https://fbref.com/en/players/22bfb57e/Jean-Victor-Makengo"
2024,"Lorient","Ligue 1","Bamo Meïté","CIV","DF","22-179",2001,1.6,2,1,2,0,0,0,1,0,1,3,2,1,3,5,9,0,"https://fbref.com/en/players/04ac78d2/Bamo-Meite"
2024,"Lorient","Ligue 1","Benjamin Mendy","FRA","DF","29-318",1994,7.9,3,1,2,1,0,1,5,20,4,8,2,6,7,10,20,0,"https://fbref.com/en/players/5271c8f1/Benjamin-Mendy"
2024,"Lorient","Ligue 1","Formose Mendy","SEN","DF","23-149",2001,14,33,19,24,8,1,20,33,60.6,13,23,12,11,20,53,59,1,"https://fbref.com/en/players/c21983bf/Formose-Mendy"
2024,"Lorient","Ligue 1","Loris Mouyokolo","FRA","DF","23-008",2001,1,4,1,4,0,0,1,1,100,0,1,0,1,0,4,3,0,"https://fbref.com/en/players/96726741/Loris-Mouyokolo"
2024,"Lorient","Ligue 1","Joel Mugisha","NOR","FW","21-200",2002,2,NA,4,NA,NA,NA,NA,NA,NA,NA,NA,NA,NA,2,NA,NA,NA,"https://fbref.com/en/players/6032ccd8/Joel-Mugisha"
2024,"Lorient","Ligue 1","Yvon Mvogo","SUI","GK","29-359",1994,34,0,0,0,0,0,0,1,0,1,0,0,0,0,0,15,3,"https://fbref.com/en/players/dc29b608/Yvon-Mvogo"
2024,"Lorient","Ligue 1","Joel Mvuka","NOR","DF,FW","21-190",2002,0.2,5,0,3,1,1,3,7,42.9,4,1,0,1,0,5,1,0,"https://fbref.com/en/players/cc704d9c/Joel-Mvuka"
2024,"Lorient","Ligue 1","Bassirou Ndiaye","SEN","FW","22-105",2002,1.7,5,2,2,2,1,3,5,60,2,1,1,0,1,6,0,0,"https://fbref.com/en/players/b70a4c6c/Bassirou-Ndiaye"
2024,"Lorient","Ligue 1","Royce Openda Owaga","GAB","FW","22-039",2002,0.2,0,0,0,0,0,0,0,NA,0,0,0,0,0,0,0,0,"https://fbref.com/en/players/a758ca47/Royce-Openda-Owaga"
2024,"Lorient","Ligue 1","Pablo Pagis","FRA","MF","21-153",2002,1.8,10,6,5,4,1,6,10,60,4,2,0,2,3,13,1,0,"https://fbref.com/en/players/7d827b4f/Pablo-Pagis"
2024,"Lorient","Ligue 1","Aurélien Pelon","FRA","DF","20-024",2004,1,1,0,1,0,0,0,2,0,2,2,2,0,0,1,7,0,"https://fbref.com/en/players/d3b54513/Aurelien-Pelon"
2024,"Lorient","Ligue 1","Julien Ponceau","FRA","MF","23-184",2000,24.9,32,15,12,14,6,9,30,30,21,22,1,21,19,51,20,0,"https://fbref.com/en/players/e546b2e3/Julien-Ponceau"
2024,"Lorient","Ligue 1","Dembo Sylla","GUI","DF","21-202",2002,0.5,1,1,0,1,0,0,0,NA,0,0,0,0,1,2,2,0,"https://fbref.com/en/players/fcb9b1f8/Dembo-Sylla"
2024,"Lorient","Ligue 1","Montassar Talbi","TUN","DF","26-004",1998,24.5,38,22,23,13,2,19,32,59.4,13,39,23,16,32,70,114,0,"https://fbref.com/en/players/a4a44eb0/Montassar-Talbi"
2024,"Lorient","Ligue 1","Souleymane Touré","FRA","DF","21-063",2003,22.8,25,12,16,9,0,8,14,57.1,6,38,20,18,36,61,101,2,"https://fbref.com/en/players/01fd01e8/Souleymane-Toure"
2024,"Lorient","Ligue 1","Darlin Yongwa","CMR","DF","23-251",2000,12.9,30,23,17,11,2,14,25,56,11,14,2,12,15,45,36,0,"https://fbref.com/en/players/061266cd/Darlin-Yongwa"
2024,"Luton Town","Premier League","Elijah Adebayo","ENG","FW","26-144",1998,15.8,4,1,1,0,3,1,12,8.3,11,13,2,11,6,10,25,0,"https://fbref.com/en/players/0480ebc7/Elijah-Adebayo"
2024,"Luton Town","Premier League","Ross Barkley","ENG","MF","30-177",1993,29.1,47,19,16,21,10,11,48,22.9,37,25,9,16,25,72,51,2,"https://fbref.com/en/players/3a24769f/Ross-Barkley"
2024,"Luton Town","Premier League","Amari'i Bell","JAM","DF","30-025",1994,19.1,50,33,30,19,1,22,35,62.9,13,33,15,18,25,75,60,1,"https://fbref.com/en/players/399e9474/Amarii-Bell"
2024,"Luton Town","Premier League","Luke Berry","ENG","MF,DF","31-323",1992,3.6,7,2,2,4,1,2,3,66.7,1,6,1,5,0,7,3,0,"https://fbref.com/en/players/2aaadf33/Luke-Berry"
2024,"Luton Town","Premier League","Jacob Brown","SCO","MF,FW","26-050",1998,11.3,19,12,7,7,5,7,18,38.9,11,20,1,19,8,27,22,0,"https://fbref.com/en/players/ca18c8f1/Jacob-Brown"
2024,"Luton Town","Premier League","Reece Burke","ENG","DF","27-271",1996,18.4,37,23,17,14,6,12,26,46.2,14,25,18,7,18,55,78,1,"https://fbref.com/en/players/a681b7b7/Reece-Burke"
2024,"Luton Town","Premier League","Tahith Chong","NED","MF,FW","24-178",1999,22,36,22,19,13,4,15,33,45.5,18,30,6,24,8,44,11,1,"https://fbref.com/en/players/2696b6a9/Tahith-Chong"
2024,"Luton Town","Premier League","Jordan Clark","ENG","MF","30-251",1993,14.5,30,17,14,11,5,11,39,28.2,28,24,3,21,11,41,15,1,"https://fbref.com/en/players/7c5fa6cf/Jordan-Clark"
2024,"Luton Town","Premier League","Alfie Doughty","ENG","DF","24-161",1999,32.5,63,40,29,18,16,37,82,45.1,45,51,9,42,31,94,43,4,"https://fbref.com/en/players/bf33b257/Alfie-Doughty"
2024,"Luton Town","Premier League","Daiki Hashioka","JPN","DF","25-013",1999,6.6,11,5,6,4,1,5,11,45.5,6,12,7,5,8,19,20,0,"https://fbref.com/en/players/10cb48b7/Daiki-Hashioka"
2024,"Luton Town","Premier League","Ryan John Giles","ENG","DF,MF","24-125",2000,5.6,8,6,4,3,1,2,7,28.6,5,2,0,2,4,12,22,0,"https://fbref.com/en/players/73b1d65b/Ryan-John-Giles"
2024,"Luton Town","Premier League","Joseph Johnson","ENG","DF","18-099",2006,0.9,0,0,0,0,0,0,1,0,1,0,0,0,0,0,0,0,"https://fbref.com/en/players/d9e7c4da/Joseph-Johnson"
2024,"Luton Town","Premier League","Mads Juel Andersen","DEN","DF","26-155",1997,4.4,6,5,4,2,0,4,4,100,0,9,6,3,8,14,29,0,"https://fbref.com/en/players/f098c03e/Mads-Juel-Andersen"
2024,"Luton Town","Premier League","Issa Kaboré","BFA","DF","23-018",2001,19.2,52,28,23,21,8,24,45,53.3,21,22,11,11,16,68,56,2,"https://fbref.com/en/players/c066d1a5/Issa-Kabore"
2024,"Luton Town","Premier League","Thomas Kaminski","BEL","GK","31-220",1992,37.8,2,1,2,0,0,2,6,33.3,4,1,0,1,0,2,14,2,"https://fbref.com/en/players/1caa93a5/Thomas-Kaminski"
2024,"Luton Town","Premier League","Tom Lockyer","WAL","DF","29-179",1994,13,25,16,17,6,2,15,22,68.2,7,23,13,10,23,48,68,0,"https://fbref.com/en/players/37118440/Tom-Lockyer"
2024,"Luton Town","Premier League","Teden Mengi","ENG","DF","22-030",2002,27.4,54,22,33,20,1,19,30,63.3,11,39,27,12,57,111,140,1,"https://fbref.com/en/players/91748070/Teden-Mengi"
2024,"Luton Town","Premier League","Carlton Morris","ENG","FW,MF","28-166",1995,31.8,15,8,4,6,5,9,15,60,6,24,5,19,1,16,53,0,"https://fbref.com/en/players/2da834f1/Carlton-Morris"
2024,"Luton Town","Premier League","Marvelous Nakamba","ZIM","MF","30-132",1994,12.6,40,24,24,14,2,24,42,57.1,18,23,6,17,11,51,11,1,"https://fbref.com/en/players/de5b5570/Marvelous-Nakamba"
2024,"Luton Town","Premier League","Zack Nelson","ENG","MF,DF","19-249",2004,0.1,1,0,1,0,0,0,0,NA,0,0,0,0,0,1,0,0,"https://fbref.com/en/players/de0abf23/Zack-Nelson"
2024,"Luton Town","Premier League","Chiedozie Ogbene","IRL","MF,DF","27-029",1997,22.2,17,10,10,7,0,12,22,54.5,10,14,3,11,7,24,34,2,"https://fbref.com/en/players/788c0277/Chiedozie-Ogbene"
2024,"Luton Town","Premier League","Fred Onyedinma","ENG","DF,MF","27-188",1996,4.5,10,6,7,3,0,5,12,41.7,7,3,0,3,1,11,13,0,"https://fbref.com/en/players/387d06b2/Fred-Onyedinma"
2024,"Luton Town","Premier League","Gabriel Osho","NGA","DF","25-290",1998,20.5,41,22,21,19,1,16,27,59.3,11,37,20,17,31,72,92,0,"https://fbref.com/en/players/cd889153/Gabriel-Osho"
2024,"Luton Town","Premier League","Pelly Ruddock Mpanzu","COD","MF","30-318",1993,12.2,13,5,6,6,1,5,9,55.6,4,15,7,8,9,22,16,3,"https://fbref.com/en/players/a9b1c319/Pelly-Ruddock-Mpanzu"
2024,"Luton Town","Premier League","Albert Sambi Lokonga","BEL","MF","24-221",1999,14.5,29,18,14,12,3,17,24,70.8,7,23,13,10,11,40,14,0,"https://fbref.com/en/players/1b4f1169/Albert-Sambi-Lokonga"
2024,"Luton Town","Premier League","James Shea","ENG","GK","32-349",1991,0.2,0,0,0,0,0,0,0,NA,0,0,0,0,0,0,2,0,"https://fbref.com/en/players/ee7c0a5e/James-Shea"
2024,"Luton Town","Premier League","Andros Townsend","ENG","MF,FW","32-319",1991,13.4,21,13,11,2,8,13,27,48.1,14,12,0,12,5,26,10,0,"https://fbref.com/en/players/b28bbd58/Andros-Townsend"
2024,"Luton Town","Premier League","Cauley Woodrow","ENG","FW,MF","29-180",1994,4.7,16,10,8,4,4,9,16,56.3,7,7,1,6,1,17,14,0,"https://fbref.com/en/players/d3085b49/Cauley-Woodrow"
2024,"Lyon","Ligue 1","Adryelson","BRA","DF,FW","26-068",1998,0.1,0,0,0,0,0,0,0,NA,0,0,0,0,1,1,3,0,"https://fbref.com/en/players/e980e78d/Adryelson"
2024,"Lyon","Ligue 1","Paul Akouokou","CIV","MF","26-162",1997,3.4,14,9,2,10,2,6,7,85.7,1,5,1,4,6,20,11,0,"https://fbref.com/en/players/31f5b89b/Paul-Akouokou"
2024,"Lyon","Ligue 1","Skelly Alvero","FRA","MF","22-026",2002,4.7,8,7,5,2,1,2,9,22.2,7,5,1,4,2,10,5,0,"https://fbref.com/en/players/add37c13/Skelly-Alvero"
2024,"Lyon","Ligue 1","Mohamed El Arouch","FRA","FW","20-054",2004,0,0,0,0,0,0,0,0,NA,0,0,0,0,0,0,0,0,"https://fbref.com/en/players/508a9011/Mohamed-El-Arouch"
2024,"Lyon","Ligue 1","Bradley Barcola","FRA","FW","21-271",2002,3,5,2,0,2,3,1,7,14.3,6,4,0,4,2,7,0,0,"https://fbref.com/en/players/a0d55a09/Bradley-Barcola"
2024,"Lyon","Ligue 1","Saïd Benrahma","ALG","FW,MF","28-294",1995,8.6,9,7,1,6,2,5,7,71.4,2,7,0,7,1,10,3,0,"https://fbref.com/en/players/5a04fd92/Said-Benrahma"
2024,"Lyon","Ligue 1","Duje Ćaleta-Car","CRO","DF","27-256",1996,22.1,26,11,19,6,1,18,22,81.8,4,27,14,13,18,44,94,1,"https://fbref.com/en/players/94f8d10c/Duje-Caleta-Car"
2024,"Lyon","Ligue 1","Maxence Caqueret","FRA","MF","24-105",2000,33.6,91,64,39,37,15,38,107,35.5,69,40,9,31,48,139,26,2,"https://fbref.com/en/players/f81ef10d/Maxence-Caqueret"
2024,"Lyon","Ligue 1","Rayan Cherki","FRA","MF,FW","20-287",2003,19.1,28,15,4,16,8,17,46,37,29,13,3,10,7,35,1,0,"https://fbref.com/en/players/b34c63a5/Rayan-Cherki"
2024,"Lyon","Ligue 1","Mahamadou Diawara","FRA","MF","19-103",2005,4,9,6,4,5,0,3,11,27.3,8,4,1,3,4,13,4,0,"https://fbref.com/en/players/1906b842/Mahamadou-Diawara"
2024,"Lyon","Ligue 1","Sinaly Diomande","CIV","DF","23-051",2001,9.9,10,4,5,3,2,9,16,56.3,7,12,9,3,15,25,26,1,"https://fbref.com/en/players/6de23ab0/Sinaly-Diomande"
2024,"Lyon","Ligue 1","Chaim El Djebali","TUN","MF","20-113",2004,0.1,0,0,0,0,0,0,0,NA,0,0,0,0,0,0,0,0,"https://fbref.com/en/players/a1dbb2c7/Chaim-El-Djebali"
2024,"Lyon","Ligue 1","Malick Fofana","BEL","FW","19-060",2005,6.2,5,4,3,1,1,4,9,44.4,5,3,0,3,5,10,9,0,"https://fbref.com/en/players/8236f673/Malick-Fofana"
2024,"Lyon","Ligue 1","Henrique","BRA","DF","30-035",1994,6.7,10,6,6,4,0,6,11,54.5,5,8,2,6,10,20,3,0,"https://fbref.com/en/players/f28474a4/Henrique"
2024,"Lyon","Ligue 1","Jeffinho","BRA","FW,MF","24-152",1999,3.4,11,4,3,5,3,4,11,36.4,7,1,0,1,0,11,0,0,"https://fbref.com/en/players/45cce300/Jeffinho"
2024,"Lyon","Ligue 1","Tino Kadewere","ZIM","FW,MF","28-146",1996,3.3,1,1,0,1,0,1,5,20,4,3,1,2,5,6,7,0,"https://fbref.com/en/players/7d08063d/Tino-Kadewere"
2024,"Lyon","Ligue 1","Sael Kumbedi","FRA","DF","19-065",2005,10.3,30,20,14,12,4,9,22,40.9,13,12,3,9,14,44,18,2,"https://fbref.com/en/players/c385bf49/Sael-Kumbedi"
2024,"Lyon","Ligue 1","Alexandre Lacazette","FRA","FW","33-002",1991,25.5,19,12,8,9,2,5,17,29.4,12,22,3,19,8,27,9,0,"https://fbref.com/en/players/9dbb75ca/Alexandre-Lacazette"
2024,"Lyon","Ligue 1","Johann Lepenant","FRA","MF","21-221",2002,2.8,4,3,2,2,0,1,8,12.5,7,5,0,5,4,8,0,0,"https://fbref.com/en/players/1e52971c/Johann-Lepenant"
2024,"Lyon","Ligue 1","Anthony Lopes","POR","GK","33-242",1990,31,0,0,0,0,0,0,0,NA,0,0,0,0,0,0,16,0,"https://fbref.com/en/players/f00de885/Anthony-Lopes"
2024,"Lyon","Ligue 1","Dejan Lovren","CRO","DF","34-330",1989,8,9,7,6,3,0,3,7,42.9,4,6,5,1,12,21,37,0,"https://fbref.com/en/players/1a2935f6/Dejan-Lovren"
2024,"Lyon","Ligue 1","Ainsley Maitland-Niles","ENG","DF,MF","26-275",1997,15.9,34,18,12,14,8,19,37,51.4,18,16,6,10,17,51,29,1,"https://fbref.com/en/players/e3a5814e/Ainsley-Maitland-Niles"
2024,"Lyon","Ligue 1","Orel Mangala","BEL","MF","26-073",1998,4.4,5,3,0,2,3,1,3,33.3,2,3,2,1,5,10,6,0,"https://fbref.com/en/players/a572e291/Orel-Mangala"
2024,"Lyon","Ligue 1","Clinton Mata","ANG","DF","31-205",1992,24.7,43,24,29,8,6,23,40,57.5,17,35,16,19,40,83,61,0,"https://fbref.com/en/players/55abe554/Clinton-Mata"
2024,"Lyon","Ligue 1","Nemanja Matić","SRB","MF","35-303",1988,13.9,17,11,8,7,2,9,19,47.4,10,17,6,11,16,33,17,1,"https://fbref.com/en/players/eb7822d7/Nemanja-Matic"
2024,"Lyon","Ligue 1","Diego Moreira","POR","FW,MF","19-298",2004,3,0,0,0,0,0,0,3,0,3,3,0,3,2,2,5,0,"https://fbref.com/en/players/12de1b0d/Diego-Moreira"
2024,"Lyon","Ligue 1","Ernest Nuamah","GHA","FW,MF","20-211",2003,20.4,28,14,18,6,4,12,38,31.6,26,15,1,14,8,36,9,0,"https://fbref.com/en/players/234a703c/Ernest-Nuamah"
2024,"Lyon","Ligue 1","Jake O'Brien","IRL","DF","23-015",2001,26.3,22,16,16,5,1,14,20,70,6,23,18,5,12,34,98,1,"https://fbref.com/en/players/25f2ef01/Jake-OBrien"
2024,"Lyon","Ligue 1","Gift Orban","NGA","FW","21-318",2002,5.3,4,3,0,1,3,1,4,25,3,2,0,2,1,5,2,1,"https://fbref.com/en/players/de17db90/Gift-Orban"
2024,"Lyon","Ligue 1","Rémy Riou","FRA","GK","36-298",1987,3,0,0,0,0,0,0,1,0,1,0,0,0,0,0,1,1,"https://fbref.com/en/players/7f41ee30/Remy-Riou"
2024,"Lyon","Ligue 1","Mama Samba Baldé","GNB","FW,MF","28-206",1995,6.1,8,5,1,2,5,3,9,33.3,6,0,0,0,3,11,1,1,"https://fbref.com/en/players/fb14aa28/Mama-Samba-Balde"
2024,"Lyon","Ligue 1","Amin Sarr","SWE","FW,MF","23-080",2001,1.1,1,0,0,1,0,0,0,NA,0,1,0,1,0,1,1,0,"https://fbref.com/en/players/d5326924/Amin-Sarr"
2024,"Lyon","Ligue 1","Mamadou Sarr","FRA","DF","18-275",2005,0.1,0,0,0,0,0,0,0,NA,0,0,0,0,0,0,0,0,"https://fbref.com/en/players/61f80c89/Mamadou-Sarr"
2024,"Lyon","Ligue 1","Nicolás Tagliafico","ARG","DF","31-273",1992,23.6,54,34,23,22,9,22,49,44.9,27,25,8,17,28,82,43,0,"https://fbref.com/en/players/f0661424/Nicolas-Tagliafico"
2024,"Lyon","Ligue 1","Corentin Tolisso","FRA","MF","29-301",1994,19.3,33,21,13,11,9,14,33,42.4,19,26,9,17,10,43,18,0,"https://fbref.com/en/players/652d4c37/Corentin-Tolisso"
2024,"Mainz 05","Bundesliga","Ludovic Ajorque","FRA","FW","30-095",1994,15.1,3,2,1,2,0,2,11,18.2,9,6,2,4,4,7,11,0,"https://fbref.com/en/players/462475ed/Ludovic-Ajorque"
2024,"Mainz 05","Bundesliga","Nadiem Amiri","GER","MF","27-216",1996,14.6,22,14,8,10,4,13,19,68.4,6,16,2,14,14,36,18,0,"https://fbref.com/en/players/555d5edd/Nadiem-Amiri"
2024,"Mainz 05","Bundesliga","Aymen Barkok","MAR","MF,FW","26-009",1998,3.6,9,5,2,6,1,3,6,50,3,7,0,7,2,11,1,0,"https://fbref.com/en/players/a2a85828/Aymen-Barkok"
2024,"Mainz 05","Bundesliga","Leandro Barreiro Martins","LUX","MF","24-148",2000,29,65,40,19,37,9,30,50,60,20,45,16,29,36,101,53,0,"https://fbref.com/en/players/00242b75/Leandro-Barreiro-Martins"
2024,"Mainz 05","Bundesliga","Daniel Batz","GER","GK","33-139",1991,4,0,0,0,0,0,0,0,NA,0,0,0,0,0,0,3,0,"https://fbref.com/en/players/ec759ba1/Daniel-Batz"
2024,"Mainz 05","Bundesliga","Stefan Bell","GER","DF","32-280",1991,7.4,8,8,7,1,0,4,8,50,4,7,5,2,6,14,30,0,"https://fbref.com/en/players/857a5abe/Stefan-Bell"
2024,"Mainz 05","Bundesliga","Jonathan Burkardt","GER","FW,MF","23-324",2000,17.1,12,8,2,6,4,4,11,36.4,7,16,3,13,3,15,2,0,"https://fbref.com/en/players/05f99a4a/Jonathan-Burkardt"
2024,"Mainz 05","Bundesliga","Anthony Caci","FRA","DF","26-334",1997,27.6,56,23,30,25,1,27,44,61.4,17,43,7,36,32,88,45,0,"https://fbref.com/en/players/0118c54c/Anthony-Caci"
2024,"Mainz 05","Bundesliga","Danny da Costa","GER","DF","30-322",1993,9.2,18,9,9,7,2,9,19,47.4,10,17,4,13,16,34,24,0,"https://fbref.com/en/players/5ddb8f9f/Danny-da-Costa"
2024,"Mainz 05","Bundesliga","Sepp van den Berg","NED","DF","22-162",2001,31.5,38,23,20,15,3,15,26,57.7,11,66,36,30,43,81,159,2,"https://fbref.com/en/players/7bf9400b/Sepp-van-den-Berg"
2024,"Mainz 05","Bundesliga","Edimilson Fernandes","SUI","DF","28-045",1996,14.3,25,16,15,9,1,16,24,66.7,8,14,6,8,22,47,52,0,"https://fbref.com/en/players/3bb625ac/Edimilson-Fernandes"
2024,"Mainz 05","Bundesliga","Anwar El Ghazi","NED","MF,DF","29-027",1995,0.6,0,0,0,0,0,0,1,0,1,0,0,0,0,0,0,0,"https://fbref.com/en/players/ffa90327/Anwar-El-Ghazi"
2024,"Mainz 05","Bundesliga","Brajan Gruda","GER","MF,FW","19-365",2004,18.2,22,14,5,11,6,14,24,58.3,10,15,0,15,5,27,4,0,"https://fbref.com/en/players/ae9b998d/Brajan-Gruda"
2024,"Mainz 05","Bundesliga","Josuha Guilavogui","FRA","DF","33-254",1990,4.5,15,10,10,5,0,6,7,85.7,1,13,7,6,13,28,21,0,"https://fbref.com/en/players/e6c43eec/Josuha-Guilavogui"
2024,"Mainz 05","Bundesliga","Andreas Hanche-Olsen","NOR","DF","27-134",1997,11,20,12,10,8,2,10,16,62.5,6,10,4,6,11,31,41,0,"https://fbref.com/en/players/2e77d607/Andreas-Hanche-Olsen"
2024,"Mainz 05","Bundesliga","Lee Jae-sung","KOR","MF,FW","31-294",1992,23.5,33,20,11,16,6,13,39,33.3,26,22,2,20,27,60,23,0,"https://fbref.com/en/players/34b0387f/Lee-Jae-sung"
2024,"Mainz 05","Bundesliga","Dominik Kohr","GER","DF,MF","30-120",1994,24.3,65,42,36,25,4,36,57,63.2,21,27,6,21,43,108,58,0,"https://fbref.com/en/players/0fbecd11/Dominik-Kohr"
2024,"Mainz 05","Bundesliga","Tom Krauß","GER","MF","22-343",2001,15,57,33,22,31,4,21,58,36.2,37,33,4,29,17,74,28,0,"https://fbref.com/en/players/9f77012e/Tom-Krauss"
2024,"Mainz 05","Bundesliga","Maxim Leitsch","GER","DF","26-012",1998,4.2,6,3,5,1,0,3,6,50,3,2,0,2,4,10,13,0,"https://fbref.com/en/players/7e12a98d/Maxim-Leitsch"
2024,"Mainz 05","Bundesliga","David Mamutovic","GER","FW,DF","23-177",2000,0.1,1,1,0,1,0,1,1,100,0,0,0,0,0,1,0,0,"https://fbref.com/en/players/7c24eaf8/David-Mamutovic"
2024,"Mainz 05","Bundesliga","Marcus Müller","GER","MF","21-284",2002,0.2,0,0,0,0,0,0,0,NA,0,0,0,0,0,0,0,0,"https://fbref.com/en/players/3c151571/Marcus-Muller"
2024,"Mainz 05","Bundesliga","Phillipp Mwene","AUT","DF","30-122",1994,22.2,34,15,15,16,3,16,33,48.5,17,27,3,24,17,51,47,0,"https://fbref.com/en/players/2ff76adc/Phillipp-Mwene"
2024,"Mainz 05","Bundesliga","Jessic Ngankam","GER","FW,MF","23-315",2000,2,1,1,0,1,0,0,0,NA,0,3,1,2,3,4,0,0,"https://fbref.com/en/players/bc249af8/Jessic-Ngankam"
2024,"Mainz 05","Bundesliga","Karim Onisiwo","AUT","FW,MF","32-074",1992,16.6,17,8,4,6,7,6,11,54.5,5,18,4,14,2,19,7,0,"https://fbref.com/en/players/f26834c7/Karim-Onisiwo"
2024,"Mainz 05","Bundesliga","Matondo-Merveille Papela","GER","MF,DF","23-133",2001,2.9,5,4,2,3,0,0,4,0,4,1,0,1,4,9,2,0,"https://fbref.com/en/players/b4b08774/Matondo-Merveille-Papela"
2024,"Mainz 05","Bundesliga","Marco Richter","GER","MF,FW","26-188",1997,8,10,4,5,3,2,4,11,36.4,7,9,0,9,2,12,1,0,"https://fbref.com/en/players/f972644c/Marco-Richter"
2024,"Mainz 05","Bundesliga","Anton Stach","GER","MF","25-197",1998,1.9,3,0,2,0,1,2,4,50,2,5,0,5,2,5,5,0,"https://fbref.com/en/players/0f59a7bf/Anton-Stach"
2024,"Mainz 05","Bundesliga","Nelson Weiper","GER","FW,MF","19-074",2005,1.4,2,1,2,0,0,2,3,66.7,1,1,0,1,1,3,0,0,"https://fbref.com/en/players/231c67ff/Nelson-Weiper"
2024,"Mainz 05","Bundesliga","Silvan Widmer","SUI","DF","31-086",1993,13.8,23,10,12,8,3,17,28,60.7,11,18,5,13,16,39,37,0,"https://fbref.com/en/players/f68b64fc/Silvan-Widmer"
2024,"Mainz 05","Bundesliga","Robin Zentner","GER","GK","29-215",1994,30,2,2,2,0,0,2,5,40,3,1,0,1,1,3,19,1,"https://fbref.com/en/players/5c4bf6ba/Robin-Zentner"
2024,"Mallorca","La Liga","Amath","SEN","FW,MF","27-319",1996,4.4,9,6,7,2,0,2,10,20,8,2,0,2,3,12,6,0,"https://fbref.com/en/players/f3b1d9a2/Amath"
2024,"Mallorca","La Liga","Copete","ESP","DF","24-233",1999,14.8,45,27,27,17,1,30,43,69.8,13,12,6,6,32,77,47,1,"https://fbref.com/en/players/0f26ffd7/Copete"
2024,"Mallorca","La Liga","Jaume Costa","ESP","DF","36-073",1988,18.7,38,22,23,10,5,18,29,62.1,11,14,4,10,16,54,35,0,"https://fbref.com/en/players/808d48f3/Jaume-Costa"
2024,"Mallorca","La Liga","Samu Costa","POR","MF","23-185",2000,25.6,91,50,40,46,5,46,93,49.5,47,28,14,14,39,130,59,3,"https://fbref.com/en/players/76c2a023/Samu-Costa"
2024,"Mallorca","La Liga","Iván Cuéllar","ESP","GK","40-003",1984,1,0,0,0,0,0,0,0,NA,0,0,0,0,0,0,0,0,"https://fbref.com/en/players/75751c99/Ivan-Cuellar"
2024,"Mallorca","La Liga","Sergi Darder","ESP","MF","30-160",1993,24,39,26,13,21,5,12,31,38.7,19,20,4,16,16,55,16,0,"https://fbref.com/en/players/070a3904/Sergi-Darder"
2024,"Mallorca","La Liga","Giovanni González","URU","DF","29-253",1994,27.4,73,45,37,32,4,40,81,49.4,41,24,3,21,31,104,60,2,"https://fbref.com/en/players/1fc474ae/Giovanni-Gonzalez"
2024,"Mallorca","La Liga","Dominik Greif","SVK","GK","27-054",1997,1,0,0,0,0,0,0,0,NA,0,0,0,0,0,0,0,0,"https://fbref.com/en/players/30061f53/Dominik-Greif"
2024,"Mallorca","La Liga","Cyle Larin","CAN","FW","29-043",1995,20.3,17,8,6,4,7,2,7,28.6,5,16,5,11,3,20,17,0,"https://fbref.com/en/players/e7af9060/Cyle-Larin"
2024,"Mallorca","La Liga","Toni Lato","ESP","DF","26-191",1997,17.2,38,23,19,13,6,16,27,59.3,11,17,3,14,17,55,27,0,"https://fbref.com/en/players/8e088e04/Toni-Lato"
2024,"Mallorca","La Liga","Javier Llabrés","ESP","MF,FW","21-262",2002,2.7,3,1,1,1,1,1,2,50,1,1,0,1,3,6,4,0,"https://fbref.com/en/players/38b0cf42/Javier-Llabres"
2024,"Mallorca","La Liga","Pablo Maffeo","ESP","DF","26-323",1997,16.2,35,22,18,13,4,23,40,57.5,17,12,2,10,10,45,23,0,"https://fbref.com/en/players/5db04597/Pablo-Maffeo"
2024,"Mallorca","La Liga","Omar Mascarell","ESP","MF","31-118",1993,17.5,33,16,16,17,0,18,35,51.4,17,24,8,16,31,64,30,1,"https://fbref.com/en/players/11fd2b75/Omar-Mascarell"
2024,"Mallorca","La Liga","Manu Morlanes","ESP","MF","25-139",1999,17.9,50,29,23,26,1,23,53,43.4,30,13,1,12,20,70,21,0,"https://fbref.com/en/players/a0255c67/Manu-Morlanes"
2024,"Mallorca","La Liga","Vedat Muriqi","KVX","FW","30-036",1994,25.9,11,6,4,3,4,2,14,14.3,12,11,4,7,6,17,26,0,"https://fbref.com/en/players/0cadc46d/Vedat-Muriqi"
2024,"Mallorca","La Liga","Matija Nastasić","SRB","DF","31-063",1993,25.1,35,17,26,9,0,24,32,75,8,33,20,13,29,64,114,0,"https://fbref.com/en/players/f35430a4/Matija-Nastasic"
2024,"Mallorca","La Liga","Abdón Prats","ESP","FW,MF","31-175",1992,14.1,6,4,2,2,2,3,5,60,2,6,3,3,2,8,12,0,"https://fbref.com/en/players/d1b060e2/Abdon-Prats"
2024,"Mallorca","La Liga","Nemanja Radonjić","SRB","MF,DF","28-105",1996,3.9,4,2,1,3,0,1,4,25,3,2,0,2,3,7,3,0,"https://fbref.com/en/players/0630eb63/Nemanja-Radonjic"
2024,"Mallorca","La Liga","Antonio Raillo","ESP","DF","32-235",1991,24.4,30,23,18,12,0,17,23,73.9,6,44,30,14,37,67,104,2,"https://fbref.com/en/players/b857bd29/Antonio-Raillo"
2024,"Mallorca","La Liga","Predrag Rajković","SRB","GK","28-212",1995,36,2,1,2,0,0,2,2,100,0,0,0,0,0,2,14,0,"https://fbref.com/en/players/58ad9383/Predrag-Rajkovic"
2024,"Mallorca","La Liga","Dani Rodríguez","ESP","MF","35-359",1988,29.1,47,24,21,20,6,21,45,46.7,24,34,5,29,15,62,21,0,"https://fbref.com/en/players/70f8e0bd/Dani-Rodriguez"
2024,"Mallorca","La Liga","Antonio Sánchez","ESP","MF","27-150",1997,16.1,25,11,13,10,2,11,32,34.4,21,24,5,19,13,38,13,0,"https://fbref.com/en/players/a254bbe0/Antonio-Sanchez"
2024,"Mallorca","La Liga","Martin Valjent","SVK","DF","28-171",1995,26.1,34,18,19,13,2,18,30,60,12,26,11,15,29,63,112,1,"https://fbref.com/en/players/f2c6ac01/Martin-Valjent"
2024,"Mallorca","La Liga","Siebe Van Der Heyden","BEL","DF","26-000",1998,3.2,9,2,7,2,0,4,6,66.7,2,1,1,0,7,16,12,0,"https://fbref.com/en/players/cf9bdd43/Siebe-Van-Der-Heyden"
2024,"Mallorca","La Liga","Nacho Vidal","ESP","DF","29-127",1995,4.6,12,5,4,5,3,6,13,46.2,7,5,2,3,3,15,9,0,"https://fbref.com/en/players/3a9c4b7b/Nacho-Vidal"
2024,"Manchester City","Premier League","Manuel Akanji","SUI","DF,MF","28-316",1995,27.9,42,28,16,18,8,22,39,56.4,17,28,12,16,23,65,70,3,"https://fbref.com/en/players/89ac64a6/Manuel-Akanji"
2024,"Manchester City","Premier League","Nathan Aké","NED","DF","29-102",1995,22.7,26,16,15,8,3,13,20,65,7,17,2,15,14,40,54,0,"https://fbref.com/en/players/eaeca114/Nathan-Ake"
2024,"Manchester City","Premier League","Julián Álvarez","ARG","MF,FW","24-120",2000,29.4,24,13,5,8,11,8,32,25,24,30,0,30,2,26,14,1,"https://fbref.com/en/players/15ab5a2b/Julian-Alvarez"
2024,"Manchester City","Premier League","Oscar Bobb","NOR","FW,MF","20-323",2003,3.4,7,3,1,2,4,2,4,50,2,4,0,4,5,12,1,0,"https://fbref.com/en/players/eed2427e/Oscar-Bobb"
2024,"Manchester City","Premier League","Kevin De Bruyne","BEL","MF","32-337",1991,13.6,14,9,1,5,8,7,20,35,13,5,0,5,4,18,4,0,"https://fbref.com/en/players/e46012d4/Kevin-De-Bruyne"
2024,"Manchester City","Premier League","Rúben Dias","POR","DF","27-016",1997,28.4,39,20,14,21,4,19,26,73.1,7,32,17,15,30,69,77,0,"https://fbref.com/en/players/31c69ef1/Ruben-Dias"
2024,"Manchester City","Premier League","Jeremy Doku","BEL","FW,MF","22-003",2002,17.7,39,22,13,12,14,9,20,45,11,14,0,14,9,48,5,0,"https://fbref.com/en/players/fffea3e5/Jeremy-Doku"
2024,"Manchester City","Premier League","Ederson","BRA","GK","30-287",1993,30.9,0,0,0,0,0,0,1,0,1,0,0,0,0,0,10,1,"https://fbref.com/en/players/3bb7b8b4/Ederson"
2024,"Manchester City","Premier League","Phil Foden","ENG","FW,MF","24-002",2000,31.7,31,20,11,10,10,13,31,41.9,18,30,0,30,13,44,18,1,"https://fbref.com/en/players/ed1e53f3/Phil-Foden"
2024,"Manchester City","Premier League","Sergio Gómez","ESP","FW,MF","23-269",2000,0.6,1,0,0,1,0,1,2,50,1,0,0,0,1,2,0,0,"https://fbref.com/en/players/01e5f06e/Sergio-Gomez"
2024,"Manchester City","Premier League","Jack Grealish","ENG","FW,MF","28-263",1995,11.2,13,8,6,7,0,6,12,50,6,13,2,11,6,19,5,0,"https://fbref.com/en/players/b0b4fd3e/Jack-Grealish"
2024,"Manchester City","Premier League","Joško Gvardiol","CRO","DF","22-128",2002,25.9,55,33,21,24,10,21,38,55.3,17,36,12,24,27,82,37,3,"https://fbref.com/en/players/5ad50391/Josko-Gvardiol"
2024,"Manchester City","Premier League","Erling Haaland","NOR","FW","23-314",2000,28.4,6,3,0,3,3,2,3,66.7,1,11,1,10,2,8,16,0,"https://fbref.com/en/players/1f44ac21/Erling-Haaland"
2024,"Manchester City","Premier League","Mateo Kovačić","CRO","MF","30-024",1994,17.2,36,25,16,15,5,18,28,64.3,10,23,1,22,10,46,10,0,"https://fbref.com/en/players/79c0821a/Mateo-Kovacic"
2024,"Manchester City","Premier League","Aymeric Laporte","ESP","DF","30-003",1994,0.1,0,0,0,0,0,0,0,NA,0,1,1,0,0,0,1,0,"https://fbref.com/en/players/119b9a8e/Aymeric-Laporte"
2024,"Manchester City","Premier League","Rico Lewis","ENG","DF,MF","19-191",2004,9,10,7,4,4,2,3,7,42.9,4,7,1,6,4,14,6,0,"https://fbref.com/en/players/b57e066e/Rico-Lewis"
2024,"Manchester City","Premier League","James Mcatee","ENG","MF","21-225",2002,0,0,0,0,0,0,0,0,NA,0,1,0,1,0,0,0,0,"https://fbref.com/en/players/96593e89/James-Mcatee"
2024,"Manchester City","Premier League","Matheus Nunes","POR","MF","25-277",1998,7.3,10,4,1,7,2,5,16,31.3,11,7,1,6,1,11,8,1,"https://fbref.com/en/players/e6af02e0/Matheus-Nunes"
2024,"Manchester City","Premier League","Stefan Ortega","GER","GK","31-206",1992,7.1,0,0,0,0,0,0,0,NA,0,0,0,0,0,0,2,1,"https://fbref.com/en/players/c1242d4e/Stefan-Ortega"
2024,"Manchester City","Premier League","Cole Palmer","ENG","MF","22-024",2002,0.1,0,0,0,0,0,0,0,NA,0,0,0,0,0,0,0,0,"https://fbref.com/en/players/dc7f8a28/Cole-Palmer"
2024,"Manchester City","Premier League","Kalvin Phillips","ENG","MF","28-180",1995,1,3,3,1,1,1,0,0,NA,0,0,0,0,2,5,2,0,"https://fbref.com/en/players/4f565d77/Kalvin-Phillips"
2024,"Manchester City","Premier League","Rodri","ESP","MF","27-343",1996,32.6,70,43,25,33,12,29,60,48.3,31,32,8,24,26,96,41,4,"https://fbref.com/en/players/6434f10d/Rodri"
2024,"Manchester City","Premier League","Bernardo Silva","POR","MF,FW","29-294",1994,28.6,51,23,13,25,13,25,57,43.9,32,32,4,28,17,68,15,1,"https://fbref.com/en/players/3eb22ec9/Bernardo-Silva"
2024,"Manchester City","Premier League","John Stones","ENG","DF,MF","30-002",1994,11.8,2,1,1,0,1,0,3,0,3,11,7,4,10,12,21,0,"https://fbref.com/en/players/5eecec3d/John-Stones"
2024,"Manchester City","Premier League","Kyle Walker","ENG","DF","34-002",1990,30.7,38,24,19,17,2,19,39,48.7,20,19,6,13,27,65,40,1,"https://fbref.com/en/players/86dd77d1/Kyle-Walker"
2024,"Manchester Utd","Premier League","Sofyan Amrabat","MAR","MF,DF","27-283",1996,10.4,27,16,17,8,2,17,31,54.8,14,19,7,12,8,35,19,2,"https://fbref.com/en/players/5a2cb25d/Sofyan-Amrabat"
2024,"Manchester Utd","Premier League","Antony","BRA","FW","24-096",2000,14.7,40,21,15,19,6,20,40,50,20,29,1,28,12,52,9,0,"https://fbref.com/en/players/99127249/Antony"
2024,"Manchester Utd","Premier League","Donny van de Beek","NED","DF","27-042",1997,0,0,0,0,0,0,0,0,NA,0,1,0,1,0,0,0,0,"https://fbref.com/en/players/50dc94ce/Donny-van-de-Beek"
2024,"Manchester Utd","Premier League","Casemiro","BRA","MF,DF","32-097",1992,22,83,56,43,32,8,51,106,48.1,55,74,33,41,17,100,71,1,"https://fbref.com/en/players/4d224fe8/Casemiro"
2024,"Manchester Utd","Premier League","Diogo Dalot","POR","DF","25-073",1999,35.3,81,51,58,12,11,51,74,68.9,23,44,16,28,37,118,109,0,"https://fbref.com/en/players/d9565625/Diogo-Dalot"
2024,"Manchester Utd","Premier League","Amad Diallo","CIV","FW,MF","21-324",2002,4.3,10,3,1,6,3,3,4,75,1,3,1,2,1,11,6,0,"https://fbref.com/en/players/9dc96f10/Amad-Diallo"
2024,"Manchester Utd","Premier League","Christian Eriksen","DEN","MF","32-106",1992,12.7,18,13,5,10,3,12,33,36.4,21,17,6,11,4,22,13,0,"https://fbref.com/en/players/980522ec/Christian-Eriksen"
2024,"Manchester Utd","Premier League","Jonny Evans","NIR","DF","36-148",1988,15.5,22,14,20,2,0,12,21,57.1,9,25,18,7,23,45,75,0,"https://fbref.com/en/players/f8fcd2a5/Jonny-Evans"
2024,"Manchester Utd","Premier League","Bruno Fernandes","POR","MF,FW","29-265",1994,34.6,68,38,27,25,16,30,88,34.1,58,49,6,43,27,95,49,2,"https://fbref.com/en/players/507c7bdf/Bruno-Fernandes"
2024,"Manchester Utd","Premier League","Omari Forson","ENG","FW","19-315",2004,0.8,2,0,0,2,0,1,1,100,0,0,0,0,0,2,0,0,"https://fbref.com/en/players/1b9728b0/Omari-Forson"
2024,"Manchester Utd","Premier League","Alejandro Garnacho","ARG","FW","19-334",2004,28.5,22,15,7,6,9,12,45,26.7,33,26,2,24,18,40,18,0,"https://fbref.com/en/players/7aa8adfe/Alejandro-Garnacho"
2024,"Manchester Utd","Premier League","Daniel Gore","ENG","MF","19-247",2004,0,1,1,0,1,0,1,1,100,0,0,0,0,1,2,0,0,"https://fbref.com/en/players/861e9b3b/Daniel-Gore"
2024,"Manchester Utd","Premier League","Rasmus Højlund","DEN","FW","21-116",2003,24,11,7,2,3,6,5,13,38.5,8,9,1,8,1,12,19,0,"https://fbref.com/en/players/491a433d/Rasmus-Hojlund"
2024,"Manchester Utd","Premier League","Willy Kambwala","FRA","DF","19-279",2004,3.7,3,1,1,2,0,1,3,33.3,2,6,3,3,4,7,14,1,"https://fbref.com/en/players/6a7353d7/Willy-Kambwala"
2024,"Manchester Utd","Premier League","Victor Lindelöf","SWE","DF","29-318",1994,14.8,15,10,8,7,0,5,13,38.5,8,18,9,9,12,27,40,1,"https://fbref.com/en/players/f5deef4c/Victor-Lindelof"
2024,"Manchester Utd","Premier League","Harry Maguire","ENG","DF","31-086",1993,18.4,24,17,14,10,0,12,22,54.5,10,33,24,9,25,49,83,1,"https://fbref.com/en/players/d8931174/Harry-Maguire"
2024,"Manchester Utd","Premier League","Kobbie Mainoo","ENG","MF","19-041",2005,21.4,47,27,20,16,11,21,45,46.7,24,20,12,8,22,69,30,1,"https://fbref.com/en/players/c6220452/Kobbie-Mainoo"
2024,"Manchester Utd","Premier League","Anthony Martial","FRA","FW","28-177",1995,5,4,1,1,1,2,1,1,100,0,4,0,4,0,4,3,0,"https://fbref.com/en/players/8b788c01/Anthony-Martial"
2024,"Manchester Utd","Premier League","Lisandro Martínez","ARG","DF","26-133",1998,7.2,12,8,8,4,0,5,12,41.7,7,10,8,2,5,17,26,0,"https://fbref.com/en/players/bac46a10/Lisandro-Martinez"
2024,"Manchester Utd","Premier League","Scott McTominay","SCO","MF,FW","27-174",1996,21.1,48,24,23,23,2,22,33,66.7,11,34,12,22,14,62,53,0,"https://fbref.com/en/players/d93c2511/Scott-McTominay"
2024,"Manchester Utd","Premier League","Hannibal Mejbri","TUN","MF,FW","21-130",2003,1.5,3,3,1,2,0,1,3,33.3,2,1,1,0,0,3,0,0,"https://fbref.com/en/players/ca22ccb0/Hannibal-Mejbri"
2024,"Manchester Utd","Premier League","Mason Mount","ENG","MF,FW","25-141",1999,5.7,22,14,6,10,6,6,16,37.5,10,6,1,5,6,28,3,0,"https://fbref.com/en/players/9674002f/Mason-Mount"
2024,"Manchester Utd","Premier League","André Onana","CMR","GK","28-058",1996,38,2,0,2,0,0,2,2,100,0,0,0,0,0,2,11,2,"https://fbref.com/en/players/e9c0c1b2/Andre-Onana"
2024,"Manchester Utd","Premier League","Facundo Pellistri","URU","FW,MF","22-162",2001,1.9,5,3,4,1,0,1,3,33.3,2,7,1,6,1,6,5,0,"https://fbref.com/en/players/ac7e7b1c/Facundo-Pellistri"
2024,"Manchester Utd","Premier League","Marcus Rashford","ENG","FW","26-212",1997,25.2,19,12,9,4,6,9,26,34.6,17,15,1,14,4,23,20,0,"https://fbref.com/en/players/a1d5bd30/Marcus-Rashford"
2024,"Manchester Utd","Premier League","Sergio Reguilón","ESP","DF","27-166",1996,4.6,13,8,6,2,5,8,17,47.1,9,10,0,10,5,18,7,0,"https://fbref.com/en/players/3353737a/Sergio-Reguilon"
2024,"Manchester Utd","Premier League","Jadon Sancho","ENG","FW,MF","24-066",2000,0.9,1,0,1,0,0,1,3,33.3,2,1,0,1,1,2,0,0,"https://fbref.com/en/players/dbf053da/Jadon-Sancho"
2024,"Manchester Utd","Premier League","Luke Shaw","ENG","DF","28-323",1995,10.7,11,8,7,3,1,9,15,60,6,18,11,7,6,17,39,0,"https://fbref.com/en/players/9c94165b/Luke-Shaw"
2024,"Manchester Utd","Premier League","Raphaël Varane","FRA","DF","31-035",1993,15.3,18,11,10,7,1,10,14,71.4,4,23,18,5,15,33,88,0,"https://fbref.com/en/players/9f8e9423/Raphael-Varane"
2024,"Manchester Utd","Premier League","Aaron Wan-Bissaka","ENG","DF","26-186",1997,19.8,42,25,18,20,4,19,26,73.1,7,30,15,15,41,83,68,1,"https://fbref.com/en/players/9e525177/Aaron-Wan-Bissaka"
2024,"Manchester Utd","Premier League","Ethan Wheatley","ENG","FW","18-131",2006,0.2,1,1,0,1,0,1,1,100,0,2,0,2,2,3,0,0,"https://fbref.com/en/players/5c368c88/Ethan-Wheatley"
2024,"Marseille","Ligue 1","Keyliane Abdallah","FRA","FW","18-055",2006,0,0,0,0,0,0,0,0,NA,0,0,0,0,0,0,0,0,"https://fbref.com/en/players/7310786d/Keyliane-Abdallah"
2024,"Marseille","Ligue 1","Michael Amir Murillo","PAN","DF","28-109",1996,11.1,23,11,13,6,4,15,23,65.2,8,9,2,7,11,34,34,2,"https://fbref.com/en/players/349cae8f/Michael-Amir-Murillo"
2024,"Marseille","Ligue 1","Pierre-Emerick Aubameyang","GAB","FW","34-347",1989,29.1,22,14,4,11,7,7,26,26.9,19,30,5,25,9,31,26,0,"https://fbref.com/en/players/d5dd5f1f/Pierre-Emerick-Aubameyang"
2024,"Marseille","Ligue 1","Leonardo Balerdi","ARG","DF","25-125",1999,25.2,79,50,55,23,1,49,67,73.1,18,38,15,23,51,130,91,0,"https://fbref.com/en/players/7c3ed041/Leonardo-Balerdi"
2024,"Marseille","Ligue 1","Rubén Blanco","ESP","GK","28-310",1995,1.3,0,0,0,0,0,0,0,NA,0,0,0,0,0,0,0,0,"https://fbref.com/en/players/967f34d3/Ruben-Blanco"
2024,"Marseille","Ligue 1","Jonathan Clauss","FRA","DF","31-248",1992,23,47,20,22,19,6,26,49,53.1,23,17,3,14,36,83,46,0,"https://fbref.com/en/players/5219ab4a/Jonathan-Clauss"
2024,"Marseille","Ligue 1","Joaquín Correa","ARG","FW,MF","29-291",1994,4.8,7,5,4,2,1,0,8,0,8,2,0,2,1,8,1,0,"https://fbref.com/en/players/45b9b619/Joaquin-Correa"
2024,"Marseille","Ligue 1","Raimane Daou","COM","DF,MF","19-192",2004,0.3,1,1,1,0,0,1,2,50,1,0,0,0,0,1,2,0,"https://fbref.com/en/players/a2c9af28/Raimane-Daou"
2024,"Marseille","Ligue 1","Ulisses Garcia","SUI","DF","28-140",1996,10.1,21,16,6,13,2,13,20,65,7,8,3,5,7,28,13,2,"https://fbref.com/en/players/c952f633/Ulisses-Garcia"
2024,"Marseille","Ligue 1","Samuel Gigot","FRA","DF","30-231",1993,19.2,33,22,16,13,4,13,19,68.4,6,28,18,10,25,58,93,1,"https://fbref.com/en/players/41eebdf5/Samuel-Gigot"
2024,"Marseille","Ligue 1","Mattéo Guendouzi","FRA","MF","25-046",1999,0.2,0,0,0,0,0,0,0,NA,0,1,1,0,0,0,0,0,"https://fbref.com/en/players/5ea8ef20/Matteo-Guendouzi"
2024,"Marseille","Ligue 1","Pape Gueye","SEN","MF,DF","25-127",1999,8.5,33,21,11,19,3,13,19,68.4,6,17,3,14,13,46,12,0,"https://fbref.com/en/players/7155e3e1/Pape-Gueye"
2024,"Marseille","Ligue 1","Amine Harit","MAR","MF,FW","26-347",1997,20.2,28,16,8,17,3,13,37,35.1,24,31,4,27,12,40,4,0,"https://fbref.com/en/players/e7d59f4f/Amine-Harit"
2024,"Marseille","Ligue 1","Luis Henrique","BRA","FW,DF","22-168",2001,8.7,8,7,4,1,3,4,7,57.1,3,9,0,9,8,16,3,0,"https://fbref.com/en/players/f36d5624/Luis-Henrique"
2024,"Marseille","Ligue 1","Geoffrey Kondogbia","CTA","MF","31-105",1993,16.3,48,31,18,25,5,13,32,40.6,19,21,4,17,30,78,25,0,"https://fbref.com/en/players/cce181df/Geoffrey-Kondogbia"
2024,"Marseille","Ligue 1","Renan Lodi","BRA","DF","26-052",1998,13.7,24,16,8,13,3,13,21,61.9,8,7,2,5,16,40,35,0,"https://fbref.com/en/players/ed9f7cfe/Renan-Lodi"
2024,"Marseille","Ligue 1","Pau López","ESP","GK","29-169",1994,32.7,0,0,0,0,0,0,2,0,2,0,0,0,0,0,10,1,"https://fbref.com/en/players/20b9f052/Pau-Lopez"
2024,"Marseille","Ligue 1","Noam Mayoka-Tika","BEL","MF","20-210",2003,0,0,0,0,0,0,0,0,NA,0,0,0,0,0,0,0,0,"https://fbref.com/en/players/1b2ec72e/Noam-Mayoka-Tika"
2024,"Marseille","Ligue 1","Chancel Mbemba","COD","DF","29-296",1994,24.5,33,21,25,7,1,17,30,56.7,13,21,13,8,13,46,95,1,"https://fbref.com/en/players/e76cb9cc/Chancel-Mbemba"
2024,"Marseille","Ligue 1","Bamo Meïté","CIV","DF","22-179",2001,7.1,16,10,13,3,0,8,12,66.7,4,11,5,6,11,27,35,0,"https://fbref.com/en/players/04ac78d2/Bamo-Meite"
2024,"Marseille","Ligue 1","Quentin Merlin","FRA","DF","22-014",2002,7.8,13,12,7,5,1,8,20,40,12,4,0,4,6,19,14,0,"https://fbref.com/en/players/0bfca6a1/Quentin-Merlin"
2024,"Marseille","Ligue 1","François Mughe","CMR","MF,DF","19-349",2004,2,0,0,0,0,0,0,3,0,3,2,0,2,1,1,1,0,"https://fbref.com/en/players/7af655fe/Francois-Mughe"
2024,"Marseille","Ligue 1","Bilal Nadir","FRA","MF,FW","20-184",2003,1.3,4,3,2,2,0,1,2,50,1,0,0,0,2,6,2,0,"https://fbref.com/en/players/226673c2/Bilal-Nadir"
2024,"Marseille","Ligue 1","Iliman Ndiaye","SEN","FW,MF","24-085",2000,18,21,18,5,11,5,11,29,37.9,18,14,2,12,6,27,6,0,"https://fbref.com/en/players/5ed97752/Iliman-Ndiaye"
2024,"Marseille","Ligue 1","Jean Onana","CMR","MF","24-143",2000,6.3,23,14,6,14,3,13,25,52,12,10,2,8,11,34,11,1,"https://fbref.com/en/players/b5bb8188/Jean-Onana"
2024,"Marseille","Ligue 1","Azzedine Ounahi","MAR","MF","24-041",2000,13.4,25,11,9,14,2,11,32,34.4,21,6,1,5,11,36,8,0,"https://fbref.com/en/players/83299cc0/Azzedine-Ounahi"
2024,"Marseille","Ligue 1","Faris Pemi Moumbagna","CMR","FW","23-334",2000,6.1,2,1,0,2,0,0,3,0,3,4,0,4,3,5,1,0,"https://fbref.com/en/players/58aae0a9/Faris-Pemi-Moumbagna"
2024,"Marseille","Ligue 1","Valentin Rongier","FRA","MF","29-175",1994,9.5,23,12,9,12,2,14,26,53.8,12,16,4,12,15,38,18,0,"https://fbref.com/en/players/ed45c4a5/Valentin-Rongier"
2024,"Marseille","Ligue 1","Ismaila Sarr","SEN","FW,MF","26-095",1998,16.1,14,8,2,10,2,6,17,35.3,11,21,6,15,13,27,11,0,"https://fbref.com/en/players/bfdb33aa/Ismaila-Sarr"
2024,"Marseille","Ligue 1","Sofiane Sidi Ali","FRA","MF","28-321",1995,0.2,2,0,0,2,0,1,2,50,1,1,0,1,2,4,0,0,"https://fbref.com/en/players/1609700b/Sofiane-Sidi-Ali"
2024,"Marseille","Ligue 1","Emran Soglo","ENG","MF,DF","18-324",2005,1.2,2,1,0,2,0,1,3,33.3,2,6,0,6,1,3,3,0,"https://fbref.com/en/players/47f82561/Emran-Soglo"
2024,"Marseille","Ligue 1","Jordan Veretout","FRA","MF","31-090",1993,24.3,38,22,19,13,6,18,39,46.2,21,20,4,16,13,51,25,0,"https://fbref.com/en/players/4a56052c/Jordan-Veretout"
2024,"Marseille","Ligue 1","Vitinha","POR","FW","24-076",2000,10.3,14,8,3,5,6,3,12,25,9,11,2,9,5,19,8,0,"https://fbref.com/en/players/74d4cec6/Vitinha"
2024,"Metz","Ligue 1","Papa Amadou Diallo","SEN","FW","19-340",2004,9.9,18,8,10,7,1,7,21,33.3,14,11,1,10,11,29,16,0,"https://fbref.com/en/players/d638ab17/Papa-Amadou-Diallo"
2024,"Metz","Ligue 1","Joel Asoro","SWE","FW,MF","25-033",1999,9.4,13,9,7,6,0,3,10,30,7,7,1,6,6,19,9,0,"https://fbref.com/en/players/13e827f8/Joel-Asoro"
2024,"Metz","Ligue 1","Arthur Atta","FRA","MF,FW","21-137",2003,10.3,18,14,8,7,3,8,19,42.1,11,13,3,10,10,28,23,0,"https://fbref.com/en/players/d3ddf88b/Arthur-Atta"
2024,"Metz","Ligue 1","Lamine Camara","SEN","MF","20-150",2004,25.1,62,42,26,30,6,24,49,49,25,35,2,33,28,90,34,0,"https://fbref.com/en/players/19c2ffa4/Lamine-Camara"
2024,"Metz","Ligue 1","Fali Candé","GNB","DF","26-127",1998,20.5,40,19,31,9,0,20,35,57.1,15,41,28,13,20,60,107,1,"https://fbref.com/en/players/3cc4bb19/Fali-Cande"
2024,"Metz","Ligue 1","Maxime Colin","FRA","DF","32-197",1991,20.4,39,23,25,7,7,16,29,55.2,13,22,7,15,20,59,71,0,"https://fbref.com/en/players/2f71c116/Maxime-Colin"
2024,"Metz","Ligue 1","Guillaume Dietsch","FRA","GK","23-043",2001,0.8,0,0,0,0,0,0,0,NA,0,0,0,0,0,0,0,0,"https://fbref.com/en/players/e11a39aa/Guillaume-Dietsch"
2024,"Metz","Ligue 1","Simon Elisor","FRA","FW","24-313",1999,8.5,9,2,3,2,4,2,6,33.3,4,6,1,5,0,9,9,0,"https://fbref.com/en/players/825ed0d1/Simon-Elisor"
2024,"Metz","Ligue 1","Oscar Estupiñan","COL","FW","27-153",1996,2.9,5,4,0,3,2,1,2,50,1,2,0,2,0,5,0,0,"https://fbref.com/en/players/213ab9bb/Oscar-Estupinan"
2024,"Metz","Ligue 1","Jean Frederic N'Guessan","CIV","MF,FW","21-043",2003,1.2,3,1,0,3,0,0,3,0,3,3,0,3,1,4,0,0,"https://fbref.com/en/players/eef3f9c6/Jean-Frederic-NGuessan"
2024,"Metz","Ligue 1","Christophe Hérelle","MTQ","DF","31-282",1992,18,32,15,24,7,1,13,23,56.5,10,16,9,7,18,50,68,2,"https://fbref.com/en/players/3681cfff/Christophe-Herelle"
2024,"Metz","Ligue 1","Ablie Jallow","GAM","MF,FW","25-198",1998,10.2,8,5,2,3,3,3,5,60,2,4,0,4,8,16,3,0,"https://fbref.com/en/players/1bc6135b/Ablie-Jallow"
2024,"Metz","Ligue 1","Danley Jean-Jacques","HAI","MF","24-010",2000,29.8,54,28,24,21,9,19,56,33.9,37,48,7,41,44,98,44,0,"https://fbref.com/en/players/59fcbd6d/Danley-Jean-Jacques"
2024,"Metz","Ligue 1","Koffi Kouao","CIV","DF","26-010",1998,9.6,20,13,12,7,1,11,17,64.7,6,9,6,3,13,33,38,1,"https://fbref.com/en/players/32100829/Koffi-Kouao"
2024,"Metz","Ligue 1","Didier Lamkel Zé","CMR","FW,MF","27-256",1996,6.1,7,2,2,4,1,2,5,40,3,4,0,4,0,7,11,0,"https://fbref.com/en/players/b229aa13/Didier-Lamkel-Ze"
2024,"Metz","Ligue 1","Abou Lô","SEN","MF,DF","24-149",2000,2.2,3,1,2,1,0,1,4,25,3,5,2,3,4,7,8,0,"https://fbref.com/en/players/10e51236/Abou-Lo"
2024,"Metz","Ligue 1","Habib Maïga","CIV","MF,FW","28-150",1996,1.6,2,2,1,0,1,1,3,33.3,2,2,0,2,4,6,2,0,"https://fbref.com/en/players/e768de1f/Habib-Maiga"
2024,"Metz","Ligue 1","Youssef Maziz","FRA","FW,MF","25-341",1998,1.4,0,0,0,0,0,0,2,0,2,1,0,1,1,1,2,0,"https://fbref.com/en/players/514270e8/Youssef-Maziz"
2024,"Metz","Ligue 1","Malick Mbaye","SEN","MF,FW","20-054",2004,1.7,5,1,0,1,4,1,2,50,1,1,0,1,1,6,2,0,"https://fbref.com/en/players/6d2b0ada/Malick-Mbaye"
2024,"Metz","Ligue 1","Georges Mikautadze","GEO","FW","23-212",2000,19.4,4,3,1,2,1,0,9,0,9,11,0,11,8,12,3,0,"https://fbref.com/en/players/4788cb6b/Georges-Mikautadze"
2024,"Metz","Ligue 1","Kévin N'Doram","FRA","MF","28-129",1996,17.8,31,22,20,9,2,17,38,44.7,21,17,8,9,27,58,38,0,"https://fbref.com/en/players/e50623a0/Kevin-NDoram"
2024,"Metz","Ligue 1","Joseph Nduquidi","FRA","MF,DF","19-212",2004,8.3,11,4,6,3,2,1,9,11.1,8,11,3,8,11,22,15,1,"https://fbref.com/en/players/f365b837/Joseph-Nduquidi"
2024,"Metz","Ligue 1","Alexandre Oukidja","ALG","GK","35-316",1988,33.2,2,1,2,0,0,1,2,50,1,1,0,1,3,5,24,3,"https://fbref.com/en/players/ae7d0ecd/Alexandre-Oukidja"
2024,"Metz","Ligue 1","Ibou Sané","SEN","MF,FW","19-063",2005,1.4,6,4,2,1,3,2,2,100,0,3,0,3,1,7,2,0,"https://fbref.com/en/players/22d90df9/Ibou-Sane"
2024,"Metz","Ligue 1","Sadibou Sané","SEN","DF","19-355",2004,9.4,19,12,16,2,1,6,7,85.7,1,14,9,5,8,27,64,0,"https://fbref.com/en/players/b2009f99/Sadibou-Sane"
2024,"Metz","Ligue 1","Benjamin Tetteh","GHA","FW,MF","26-325",1997,3.1,6,6,1,5,0,4,7,57.1,3,0,0,0,0,6,1,0,"https://fbref.com/en/players/91f04b44/Benjamin-Tetteh"
2024,"Metz","Ligue 1","Cheikh Tidiane Sabaly","SEN","FW,MF","25-087",1999,15.3,40,20,23,12,5,16,40,40,24,19,2,17,10,50,14,0,"https://fbref.com/en/players/9ddf7fae/Cheikh-Tidiane-Sabaly"
2024,"Metz","Ligue 1","Ismaël Traoré","CIV","DF","37-286",1986,24.7,19,12,13,6,0,8,21,38.1,13,33,20,13,30,49,86,0,"https://fbref.com/en/players/b666421b/Ismael-Traore"
2024,"Metz","Ligue 1","Matthieu Udol","FRA","DF","28-071",1996,30,55,37,38,12,5,38,56,67.9,18,62,16,46,50,105,108,0,"https://fbref.com/en/players/cc41f558/Matthieu-Udol"
2024,"Metz","Ligue 1","Kévin Van Den Kerkhof","ALG","FW,MF","28-077",1996,21.3,31,24,11,13,7,13,32,40.6,19,15,2,13,11,42,32,1,"https://fbref.com/en/players/f6a3c84d/Kevin-Van-Den-Kerkhof"
2024,"Milan","Serie A","Yacine Adli","FRA","MF","23-306",2000,15.6,34,17,17,13,4,13,35,37.1,22,22,8,14,20,54,15,1,"https://fbref.com/en/players/26777636/Yacine-Adli"
2024,"Milan","Serie A","Davide Bartesaghi","ITA","DF,MF","18-153",2005,0.9,2,0,1,1,0,2,4,50,2,1,1,0,0,2,7,0,"https://fbref.com/en/players/7e0b6c50/Davide-Bartesaghi"
2024,"Milan","Serie A","Ismaël Bennacer","ALG","MF","26-181",1997,12.8,29,19,11,16,2,11,22,50,11,12,4,8,12,41,9,2,"https://fbref.com/en/players/db092d3b/Ismael-Bennacer"
2024,"Milan","Serie A","Davide Calabria","ITA","DF","27-176",1996,24.3,70,38,38,25,7,44,72,61.1,28,26,7,19,24,94,49,1,"https://fbref.com/en/players/2146785a/Davide-Calabria"
2024,"Milan","Serie A","Mattia Caldara","ITA","DF","30-025",1994,0.4,1,1,1,0,0,1,1,100,0,1,1,0,1,2,1,0,"https://fbref.com/en/players/ac7e640b/Mattia-Caldara"
2024,"Milan","Serie A","Francesco Camarda","ITA","FW","16-081",2008,0.2,0,0,0,0,0,0,2,0,2,0,0,0,0,0,0,0,"https://fbref.com/en/players/1956a64b/Francesco-Camarda"
2024,"Milan","Serie A","Samuel Chukwueze","NGA","FW","25-008",1999,11.3,18,7,11,5,2,9,17,52.9,8,3,1,2,6,24,3,0,"https://fbref.com/en/players/b8a642fc/Samuel-Chukwueze"
2024,"Milan","Serie A","Alessandro Florenzi","ITA","DF","33-080",1991,19.2,43,21,26,12,5,26,48,54.2,22,16,9,7,20,63,25,1,"https://fbref.com/en/players/e288d4b3/Alessandro-Florenzi"
2024,"Milan","Serie A","Matteo Gabbia","ITA","DF","24-222",1999,14.2,29,20,15,13,1,18,24,75,6,11,6,5,10,39,48,0,"https://fbref.com/en/players/c235e803/Matteo-Gabbia"
2024,"Milan","Serie A","Olivier Giroud","FRA","FW","37-243",1986,26.3,17,11,6,6,5,2,14,14.3,12,14,3,11,6,23,22,0,"https://fbref.com/en/players/16ceb862/Olivier-Giroud"
2024,"Milan","Serie A","Theo Hernández","FRA","DF","26-237",1997,31,30,17,19,11,0,11,22,50,11,33,13,20,23,53,42,1,"https://fbref.com/en/players/d4c9725f/Theo-Hernandez"
2024,"Milan","Serie A","Alejandro Jiménez","ESP","DF","19-022",2005,0.8,2,1,2,0,0,2,5,40,3,0,0,0,0,2,4,0,"https://fbref.com/en/players/faa13947/Alejandro-Jimenez"
2024,"Milan","Serie A","Luka Jović","SRB","FW","26-159",1997,9.7,6,4,0,3,3,4,6,66.7,2,3,0,3,1,7,9,0,"https://fbref.com/en/players/4d8cd038/Luka-Jovic"
2024,"Milan","Serie A","Pierre Kalulu","FRA","DF","23-360",2000,4.2,5,1,2,3,0,1,2,50,1,4,3,1,1,6,12,1,"https://fbref.com/en/players/85f7d1be/Pierre-Kalulu"
2024,"Milan","Serie A","Simon Kjær","DEN","DF","35-065",1989,13,24,15,11,11,2,14,22,63.6,8,22,16,6,14,38,46,2,"https://fbref.com/en/players/8b8a56ce/Simon-Kjaer"
2024,"Milan","Serie A","Rade Krunić","BIH","MF","30-236",1993,7.6,10,8,3,6,1,4,9,44.4,5,7,3,4,11,21,14,0,"https://fbref.com/en/players/817c6964/Rade-Krunic"
2024,"Milan","Serie A","Rafael Leão","POR","FW","24-355",1999,27.9,16,10,3,8,5,8,13,61.5,5,15,1,14,9,25,19,0,"https://fbref.com/en/players/20730eae/Rafael-Leao"
2024,"Milan","Serie A","Ruben Loftus-Cheek","ENG","MF","28-128",1996,23,28,18,7,14,7,15,27,55.6,12,24,12,12,9,37,10,1,"https://fbref.com/en/players/e97fd090/Ruben-Loftus-Cheek"
2024,"Milan","Serie A","Mike Maignan","FRA","GK","28-332",1995,29,1,0,1,0,0,1,1,100,0,1,0,1,1,2,4,3,"https://fbref.com/en/players/fcb38f57/Mike-Maignan"
2024,"Milan","Serie A","Antonio Mirante","ITA","GK","40-327",1983,2,0,0,0,0,0,0,0,NA,0,0,0,0,0,0,1,0,"https://fbref.com/en/players/30223b33/Antonio-Mirante"
2024,"Milan","Serie A","Yunus Musah","USA","MF,FW","21-183",2002,16.4,25,14,15,6,4,8,15,53.3,7,18,4,14,10,35,16,1,"https://fbref.com/en/players/b51b1b9c/Yunus-Musah"
2024,"Milan","Serie A","Lapo Nava","ITA","GK","20-129",2004,0,0,0,0,0,0,0,0,NA,0,0,0,0,0,0,0,0,"https://fbref.com/en/players/c0f732e1/Lapo-Nava"
2024,"Milan","Serie A","Noah Okafor","SUI","FW,MF","24-006",2000,9.9,6,4,1,4,1,3,10,30,7,8,1,7,0,6,10,0,"https://fbref.com/en/players/ca607d59/Noah-Okafor"
2024,"Milan","Serie A","Marco Pellegrino","","DF","",NA,0.8,1,1,0,0,1,0,2,0,2,1,1,0,1,2,2,0,"https://fbref.com/en/players/18950a80/Marco-Pellegrino"
2024,"Milan","Serie A","Tommaso Pobega","ITA","MF","24-320",1999,3.5,16,9,11,5,0,6,13,46.2,7,10,2,8,6,22,7,0,"https://fbref.com/en/players/55a1cac2/Tommaso-Pobega"
2024,"Milan","Serie A","Christian Pulisic","USA","FW,MF","25-255",1998,28.9,35,26,14,11,10,17,30,56.7,13,20,1,19,10,45,10,1,"https://fbref.com/en/players/1bf33a9a/Christian-Pulisic"
2024,"Milan","Serie A","Tijjani Reijnders","NED","MF","25-306",1998,31.3,46,25,10,31,5,21,43,48.8,22,26,8,18,18,64,26,0,"https://fbref.com/en/players/afb61630/Tijjani-Reijnders"
2024,"Milan","Serie A","Luka Romero","ARG","FW,MF","19-194",2004,1,0,0,0,0,0,0,3,0,3,2,0,2,0,0,0,0,"https://fbref.com/en/players/ca6edaa0/Luka-Romero"
2024,"Milan","Serie A","Jan-Carlo Simic","SRB","DF","19-028",2005,1.6,1,1,1,0,0,0,0,NA,0,5,4,1,0,1,3,0,"https://fbref.com/en/players/c9fc39ce/Jan-Carlo-Simic"
2024,"Milan","Serie A","Marco Sportiello","ITA","GK","32-020",1992,7,0,0,0,0,0,0,0,NA,0,0,0,0,0,0,2,0,"https://fbref.com/en/players/ac4003af/Marco-Sportiello"
2024,"Milan","Serie A","Filippo Terracciano","ITA","DF,FW","21-112",2003,0.8,2,2,1,1,0,1,3,33.3,2,3,0,3,0,2,1,0,"https://fbref.com/en/players/5cbb5ad6/Filippo-Terracciano"
2024,"Milan","Serie A","Malick Thiaw","GER","DF","22-296",2001,18,34,17,15,17,2,12,25,48,13,23,13,10,13,47,55,0,"https://fbref.com/en/players/ff5ea0bf/Malick-Thiaw"
2024,"Milan","Serie A","Fikayo Tomori","ENG","DF","26-163",1997,23.6,42,24,29,10,3,18,29,62.1,11,34,23,11,26,68,75,1,"https://fbref.com/en/players/7edfbb8a/Fikayo-Tomori"
2024,"Milan","Serie A","Chaka Traorè","CIV","FW","19-159",2004,0.2,2,1,2,0,0,1,2,50,1,1,1,0,0,2,0,0,"https://fbref.com/en/players/ee6e2b92/Chaka-Traore"
2024,"Milan","Serie A","Kevin Zeroli","ITA","MF","19-140",2005,0.3,1,1,1,0,0,0,0,NA,0,1,0,1,0,1,1,0,"https://fbref.com/en/players/7d6d4395/Kevin-Zeroli"
2024,"Monaco","Ligue 1","Maghnes Akliouche","FRA","MF,FW","22-095",2002,17.9,37,23,12,20,5,12,36,33.3,24,21,0,21,9,46,3,0,"https://fbref.com/en/players/b625b241/Maghnes-Akliouche"
2024,"Monaco","Ligue 1","Folarin Balogun","USA","FW","22-332",2001,18.8,12,4,3,8,1,5,13,38.5,8,10,0,10,3,15,4,0,"https://fbref.com/en/players/31822f8c/Folarin-Balogun"
2024,"Monaco","Ligue 1","Eliesse Ben Seghir","MAR","MF,FW","19-104",2005,4.8,9,6,2,5,2,3,7,42.9,4,6,0,6,2,11,2,0,"https://fbref.com/en/players/3bd65247/Eliesse-Ben-Seghir"
2024,"Monaco","Ligue 1","Wissam Ben Yedder","FRA","FW","33-292",1990,25.7,4,3,1,2,1,1,11,9.1,10,18,0,18,8,12,1,0,"https://fbref.com/en/players/942b4f90/Wissam-Ben-Yedder"
2024,"Monaco","Ligue 1","Myron Boadu","NED","FW","23-137",2001,0.9,2,2,0,1,1,1,2,50,1,2,0,2,0,2,0,0,"https://fbref.com/en/players/5b479568/Myron-Boadu"
2024,"Monaco","Ligue 1","Saïmon Bouabré","FRA","MF","17-364",2006,0.5,2,2,0,2,0,1,2,50,1,1,0,1,0,2,0,0,"https://fbref.com/en/players/f40e77d9/Saimon-Bouabre"
2024,"Monaco","Ligue 1","Mohamed Camara","MLI","MF","24-145",2000,11.5,35,21,10,20,5,15,29,51.7,14,8,2,6,11,46,7,0,"https://fbref.com/en/players/489e80e3/Mohamed-Camara"
2024,"Monaco","Ligue 1","Antonin Cartillier","FRA","DF","19-342",2004,0.1,0,0,0,0,0,0,0,NA,0,1,0,1,0,0,0,0,"https://fbref.com/en/players/c4a71372/Antonin-Cartillier"
2024,"Monaco","Ligue 1","Mamadou Coulibaly","FRA","MF","20-039",2004,1.3,7,4,2,3,2,3,8,37.5,5,4,0,4,0,7,0,0,"https://fbref.com/en/players/dacf856a/Mamadou-Coulibaly"
2024,"Monaco","Ligue 1","Krépin Diatta","SEN","DF,FW","25-095",1999,13.4,37,20,17,16,4,27,49,55.1,22,17,2,15,16,53,22,0,"https://fbref.com/en/players/8104e41e/Krepin-Diatta"
2024,"Monaco","Ligue 1","Edan Diop","FRA","MF,DF","19-276",2004,1.8,10,8,6,3,1,7,9,77.8,2,3,0,3,1,11,5,0,"https://fbref.com/en/players/37143438/Edan-Diop"
2024,"Monaco","Ligue 1","Breel Embolo","SUI","FW","27-106",1997,2,3,3,0,2,1,1,4,25,3,1,0,1,1,4,2,0,"https://fbref.com/en/players/0b4f388a/Breel-Embolo"
2024,"Monaco","Ligue 1","Youssouf Fofana","FRA","MF","25-141",1999,30,61,39,19,36,6,30,66,45.5,36,35,7,28,37,98,31,1,"https://fbref.com/en/players/822d51d7/Youssouf-Fofana"
2024,"Monaco","Ligue 1","Aleksandr Golovin","RUS","MF,FW","28-000",1996,23.9,42,30,14,22,6,15,42,35.7,27,37,3,34,21,63,14,0,"https://fbref.com/en/players/3708e9fa/Aleksandr-Golovin"
2024,"Monaco","Ligue 1","Ismail Jakobs","SEN","DF","24-287",1999,16.3,57,41,27,21,9,29,47,61.7,18,19,2,17,11,68,40,0,"https://fbref.com/en/players/a0415710/Ismail-Jakobs"
2024,"Monaco","Ligue 1","Thilo Kehrer","GER","DF","27-252",1996,14.7,32,22,22,7,3,22,39,56.4,17,18,6,12,30,62,55,0,"https://fbref.com/en/players/51dbeea9/Thilo-Kehrer"
2024,"Monaco","Ligue 1","Philipp Köhn","SUI","GK","26-058",1998,22,1,1,1,0,0,1,1,100,0,0,0,0,1,2,5,3,"https://fbref.com/en/players/ff74841d/Philipp-Kohn"
2024,"Monaco","Ligue 1","Soungoutou Magassa","FRA","DF,MF","20-235",2003,15,56,26,22,32,2,26,48,54.2,22,21,4,17,21,77,36,2,"https://fbref.com/en/players/dfc5d4fa/Soungoutou-Magassa"
2024,"Monaco","Ligue 1","Radosław Majecki","POL","GK","24-196",1999,12,0,0,0,0,0,0,0,NA,0,1,0,1,0,0,5,1,"https://fbref.com/en/players/20de219a/Radoslaw-Majecki"
2024,"Monaco","Ligue 1","Guillermo Maripán","CHI","DF","30-024",1994,19.6,22,8,15,6,1,10,27,37,17,26,13,13,30,52,106,4,"https://fbref.com/en/players/d9764034/Guillermo-Maripan"
2024,"Monaco","Ligue 1","Eliot Matazo","BEL","MF","22-105",2002,1.1,3,1,0,3,0,2,4,50,2,1,1,0,3,6,0,0,"https://fbref.com/en/players/15944afd/Eliot-Matazo"
2024,"Monaco","Ligue 1","Chrislain Matsima","FRA","DF","22-015",2002,3.3,9,7,5,3,1,2,7,28.6,5,4,1,3,4,13,4,0,"https://fbref.com/en/players/cf1ef7ec/Chrislain-Matsima"
2024,"Monaco","Ligue 1","Lucas Michel","FRA","FW","20-040",2004,0.1,0,0,0,0,0,0,0,NA,0,0,0,0,0,0,0,0,"https://fbref.com/en/players/73be1fdd/Lucas-Michel"
2024,"Monaco","Ligue 1","Takumi Minamino","JPN","MF","29-135",1995,23.5,34,17,10,13,11,16,54,29.6,38,29,1,28,11,45,8,0,"https://fbref.com/en/players/f833a830/Takumi-Minamino"
2024,"Monaco","Ligue 1","Kassoum Ouattara","FRA","DF,FW","19-229",2004,7.1,17,12,8,5,4,9,20,45,11,11,0,11,13,30,20,0,"https://fbref.com/en/players/6620c21a/Kassoum-Ouattara"
2024,"Monaco","Ligue 1","Mohammed Salisu","GHA","DF","25-043",1999,11.5,27,12,11,13,3,17,26,65.4,9,21,12,9,22,49,44,0,"https://fbref.com/en/players/0b33f6ad/Mohammed-Salisu"
2024,"Monaco","Ligue 1","Caio Henrique Oliveira Silva","BRA","DF","26-304",1997,6.9,13,7,3,7,3,6,9,66.7,3,8,2,6,6,19,9,0,"https://fbref.com/en/players/30af8b93/Caio-Henrique-Oliveira-Silva"
2024,"Monaco","Ligue 1","Wilfried Singo","CIV","DF","23-157",2000,24.3,34,25,18,14,2,17,26,65.4,9,27,14,13,51,85,81,2,"https://fbref.com/en/players/8b609c34/Wilfried-Singo"
2024,"Monaco","Ligue 1","Vanderson","BRA","DF","22-344",2001,18.2,60,41,20,30,10,32,70,45.7,38,29,2,27,35,95,37,1,"https://fbref.com/en/players/ee45fd85/Vanderson"
2024,"Monaco","Ligue 1","Denis Zakaria","SUI","MF,DF","27-192",1996,23.7,38,27,11,20,7,12,30,40,18,39,13,26,47,85,41,0,"https://fbref.com/en/players/384d58d9/Denis-Zakaria"
2024,"Montpellier","Ligue 1","Akor Adams","NGA","FW","24-122",2000,25,12,4,3,4,5,3,7,42.9,4,9,2,7,5,17,11,0,"https://fbref.com/en/players/2ccd39ed/Akor-Adams"
2024,"Montpellier","Ligue 1","Dimitry Bertaud","COD","GK","25-359",1998,4,0,0,0,0,0,0,0,NA,0,0,0,0,0,0,0,0,"https://fbref.com/en/players/380a15e2/Dimitry-Bertaud"
2024,"Montpellier","Ligue 1","Joris Chotard","FRA","MF","22-249",2001,28.7,81,52,45,25,11,48,96,50,48,47,21,26,44,125,60,0,"https://fbref.com/en/players/7909ffa4/Joris-Chotard"
2024,"Montpellier","Ligue 1","Tanguy Coulibaly","FRA","FW,MF","23-102",2001,6.9,13,11,8,4,1,4,9,44.4,5,11,1,10,2,15,2,0,"https://fbref.com/en/players/05ba9d7c/Tanguy-Coulibaly"
2024,"Montpellier","Ligue 1","Sacha Delaye","FRA","MF,FW","22-037",2002,1.4,7,2,2,2,3,1,6,16.7,5,2,0,2,0,7,1,0,"https://fbref.com/en/players/e4448c8c/Sacha-Delaye"
2024,"Montpellier","Ligue 1","Maxime Estève","FRA","DF","22-004",2002,11.1,16,12,11,5,0,10,15,66.7,5,13,9,4,18,34,50,0,"https://fbref.com/en/players/1a066e69/Maxime-Esteve"
2024,"Montpellier","Ligue 1","Khalil Fayad","FRA","FW,MF","19-356",2004,11.4,28,15,17,7,4,9,22,40.9,13,15,3,12,14,42,6,0,"https://fbref.com/en/players/faf00ab8/Khalil-Fayad"
2024,"Montpellier","Ligue 1","Jordan Ferri","FRA","MF","32-079",1992,22.6,36,22,16,17,3,20,67,29.9,47,19,1,18,13,49,23,0,"https://fbref.com/en/players/375622c5/Jordan-Ferri"
2024,"Montpellier","Ligue 1","Axel Gueguin","FRA","DF,FW","19-067",2005,1.5,9,5,6,2,1,2,6,33.3,4,2,0,2,2,11,6,0,"https://fbref.com/en/players/f6857b4f/Axel-Gueguin"
2024,"Montpellier","Ligue 1","Silvan Hefti","SUI","DF,FW","26-218",1997,7.9,21,15,10,7,4,15,29,51.7,14,7,2,5,8,29,11,0,"https://fbref.com/en/players/f8342731/Silvan-Hefti"
2024,"Montpellier","Ligue 1","Yanis Issoufou","FRA","MF","17-215",2006,0.1,0,0,0,0,0,0,0,NA,0,0,0,0,0,0,0,0,"https://fbref.com/en/players/5d004b30/Yanis-Issoufou"
2024,"Montpellier","Ligue 1","Christopher Jullien","FRA","DF","31-069",1993,13.7,16,12,11,5,0,6,17,35.3,11,25,20,5,12,28,106,2,"https://fbref.com/en/players/f323d995/Christopher-Jullien"
2024,"Montpellier","Ligue 1","Yann Karamoh","FRA","FW,MF","25-327",1998,3.2,1,0,0,0,1,1,2,50,1,3,0,3,0,1,0,0,"https://fbref.com/en/players/8b66d9cc/Yann-Karamoh"
2024,"Montpellier","Ligue 1","Wahbi Khazri","TUN","FW","33-112",1991,12.6,24,17,8,12,4,14,35,40,21,10,0,10,3,27,7,0,"https://fbref.com/en/players/2677a1de/Wahbi-Khazri"
2024,"Montpellier","Ligue 1","Boubakar Kouyaté","MLI","DF","27-045",1997,21.4,49,30,39,8,2,28,51,54.9,23,31,20,11,29,78,123,1,"https://fbref.com/en/players/562a4799/Boubakar-Kouyate"
2024,"Montpellier","Ligue 1","Benjamin Lecomte","FRA","GK","33-034",1991,30,0,0,0,0,0,0,1,0,1,0,0,0,0,0,16,1,"https://fbref.com/en/players/2fa2a875/Benjamin-Lecomte"
2024,"Montpellier","Ligue 1","Léo Leroy","FRA","MF","24-106",2000,5.5,19,10,8,8,3,6,21,28.6,15,12,3,9,7,26,8,0,"https://fbref.com/en/players/fcc84a07/Leo-Leroy"
2024,"Montpellier","Ligue 1","Othmane Maamma","FRA","FW","18-237",2005,1,3,3,2,0,1,1,1,100,0,3,0,3,0,3,0,0,"https://fbref.com/en/players/5bdb4a7b/Othmane-Maamma"
2024,"Montpellier","Ligue 1","Lucas Mincarelli","FRA","DF,MF","20-146",2004,10.9,29,16,19,6,4,17,34,50,17,17,4,13,8,37,27,0,"https://fbref.com/en/players/02b3733e/Lucas-Mincarelli"
2024,"Montpellier","Ligue 1","Arnaud Nordin","FRA","FW,MF","25-348",1998,13.8,12,6,3,5,4,6,16,37.5,10,11,0,11,2,14,10,0,"https://fbref.com/en/players/7b9a9e25/Arnaud-Nordin"
2024,"Montpellier","Ligue 1","Becir Omeragic","SUI","DF,MF","22-131",2002,25.7,48,29,31,13,4,20,33,60.6,13,51,29,22,27,75,65,0,"https://fbref.com/en/players/c284d6fb/Becir-Omeragic"
2024,"Montpellier","Ligue 1","Falaye Sacko","MLI","DF","29-029",1995,15.4,28,16,13,10,5,21,32,65.6,11,19,7,12,24,52,37,0,"https://fbref.com/en/players/6388e356/Falaye-Sacko"
2024,"Montpellier","Ligue 1","Modibo Sagnan","MLI","DF","25-046",1999,11.7,34,22,23,9,2,15,25,60,10,13,9,4,15,49,67,0,"https://fbref.com/en/players/76d679c7/Modibo-Sagnan"
2024,"Montpellier","Ligue 1","Théo Sainte-Luce","FRA","DF","25-223",1998,3.8,17,7,10,6,1,11,19,57.9,8,9,4,5,3,20,15,0,"https://fbref.com/en/players/93c942fb/Theo-Sainte-Luce"
2024,"Montpellier","Ligue 1","Mamadou Sakho","FRA","DF","34-107",1990,0.1,1,1,1,0,0,1,1,100,0,0,0,0,0,1,1,0,"https://fbref.com/en/players/87935cf3/Mamadou-Sakho"
2024,"Montpellier","Ligue 1","Téji Savanier","FRA","MF","32-160",1991,30.7,37,20,16,15,6,14,63,22.2,49,36,8,28,33,70,28,1,"https://fbref.com/en/players/6bde367b/Teji-Savanier"
2024,"Montpellier","Ligue 1","Issiaga Sylla","GUI","DF,FW","30-150",1994,16.2,28,17,20,6,2,16,34,47.1,18,21,7,14,23,51,53,0,"https://fbref.com/en/players/b99bec05/Issiaga-Sylla"
2024,"Montpellier","Ligue 1","Musa Al-Taamari","JOR","FW","26-355",1997,21.4,20,16,10,5,5,9,21,42.9,12,18,2,16,4,24,5,0,"https://fbref.com/en/players/f15f8b2b/Musa-Al-Taamari"
2024,"Montpellier","Ligue 1","Enzo Tchato","CMR","DF","21-189",2002,12.5,26,17,18,4,4,11,25,44,14,20,7,13,11,37,25,0,"https://fbref.com/en/players/7f783431/Enzo-Tchato"
2024,"Montpellier","Ligue 1","Elye Wahi","FRA","FW","21-149",2003,0.2,0,0,0,0,0,0,0,NA,0,0,0,0,0,0,0,0,"https://fbref.com/en/players/0d7b6576/Elye-Wahi"
2024,"Montpellier","Ligue 1","Kelvin Yeboah","ITA","FW","24-024",2000,3.1,4,2,2,2,0,1,3,33.3,2,3,2,1,1,5,3,0,"https://fbref.com/en/players/ea0893d6/Kelvin-Yeboah"
2024,"Monza","Serie A","Jean-Daniel Akpa-Akpro","CIV","MF","31-232",1992,7.8,20,11,14,4,2,3,9,33.3,6,10,4,6,12,32,15,1,"https://fbref.com/en/players/fdf4b948/Jean-Daniel-Akpa-Akpro"
2024,"Monza","Serie A","Davide Bettella","ITA","MF","24-053",2000,0,0,0,0,0,0,0,0,NA,0,0,0,0,0,0,0,0,"https://fbref.com/en/players/2edcd048/Davide-Bettella"
2024,"Monza","Serie A","Samuele Birindelli","ITA","DF","24-316",1999,22.4,28,19,16,7,5,14,25,56,11,30,11,19,18,46,48,0,"https://fbref.com/en/players/204ac005/Samuele-Birindelli"
2024,"Monza","Serie A","Warren Bondo","FRA","MF","20-258",2003,16.4,29,22,16,10,3,13,17,76.5,4,13,3,10,6,35,13,0,"https://fbref.com/en/players/0def2376/Warren-Bondo"
2024,"Monza","Serie A","Luca Caldirola","ITA","DF","33-119",1991,23.8,25,14,19,4,2,13,22,59.1,9,26,17,9,29,54,53,0,"https://fbref.com/en/players/226008f1/Luca-Caldirola"
2024,"Monza","Serie A","Gianluca Caprari","ITA","MF,FW","30-305",1993,3.2,2,1,1,1,0,0,1,0,1,0,0,0,2,4,0,0,"https://fbref.com/en/players/54e53b7e/Gianluca-Caprari"
2024,"Monza","Serie A","Andrea Carboni","ITA","DF","23-116",2001,16.5,38,22,24,12,2,20,31,64.5,11,23,13,10,17,55,56,1,"https://fbref.com/en/players/f7e2af2c/Andrea-Carboni"
2024,"Monza","Serie A","Valentin Carboni","ARG","MF,FW","19-086",2005,13,25,15,10,12,3,8,26,30.8,18,12,1,11,7,32,4,0,"https://fbref.com/en/players/707b98f1/Valentin-Carboni"
2024,"Monza","Serie A","Giorgio Cittadini","ITA","DF","22-042",2002,0.2,1,1,1,0,0,1,1,100,0,1,1,0,0,1,0,0,"https://fbref.com/en/players/e4ba67f2/Giorgio-Cittadini"
2024,"Monza","Serie A","Patrick Ciurria","ITA","DF,MF","29-111",1995,17.8,30,18,13,13,4,13,21,61.9,8,20,5,15,9,39,28,0,"https://fbref.com/en/players/5de3866c/Patrick-Ciurria"
2024,"Monza","Serie A","Lorenzo Colombo","ITA","FW","22-083",2002,15.1,17,12,3,9,5,8,14,57.1,6,18,5,13,0,17,14,0,"https://fbref.com/en/players/04df29a5/Lorenzo-Colombo"
2024,"Monza","Serie A","Andrea Colpani","ITA","MF,FW","25-019",1999,29.5,25,15,6,13,6,11,20,55,9,11,4,7,14,39,14,0,"https://fbref.com/en/players/6499048c/Andrea-Colpani"
2024,"Monza","Serie A","Danilo D'Ambrosio","ITA","DF","35-264",1988,17.1,57,34,34,20,3,28,41,68.3,13,22,13,9,14,71,31,0,"https://fbref.com/en/players/44eb9093/Danilo-DAmbrosio"
2024,"Monza","Serie A","Michele Di Gregorio","ITA","GK","26-308",1997,31.9,1,0,1,0,0,1,4,25,3,1,0,1,1,2,10,2,"https://fbref.com/en/players/4e0c8d66/Michele-Di-Gregorio"
2024,"Monza","Serie A","Giulio Donati","ITA","DF","34-115",1990,0.4,0,0,0,0,0,0,0,NA,0,0,0,0,0,0,1,1,"https://fbref.com/en/players/22051fbe/Giulio-Donati"
2024,"Monza","Serie A","Andrea Ferraris","ITA","MF","21-098",2003,0.1,1,1,1,0,0,0,0,NA,0,0,0,0,0,1,0,0,"https://fbref.com/en/players/da69a0ef/Andrea-Ferraris"
2024,"Monza","Serie A","Roberto Gagliardini","ITA","MF,DF","30-053",1994,26.2,61,30,27,25,9,31,50,62,19,30,11,19,31,92,38,0,"https://fbref.com/en/players/ce30bfc8/Roberto-Gagliardini"
2024,"Monza","Serie A","Papu Gómez","ARG","MF,FW","36-105",1988,0.5,0,0,0,0,0,0,2,0,2,0,0,0,1,1,0,0,"https://fbref.com/en/players/6e4df551/Papu-Gomez"
2024,"Monza","Serie A","Armando Izzo","ITA","DF","32-089",1992,18.3,27,17,17,9,1,16,27,59.3,11,20,16,4,27,54,49,1,"https://fbref.com/en/players/89976232/Armando-Izzo"
2024,"Monza","Serie A","Giorgos Kyriakopoulos","GRE","DF","28-115",1996,19,19,10,16,3,0,11,24,45.8,13,18,1,17,13,32,28,0,"https://fbref.com/en/players/0a483542/Giorgos-Kyriakopoulos"
2024,"Monza","Serie A","Daniel Maldini","ITA","MF,FW","22-232",2001,3.7,3,2,0,2,1,3,6,50,3,2,0,2,2,5,1,0,"https://fbref.com/en/players/801831fe/Daniel-Maldini"
2024,"Monza","Serie A","Pablo Marí","ESP","DF","30-273",1993,29.1,41,25,34,7,0,22,34,64.7,12,40,25,15,37,78,115,1,"https://fbref.com/en/players/aa54ec6f/Pablo-Mari"
2024,"Monza","Serie A","Mirko Marić","CRO","FW","29-014",1995,3.2,4,0,2,1,1,0,2,0,2,4,0,4,2,6,3,0,"https://fbref.com/en/players/78338347/Mirko-Maric"
2024,"Monza","Serie A","Dany Mota","POR","FW,MF","26-028",1998,22.8,13,7,2,5,6,8,17,47.1,9,4,1,3,2,15,18,0,"https://fbref.com/en/players/efc9e31f/Dany-Mota"
2024,"Monza","Serie A","Pepín","EQG","MF,FW","27-290",1996,2.7,6,1,1,4,1,2,4,50,2,5,2,3,0,6,6,0,"https://fbref.com/en/players/7afb1573/Pepin"
2024,"Monza","Serie A","Pedro Pereira","POR","DF","26-129",1998,9.3,19,13,14,4,1,9,17,52.9,8,15,2,13,4,23,18,0,"https://fbref.com/en/players/c77be0cf/Pedro-Pereira"
2024,"Monza","Serie A","Matteo Pessina","ITA","MF","27-039",1997,35.8,44,25,20,20,4,23,49,46.9,26,29,11,18,27,71,46,1,"https://fbref.com/en/players/780e3631/Matteo-Pessina"
2024,"Monza","Serie A","Alessandro Sorrentino","ITA","GK","22-057",2002,6.1,0,0,0,0,0,0,0,NA,0,0,0,0,0,0,0,0,"https://fbref.com/en/players/8ef2452a/Alessandro-Sorrentino"
2024,"Monza","Serie A","Samuele Vignato","ITA","MF,FW","20-096",2004,3.8,6,4,2,3,1,2,3,66.7,1,2,0,2,1,7,1,0,"https://fbref.com/en/players/a14d0ab0/Samuele-Vignato"
2024,"Monza","Serie A","Alessio Zerbin","ITA","DF,FW","25-088",1999,7.6,18,10,13,2,3,4,13,30.8,9,16,3,13,3,21,5,0,"https://fbref.com/en/players/d19ef4ef/Alessio-Zerbin"
2024,"Monza","Serie A","Milan Đurić","BIH","FW","34-008",1990,14,5,5,0,5,0,2,4,50,2,6,2,4,0,5,27,0,"https://fbref.com/en/players/405f6586/Milan-Djuric"
2024,"Nantes","Ligue 1","Matthis Abline","FRA","FW","21-063",2003,11.6,9,4,4,3,2,3,8,37.5,5,3,0,3,3,12,5,0,"https://fbref.com/en/players/0e46fa2f/Matthis-Abline"
2024,"Nantes","Ligue 1","Bénie Adama Traore","CIV","FW,MF","21-182",2002,5.6,8,4,2,5,1,3,7,42.9,4,3,0,3,1,9,1,0,"https://fbref.com/en/players/77816c91/Benie-Adama-Traore"
2024,"Nantes","Ligue 1","Adson","BRA","MF,FW","23-237",2000,2.6,7,6,1,6,0,2,2,100,0,5,0,5,2,9,2,0,"https://fbref.com/en/players/eda38706/Adson"
2024,"Nantes","Ligue 1","Kelvin Amian","FRA","DF","26-112",1998,8.9,16,7,12,4,0,11,15,73.3,4,6,0,6,7,23,28,0,"https://fbref.com/en/players/bcc81786/Kelvin-Amian"
2024,"Nantes","Ligue 1","Stredair Appuah","FRA","FW,MF","19-338",2004,0.9,0,0,0,0,0,0,3,0,3,0,0,0,1,1,1,0,"https://fbref.com/en/players/42f0113f/Stredair-Appuah"
2024,"Nantes","Ligue 1","Hugo Boutsingkham","FRA","MF,FW","21-131",2003,0.1,0,0,0,0,0,0,0,NA,0,0,0,0,0,0,1,0,"https://fbref.com/en/players/3b6ace25/Hugo-Boutsingkham"
2024,"Nantes","Ligue 1","Jean-Charles Castelletto","CMR","DF","29-125",1995,27.4,34,26,22,10,2,18,29,62.1,11,19,10,9,32,66,81,0,"https://fbref.com/en/players/e0f3a1f6/Jean-Charles-Castelletto"
2024,"Nantes","Ligue 1","Fabien Centonze","FRA","DF","28-135",1996,1,2,1,2,0,0,2,3,66.7,1,2,1,1,0,2,1,0,"https://fbref.com/en/players/3c6bbbab/Fabien-Centonze"
2024,"Nantes","Ligue 1","Pedro Chirivella","ESP","MF","27-007",1997,28.8,50,28,20,29,1,30,76,39.5,46,22,5,17,31,81,28,0,"https://fbref.com/en/players/68a26d51/Pedro-Chirivella"
2024,"Nantes","Ligue 1","Marcus Coco","FRA","DF,FW","27-341",1996,16.5,43,26,29,10,4,28,60,46.7,32,19,1,18,21,64,38,0,"https://fbref.com/en/players/3010aefb/Marcus-Coco"
2024,"Nantes","Ligue 1","Eray Cömert","SUI","DF","26-116",1998,22.2,42,28,28,13,1,28,38,73.7,10,35,18,17,36,78,78,1,"https://fbref.com/en/players/15937e17/Eray-Comert"
2024,"Nantes","Ligue 1","Nicolas Cozza","FRA","DF","25-143",1999,9.9,35,23,23,10,2,17,24,70.8,7,7,0,7,14,49,32,0,"https://fbref.com/en/players/8f325097/Nicolas-Cozza"
2024,"Nantes","Ligue 1","Rémy Descamps","FRA","GK","27-340",1996,6,0,0,0,0,0,0,0,NA,0,0,0,0,0,0,7,0,"https://fbref.com/en/players/477e50ce/Remy-Descamps"
2024,"Nantes","Ligue 1","Lamine Diack","SEN","MF","23-197",2000,0,0,0,0,0,0,0,0,NA,0,0,0,0,0,0,0,0,"https://fbref.com/en/players/f4547573/Lamine-Diack"
2024,"Nantes","Ligue 1","Douglas","BRA","MF","27-138",1997,19.7,70,42,34,30,6,30,59,50.8,29,22,8,14,26,96,30,0,"https://fbref.com/en/players/301c287b/Douglas"
2024,"Nantes","Ligue 1","Jean-Kevin Duverne","HAI","DF","26-323",1997,15,37,19,16,17,4,18,44,40.9,26,17,5,12,18,55,34,0,"https://fbref.com/en/players/0cbc8baa/Jean-Kevin-Duverne"
2024,"Nantes","Ligue 1","Ignatius Ganago","CMR","FW,MF","25-104",1999,2,0,0,0,0,0,0,1,0,1,1,0,1,1,1,1,0,"https://fbref.com/en/players/23c63b7f/Ignatius-Ganago"
2024,"Nantes","Ligue 1","Jaouen Hadjam","ALG","DF","21-065",2003,1.2,6,4,5,1,0,1,2,50,1,0,0,0,3,9,2,0,"https://fbref.com/en/players/576817b7/Jaouen-Hadjam"
2024,"Nantes","Ligue 1","Abdoul Kader Bamba","FRA","FW,MF","30-005",1994,6.8,10,7,2,5,3,5,15,33.3,10,4,0,4,4,14,4,1,"https://fbref.com/en/players/32f3d97e/Abdoul-Kader-Bamba"
2024,"Nantes","Ligue 1","Tino Kadewere","ZIM","FW,MF","28-146",1996,8.7,9,4,3,3,3,6,11,54.5,5,10,1,9,10,19,8,0,"https://fbref.com/en/players/7d08063d/Tino-Kadewere"
2024,"Nantes","Ligue 1","Alban Lafont","FRA","GK","25-128",1999,27.7,0,0,0,0,0,0,2,0,2,0,0,0,0,0,14,0,"https://fbref.com/en/players/4e7db402/Alban-Lafont"
2024,"Nantes","Ligue 1","Adel Mahamoud","COM","FW","21-116",2003,0.1,0,0,0,0,0,0,1,0,1,0,0,0,0,0,0,0,"https://fbref.com/en/players/69c9532c/Adel-Mahamoud"
2024,"Nantes","Ligue 1","Marquinhos","BRA","FW,MF","21-053",2003,1.7,3,2,2,0,1,1,4,25,3,7,2,5,6,9,1,0,"https://fbref.com/en/players/59878425/Marquinhos"
2024,"Nantes","Ligue 1","Quentin Merlin","FRA","DF","22-014",2002,14.3,29,20,15,12,2,16,25,64,9,22,1,21,18,47,22,0,"https://fbref.com/en/players/0bfca6a1/Quentin-Merlin"
2024,"Nantes","Ligue 1","Bastien Meupiyou","FRA","DF","18-072",2006,0.1,0,0,0,0,0,0,0,NA,0,0,0,0,0,0,1,0,"https://fbref.com/en/players/dcd94cdb/Bastien-Meupiyou"
2024,"Nantes","Ligue 1","Mostafa Mohamed","EGY","FW","26-184",1997,22.2,21,14,7,11,3,6,28,21.4,22,21,5,16,12,33,29,0,"https://fbref.com/en/players/595e6f3e/Mostafa-Mohamed"
2024,"Nantes","Ligue 1","Florent Mollet","FRA","MF,FW","32-193",1991,23.1,18,11,8,6,4,10,31,32.3,21,18,5,13,13,31,17,0,"https://fbref.com/en/players/7e82a78f/Florent-Mollet"
2024,"Nantes","Ligue 1","Enzo Mongo","FRA","DF","19-052",2005,0.1,1,1,1,0,0,1,2,50,1,1,1,0,1,2,0,0,"https://fbref.com/en/players/575b1a7b/Enzo-Mongo"
2024,"Nantes","Ligue 1","Samuel Moutoussamy","COD","MF","27-292",1996,12.3,38,20,14,17,7,17,37,45.9,20,16,3,13,11,49,13,0,"https://fbref.com/en/players/af0c835b/Samuel-Moutoussamy"
2024,"Nantes","Ligue 1","Nicolas Pallois","FRA","DF","36-254",1987,17.7,34,19,21,11,2,19,35,54.3,16,37,26,11,26,60,111,0,"https://fbref.com/en/players/779847d6/Nicolas-Pallois"
2024,"Nantes","Ligue 1","Denis Petrić","SRB","GK","36-006",1988,0.3,0,0,0,0,0,0,0,NA,0,0,0,0,0,0,0,0,"https://fbref.com/en/players/dab1b8dc/Denis-Petric"
2024,"Nantes","Ligue 1","Ronaël Pierre-Gabriel","FRA","DF","25-352",1998,6.6,15,9,12,2,1,5,7,71.4,2,13,4,9,8,23,25,0,"https://fbref.com/en/players/64ba07c0/Ronael-Pierre-Gabriel"
2024,"Nantes","Ligue 1","Moses Simon","NGA","FW,MF","28-323",1995,19.9,7,5,2,5,0,2,8,25,6,9,1,8,3,10,5,1,"https://fbref.com/en/players/5f3eaaf5/Moses-Simon"
2024,"Nantes","Ligue 1","Moussa Sissoko","FRA","MF","34-288",1989,20.2,27,16,13,8,6,12,25,48,13,8,2,6,12,39,31,0,"https://fbref.com/en/players/2acd49b9/Moussa-Sissoko"
2024,"Nantes","Ligue 1","Nathan Zeze","FRA","DF","18-347",2005,11.4,11,6,9,2,0,7,14,50,7,12,3,9,12,23,47,1,"https://fbref.com/en/players/fb4c5b6e/Nathan-Zeze"
2024,"Napoli","Serie A","Jens Cajuste","SWE","MF","24-294",1999,11.3,36,24,13,17,6,20,37,54.1,17,20,3,17,4,40,15,0,"https://fbref.com/en/players/928a4a61/Jens-Cajuste"
2024,"Napoli","Serie A","Nikita Contini Baranovsky","ITA","GK","28-009",1996,0.2,0,0,0,0,0,0,0,NA,0,0,0,0,0,0,1,0,"https://fbref.com/en/players/e95069bb/Nikita-Contini-Baranovsky"
2024,"Napoli","Serie A","Diego Demme","GER","MF","32-191",1991,0.8,1,1,0,1,0,0,1,0,1,0,0,0,0,1,0,0,"https://fbref.com/en/players/dc3fa3b5/Diego-Demme"
2024,"Napoli","Serie A","Leander Dendoncker","BEL","MF","29-045",1995,0.3,0,0,0,0,0,0,0,NA,0,1,1,0,0,0,0,0,"https://fbref.com/en/players/5a7301ae/Leander-Dendoncker"
2024,"Napoli","Serie A","Giovanni Di Lorenzo","ITA","DF","30-300",1993,35.9,58,36,26,26,6,32,68,47.1,36,43,16,27,24,82,45,0,"https://fbref.com/en/players/230a2fac/Giovanni-Di-Lorenzo"
2024,"Napoli","Serie A","Elif Elmas","MKD","FW,MF","24-249",1999,3.8,4,3,1,3,0,2,2,100,0,2,0,2,2,6,8,0,"https://fbref.com/en/players/cf007308/Elif-Elmas"
2024,"Napoli","Serie A","Gianluca Gaetano","ITA","MF","24-025",2000,1.8,4,1,0,4,0,2,4,50,2,5,2,3,1,5,4,0,"https://fbref.com/en/players/3b387cc7/Gianluca-Gaetano"
2024,"Napoli","Serie A","Pierluigi Gollini","ITA","GK","29-073",1995,7,1,1,1,0,0,1,1,100,0,0,0,0,1,2,2,0,"https://fbref.com/en/players/f0f7f62f/Pierluigi-Gollini"
2024,"Napoli","Serie A","Juan Jesus","BRA","DF","32-355",1991,23.5,42,19,28,12,2,23,33,69.7,10,23,12,11,23,65,67,1,"https://fbref.com/en/players/79083382/Juan-Jesus"
2024,"Napoli","Serie A","Hamed Junior Traorè","CIV","MF","24-104",2000,4.2,4,2,2,0,2,1,6,16.7,5,3,0,3,2,6,1,1,"https://fbref.com/en/players/570bb4b9/Hamed-Junior-Traore"
2024,"Napoli","Serie A","Khvicha Kvaratskhelia","GEO","FW","23-108",2001,30.4,42,21,11,19,12,15,49,30.6,34,15,1,14,13,55,9,0,"https://fbref.com/en/players/dea88efd/Khvicha-Kvaratskhelia"
2024,"Napoli","Serie A","Jesper Lindstrøm","DEN","FW,MF","24-091",2000,4.8,8,3,2,3,3,4,8,50,4,3,0,3,2,10,6,0,"https://fbref.com/en/players/37dc1a48/Jesper-Lindstrom"
2024,"Napoli","Serie A","Stanislav Lobotka","SVK","MF","29-187",1994,36.5,61,39,18,30,13,24,60,40,36,30,8,22,30,91,29,0,"https://fbref.com/en/players/e1cbb531/Stanislav-Lobotka"
2024,"Napoli","Serie A","Pasquale Mazzocchi","ITA","DF","28-308",1995,4.8,5,2,1,2,2,2,3,66.7,1,5,1,4,1,6,13,0,"https://fbref.com/en/players/eb0ec070/Pasquale-Mazzocchi"
2024,"Napoli","Serie A","Alex Meret","ITA","GK","27-069",1997,30.8,1,0,1,0,0,1,2,50,1,0,0,0,0,1,10,1,"https://fbref.com/en/players/9413b19f/Alex-Meret"
2024,"Napoli","Serie A","Natan","BRA","DF","23-114",2001,10.6,14,10,10,3,1,5,10,50,5,12,9,3,8,22,32,0,"https://fbref.com/en/players/94bccc82/Natan"
2024,"Napoli","Serie A","Cyril Ngonge","BEL","FW","24-004",2000,3.5,5,3,1,4,0,2,2,100,0,2,0,2,0,5,2,0,"https://fbref.com/en/players/2b8360f1/Cyril-Ngonge"
2024,"Napoli","Serie A","Mathías Olivera","URU","DF","26-212",1997,17.4,50,29,29,15,6,23,39,59,16,35,6,29,20,70,25,0,"https://fbref.com/en/players/41c12f75/Mathias-Olivera"
2024,"Napoli","Serie A","Victor Osimhen","NGA","FW","25-153",1998,22,9,5,0,4,5,2,4,50,2,5,1,4,2,11,18,0,"https://fbref.com/en/players/8c90fd7a/Victor-Osimhen"
2024,"Napoli","Serie A","Matteo Politano","ITA","FW","30-301",1993,26.2,19,8,8,7,4,11,34,32.4,23,9,1,8,15,34,11,1,"https://fbref.com/en/players/5e861944/Matteo-Politano"
2024,"Napoli","Serie A","Giacomo Raspadori","ITA","FW,MF","24-102",2000,17.6,21,10,6,10,5,6,15,40,9,15,1,14,3,24,7,0,"https://fbref.com/en/players/6e058f06/Giacomo-Raspadori"
2024,"Napoli","Serie A","Amir Rrahmani","KVX","DF","30-096",1994,28.9,33,27,17,14,2,16,32,50,16,24,10,14,20,53,90,0,"https://fbref.com/en/players/4b3e1a38/Amir-Rrahmani"
2024,"Napoli","Serie A","Mário Rui","POR","DF","33-003",1991,13.4,27,15,17,5,5,14,21,66.7,7,17,2,15,15,42,19,0,"https://fbref.com/en/players/0b5a292a/Mario-Rui"
2024,"Napoli","Serie A","Giovanni Simeone","ARG","FW","28-330",1995,8.9,12,4,1,3,8,3,12,25,9,11,0,11,1,13,7,0,"https://fbref.com/en/players/343c0d52/Giovanni-Simeone"
2024,"Napoli","Serie A","Leo Skiri Østigård","NOR","DF","24-184",1999,18.1,24,12,13,10,1,6,11,54.5,5,18,12,6,16,40,65,0,"https://fbref.com/en/players/b35a7399/Leo-Skiri-Ostigard"
2024,"Napoli","Serie A","Andre-Frank Zambo Anguissa","CMR","MF","28-196",1995,31,61,33,21,29,11,34,69,49.3,35,40,5,35,28,89,19,1,"https://fbref.com/en/players/6bb2c084/Andre-Frank-Zambo-Anguissa"
2024,"Napoli","Serie A","Alessandro Zanoli","ITA","DF,FW","23-240",2000,0.6,1,1,1,0,0,0,0,NA,0,0,0,0,1,2,1,0,"https://fbref.com/en/players/3b12b11f/Alessandro-Zanoli"
2024,"Napoli","Serie A","Alessio Zerbin","ITA","FW,DF","25-088",1999,1.7,5,2,1,3,1,2,7,28.6,5,1,0,1,0,5,0,0,"https://fbref.com/en/players/d19ef4ef/Alessio-Zerbin"
2024,"Napoli","Serie A","Piotr Zieliński","POL","MF","30-010",1994,21.4,23,15,6,13,4,12,24,50,12,12,1,11,9,32,15,0,"https://fbref.com/en/players/a5296e55/Piotr-Zielinski"
2024,"Newcastle Utd","Premier League","Miguel Almirón","PAR","FW","30-110",1994,21.5,36,24,13,15,8,11,29,37.9,18,29,2,27,10,46,13,0,"https://fbref.com/en/players/862a1c15/Miguel-Almiron"
2024,"Newcastle Utd","Premier League","Elliot Anderson","SCO","MF,FW","21-206",2002,11.4,24,18,12,9,3,15,29,51.7,14,23,4,19,8,32,23,0,"https://fbref.com/en/players/de31038e/Elliot-Anderson"
2024,"Newcastle Utd","Premier League","Harvey Barnes","ENG","FW,MF","26-173",1997,8.9,6,1,3,2,1,1,2,50,1,1,0,1,5,11,3,0,"https://fbref.com/en/players/3ea50f67/Harvey-Barnes"
2024,"Newcastle Utd","Premier League","Sven Botman","NED","DF","24-139",2000,15.3,20,13,14,6,0,8,13,61.5,5,20,16,4,9,29,61,3,"https://fbref.com/en/players/ccce7025/Sven-Botman"
2024,"Newcastle Utd","Premier League","Dan Burn","ENG","DF","32-021",1992,30.3,61,33,37,20,4,26,61,42.6,35,55,25,30,37,98,124,1,"https://fbref.com/en/players/b2d31e83/Dan-Burn"
2024,"Newcastle Utd","Premier League","Amadou Diallo","ENG","MF","21-105",2003,0,0,0,0,0,0,0,0,NA,0,0,0,0,0,0,0,0,"https://fbref.com/en/players/e31708b2/Amadou-Diallo"
2024,"Newcastle Utd","Premier League","Martin Dúbravka","SVK","GK","35-136",1989,22.1,0,0,0,0,0,0,4,0,4,0,0,0,0,0,8,1,"https://fbref.com/en/players/3a949a25/Martin-Dubravka"
2024,"Newcastle Utd","Premier League","Paul Dummett","WAL","DF","32-247",1991,0.2,1,0,1,0,0,1,1,100,0,0,0,0,0,1,1,0,"https://fbref.com/en/players/3fe6bd8c/Paul-Dummett"
2024,"Newcastle Utd","Premier League","Anthony Gordon","ENG","FW","23-096",2001,32.1,55,34,16,28,11,22,64,34.4,42,27,0,27,7,62,7,0,"https://fbref.com/en/players/2bd83368/Anthony-Gordon"
2024,"Newcastle Utd","Premier League","Bruno Guimarães","BRA","MF","26-196",1997,36.3,88,53,45,32,11,40,77,51.9,37,52,14,38,34,122,20,0,"https://fbref.com/en/players/82518f62/Bruno-Guimaraes"
2024,"Newcastle Utd","Premier League","Lewis Hall","ENG","DF","19-265",2004,8.7,28,18,17,10,1,17,28,60.7,11,17,2,15,13,41,21,1,"https://fbref.com/en/players/da011f18/Lewis-Hall"
2024,"Newcastle Utd","Premier League","Alexander Isak","SWE","FW","24-252",1999,25.1,5,0,2,1,2,2,8,25,6,16,1,15,6,11,13,0,"https://fbref.com/en/players/8e92be30/Alexander-Isak"
2024,"Newcastle Utd","Premier League","Joelinton","BRA","MF,FW","27-290",1996,14.2,39,27,21,15,3,14,38,36.8,24,23,7,16,19,58,11,1,"https://fbref.com/en/players/c17bfb65/Joelinton"
2024,"Newcastle Utd","Premier League","Loris Karius","GER","GK","30-343",1993,1,0,0,0,0,0,0,0,NA,0,0,0,0,0,0,1,0,"https://fbref.com/en/players/32e7ce92/Loris-Karius"
2024,"Newcastle Utd","Premier League","Emil Krafth","SWE","DF","29-302",1994,10.1,21,14,10,7,4,12,25,48,13,8,3,5,9,30,21,0,"https://fbref.com/en/players/77cf6852/Emil-Krafth"
2024,"Newcastle Utd","Premier League","Jamaal Lascelles","ENG","DF","30-201",1993,12,14,9,7,7,0,6,11,54.5,5,17,12,5,5,19,42,0,"https://fbref.com/en/players/450ab6fc/Jamaal-Lascelles"
2024,"Newcastle Utd","Premier League","Valentino Livramento","ENG","DF","21-200",2002,14.6,23,13,15,6,2,10,21,47.6,11,16,7,9,25,48,41,1,"https://fbref.com/en/players/afed6722/Valentino-Livramento"
2024,"Newcastle Utd","Premier League","Sean Longstaff","ENG","MF","26-213",1997,30.5,54,30,17,29,8,24,63,38.1,39,43,7,36,17,71,23,0,"https://fbref.com/en/players/a2b105e0/Sean-Longstaff"
2024,"Newcastle Utd","Premier League","Lewis Miley","ENG","MF","18-029",2006,13.4,33,21,6,20,7,15,32,46.9,17,20,3,17,8,41,18,2,"https://fbref.com/en/players/2c6835e5/Lewis-Miley"
2024,"Newcastle Utd","Premier League","Alex Murphy","IRL","DF,FW","19-340",2004,0.1,1,1,0,1,0,1,2,50,1,1,0,1,1,2,0,0,"https://fbref.com/en/players/f1c42eb3/Alex-Murphy"
2024,"Newcastle Utd","Premier League","Jacob Murphy","ENG","FW,DF","29-096",1995,13.2,20,10,8,4,8,12,26,46.2,14,18,0,18,5,25,16,0,"https://fbref.com/en/players/de112b84/Jacob-Murphy"
2024,"Newcastle Utd","Premier League","Michael Ndiweni","ENG","FW","20-180",2003,0,0,0,0,0,0,0,0,NA,0,0,0,0,0,0,0,0,"https://fbref.com/en/players/8aff2b51/Michael-Ndiweni"
2024,"Newcastle Utd","Premier League","Ben Parkinson","ENG","FW","19-081",2005,0.3,0,0,0,0,0,0,0,NA,0,1,0,1,0,0,1,0,"https://fbref.com/en/players/32163807/Ben-Parkinson"
2024,"Newcastle Utd","Premier League","Nick Pope","ENG","GK","32-041",1992,14.9,0,0,0,0,0,0,1,0,1,0,0,0,0,0,7,2,"https://fbref.com/en/players/4b40d9ca/Nick-Pope"
2024,"Newcastle Utd","Premier League","Matt Ritchie","SCO","FW,MF","34-263",1989,1.4,5,3,2,2,1,2,4,50,2,3,2,1,1,6,5,0,"https://fbref.com/en/players/71ef519e/Matt-Ritchie"
2024,"Newcastle Utd","Premier League","Fabian Schär","SUI","DF","32-162",1991,33.9,42,24,27,13,2,18,40,45,22,50,38,12,36,78,131,1,"https://fbref.com/en/players/c8aa95da/Fabian-Schar"
2024,"Newcastle Utd","Premier League","Matt Targett","ENG","DF","28-255",1995,0.9,2,0,1,1,0,1,1,100,0,1,0,1,0,2,2,0,"https://fbref.com/en/players/e514ab62/Matt-Targett"
2024,"Newcastle Utd","Premier League","Sandro Tonali","ITA","MF","24-022",2000,4.9,7,7,4,2,1,3,9,33.3,6,3,0,3,2,9,4,0,"https://fbref.com/en/players/0db169ae/Sandro-Tonali"
2024,"Newcastle Utd","Premier League","Kieran Trippier","ENG","DF","33-254",1990,24.8,57,27,30,16,11,37,77,48.1,40,41,8,33,24,81,56,3,"https://fbref.com/en/players/21512407/Kieran-Trippier"
2024,"Newcastle Utd","Premier League","Joe White","ENG","MF","21-242",2002,0.1,1,1,1,0,0,0,0,NA,0,0,0,0,0,1,0,0,"https://fbref.com/en/players/d60c03a9/Joe-White"
2024,"Newcastle Utd","Premier League","Joe Willock","ENG","MF","24-284",1999,4.7,13,7,7,6,0,4,11,36.4,7,7,0,7,1,14,1,0,"https://fbref.com/en/players/a3b03921/Joe-Willock"
2024,"Newcastle Utd","Premier League","Callum Wilson","ENG","FW","32-093",1992,11,5,3,0,2,3,0,4,0,4,6,0,6,2,7,4,0,"https://fbref.com/en/players/c596fcb0/Callum-Wilson"
2024,"Nice","Ligue 1","Mohamed Ali Cho","FRA","FW","20-132",2004,9.6,12,9,4,7,1,3,11,27.3,8,10,0,10,3,15,6,0,"https://fbref.com/en/players/f8405304/Mohamed-Ali-Cho"
2024,"Nice","Ligue 1","Youcef Atal","ALG","DF","28-013",1996,4,9,3,6,2,1,6,8,75,2,7,1,6,4,13,1,0,"https://fbref.com/en/players/6a827d8e/Youcef-Atal"
2024,"Nice","Ligue 1","Aliou Badara Baldé","SEN","FW,DF","21-170",2002,0.8,4,1,0,3,1,1,1,100,0,2,1,1,3,7,0,0,"https://fbref.com/en/players/7362a6f2/Aliou-Badara-Balde"
2024,"Nice","Ligue 1","Melvin Bard","FRA","DF","23-206",2000,29.5,69,38,28,30,11,37,63,58.7,26,46,12,34,42,111,46,0,"https://fbref.com/en/players/1ddbc7ca/Melvin-Bard"
2024,"Nice","Ligue 1","Reda Belahyane","FRA","MF","19-364",2004,0.3,1,0,0,1,0,1,1,100,0,0,0,0,0,1,0,0,"https://fbref.com/en/players/705a1642/Reda-Belahyane"
2024,"Nice","Ligue 1","Jeremie Boga","CIV","FW","27-148",1997,22.2,18,7,6,10,2,10,20,50,10,26,2,24,8,26,4,0,"https://fbref.com/en/players/fe012aca/Jeremie-Boga"
2024,"Nice","Ligue 1","Badredine Bouanani","ALG","FW","19-174",2004,1.8,3,2,1,1,1,3,4,75,1,5,0,5,3,6,0,0,"https://fbref.com/en/players/0400dd2f/Badredine-Bouanani"
2024,"Nice","Ligue 1","Hicham Boudaoui","ALG","MF","24-250",1999,17.9,41,19,16,22,3,21,30,70,9,15,1,14,11,52,15,0,"https://fbref.com/en/players/f9d5908e/Hicham-Boudaoui"
2024,"Nice","Ligue 1","Bilal Brahimi","ALG","FW","24-077",2000,0.1,0,0,0,0,0,0,1,0,1,0,0,0,0,0,0,0,"https://fbref.com/en/players/02bcaf8e/Bilal-Brahimi"
2024,"Nice","Ligue 1","Marcin Bułka","POL","GK","24-239",1999,34,0,0,0,0,0,0,2,0,2,0,0,0,0,0,9,3,"https://fbref.com/en/players/db87a2c4/Marcin-Bulka"
2024,"Nice","Ligue 1","Alexis Claude-Maurice","FRA","MF","25-359",1998,5.6,12,5,3,6,3,1,5,20,4,4,1,3,5,17,7,0,"https://fbref.com/en/players/741418c3/Alexis-Claude-Maurice"
2024,"Nice","Ligue 1","Dante","BRA","DF","40-225",1983,31.6,62,30,44,16,2,38,52,73.1,14,43,22,21,37,99,77,2,"https://fbref.com/en/players/fd2bc67d/Dante"
2024,"Nice","Ligue 1","Sofiane Diop","FRA","FW","23-356",2000,5.5,8,6,3,4,1,4,10,40,6,4,0,4,3,11,3,0,"https://fbref.com/en/players/19053e31/Sofiane-Diop"
2024,"Nice","Ligue 1","Evann Guessand","FRA","FW","22-334",2001,17.3,16,7,2,7,7,6,7,85.7,1,12,1,11,12,28,7,0,"https://fbref.com/en/players/b73f17f8/Evann-Guessand"
2024,"Nice","Ligue 1","Gaëtan Laborde","FRA","FW,MF","30-027",1994,21.2,18,12,8,4,6,11,30,36.7,19,20,2,18,6,24,8,1,"https://fbref.com/en/players/7cdda3bf/Gaetan-Laborde"
2024,"Nice","Ligue 1","Jordan Lotomba","SUI","DF","25-244",1998,20,36,28,18,9,9,25,35,71.4,10,30,9,21,16,52,26,1,"https://fbref.com/en/players/fc4cf6a7/Jordan-Lotomba"
2024,"Nice","Ligue 1","Tom Louchet","FRA","MF,DF","21-026",2003,4.5,14,5,6,6,2,7,11,63.6,4,7,3,4,3,17,9,0,"https://fbref.com/en/players/f999e9be/Tom-Louchet"
2024,"Nice","Ligue 1","Antoine Mendy","FRA","DF","20-003",2004,4.6,7,5,4,3,0,3,7,42.9,4,4,1,3,8,15,16,0,"https://fbref.com/en/players/3322e296/Antoine-Mendy"
2024,"Nice","Ligue 1","Terem Moffi","NGA","FW","25-005",1999,21.7,7,4,0,5,2,3,12,25,9,14,1,13,3,10,15,0,"https://fbref.com/en/players/065dc209/Terem-Moffi"
2024,"Nice","Ligue 1","Youssouf Ndayishimiye","BDI","MF,DF","25-216",1998,19,31,20,17,12,2,12,23,52.2,11,19,11,8,12,43,47,1,"https://fbref.com/en/players/65c55288/Youssouf-Ndayishimiye"
2024,"Nice","Ligue 1","Romain Perraud","FRA","DF,FW","26-251",1997,4.1,7,6,5,1,1,4,11,36.4,7,4,0,4,6,13,15,1,"https://fbref.com/en/players/6dfd8f05/Romain-Perraud"
2024,"Nice","Ligue 1","Pablo Rosario","NED","MF,DF","27-144",1997,22.3,36,25,15,16,5,23,34,67.6,11,27,13,14,29,65,39,0,"https://fbref.com/en/players/1a6b7ea4/Pablo-Rosario"
2024,"Nice","Ligue 1","Valentin Rosier","FRA","DF,MF","27-285",1996,0.6,1,0,1,0,0,0,0,NA,0,1,0,1,2,3,5,0,"https://fbref.com/en/players/9b6d9b53/Valentin-Rosier"
2024,"Nice","Ligue 1","Morgan Sanson","FRA","MF","29-286",1994,21.8,26,19,12,7,7,12,31,38.7,19,34,5,29,20,46,16,0,"https://fbref.com/en/players/6e7f1353/Morgan-Sanson"
2024,"Nice","Ligue 1","Khéphren Thuram","FRA","MF","23-065",2001,23.4,42,29,13,23,6,20,40,50,20,21,10,11,18,60,37,0,"https://fbref.com/en/players/7d9397f8/Khephren-Thuram"
2024,"Nice","Ligue 1","Jean-Clair Todibo","FRA","DF","24-152",1999,29.5,58,28,35,17,6,34,56,60.7,22,34,15,19,38,96,97,1,"https://fbref.com/en/players/88f130ed/Jean-Clair-Todibo"
2024,"Nice","Ligue 1","Daouda Traoré","FRA","MF","17-313",2006,0.2,0,0,0,0,0,0,0,NA,0,0,0,0,0,0,0,0,"https://fbref.com/en/players/b26afd1e/Daouda-Traore"
2024,"Nott'ham Forest","Premier League","Brandon Aguilera","CRC","FW","20-337",2003,0.1,0,0,0,0,0,0,0,NA,0,0,0,0,0,0,0,0,"https://fbref.com/en/players/938fa024/Brandon-Aguilera"
2024,"Nott'ham Forest","Premier League","Ola Aina","NGA","DF","27-235",1996,18.8,47,31,31,12,4,29,41,70.7,12,19,3,16,18,65,51,1,"https://fbref.com/en/players/246d153b/Ola-Aina"
2024,"Nott'ham Forest","Premier League","Serge Aurier","CIV","DF,MF","31-158",1992,9.3,20,14,9,11,0,5,11,45.5,6,10,3,7,9,29,36,1,"https://fbref.com/en/players/5c2b4f07/Serge-Aurier"
2024,"Nott'ham Forest","Premier League","Taiwo Awoniyi","NGA","FW","26-292",1997,11.6,9,7,1,4,4,1,2,50,1,7,2,5,1,10,9,0,"https://fbref.com/en/players/e5478b87/Taiwo-Awoniyi"
2024,"Nott'ham Forest","Premier League","Willy Boly","CIV","DF","33-117",1991,16,46,29,36,9,1,22,40,55,18,32,21,11,25,71,90,0,"https://fbref.com/en/players/a4ac4b8f/Willy-Boly"
2024,"Nott'ham Forest","Premier League","Danilo","BRA","MF","23-031",2001,19.9,36,18,22,12,2,21,46,45.7,25,33,8,25,35,71,42,0,"https://fbref.com/en/players/a816dbfb/Danilo"
2024,"Nott'ham Forest","Premier League","Nicolás Domínguez","ARG","MF,FW","25-337",1998,16.6,63,34,35,27,1,23,48,47.9,25,31,5,26,18,81,24,0,"https://fbref.com/en/players/20b3a502/Nicolas-Dominguez"
2024,"Nott'ham Forest","Premier League","Anthony Elanga","SWE","FW,MF","22-033",2002,27,33,19,20,6,7,17,36,47.2,19,22,2,20,8,41,20,1,"https://fbref.com/en/players/2fba6108/Anthony-Elanga"
2024,"Nott'ham Forest","Premier League","Felipe","BRA","DF","35-014",1989,4.2,12,9,9,3,0,9,12,75,3,4,1,3,4,16,12,0,"https://fbref.com/en/players/51a3c4c8/Felipe"
2024,"Nott'ham Forest","Premier League","Morgan Gibbs-White","ENG","MF,FW","24-124",2000,35.1,36,24,6,20,10,14,33,42.4,19,31,8,23,17,53,21,0,"https://fbref.com/en/players/32f60ed8/Morgan-Gibbs-White"
2024,"Nott'ham Forest","Premier League","Callum Hudson-Odoi","ENG","FW,MF","23-205",2000,20.6,18,8,4,5,9,7,28,25,21,16,1,15,7,25,12,1,"https://fbref.com/en/players/15f3ec41/Callum-Hudson-Odoi"
2024,"Nott'ham Forest","Premier League","Brennan Johnson","WAL","FW,MF","23-007",2001,2.6,4,1,1,1,2,2,4,50,2,4,1,3,0,4,0,0,"https://fbref.com/en/players/0cd31129/Brennan-Johnson"
2024,"Nott'ham Forest","Premier League","Cheikhou Kouyaté","SEN","MF","34-161",1989,2.4,8,5,3,3,2,1,4,25,3,4,1,3,2,10,10,0,"https://fbref.com/en/players/8d3c902d/Cheikhou-Kouyate"
2024,"Nott'ham Forest","Premier League","Orel Mangala","BEL","MF","26-073",1998,17.4,27,13,16,10,1,14,29,48.3,15,12,6,6,26,53,32,0,"https://fbref.com/en/players/a572e291/Orel-Mangala"
2024,"Nott'ham Forest","Premier League","Scott McKenna","SCO","DF","27-200",1996,4.6,4,0,3,1,0,2,3,66.7,1,6,4,2,5,9,27,0,"https://fbref.com/en/players/4e5a4cbc/Scott-McKenna"
2024,"Nott'ham Forest","Premier League","Gonzalo Montiel","ARG","DF","27-150",1997,8.9,22,19,12,8,2,16,29,55.2,13,8,3,5,9,31,31,1,"https://fbref.com/en/players/374d5158/Gonzalo-Montiel"
2024,"Nott'ham Forest","Premier League","Murillo","BRA","DF","21-331",2002,31,50,31,36,13,1,19,33,57.6,14,41,24,17,37,87,188,0,"https://fbref.com/en/players/1704b0b8/Murillo"
2024,"Nott'ham Forest","Premier League","Moussa Niakhate","SEN","DF","28-083",1996,16.2,42,25,33,9,0,20,25,80,5,19,12,7,14,56,51,0,"https://fbref.com/en/players/00242715/Moussa-Niakhate"
2024,"Nott'ham Forest","Premier League","Andrew Omobamidele","IRL","DF","21-342",2002,8.7,10,3,9,1,0,5,8,62.5,3,12,8,4,13,23,42,1,"https://fbref.com/en/players/c393a6c4/Andrew-Omobamidele"
2024,"Nott'ham Forest","Premier League","Divock Origi","BEL","FW","29-042",1995,6.7,6,4,5,0,1,0,0,NA,0,6,0,6,2,8,4,0,"https://fbref.com/en/players/43a166b4/Divock-Origi"
2024,"Nott'ham Forest","Premier League","Gio Reyna","USA","FW,MF","21-199",2002,2.6,7,3,4,0,3,3,6,50,3,3,0,3,2,9,0,0,"https://fbref.com/en/players/7fa4e703/Gio-Reyna"
2024,"Nott'ham Forest","Premier League","Rodrigo Ribeiro","POR","MF,FW","19-032",2005,0.2,0,0,0,0,0,0,1,0,1,1,0,1,1,1,0,0,"https://fbref.com/en/players/484a3eae/Rodrigo-Ribeiro"
2024,"Nott'ham Forest","Premier League","Ibrahim Sangaré","CIV","MF","26-180",1997,11.5,42,23,25,13,4,12,29,41.4,17,24,7,17,16,58,21,0,"https://fbref.com/en/players/bced0375/Ibrahim-Sangare"
2024,"Nott'ham Forest","Premier League","Andrey Santos","BRA","MF","20-027",2004,0.1,0,0,0,0,0,0,0,NA,0,1,0,1,0,0,0,0,"https://fbref.com/en/players/dd745366/Andrey-Santos"
2024,"Nott'ham Forest","Premier League","Matz Sels","BEL","GK","32-094",1992,16,0,0,0,0,0,0,0,NA,0,0,0,0,0,0,11,1,"https://fbref.com/en/players/834b5c4c/Matz-Sels"
2024,"Nott'ham Forest","Premier League","Nuno Tavares","POR","DF","24-125",2000,5.1,11,7,9,1,1,8,9,88.9,1,6,0,6,1,12,21,0,"https://fbref.com/en/players/a65c844b/Nuno-Tavares"
2024,"Nott'ham Forest","Premier League","Harry Toffolo","ENG","DF","28-285",1995,16.2,26,14,20,6,0,15,24,62.5,9,34,13,21,14,40,49,0,"https://fbref.com/en/players/a105d46a/Harry-Toffolo"
2024,"Nott'ham Forest","Premier League","Matt Turner","USA","GK","29-341",1994,17,0,0,0,0,0,0,0,NA,0,0,0,0,0,0,8,4,"https://fbref.com/en/players/4a51ba65/Matt-Turner"
2024,"Nott'ham Forest","Premier League","Odisseas Vlachodimos","GRE","GK","30-034",1994,5,0,0,0,0,0,0,1,0,1,0,0,0,0,0,1,0,"https://fbref.com/en/players/03df04ff/Odisseas-Vlachodimos"
2024,"Nott'ham Forest","Premier League","Neco Williams","WAL","DF","23-047",2001,18.2,69,40,42,18,9,35,56,62.5,21,44,13,31,22,91,53,0,"https://fbref.com/en/players/dd323728/Neco-Williams"
2024,"Nott'ham Forest","Premier League","Chris Wood","NZL","FW","32-175",1991,20.1,7,4,1,4,2,3,9,33.3,6,11,3,8,1,8,26,0,"https://fbref.com/en/players/4e9a0555/Chris-Wood"
2024,"Nott'ham Forest","Premier League","Joe Worrall","ENG","DF","27-141",1997,4.9,7,5,6,1,0,3,6,50,3,5,4,1,3,10,32,1,"https://fbref.com/en/players/a5212312/Joe-Worrall"
2024,"Nott'ham Forest","Premier League","Ryan Yates","ENG","MF","26-191",1997,22.1,66,39,39,21,6,19,34,55.9,15,42,15,27,21,87,44,1,"https://fbref.com/en/players/c1fe2a48/Ryan-Yates"
2024,"Osasuna","La Liga","Jesús Areso","ESP","DF","24-333",1999,29.6,45,24,25,13,7,31,38,81.6,7,36,15,21,18,63,58,0,"https://fbref.com/en/players/94e01ec6/Jesus-Areso"
2024,"Osasuna","La Liga","Iñigo Arguibide","ESP","DF","19-041",2005,0.2,1,0,0,1,0,0,0,NA,0,0,0,0,0,1,1,0,"https://fbref.com/en/players/d80d7f17/Inigo-Arguibide"
2024,"Osasuna","La Liga","José Arnaiz","ESP","FW,MF","29-045",1995,10.3,14,8,6,4,4,6,21,28.6,15,11,2,9,3,17,2,0,"https://fbref.com/en/players/46e07328/Jose-Arnaiz"
2024,"Osasuna","La Liga","Ezequiel Ávila","ARG","FW,MF","30-114",1994,9.6,3,2,1,1,1,3,11,27.3,8,14,0,14,4,7,8,0,"https://fbref.com/en/players/253a06b9/Ezequiel-Avila"
2024,"Osasuna","La Liga","Kike Barja","ESP","FW,MF","27-059",1997,3.4,6,2,2,2,2,3,8,37.5,5,2,1,1,2,8,2,0,"https://fbref.com/en/players/aad53e64/Kike-Barja"
2024,"Osasuna","La Liga","Darko Brašanac","SRB","MF","32-108",1992,0.5,1,0,1,0,0,1,1,100,0,1,0,1,0,1,0,0,"https://fbref.com/en/players/4accb7e0/Darko-Brasanac"
2024,"Osasuna","La Liga","Ante Budimir","CRO","FW","32-313",1991,27.1,21,15,2,11,8,5,14,35.7,9,19,5,14,5,26,18,0,"https://fbref.com/en/players/8f3565b3/Ante-Budimir"
2024,"Osasuna","La Liga","Catena","ESP","DF","29-215",1994,28.2,33,18,26,6,1,19,35,54.3,16,24,15,9,15,48,119,3,"https://fbref.com/en/players/274ab13c/Catena"
2024,"Osasuna","La Liga","Juan Cruz Armada","ESP","DF","31-307",1992,18.5,27,15,16,10,1,17,25,68,8,14,7,7,12,39,39,1,"https://fbref.com/en/players/a56da3ba/Juan-Cruz-Armada"
2024,"Osasuna","La Liga","Aitor Fernández","ESP","GK","33-027",1991,6.1,0,0,0,0,0,0,1,0,1,0,0,0,0,0,5,1,"https://fbref.com/en/players/a01c3d54/Aitor-Fernandez"
2024,"Osasuna","La Liga","David García","ESP","DF","30-106",1994,25.9,29,18,19,9,1,16,26,61.5,10,40,19,21,18,47,115,2,"https://fbref.com/en/players/3e42f707/David-Garcia"
2024,"Osasuna","La Liga","Rubén García","ESP","FW,MF","30-321",1993,17.2,32,18,8,17,7,13,33,39.4,20,23,3,20,12,44,23,0,"https://fbref.com/en/players/5c96b017/Ruben-Garcia"
2024,"Osasuna","La Liga","Unai García","ESP","DF","32-117",1992,6.2,12,9,9,2,1,5,10,50,5,7,1,6,8,20,18,0,"https://fbref.com/en/players/4a633cfe/Unai-Garcia"
2024,"Osasuna","La Liga","Moi Gómez","ESP","MF,FW","29-342",1994,22.3,30,19,7,19,4,9,24,37.5,15,15,1,14,11,41,22,0,"https://fbref.com/en/players/5a626448/Moi-Gomez"
2024,"Osasuna","La Liga","Jorge Herrando","ESP","DF","23-092",2001,18.3,29,19,23,6,0,12,19,63.2,7,20,11,9,15,44,69,1,"https://fbref.com/en/players/e19c989c/Jorge-Herrando"
2024,"Osasuna","La Liga","Sergio Herrera","ESP","GK","30-360",1993,31.9,2,2,2,0,0,2,3,66.7,1,0,0,0,0,2,22,3,"https://fbref.com/en/players/a4995f48/Sergio-Herrera"
2024,"Osasuna","La Liga","Xabier Huarte Armendáriz","ESP","MF","23-095",2001,0.1,0,0,0,0,0,0,0,NA,0,0,0,0,0,0,0,0,"https://fbref.com/en/players/e83e8928/Xabier-Huarte-Armendariz"
2024,"Osasuna","La Liga","Pablo Ibáñez","ESP","MF","25-253",1998,12.8,18,9,5,7,6,5,21,23.8,16,26,3,23,9,27,17,0,"https://fbref.com/en/players/3701906c/Pablo-Ibanez"
2024,"Osasuna","La Liga","Johan Mojica","COL","DF","31-283",1992,22.7,30,22,11,15,4,16,25,64,9,15,2,13,21,51,40,2,"https://fbref.com/en/players/608f2092/Johan-Mojica"
2024,"Osasuna","La Liga","Jon Moncayola","ESP","MF","26-017",1998,20,27,18,14,10,3,17,42,40.5,25,31,5,26,15,42,21,0,"https://fbref.com/en/players/9939e168/Jon-Moncayola"
2024,"Osasuna","La Liga","Jorge Moreno","ESP","DF","23-037",2001,0.2,0,0,0,0,0,0,0,NA,0,1,0,1,0,0,3,0,"https://fbref.com/en/players/1f875ef8/Jorge-Moreno"
2024,"Osasuna","La Liga","Iker Muñoz","ESP","MF","21-207",2002,20.6,32,18,13,17,2,15,31,48.4,16,16,5,11,11,43,50,0,"https://fbref.com/en/players/175ece4c/Iker-Munoz"
2024,"Osasuna","La Liga","Aimar Oroz","ESP","MF","22-185",2001,26,43,26,18,20,5,13,37,35.1,24,27,2,25,16,59,11,0,"https://fbref.com/en/players/7c363088/Aimar-Oroz"
2024,"Osasuna","La Liga","Asier Osambela","ESP","MF","20-112",2004,0.1,2,1,0,1,1,0,0,NA,0,0,0,0,0,2,0,0,"https://fbref.com/en/players/e87c44a9/Asier-Osambela"
2024,"Osasuna","La Liga","Rubén Peña","ESP","DF,FW","32-317",1991,23.2,47,25,22,18,7,20,49,40.8,29,37,8,29,30,77,39,3,"https://fbref.com/en/players/1f079188/Ruben-Pena"
2024,"Osasuna","La Liga","Raúl","ESP","FW","23-209",2000,15.1,10,4,4,2,4,2,10,20,8,9,1,8,5,15,11,0,"https://fbref.com/en/players/18f0a9f0/Raul"
2024,"Osasuna","La Liga","Max Svensson","ESP","FW","",NA,0,1,0,0,0,1,0,0,NA,0,0,0,0,0,1,0,0,"https://fbref.com/en/players/cf603737/Max-Svensson"
2024,"Osasuna","La Liga","Lucas Torró","ESP","MF","29-316",1994,19.9,25,15,11,8,6,11,28,39.3,17,10,2,8,33,58,37,0,"https://fbref.com/en/players/0e4fef6e/Lucas-Torro"
2024,"Osasuna","La Liga","Nacho Vidal","ESP","DF,FW","29-127",1995,1.1,5,4,2,2,1,2,5,40,3,2,0,2,0,5,6,0,"https://fbref.com/en/players/3a9c4b7b/Nacho-Vidal"
2024,"Paris S-G","Ligue 1","Marco Asensio","ESP","MF,FW","28-130",1996,12.4,12,10,4,7,1,4,13,30.8,9,7,0,7,5,17,2,0,"https://fbref.com/en/players/45af8a54/Marco-Asensio"
2024,"Paris S-G","Ligue 1","Bradley Barcola","FRA","FW,MF","21-271",2002,15.2,34,16,12,13,9,7,25,28,18,27,2,25,10,44,13,1,"https://fbref.com/en/players/a0d55a09/Bradley-Barcola"
2024,"Paris S-G","Ligue 1","Lucas Beraldo","BRA","DF","20-188",2003,11.2,22,14,14,8,0,10,25,40,15,15,6,9,20,42,25,0,"https://fbref.com/en/players/b8aedf06/Lucas-Beraldo"
2024,"Paris S-G","Ligue 1","Ousmane Dembélé","FRA","MF,FW","27-015",1997,16.7,19,14,2,7,10,6,13,46.2,7,11,0,11,5,24,4,1,"https://fbref.com/en/players/b19db005/Ousmane-Dembele"
2024,"Paris S-G","Ligue 1","Gianluigi Donnarumma","ITA","GK","25-095",1999,24.1,0,0,0,0,0,0,0,NA,0,0,0,0,1,1,9,4,"https://fbref.com/en/players/08f5afaa/Gianluigi-Donnarumma"
2024,"Paris S-G","Ligue 1","Hugo Ekitike","FRA","FW","21-345",2002,0.1,0,0,0,0,0,0,0,NA,0,0,0,0,0,0,0,0,"https://fbref.com/en/players/5b92d896/Hugo-Ekitike"
2024,"Paris S-G","Ligue 1","Achraf Hakimi","MAR","DF","25-208",1998,21.5,29,19,14,9,6,17,34,50,17,28,4,24,12,41,28,2,"https://fbref.com/en/players/e42d61c7/Achraf-Hakimi"
2024,"Paris S-G","Ligue 1","Lucas Hernández","FRA","DF","28-106",1996,21.2,52,36,28,15,9,29,50,58,21,21,5,16,27,79,38,0,"https://fbref.com/en/players/c3ee18ef/Lucas-Hernandez"
2024,"Paris S-G","Ligue 1","Lee Kang-in","KOR","FW,MF","23-101",2001,16.3,26,13,7,9,10,15,36,41.7,21,7,0,7,6,32,3,0,"https://fbref.com/en/players/8455ad90/Lee-Kang-in"
2024,"Paris S-G","Ligue 1","Randal Kolo Muani","FRA","FW,MF","25-177",1998,14.1,10,8,5,3,2,5,13,38.5,8,5,0,5,4,14,10,0,"https://fbref.com/en/players/c0b3669f/Randal-Kolo-Muani"
2024,"Paris S-G","Ligue 1","Layvin Kurzawa","FRA","DF","31-269",1992,0.1,0,0,0,0,0,0,0,NA,0,0,0,0,0,0,0,0,"https://fbref.com/en/players/41e7ef1c/Layvin-Kurzawa"
2024,"Paris S-G","Ligue 1","Marquinhos","BRA","DF","30-016",1994,17.1,19,11,10,7,2,11,17,64.7,6,29,19,10,17,36,58,1,"https://fbref.com/en/players/d5f2f82b/Marquinhos"
2024,"Paris S-G","Ligue 1","Senny Mayulu","FRA","FW,MF","18-013",2006,3.6,13,8,6,6,1,6,7,85.7,1,1,0,1,3,16,0,0,"https://fbref.com/en/players/bac89b96/Senny-Mayulu"
2024,"Paris S-G","Ligue 1","Ethan Mbappé","FRA","MF,DF","17-153",2006,0.5,0,0,0,0,0,0,2,0,2,1,0,1,0,0,0,0,"https://fbref.com/en/players/d595de71/Ethan-Mbappe"
2024,"Paris S-G","Ligue 1","Kylian Mbappé","FRA","FW","25-162",1998,24,4,1,1,1,2,4,9,44.4,5,4,0,4,2,6,2,0,"https://fbref.com/en/players/42fd9c7f/Kylian-Mbappe"
2024,"Paris S-G","Ligue 1","Nuno Mendes","POR","DF","21-346",2002,3,5,5,4,1,0,4,7,57.1,3,4,0,4,4,9,2,0,"https://fbref.com/en/players/f20e4cc9/Nuno-Mendes"
2024,"Paris S-G","Ligue 1","Nordi Mukiele","FRA","DF","26-211",1997,8.8,12,8,6,5,1,8,15,53.3,7,17,4,13,14,26,28,0,"https://fbref.com/en/players/ac73ec79/Nordi-Mukiele"
2024,"Paris S-G","Ligue 1","Keylor Navas","CRC","GK","37-167",1986,4,0,0,0,0,0,0,0,NA,0,0,0,0,0,0,2,0,"https://fbref.com/en/players/ecada4fc/Keylor-Navas"
2024,"Paris S-G","Ligue 1","Cher Ndour","ITA","MF","19-308",2004,0.3,2,2,0,2,0,1,2,50,1,0,0,0,0,2,0,0,"https://fbref.com/en/players/3b88609d/Cher-Ndour"
2024,"Paris S-G","Ligue 1","Danilo Pereira","POR","DF","32-264",1991,22.2,22,12,14,6,2,9,17,52.9,8,29,26,3,23,45,100,1,"https://fbref.com/en/players/8fd9996f/Danilo-Pereira"
2024,"Paris S-G","Ligue 1","Gonçalo Ramos","POR","FW","22-345",2001,15.8,25,15,4,12,9,6,20,30,14,12,2,10,5,30,16,0,"https://fbref.com/en/players/f63cda26/Goncalo-Ramos"
2024,"Paris S-G","Ligue 1","Fabián Ruiz Peña","ESP","MF","28-057",1996,13.3,34,23,17,14,3,23,42,54.8,19,8,2,6,11,45,21,2,"https://fbref.com/en/players/c0c7ff58/Fabian-Ruiz-Pena"
2024,"Paris S-G","Ligue 1","Milan Škriniar","SVK","DF","29-109",1995,18.1,24,18,17,7,0,14,22,63.6,8,19,10,9,12,36,51,2,"https://fbref.com/en/players/30f5ffa9/Milan-Skriniar"
2024,"Paris S-G","Ligue 1","Carlos Soler","ESP","MF,DF","27-149",1997,12.1,15,10,9,2,4,6,21,28.6,15,10,3,7,5,20,11,1,"https://fbref.com/en/players/fed17f5a/Carlos-Soler"
2024,"Paris S-G","Ligue 1","Arnau Tenas","ESP","GK","23-000",2001,5.9,0,0,0,0,0,0,0,NA,0,0,0,0,0,0,0,0,"https://fbref.com/en/players/30670b0e/Arnau-Tenas"
2024,"Paris S-G","Ligue 1","Manuel Ugarte Ribeiro","URU","MF","23-049",2001,21.5,98,57,39,43,16,43,89,48.3,46,27,6,21,40,138,25,2,"https://fbref.com/en/players/c9817014/Manuel-Ugarte-Ribeiro"
2024,"Paris S-G","Ligue 1","Vitinha","POR","MF","24-107",2000,23.6,39,24,12,16,11,16,48,33.3,32,29,11,18,23,62,30,2,"https://fbref.com/en/players/3b029691/Vitinha"
2024,"Paris S-G","Ligue 1","Yoram Zague","FRA","DF","18-015",2006,4.1,18,8,11,4,3,11,24,45.8,13,3,0,3,4,22,9,1,"https://fbref.com/en/players/5ce497e2/Yoram-Zague"
2024,"Paris S-G","Ligue 1","Warren Zaire-Emery","FRA","MF,DF","18-083",2006,21.8,51,28,18,24,9,28,51,54.9,23,32,8,24,15,66,22,2,"https://fbref.com/en/players/6b9960cf/Warren-Zaire-Emery"
2024,"RB Leipzig","Bundesliga","Christoph Baumgartner","AUT","MF,FW","24-303",1999,12.9,26,13,10,12,4,14,38,36.8,24,20,1,19,5,31,14,0,"https://fbref.com/en/players/437f2b00/Christoph-Baumgartner"
2024,"RB Leipzig","Bundesliga","Janis Blaswich","GER","GK","33-028",1991,21,1,1,1,0,0,0,0,NA,0,0,0,0,0,1,7,3,"https://fbref.com/en/players/663e080e/Janis-Blaswich"
2024,"RB Leipzig","Bundesliga","Fabio Carvalho","POR","MF","21-274",2002,1.8,3,1,0,2,1,1,3,33.3,2,8,0,8,0,3,1,0,"https://fbref.com/en/players/966e28d0/Fabio-Carvalho"
2024,"RB Leipzig","Bundesliga","El Chadaille Bitshiabu","FRA","DF,MF","19-014",2005,0.4,1,0,1,0,0,0,0,NA,0,0,0,0,1,2,4,0,"https://fbref.com/en/players/2180c761/El-Chadaille-Bitshiabu"
2024,"RB Leipzig","Bundesliga","Elif Elmas","MKD","MF,FW","24-249",1999,3,8,6,1,6,1,6,8,75,2,5,0,5,1,9,2,0,"https://fbref.com/en/players/cf007308/Elif-Elmas"
2024,"RB Leipzig","Bundesliga","Emil Forsberg","SWE","MF,FW","32-220",1991,5.2,7,3,2,5,0,5,12,41.7,7,7,0,7,0,7,5,0,"https://fbref.com/en/players/9a2e0ccc/Emil-Forsberg"
2024,"RB Leipzig","Bundesliga","Péter Gulácsi","HUN","GK","34-024",1990,13,0,0,0,0,0,0,0,NA,0,0,0,0,0,0,8,1,"https://fbref.com/en/players/bcb2ccd8/Peter-Gulacsi"
2024,"RB Leipzig","Bundesliga","Amadou Haidara","MLI","MF","26-120",1998,17,42,27,24,16,2,23,41,56.1,18,28,6,22,21,63,37,0,"https://fbref.com/en/players/92432bc6/Amadou-Haidara"
2024,"RB Leipzig","Bundesliga","Benjamin Henrichs","GER","DF","27-097",1997,28.1,68,39,32,26,10,27,58,46.6,31,49,4,45,33,101,37,0,"https://fbref.com/en/players/0a89e877/Benjamin-Henrichs"
2024,"RB Leipzig","Bundesliga","Nuha Jatta","GAM","FW","18-076",2006,0,0,0,0,0,0,0,0,NA,0,0,0,0,0,0,0,0,"https://fbref.com/en/players/039f01a9/Nuha-Jatta"
2024,"RB Leipzig","Bundesliga","Kevin Kampl","SVN","MF","33-234",1990,15.1,19,8,8,9,2,10,21,47.6,11,19,7,12,11,30,14,1,"https://fbref.com/en/players/b825a650/Kevin-Kampl"
2024,"RB Leipzig","Bundesliga","Lukas Klostermann","GER","DF","27-362",1996,16,15,10,7,7,1,4,13,30.8,9,25,12,13,13,28,64,1,"https://fbref.com/en/players/ca8033cb/Lukas-Klostermann"
2024,"RB Leipzig","Bundesliga","Christopher Lenz","GER","DF,MF","29-251",1994,0.5,2,1,2,0,0,1,1,100,0,0,0,0,2,4,2,0,"https://fbref.com/en/players/bbd86530/Christopher-Lenz"
2024,"RB Leipzig","Bundesliga","Castello Lukeba","FRA","DF","21-165",2002,24.3,19,12,10,9,0,10,12,83.3,2,35,13,22,12,31,94,2,"https://fbref.com/en/players/5b9512c5/Castello-Lukeba"
2024,"RB Leipzig","Bundesliga","Jonathan Norbye","NOR","MF","17-065",2007,0,0,0,0,0,0,0,0,NA,0,0,0,0,0,0,0,0,"https://fbref.com/en/players/ef97654b/Jonathan-Norbye"
2024,"RB Leipzig","Bundesliga","Dani Olmo","ESP","MF","26-023",1998,16.1,26,18,14,8,4,10,22,45.5,12,7,0,7,13,39,12,1,"https://fbref.com/en/players/ae44e8e2/Dani-Olmo"
2024,"RB Leipzig","Bundesliga","Loïs Openda","BEL","FW","24-104",2000,30,3,3,0,1,2,0,6,0,6,19,3,16,5,8,14,0,"https://fbref.com/en/players/8652a85c/Lois-Openda"
2024,"RB Leipzig","Bundesliga","Willi Orban","HUN","DF","31-209",1992,17.6,20,12,8,10,2,9,18,50,9,22,13,9,16,36,76,1,"https://fbref.com/en/players/20030c06/Willi-Orban"
2024,"RB Leipzig","Bundesliga","Yussuf Poulsen","DEN","FW","29-350",1994,13.5,13,8,1,9,3,4,14,28.6,10,13,3,10,4,17,15,0,"https://fbref.com/en/players/d2416c2e/Yussuf-Poulsen"
2024,"RB Leipzig","Bundesliga","David Raum","GER","DF","26-038",1998,30.4,58,35,24,29,5,34,58,58.6,24,51,9,42,27,85,82,2,"https://fbref.com/en/players/7d450ed3/David-Raum"
2024,"RB Leipzig","Bundesliga","Xaver Schlager","AUT","MF","26-245",1997,27.5,81,50,35,38,8,21,53,39.6,32,41,8,33,19,100,27,0,"https://fbref.com/en/players/8f056768/Xaver-Schlager"
2024,"RB Leipzig","Bundesliga","Nicolas Seiwald","AUT","MF","23-026",2001,8,33,18,16,15,2,16,25,64,9,12,2,10,8,41,15,0,"https://fbref.com/en/players/28c6e925/Nicolas-Seiwald"
2024,"RB Leipzig","Bundesliga","Benjamin Šeško","SVN","FW","20-365",2003,17,13,5,2,7,4,2,9,22.2,7,23,2,21,3,16,27,0,"https://fbref.com/en/players/3260690c/Benjamin-Sesko"
2024,"RB Leipzig","Bundesliga","Mohamed Simakan","FRA","DF","24-027",2000,23.8,48,29,28,19,1,32,44,72.7,12,36,14,22,29,77,69,0,"https://fbref.com/en/players/fcb27134/Mohamed-Simakan"
2024,"RB Leipzig","Bundesliga","Xavi Simons","NED","MF","21-039",2003,29.5,30,17,10,11,9,15,31,48.4,16,23,0,23,16,46,4,0,"https://fbref.com/en/players/da4d670f/Xavi-Simons"
2024,"RB Leipzig","Bundesliga","Timo Werner","GER","FW,MF","28-085",1996,2.3,2,1,0,1,1,0,0,NA,0,1,0,1,1,3,0,0,"https://fbref.com/en/players/49fe9070/Timo-Werner"
2024,"Rayo Vallecano","La Liga","Iván Balliu","ALB","DF","32-150",1992,31.9,44,31,20,24,0,22,39,56.4,17,27,11,16,29,73,66,1,"https://fbref.com/en/players/cee88597/Ivan-Balliu"
2024,"Rayo Vallecano","La Liga","Bebé","CPV","MF,FW","33-323",1990,2.4,2,2,1,1,0,1,5,20,4,1,0,1,0,2,0,0,"https://fbref.com/en/players/d8712bf9/Bebe"
2024,"Rayo Vallecano","La Liga","Sergio Camello","ESP","FW","23-110",2001,18.5,16,5,3,10,3,6,15,40,9,10,2,8,3,19,15,0,"https://fbref.com/en/players/873619c6/Sergio-Camello"
2024,"Rayo Vallecano","La Liga","Cárdenas","ESP","GK","27-063",1997,1,0,0,0,0,0,0,0,NA,0,0,0,0,0,0,1,0,"https://fbref.com/en/players/e1846dde/Cardenas"
2024,"Rayo Vallecano","La Liga","Pep Chavarría","ESP","DF,MF","26-050",1998,13,23,18,15,6,2,11,17,64.7,6,15,3,12,6,29,29,1,"https://fbref.com/en/players/63c5e56b/Pep-Chavarria"
2024,"Rayo Vallecano","La Liga","Pathé Ciss","SEN","MF","30-075",1994,18.5,44,24,16,26,2,16,29,55.2,13,27,10,17,30,74,54,0,"https://fbref.com/en/players/9a0408b6/Pathe-Ciss"
2024,"Rayo Vallecano","La Liga","Crespo","POR","MF","27-262",1996,5.9,16,9,8,6,2,9,17,52.9,8,15,6,9,10,26,7,0,"https://fbref.com/en/players/922dfade/Crespo"
2024,"Rayo Vallecano","La Liga","Stole Dimitrievski","MKD","GK","30-157",1993,37,1,1,1,0,0,1,1,100,0,0,0,0,0,1,17,3,"https://fbref.com/en/players/fc70e345/Stole-Dimitrievski"
2024,"Rayo Vallecano","La Liga","Alfonso Espino","URU","DF","32-146",1992,27.9,67,45,43,22,2,30,82,36.6,52,26,4,22,40,107,63,0,"https://fbref.com/en/players/db001fa9/Alfonso-Espino"
2024,"Rayo Vallecano","La Liga","Radamel Falcao","COL","FW,DF","38-110",1986,4.5,7,5,1,5,1,1,3,33.3,2,2,0,2,3,10,4,0,"https://fbref.com/en/players/66116290/Radamel-Falcao"
2024,"Rayo Vallecano","La Liga","Jorge de Frutos","ESP","FW,MF","27-100",1997,17.2,19,8,5,8,6,7,22,31.8,15,12,0,12,7,26,18,0,"https://fbref.com/en/players/38ce1150/Jorge-de-Frutos"
2024,"Rayo Vallecano","La Liga","Álvaro García","ESP","FW,MF","31-216",1992,27.5,34,25,15,10,9,7,34,20.6,27,35,0,35,36,70,33,0,"https://fbref.com/en/players/90bbd822/Alvaro-Garcia"
2024,"Rayo Vallecano","La Liga","Aridane Hernández","ESP","DF","35-068",1989,18.8,10,8,5,4,1,4,11,36.4,7,19,14,5,14,24,98,1,"https://fbref.com/en/players/132ac341/Aridane-Hernandez"
2024,"Rayo Vallecano","La Liga","Florian Lejeune","FRA","DF","33-010",1991,37,39,25,26,11,2,19,30,63.3,11,33,18,15,23,62,155,1,"https://fbref.com/en/players/6eaed4eb/Florian-Lejeune"
2024,"Rayo Vallecano","La Liga","Unai López","ESP","MF","28-213",1995,23.4,48,24,18,23,7,21,53,39.6,32,24,3,21,16,64,15,2,"https://fbref.com/en/players/88050721/Unai-Lopez"
2024,"Rayo Vallecano","La Liga","Diego Méndez","ESP","MF","20-275",2003,0.1,1,1,1,0,0,1,1,100,0,0,0,0,1,2,0,0,"https://fbref.com/en/players/b151a3f2/Diego-Mendez"
2024,"Rayo Vallecano","La Liga","Abdul Mumin","GHA","DF","25-359",1998,18.8,19,10,13,4,2,8,10,80,2,27,19,8,22,41,82,1,"https://fbref.com/en/players/5487adcd/Abdul-Mumin"
2024,"Rayo Vallecano","La Liga","Randy Ntekja","FRA","FW,MF","26-176",1997,6.4,11,4,1,6,4,4,10,40,6,6,1,5,2,13,11,1,"https://fbref.com/en/players/a6103274/Randy-Ntekja"
2024,"Rayo Vallecano","La Liga","Isaac Palazón Camacho","ESP","MF,FW","29-155",1994,31,46,25,16,21,9,20,58,34.5,38,29,2,27,16,62,41,0,"https://fbref.com/en/players/49dbab27/Isaac-Palazon-Camacho"
2024,"Rayo Vallecano","La Liga","Kike Pérez","ESP","MF,FW","27-106",1997,9.3,27,11,11,15,1,11,23,47.8,12,11,0,11,8,35,6,0,"https://fbref.com/en/players/237a3851/Kike-Perez"
2024,"Rayo Vallecano","La Liga","José Pozo","ESP","MF","28-076",1996,0.2,1,1,0,1,0,1,1,100,0,1,0,1,0,1,0,0,"https://fbref.com/en/players/fc8b614b/Jose-Pozo"
2024,"Rayo Vallecano","La Liga","Andrei Ratiu","ROU","DF,MF","25-345",1998,7,12,4,6,5,1,8,15,53.3,7,4,1,3,0,12,12,0,"https://fbref.com/en/players/b1b99435/Andrei-Ratiu"
2024,"Rayo Vallecano","La Liga","Salvi","ESP","MF","33-061",1991,0.3,0,0,0,0,0,0,4,0,4,0,0,0,1,1,0,0,"https://fbref.com/en/players/405f267a/Salvi"
2024,"Rayo Vallecano","La Liga","Raúl de Tomás","ESP","FW","29-226",1994,14.1,9,5,4,3,2,3,6,50,3,3,0,3,1,10,8,0,"https://fbref.com/en/players/02ef8778/Raul-de-Tomas"
2024,"Rayo Vallecano","La Liga","Óscar Trejo","ARG","FW,MF","36-034",1988,15.3,27,15,11,9,7,13,21,61.9,8,21,1,20,5,32,9,0,"https://fbref.com/en/players/fc647b34/Oscar-Trejo"
2024,"Rayo Vallecano","La Liga","Óscar Valentín","ESP","MF","29-284",1994,29.9,107,66,39,62,6,46,101,45.5,55,62,10,52,35,142,52,1,"https://fbref.com/en/players/592f3158/Oscar-Valentin"
2024,"Real Madrid","La Liga","David Alaba","AUT","DF","31-341",1992,12.8,13,9,7,5,1,4,8,50,4,10,7,3,15,28,34,0,"https://fbref.com/en/players/05439de2/David-Alaba"
2024,"Real Madrid","La Liga","Kepa Arrizabalaga","ESP","GK","29-240",1994,13.3,0,0,0,0,0,0,1,0,1,0,0,0,0,0,4,0,"https://fbref.com/en/players/28d596a0/Kepa-Arrizabalaga"
2024,"Real Madrid","La Liga","Jude Bellingham","ENG","MF","20-336",2003,25.7,42,34,14,18,10,12,36,33.3,24,55,5,50,21,63,17,0,"https://fbref.com/en/players/57d88cf9/Jude-Bellingham"
2024,"Real Madrid","La Liga","Eduardo Camavinga","FRA","MF,DF","21-202",2002,20.2,76,47,39,29,8,23,39,59,16,36,8,28,29,105,29,1,"https://fbref.com/en/players/7b9c2d84/Eduardo-Camavinga"
2024,"Real Madrid","La Liga","Dani Carvajal","ESP","DF","32-140",1992,24.1,47,32,28,15,4,23,42,54.8,19,28,9,19,22,69,54,4,"https://fbref.com/en/players/4958bfb2/Dani-Carvajal"
2024,"Real Madrid","La Liga","Dani Ceballos","ESP","MF,FW","27-297",1996,6.6,10,5,4,5,1,5,14,35.7,9,9,2,7,0,10,4,1,"https://fbref.com/en/players/c0617e2b/Dani-Ceballos"
2024,"Real Madrid","La Liga","Thibaut Courtois","BEL","GK","32-019",1992,3.7,1,0,1,0,0,0,0,NA,0,0,0,0,0,1,0,0,"https://fbref.com/en/players/1840e36d/Thibaut-Courtois"
2024,"Real Madrid","La Liga","Brahim Díaz","MAR","FW,MF","24-301",1999,17.2,29,19,4,16,9,6,13,46.2,7,16,1,15,5,34,2,0,"https://fbref.com/en/players/407feb71/Brahim-Diaz"
2024,"Real Madrid","La Liga","Fran Garcia","ESP","DF","24-290",1999,15.5,25,17,11,12,2,13,31,41.9,18,16,3,13,19,44,28,1,"https://fbref.com/en/players/7226539b/Fran-Garcia"
2024,"Real Madrid","La Liga","Gonzalo García","ESP","FW,MF","20-067",2004,0.2,0,0,0,0,0,0,1,0,1,1,1,0,0,0,1,0,"https://fbref.com/en/players/74c2d562/Gonzalo-Garcia"
2024,"Real Madrid","La Liga","Arda Güler","TUR","FW,MF","19-095",2005,4.2,6,4,1,3,2,5,8,62.5,3,0,0,0,2,8,5,0,"https://fbref.com/en/players/3741ca58/Arda-Guler"
2024,"Real Madrid","La Liga","Joselu","ESP","FW","34-064",1990,18.7,6,3,1,4,1,0,7,0,7,11,1,10,6,12,11,0,"https://fbref.com/en/players/6265208f/Joselu"
2024,"Real Madrid","La Liga","Vinicius Júnior","BRA","FW","23-323",2000,20.7,18,13,5,5,8,3,12,25,9,13,0,13,1,19,3,2,"https://fbref.com/en/players/7111d552/Vinicius-Junior"
2024,"Real Madrid","La Liga","Toni Kroos","GER","MF","34-147",1990,23.6,53,34,19,25,9,24,59,40.7,35,22,4,18,17,70,11,1,"https://fbref.com/en/players/6ce1f46f/Toni-Kroos"
2024,"Real Madrid","La Liga","Andriy Lunin","UKR","GK","25-109",1999,21,0,0,0,0,0,0,1,0,1,0,0,0,0,0,15,1,"https://fbref.com/en/players/3061e1ec/Andriy-Lunin"
2024,"Real Madrid","La Liga","Mario Martín","ESP","MF","20-086",2004,0.2,5,1,0,2,3,3,4,75,1,2,1,1,0,5,0,0,"https://fbref.com/en/players/a9aff11a/Mario-Martin"
2024,"Real Madrid","La Liga","Ferland Mendy","FRA","DF","28-357",1995,19.1,15,10,12,2,1,11,14,78.6,3,12,2,10,13,28,26,1,"https://fbref.com/en/players/3cefcaef/Ferland-Mendy"
2024,"Real Madrid","La Liga","Éder Militão","BRA","DF","26-133",1998,5.5,7,3,4,3,0,6,9,66.7,3,4,3,1,4,11,19,1,"https://fbref.com/en/players/2784f898/Eder-Militao"
2024,"Real Madrid","La Liga","Luka Modrić","CRO","MF","38-264",1985,18.8,22,15,10,6,6,9,25,36,16,13,4,9,21,43,9,0,"https://fbref.com/en/players/6025fab1/Luka-Modric"
2024,"Real Madrid","La Liga","Álvaro Muñoz","URU","FW","19-321",2004,0,0,0,0,0,0,0,0,NA,0,0,0,0,0,0,1,0,"https://fbref.com/en/players/49a6ecbb/Alvaro-Munoz"
2024,"Real Madrid","La Liga","Nacho","ESP","DF","34-133",1990,19.4,18,10,9,7,2,6,13,46.2,7,23,13,10,18,36,56,0,"https://fbref.com/en/players/2946f9a1/Nacho"
2024,"Real Madrid","La Liga","Nicolás Paz","ARG","MF,FW","19-265",2004,0.3,0,0,0,0,0,0,0,NA,0,2,0,2,1,1,0,0,"https://fbref.com/en/players/01bb93d5/Nicolas-Paz"
2024,"Real Madrid","La Liga","Rodrygo","BRA","FW","23-142",2001,26.4,16,15,2,9,5,5,19,26.3,14,14,0,14,8,24,6,0,"https://fbref.com/en/players/8f5e92a6/Rodrygo"
2024,"Real Madrid","La Liga","Antonio Rüdiger","GER","DF","31-088",1993,30.1,26,15,18,4,4,16,20,80,4,27,20,7,11,37,89,0,"https://fbref.com/en/players/18b896d6/Antonio-Rudiger"
2024,"Real Madrid","La Liga","Aurélien Tchouaméni","FRA","MF,DF","24-124",2000,22.1,38,23,19,17,2,9,18,50,9,21,13,8,28,66,52,1,"https://fbref.com/en/players/4f255115/Aurelien-Tchouameni"
2024,"Real Madrid","La Liga","Federico Valverde","URU","MF","25-313",1998,32.3,47,34,22,13,12,24,42,57.1,18,39,2,37,43,90,40,0,"https://fbref.com/en/players/0959c2a2/Federico-Valverde"
2024,"Real Madrid","La Liga","Lucas Vázquez","ESP","DF","32-334",1991,15.8,37,25,22,14,1,18,25,72,7,27,5,22,12,49,36,0,"https://fbref.com/en/players/fd51b456/Lucas-Vazquez"
2024,"Real Sociedad","La Liga","Mohamed Ali Cho","FRA","FW,MF","20-132",2004,2.8,4,3,3,1,0,2,7,28.6,5,6,0,6,1,5,1,0,"https://fbref.com/en/players/f8405304/Mohamed-Ali-Cho"
2024,"Real Sociedad","La Liga","Jon Aramburu","VEN","DF","21-312",2002,6,24,15,12,10,2,15,25,60,10,8,3,5,7,31,17,0,"https://fbref.com/en/players/dc7a172e/Jon-Aramburu"
2024,"Real Sociedad","La Liga","Ander Barrenetxea","ESP","FW,MF","22-155",2001,15.9,32,21,7,16,9,10,26,38.5,16,18,1,17,6,38,5,0,"https://fbref.com/en/players/200e89e1/Ander-Barrenetxea"
2024,"Real Sociedad","La Liga","Sheraldo Becker","SUR","FW,MF","29-111",1995,8.6,2,2,0,2,0,0,1,0,1,3,0,3,1,3,0,0,"https://fbref.com/en/players/8eb55dbb/Sheraldo-Becker"
2024,"Real Sociedad","La Liga","Alberto Dadie","ESP","MF","21-315",2002,0.3,2,1,2,0,0,0,0,NA,0,1,0,1,0,2,0,0,"https://fbref.com/en/players/cc851506/Alberto-Dadie"
2024,"Real Sociedad","La Liga","Aritz Elustondo","ESP","DF","30-063",1994,9,11,7,5,4,2,6,14,42.9,8,12,10,2,7,18,26,0,"https://fbref.com/en/players/f7dc2ae5/Aritz-Elustondo"
2024,"Real Sociedad","La Liga","Carlos Fernández","ESP","FW","28-008",1996,4.5,11,7,3,6,2,0,2,0,2,4,0,4,0,11,5,0,"https://fbref.com/en/players/e08647d6/Carlos-Fernandez"
2024,"Real Sociedad","La Liga","Javi Galán","ESP","DF","29-193",1994,11.9,38,22,15,19,4,15,30,50,15,24,1,23,14,52,17,1,"https://fbref.com/en/players/a4b00319/Javi-Galan"
2024,"Real Sociedad","La Liga","Urko González","ESP","MF","23-071",2001,1.7,4,1,0,3,1,2,2,100,0,1,0,1,1,5,6,0,"https://fbref.com/en/players/c4f5eb61/Urko-Gonzalez"
2024,"Real Sociedad","La Liga","Takefusa Kubo","JPN","FW,MF","22-361",2001,23.9,26,17,15,6,5,9,23,39.1,14,21,2,19,11,37,8,1,"https://fbref.com/en/players/16aa3654/Takefusa-Kubo"
2024,"Real Sociedad","La Liga","Robin Le Normand","ESP","DF","27-201",1996,27.4,31,22,16,15,0,17,30,56.7,13,26,15,11,28,59,96,1,"https://fbref.com/en/players/9a64e67e/Robin-Le-Normand"
2024,"Real Sociedad","La Liga","Jon Magunacelaya","ESP","FW,MF","23-322",2000,1.3,5,3,2,3,0,4,8,50,4,3,0,3,0,5,2,0,"https://fbref.com/en/players/d4808594/Jon-Magunacelaya"
2024,"Real Sociedad","La Liga","Unai Marrero","ESP","GK","22-234",2001,1.6,0,0,0,0,0,0,0,NA,0,0,0,0,0,0,0,0,"https://fbref.com/en/players/f0fe87dc/Unai-Marrero"
2024,"Real Sociedad","La Liga","Jon Martin","ESP","DF","18-150",2006,0.3,0,0,0,0,0,0,0,NA,0,0,0,0,0,0,3,0,"https://fbref.com/en/players/df33ecb5/Jon-Martin"
2024,"Real Sociedad","La Liga","Brais Méndez","ESP","MF,FW","27-144",1997,26.8,42,28,13,20,9,15,43,34.9,28,23,4,19,12,54,21,0,"https://fbref.com/en/players/c9e39d91/Brais-Mendez"
2024,"Real Sociedad","La Liga","Mikel Merino","ESP","MF","27-343",1996,27.6,77,43,25,34,18,22,48,45.8,26,36,11,25,16,93,55,3,"https://fbref.com/en/players/d080ed5e/Mikel-Merino"
2024,"Real Sociedad","La Liga","Aihen Muñoz","ESP","DF","26-288",1997,12.5,36,21,20,10,6,24,35,68.6,11,16,8,8,9,45,33,0,"https://fbref.com/en/players/228b0d9d/Aihen-Munoz"
2024,"Real Sociedad","La Liga","Álvaro Odriozola","ESP","DF","28-168",1995,4.4,9,7,7,1,1,5,5,100,0,2,1,1,8,17,7,0,"https://fbref.com/en/players/1d1691ad/Alvaro-Odriozola"
2024,"Real Sociedad","La Liga","Olasagasti","ESP","MF","23-288",2000,4,16,13,4,7,5,5,8,62.5,3,2,0,2,3,19,5,1,"https://fbref.com/en/players/3d99999d/Olasagasti"
2024,"Real Sociedad","La Liga","Mikel Oyarzabal","ESP","FW,MF","27-039",1997,24,23,18,7,11,5,7,21,33.3,14,25,4,21,4,27,12,0,"https://fbref.com/en/players/8c3c640c/Mikel-Oyarzabal"
2024,"Real Sociedad","La Liga","Jon Pacheco","ESP","DF","23-143",2001,17,25,15,21,4,0,14,22,63.6,8,17,6,11,10,35,53,1,"https://fbref.com/en/players/44150beb/Jon-Pacheco"
2024,"Real Sociedad","La Liga","Álex Remiro","ESP","GK","29-067",1995,36.4,0,0,0,0,0,0,0,NA,0,0,0,0,0,0,24,2,"https://fbref.com/en/players/374ee424/Alex-Remiro"
2024,"Real Sociedad","La Liga","Umar Sadiq","NGA","FW","27-118",1997,12,15,10,2,8,5,4,8,50,4,9,0,9,0,15,10,0,"https://fbref.com/en/players/686cbe7d/Umar-Sadiq"
2024,"Real Sociedad","La Liga","André Silva","POR","FW","28-206",1995,8.1,2,2,0,0,2,0,4,0,4,3,0,3,1,3,3,0,"https://fbref.com/en/players/3effaa34/Andre-Silva"
2024,"Real Sociedad","La Liga","Alex Sola","ESP","DF,MF","24-356",1999,0.3,0,0,0,0,0,0,0,NA,0,0,0,0,1,1,2,0,"https://fbref.com/en/players/5fa714d5/Alex-Sola"
2024,"Real Sociedad","La Liga","Kieran Tierney","SCO","DF","26-360",1997,13.8,37,24,16,18,3,18,27,66.7,9,22,8,14,10,47,45,0,"https://fbref.com/en/players/fce2302c/Kieran-Tierney"
2024,"Real Sociedad","La Liga","Hamari Traoré","MLI","DF","32-124",1992,25.5,44,19,24,17,3,25,43,58.1,18,27,8,19,24,68,59,2,"https://fbref.com/en/players/a4b1028a/Hamari-Traore"
2024,"Real Sociedad","La Liga","Beñat Turrientes","ESP","MF","22-120",2002,18.7,31,17,6,20,5,13,30,43.3,17,19,8,11,6,37,17,0,"https://fbref.com/en/players/068f4dec/Benat-Turrientes"
2024,"Real Sociedad","La Liga","Arsen Zakharyan","RUS","MF,FW","21-004",2003,13.6,22,15,8,11,3,9,22,40.9,13,16,0,16,4,26,10,0,"https://fbref.com/en/players/7f14ec2a/Arsen-Zakharyan"
2024,"Real Sociedad","La Liga","Igor Zubeldia","ESP","DF","27-061",1997,28,32,25,20,10,2,19,26,73.1,7,28,19,9,32,64,97,3,"https://fbref.com/en/players/5c7845f6/Igor-Zubeldia"
2024,"Real Sociedad","La Liga","Martín Zubimendi","ESP","MF","25-118",1999,29.5,49,27,18,29,2,23,42,54.8,19,33,9,24,37,86,54,0,"https://fbref.com/en/players/3ee0dd59/Martin-Zubimendi"
2024,"Reims","Ligue 1","Yunis Abdelhamid","MAR","DF","36-245",1987,30.9,64,35,36,23,5,26,45,57.8,19,51,32,19,39,103,109,2,"https://fbref.com/en/players/32c2d95f/Yunis-Abdelhamid"
2024,"Reims","Ligue 1","Emmanuel Agbadou","CIV","DF","26-348",1997,28.8,65,41,38,23,4,44,64,68.8,20,47,25,22,55,120,116,1,"https://fbref.com/en/players/75f1ed80/Emmanuel-Agbadou"
2024,"Reims","Ligue 1","Sergio Akieme","ESP","DF","26-166",1997,9.1,11,5,6,3,2,8,11,72.7,3,9,3,6,10,21,25,0,"https://fbref.com/en/players/06efa9dc/Sergio-Akieme"
2024,"Reims","Ligue 1","Valentin Atangana Edoa","FRA","MF","18-279",2005,6.2,19,13,6,9,4,5,13,38.5,8,5,1,4,6,25,9,0,"https://fbref.com/en/players/6b5edd5d/Valentin-Atangana-Edoa"
2024,"Reims","Ligue 1","Adama Bojang","GAM","FW","20-002",2004,0.9,2,1,1,0,1,0,0,NA,0,2,1,1,1,3,0,0,"https://fbref.com/en/players/e606b6c0/Adama-Bojang"
2024,"Reims","Ligue 1","Maxime Busi","BEL","FW,DF","24-229",1999,1.8,2,0,0,1,1,0,2,0,2,6,1,5,4,6,5,0,"https://fbref.com/en/players/7b082ec2/Maxime-Busi"
2024,"Reims","Ligue 1","Mohammed Daramy","DEN","FW,MF","22-144",2002,18.3,10,9,4,4,2,6,16,37.5,10,5,1,4,4,14,4,0,"https://fbref.com/en/players/06a1d642/Mohammed-Daramy"
2024,"Reims","Ligue 1","Thibault De Smet","BEL","DF","25-360",1998,20.3,56,35,36,16,4,33,59,55.9,26,25,5,20,21,77,51,1,"https://fbref.com/en/players/5fdcb075/Thibault-De-Smet"
2024,"Reims","Ligue 1","Mamadou Diakhon","FRA","FW,MF","18-251",2005,2.3,5,3,2,1,2,3,9,33.3,6,1,0,1,1,6,1,0,"https://fbref.com/en/players/331c5a98/Mamadou-Diakhon"
2024,"Reims","Ligue 1","Ibrahim Diakité","GUI","DF","20-212",2003,1.2,1,0,0,1,0,0,1,0,1,3,0,3,2,3,5,0,"https://fbref.com/en/players/d8c19a60/Ibrahim-Diakite"
2024,"Reims","Ligue 1","Oumar Diakité","CIV","FW","20-162",2003,17.6,25,12,10,9,6,7,21,33.3,14,13,0,13,7,32,7,0,"https://fbref.com/en/players/44435c8f/Oumar-Diakite"
2024,"Reims","Ligue 1","Yehvann Diouf","FRA","GK","24-196",1999,34,0,0,0,0,0,0,1,0,1,0,0,0,1,1,19,3,"https://fbref.com/en/players/eedea60b/Yehvann-Diouf"
2024,"Reims","Ligue 1","Thomas Foket","BEL","DF","29-248",1994,20.4,32,17,21,8,3,20,45,44.4,25,34,12,22,25,57,36,0,"https://fbref.com/en/players/90eb507d/Thomas-Foket"
2024,"Reims","Ligue 1","Junya Ito","JPN","FW,MF","31-082",1993,30.2,33,15,11,14,8,10,36,27.8,26,23,1,22,14,47,7,0,"https://fbref.com/en/players/dbd3a428/Junya-Ito"
2024,"Reims","Ligue 1","Yaya Kader Fofana","MLI","MF,DF","19-353",2004,0.4,3,3,1,1,1,0,1,0,1,0,0,0,1,4,0,0,"https://fbref.com/en/players/cedc53d2/Yaya-Kader-Fofana"
2024,"Reims","Ligue 1","Reda Khadra","GER","FW,MF","22-331",2001,15.2,16,10,5,4,7,8,20,40,12,8,2,6,3,19,13,0,"https://fbref.com/en/players/88acf83f/Reda-Khadra"
2024,"Reims","Ligue 1","Abdoul Koné","FRA","DF","19-038",2005,2.1,7,7,5,2,0,4,11,36.4,7,2,0,2,2,9,9,0,"https://fbref.com/en/players/c1ebf5d2/Abdoul-Kone"
2024,"Reims","Ligue 1","Amadou Koné","MLI","MF","19-016",2005,5.3,13,8,11,2,0,6,10,60,4,8,3,5,10,23,10,0,"https://fbref.com/en/players/2eb1ec07/Amadou-Kone"
2024,"Reims","Ligue 1","Therence Koudou","FRA","DF","19-169",2004,3.5,2,2,1,1,0,0,2,0,2,4,3,1,4,6,9,0,"https://fbref.com/en/players/059a83b8/Therence-Koudou"
2024,"Reims","Ligue 1","Azor Matusiwa","NED","MF","26-032",1998,15.4,39,27,17,19,3,22,32,68.8,10,21,3,18,33,72,32,1,"https://fbref.com/en/players/a17a94d6/Azor-Matusiwa"
2024,"Reims","Ligue 1","Christ Mbondi","FRA","FW","19-223",2004,0,1,1,1,0,0,1,1,100,0,0,0,0,0,1,0,0,"https://fbref.com/en/players/5d36f616/Christ-Mbondi"
2024,"Reims","Ligue 1","Marshall Munetsi","ZIM","MF","27-343",1996,24.1,61,39,18,34,9,33,61,54.1,28,21,7,14,14,75,33,0,"https://fbref.com/en/players/2acf0cd7/Marshall-Munetsi"
2024,"Reims","Ligue 1","Keito Nakamura","JPN","FW,MF","23-307",2000,15.3,28,11,9,10,9,17,37,45.9,20,15,2,13,6,34,7,0,"https://fbref.com/en/players/d97af612/Keito-Nakamura"
2024,"Reims","Ligue 1","Joseph Okumu","KEN","DF","27-004",1997,19.4,44,28,28,14,2,24,38,63.2,14,27,19,8,35,79,112,2,"https://fbref.com/en/players/039f1983/Joseph-Okumu"
2024,"Reims","Ligue 1","Amir Richardson","MAR","MF","22-127",2002,15,33,23,12,18,3,10,22,45.5,12,26,5,21,15,48,30,0,"https://fbref.com/en/players/2b7cdb79/Amir-Richardson"
2024,"Reims","Ligue 1","Amine Salama","FRA","FW","23-317",2000,3.5,0,0,0,0,0,0,0,NA,0,1,0,1,1,1,1,0,"https://fbref.com/en/players/bc7cc472/Amine-Salama"
2024,"Reims","Ligue 1","Benjamin Stambouli","FRA","MF","33-291",1990,3.2,9,7,3,5,1,6,11,54.5,5,3,1,2,2,11,8,0,"https://fbref.com/en/players/5939baa2/Benjamin-Stambouli"
2024,"Reims","Ligue 1","Teddy Teuma","MLT","MF","30-243",1993,23.5,54,36,19,21,14,25,62,40.3,37,33,4,29,20,74,6,0,"https://fbref.com/en/players/5c26ca51/Teddy-Teuma"
2024,"Reims","Ligue 1","Josh Wilson-Esbrand","ENG","DF,MF","21-156",2002,5.1,5,4,2,3,0,2,8,25,6,5,2,3,6,11,7,0,"https://fbref.com/en/players/c19a2df1/Josh-Wilson-Esbrand"
2024,"Rennes","Ligue 1","Lorenz Assignon","TOG","DF","23-343",2000,11.2,24,12,12,8,4,9,24,37.5,15,9,4,5,9,33,27,1,"https://fbref.com/en/players/b026bbf6/Lorenz-Assignon"
2024,"Rennes","Ligue 1","Jeanuël Belocian","FRA","DF","19-103",2005,16.1,32,22,23,8,1,22,28,78.6,6,18,10,8,13,45,49,0,"https://fbref.com/en/players/c678ddd7/Jeanuel-Belocian"
2024,"Rennes","Ligue 1","Ludovic Blas","FRA","FW,MF","26-151",1997,17.4,30,14,16,13,1,12,28,42.9,16,13,1,12,6,36,9,0,"https://fbref.com/en/players/6191093d/Ludovic-Blas"
2024,"Rennes","Ligue 1","Benjamin Bourigeaud","FRA","MF,FW","30-137",1994,26.9,31,18,14,9,8,13,44,29.5,31,31,2,29,22,53,39,2,"https://fbref.com/en/players/20e73fac/Benjamin-Bourigeaud"
2024,"Rennes","Ligue 1","Djaoui Cissé","FRA","MF","20-120",2004,0,0,0,0,0,0,0,0,NA,0,0,0,0,0,0,0,0,"https://fbref.com/en/players/576ca93f/Djaoui-Cisse"
2024,"Rennes","Ligue 1","Jeremy Doku","BEL","FW","22-003",2002,1.2,2,2,1,0,1,1,1,100,0,0,0,0,0,2,0,0,"https://fbref.com/en/players/fffea3e5/Jeremy-Doku"
2024,"Rennes","Ligue 1","Désiré Doué","FRA","MF,FW","18-362",2005,18.1,32,18,11,14,7,10,33,30.3,23,30,1,29,14,46,8,0,"https://fbref.com/en/players/9e7483ff/Desire-Doue"
2024,"Rennes","Ligue 1","Guela Doué","CIV","DF","21-226",2002,13.7,28,21,14,12,2,22,32,68.8,10,12,1,11,15,43,65,1,"https://fbref.com/en/players/b4ef3fb5/Guela-Doue"
2024,"Rennes","Ligue 1","Amine Gouiri","ALG","FW,MF","24-104",2000,23,20,10,4,11,5,8,19,42.1,11,18,1,17,14,34,12,0,"https://fbref.com/en/players/aad56ca3/Amine-Gouiri"
2024,"Rennes","Ligue 1","Jérémy Jacquet","FRA","MF","18-322",2005,0.1,1,1,1,0,0,0,1,0,1,0,0,0,1,2,0,0,"https://fbref.com/en/players/cef70c94/Jeremy-Jacquet"
2024,"Rennes","Ligue 1","Arnaud Kalimuendo","FRA","FW","22-131",2002,23.8,5,4,2,2,1,2,5,40,3,13,2,11,4,9,4,0,"https://fbref.com/en/players/bf4c41f9/Arnaud-Kalimuendo"
2024,"Rennes","Ligue 1","Mathis Lambourde","FRA","FW","18-142",2006,0.1,0,0,0,0,0,0,1,0,1,1,0,1,0,0,1,0,"https://fbref.com/en/players/0da3d7ab/Mathis-Lambourde"
2024,"Rennes","Ligue 1","Enzo Le Fée","FRA","MF","24-117",2000,17,50,35,23,17,10,23,47,48.9,24,17,3,14,19,69,20,0,"https://fbref.com/en/players/6f806d99/Enzo-Le-Fee"
2024,"Rennes","Ligue 1","Lovro Majer","CRO","MF","26-134",1998,0.2,0,0,0,0,0,0,0,NA,0,0,0,0,0,0,1,0,"https://fbref.com/en/players/fc46aab1/Lovro-Majer"
2024,"Rennes","Ligue 1","Steve Mandanda","FRA","GK","39-063",1985,34,2,0,2,0,0,2,4,50,2,0,0,0,0,2,6,1,"https://fbref.com/en/players/1d2d5cc8/Steve-Mandanda"
2024,"Rennes","Ligue 1","Nemanja Matić","SRB","MF","35-303",1988,11.4,19,10,7,9,3,9,12,75,3,15,7,8,27,46,19,0,"https://fbref.com/en/players/eb7822d7/Nemanja-Matic"
2024,"Rennes","Ligue 1","Azor Matusiwa","NED","MF","26-032",1998,8.8,7,3,3,4,0,4,7,57.1,3,9,2,7,11,18,17,0,"https://fbref.com/en/players/a17a94d6/Azor-Matusiwa"
2024,"Rennes","Ligue 1","Birger Meling","NOR","DF","29-165",1994,0.2,1,1,1,0,0,1,1,100,0,1,0,1,0,1,0,0,"https://fbref.com/en/players/70c52749/Birger-Meling"
2024,"Rennes","Ligue 1","Mahamadou Nagida","CMR","DF","18-337",2005,1.2,1,1,0,0,1,0,2,0,2,2,1,1,4,5,0,0,"https://fbref.com/en/players/8bfbf257/Mahamadou-Nagida"
2024,"Rennes","Ligue 1","Warmed Omari","FRA","DF","24-037",2000,23,32,19,23,7,2,16,28,57.1,12,30,20,10,33,65,77,2,"https://fbref.com/en/players/4534a352/Warmed-Omari"
2024,"Rennes","Ligue 1","Fabian Rieder","SUI","MF","22-104",2002,4.1,13,7,2,9,2,6,11,54.5,5,3,1,2,5,18,2,0,"https://fbref.com/en/players/c2bd8585/Fabian-Rieder"
2024,"Rennes","Ligue 1","Ibrahim Salah","MAR","FW,MF","22-274",2001,5.8,15,7,5,6,4,11,18,61.1,7,4,0,4,10,25,5,0,"https://fbref.com/en/players/cad3fd4d/Ibrahim-Salah"
2024,"Rennes","Ligue 1","Baptiste Santamaria","FRA","MF","29-082",1995,21.4,52,33,21,25,6,29,46,63,17,15,6,9,34,86,33,1,"https://fbref.com/en/players/5e22e2a4/Baptiste-Santamaria"
2024,"Rennes","Ligue 1","Alidu Seidu","GHA","DF","23-361",2000,6.6,21,9,17,3,1,14,19,73.7,5,11,3,8,10,31,13,0,"https://fbref.com/en/players/cea59f02/Alidu-Seidu"
2024,"Rennes","Ligue 1","Martin Terrier","FRA","FW,MF","27-087",1997,17,14,9,3,8,3,6,14,42.9,8,21,4,17,9,23,17,0,"https://fbref.com/en/players/5148dcc5/Martin-Terrier"
2024,"Rennes","Ligue 1","Arthur Theate","BEL","DF","24-005",2000,25.5,30,17,19,6,5,24,37,64.9,13,40,23,17,31,61,90,2,"https://fbref.com/en/players/df8d6029/Arthur-Theate"
2024,"Rennes","Ligue 1","Adrien Truffert","FRA","DF","22-192",2001,23.8,39,21,23,10,6,25,40,62.5,15,31,5,26,19,58,49,0,"https://fbref.com/en/players/5d0e0a1f/Adrien-Truffert"
2024,"Rennes","Ligue 1","Christopher Wooh","CMR","DF","22-255",2001,15.4,18,12,12,6,0,8,15,53.3,7,19,9,10,18,36,51,0,"https://fbref.com/en/players/b003239d/Christopher-Wooh"
2024,"Rennes","Ligue 1","Bertuğ Yıldırım","TUR","FW","21-323",2002,5.2,7,5,2,3,2,3,8,37.5,5,8,0,8,0,7,4,0,"https://fbref.com/en/players/7410d325/Bertug-Yildirim"
2024,"Roma","Serie A","Tammy Abraham","ENG","FW","26-241",1997,2.7,3,1,0,1,2,0,0,NA,0,1,0,1,0,3,4,0,"https://fbref.com/en/players/f586779e/Tammy-Abraham"
2024,"Roma","Serie A","Angeliño","ESP","DF","27-147",1997,12.7,21,11,12,6,3,11,19,57.9,8,11,5,6,12,33,37,1,"https://fbref.com/en/players/30941e96/Angelino"
2024,"Roma","Serie A","Houssem Aouar","ALG","MF,FW","25-335",1998,8.4,16,11,4,10,2,3,12,25,9,5,0,5,4,20,2,1,"https://fbref.com/en/players/a5db0bec/Houssem-Aouar"
2024,"Roma","Serie A","Sardar Azmoun","IRN","FW,MF","29-150",1995,6.5,8,5,2,5,1,4,8,50,4,4,1,3,3,11,6,1,"https://fbref.com/en/players/10549b49/Sardar-Azmoun"
2024,"Roma","Serie A","Tommaso Baldanzi","ITA","FW,MF","21-068",2003,5.8,9,5,3,4,2,1,1,100,0,2,0,2,0,9,4,0,"https://fbref.com/en/players/102e2599/Tommaso-Baldanzi"
2024,"Roma","Serie A","Andrea Belotti","ITA","FW","30-162",1993,7.5,8,4,2,3,3,3,6,50,3,7,0,7,2,10,3,0,"https://fbref.com/en/players/d705ba44/Andrea-Belotti"
2024,"Roma","Serie A","Edoardo Bove","ITA","MF","22-014",2002,19.8,60,31,16,31,13,27,46,58.7,19,21,1,20,11,71,11,1,"https://fbref.com/en/players/ae94a6c5/Edoardo-Bove"
2024,"Roma","Serie A","Zeki Çelik","TUR","DF","27-103",1997,7.5,23,16,10,10,3,14,25,56,11,12,5,7,8,31,25,0,"https://fbref.com/en/players/31a62dc7/Zeki-Celik"
2024,"Roma","Serie A","João Costa","BRA","MF,FW","19-063",2005,0.2,0,0,0,0,0,0,0,NA,0,0,0,0,0,0,0,0,"https://fbref.com/en/players/26952edc/Joao-Costa"
2024,"Roma","Serie A","Bryan Cristante","ITA","MF,DF","29-088",1995,36.5,72,41,33,28,11,28,50,56,22,36,6,30,25,97,55,2,"https://fbref.com/en/players/16657b95/Bryan-Cristante"
2024,"Roma","Serie A","Paulo Dybala","ARG","FW,MF","30-197",1993,21.8,22,13,3,10,9,2,18,11.1,16,12,0,12,3,25,6,1,"https://fbref.com/en/players/e0921a4f/Paulo-Dybala"
2024,"Roma","Serie A","Dean Huijsen","ESP","DF","19-046",2005,5.7,10,5,5,5,0,1,4,25,3,7,4,3,4,14,26,2,"https://fbref.com/en/players/87278bce/Dean-Huijsen"
2024,"Roma","Serie A","Rick Karsdorp","NED","DF","29-109",1995,13.2,25,18,11,8,6,16,24,66.7,8,13,4,9,9,34,16,0,"https://fbref.com/en/players/9f84febe/Rick-Karsdorp"
2024,"Roma","Serie A","Rasmus Kristensen","DEN","DF","26-324",1997,19.4,36,19,25,8,3,28,50,56,22,27,7,20,8,44,50,0,"https://fbref.com/en/players/39769cff/Rasmus-Kristensen"
2024,"Roma","Serie A","Diego Llorente","ESP","DF","30-288",1993,24.1,31,19,20,10,1,11,24,45.8,13,40,27,13,22,53,79,0,"https://fbref.com/en/players/bba30585/Diego-Llorente"
2024,"Roma","Serie A","Romelu Lukaku","BEL","FW","31-017",1993,29.3,6,5,1,2,3,2,4,50,2,7,1,6,0,6,19,1,"https://fbref.com/en/players/5eae500a/Romelu-Lukaku"
2024,"Roma","Serie A","Gianluca Mancini","ITA","DF","28-043",1996,31.9,34,20,21,11,2,11,27,40.7,16,38,26,12,36,70,77,1,"https://fbref.com/en/players/5aa53281/Gianluca-Mancini"
2024,"Roma","Serie A","Obite N'Dicka","CIV","DF","24-284",1999,24.1,32,18,12,19,1,12,20,60,8,30,16,14,16,48,75,0,"https://fbref.com/en/players/441197b8/Obite-NDicka"
2024,"Roma","Serie A","Riccardo Pagano","ITA","MF,DF","19-184",2004,0.6,2,2,1,1,0,0,6,0,6,3,2,1,0,2,2,0,"https://fbref.com/en/players/b5b9bde7/Riccardo-Pagano"
2024,"Roma","Serie A","Leandro Paredes","ARG","MF","29-336",1994,29.3,57,36,30,22,5,33,77,42.9,44,26,7,19,29,86,43,1,"https://fbref.com/en/players/dff153a4/Leandro-Paredes"
2024,"Roma","Serie A","Rui Patrício","POR","GK","36-105",1988,23,0,0,0,0,0,0,1,0,1,1,0,1,0,0,3,1,"https://fbref.com/en/players/79b0d6a0/Rui-Patricio"
2024,"Roma","Serie A","Lorenzo Pellegrini","ITA","MF","27-346",1996,20.7,35,20,14,16,5,17,51,33.3,34,28,5,23,20,55,22,0,"https://fbref.com/en/players/4a5a45c7/Lorenzo-Pellegrini"
2024,"Roma","Serie A","Niccolò Pisilli","ITA","MF","19-250",2004,0.1,0,0,0,0,0,0,0,NA,0,0,0,0,0,0,0,0,"https://fbref.com/en/players/c84dcc88/Niccolo-Pisilli"
2024,"Roma","Serie A","Renato Sanches","POR","MF","26-286",1997,1.6,2,1,1,1,0,2,3,66.7,1,2,0,2,0,2,1,0,"https://fbref.com/en/players/032f894e/Renato-Sanches"
2024,"Roma","Serie A","Stephan El Shaarawy","ITA","FW,DF","31-216",1992,19.3,21,13,14,4,3,6,15,40,9,11,4,7,13,34,15,2,"https://fbref.com/en/players/d3aaad90/Stephan-El-Shaarawy"
2024,"Roma","Serie A","Chris Smalling","ENG","DF","34-190",1989,4.3,1,1,1,0,0,1,4,25,3,6,5,1,5,6,8,0,"https://fbref.com/en/players/b6964eb6/Chris-Smalling"
2024,"Roma","Serie A","Ola Solbakken","NOR","FW","25-266",1998,0.3,0,0,0,0,0,0,0,NA,0,0,0,0,0,0,0,0,"https://fbref.com/en/players/78f13530/Ola-Solbakken"
2024,"Roma","Serie A","Leonardo Spinazzola","ITA","DF","31-066",1993,14.6,15,7,10,5,0,8,18,44.4,10,8,2,6,3,18,15,0,"https://fbref.com/en/players/3626daea/Leonardo-Spinazzola"
2024,"Roma","Serie A","Mile Svilar","SRB","GK","24-277",1999,15,0,0,0,0,0,0,0,NA,0,0,0,0,0,0,2,1,"https://fbref.com/en/players/bcf5058a/Mile-Svilar"
2024,"Roma","Serie A","Nicola Zalewski","POL","DF,FW","22-128",2002,10.8,20,14,10,9,1,8,22,36.4,14,12,4,8,9,29,17,0,"https://fbref.com/en/players/45191c29/Nicola-Zalewski"
2024,"Salernitana","Serie A","Toma Bašić","CRO","MF","27-187",1996,12.9,20,13,10,9,1,10,27,37,17,18,6,12,14,34,29,0,"https://fbref.com/en/players/80556f08/Toma-Basic"
2024,"Salernitana","Serie A","Jérôme Boateng","GER","DF","35-270",1988,2.6,0,0,0,0,0,0,0,NA,0,6,5,1,4,4,21,0,"https://fbref.com/en/players/2db2fd7b/Jerome-Boateng"
2024,"Salernitana","Serie A","Emil Bohinen","NOR","MF","25-079",1999,5.9,8,6,5,3,0,2,10,20,8,8,2,6,14,22,6,1,"https://fbref.com/en/players/c83c203f/Emil-Bohinen"
2024,"Salernitana","Serie A","Erik Botheim","NOR","FW,MF","24-141",2000,3.5,2,0,2,0,0,0,1,0,1,3,0,3,0,2,2,0,"https://fbref.com/en/players/3d13d9e4/Erik-Botheim"
2024,"Salernitana","Serie A","Domagoj Bradarić","CRO","DF","24-172",1999,30.5,29,20,13,10,6,15,25,60,10,22,7,15,32,61,62,1,"https://fbref.com/en/players/8bbe2df5/Domagoj-Bradaric"
2024,"Salernitana","Serie A","Dylan Bronn","TUN","DF,MF","28-346",1995,0.6,0,0,0,0,0,0,1,0,1,2,0,2,0,0,4,0,"https://fbref.com/en/players/edd81e2a/Dylan-Bronn"
2024,"Salernitana","Serie A","Jovane Cabral","CPV","MF,FW","25-351",1998,7.5,13,9,4,7,2,3,9,33.3,6,3,0,3,1,14,4,0,"https://fbref.com/en/players/e34e086c/Jovane-Cabral"
2024,"Salernitana","Serie A","Antonio Candreva","ITA","MF,FW","37-092",1987,30.6,18,13,8,8,2,9,25,36,16,9,0,9,7,25,23,0,"https://fbref.com/en/players/356c9002/Antonio-Candreva"
2024,"Salernitana","Serie A","Benoît Costil","FRA","GK","36-332",1987,13,2,1,1,1,0,2,3,66.7,1,0,0,0,0,2,5,1,"https://fbref.com/en/players/2434f24a/Benoit-Costil"
2024,"Salernitana","Serie A","Lassana Coulibaly","MLI","MF","28-050",1996,23.1,47,32,20,21,6,22,49,44.9,27,23,5,18,16,63,29,0,"https://fbref.com/en/players/85a44ecc/Lassana-Coulibaly"
2024,"Salernitana","Serie A","Mamadou Coulibaly","SEN","DF","25-117",1999,0,0,0,0,0,0,0,0,NA,0,0,0,0,0,0,0,0,"https://fbref.com/en/players/c976160c/Mamadou-Coulibaly"
2024,"Salernitana","Serie A","Flavius Daniliuc","AUT","DF","23-033",2001,8.3,19,11,12,5,2,9,19,47.4,10,13,4,9,8,27,15,0,"https://fbref.com/en/players/7ef972c3/Flavius-Daniliuc"
2024,"Salernitana","Serie A","Boulaye Dia","SEN","FW,MF","27-196",1996,12.7,4,2,2,2,0,1,3,33.3,2,5,0,5,3,7,7,0,"https://fbref.com/en/players/244bc2c8/Boulaye-Dia"
2024,"Salernitana","Serie A","Federico Fazio","ARG","DF","37-074",1987,15.1,18,11,14,4,0,8,14,57.1,6,22,19,3,17,35,99,1,"https://fbref.com/en/players/4e358a2d/Federico-Fazio"
2024,"Salernitana","Serie A","Vincenzo Fiorillo","ITA","GK","34-138",1990,4,0,0,0,0,0,0,0,NA,0,0,0,0,0,0,0,1,"https://fbref.com/en/players/a2565f79/Vincenzo-Fiorillo"
2024,"Salernitana","Serie A","Gerardo Fusco","ITA","FW","19-012",2005,0.2,0,0,0,0,0,0,0,NA,0,0,0,0,0,0,0,0,"https://fbref.com/en/players/f83f6de1/Gerardo-Fusco"
2024,"Salernitana","Serie A","Iron Gomis","FRA","MF","24-204",1999,1.5,4,1,2,2,0,0,1,0,1,2,0,2,2,6,2,0,"https://fbref.com/en/players/1d50130f/Iron-Gomis"
2024,"Salernitana","Serie A","Norbert Gyömbér","SVK","DF","31-332",1992,19.6,36,18,30,6,0,20,26,76.9,6,33,23,10,23,59,77,2,"https://fbref.com/en/players/0be276c6/Norbert-Gyomber"
2024,"Salernitana","Serie A","Chukwubuikem Ikwuemesi","NGA","FW","22-299",2001,11.8,3,1,0,2,1,2,6,33.3,4,1,1,0,1,4,8,0,"https://fbref.com/en/players/c6db4f29/Chukwubuikem-Ikwuemesi"
2024,"Salernitana","Serie A","Grigoris Kastanos","CYP","MF,DF","26-121",1998,16.4,23,14,8,9,6,9,20,45,11,13,4,9,8,31,9,0,"https://fbref.com/en/players/2a82aa85/Grigoris-Kastanos"
2024,"Salernitana","Serie A","Matteo Lovato","ITA","DF","24-106",2000,10.5,27,14,17,8,2,16,24,66.7,8,14,7,7,18,45,41,1,"https://fbref.com/en/players/5fa57166/Matteo-Lovato"
2024,"Salernitana","Serie A","Giulio Maggiore","ITA","MF","26-079",1998,20,49,29,26,22,1,20,42,47.6,22,27,5,22,24,73,38,0,"https://fbref.com/en/players/957e4c87/Giulio-Maggiore"
2024,"Salernitana","Serie A","Kostas Manolas","GRE","DF","32-351",1991,5.4,9,5,6,3,0,6,8,75,2,10,7,3,2,11,20,0,"https://fbref.com/en/players/c707411f/Kostas-Manolas"
2024,"Salernitana","Serie A","Agustín Martegani","ARG","MF","24-010",2000,8.1,13,7,7,3,3,6,18,33.3,12,4,1,3,4,17,7,1,"https://fbref.com/en/players/591bf874/Agustin-Martegani"
2024,"Salernitana","Serie A","Pasquale Mazzocchi","ITA","DF","28-308",1995,14.1,25,19,14,10,1,16,29,55.2,13,14,6,8,5,30,31,0,"https://fbref.com/en/players/eb0ec070/Pasquale-Mazzocchi"
2024,"Salernitana","Serie A","Simeon Nwankwo","NGA","FW","32-023",1992,7.6,6,3,0,2,4,1,3,33.3,2,7,0,7,0,6,4,0,"https://fbref.com/en/players/80dbbd10/Simeon-Nwankwo"
2024,"Salernitana","Serie A","Guillermo Ochoa","MEX","GK","38-322",1985,21,0,0,0,0,0,0,1,0,1,0,0,0,0,0,9,1,"https://fbref.com/en/players/1e9bde92/Guillermo-Ochoa"
2024,"Salernitana","Serie A","Triantafyllos Pasaridīs","GRE","DF","27-316",1996,5,11,7,9,2,0,9,14,64.3,5,7,3,4,3,14,19,0,"https://fbref.com/en/players/6416adf0/Triantafyllos-Pasaridis"
2024,"Salernitana","Serie A","Marco Pellegrino","","DF","",NA,6.1,8,6,4,3,1,5,10,50,5,11,6,5,10,18,28,0,"https://fbref.com/en/players/18950a80/Marco-Pellegrino"
2024,"Salernitana","Serie A","Niccolò Pierozzi","ITA","DF","22-261",2001,9.7,17,11,13,4,0,11,22,50,11,24,7,17,11,28,36,0,"https://fbref.com/en/players/3649ece2/Niccolo-Pierozzi"
2024,"Salernitana","Serie A","Lorenzo Pirola","ITA","DF","22-100",2002,22.1,39,23,25,14,0,15,28,53.6,13,46,30,16,25,64,93,1,"https://fbref.com/en/players/caec77da/Lorenzo-Pirola"
2024,"Salernitana","Serie A","Junior Sambia","FRA","DF,MF","27-266",1996,11.5,12,5,8,1,3,6,11,54.5,5,15,7,8,11,23,28,0,"https://fbref.com/en/players/24eb7ed6/Junior-Sambia"
2024,"Salernitana","Serie A","Andres Sfait","ROU","DF,MF","19-173",2004,0.3,1,1,1,0,0,1,2,50,1,0,0,0,0,1,0,0,"https://fbref.com/en/players/4fb7cc15/Andres-Sfait"
2024,"Salernitana","Serie A","Trivante Stewart","JAM","FW,MF","24-069",2000,1.1,0,0,0,0,0,0,0,NA,0,1,0,1,0,0,0,0,"https://fbref.com/en/players/75bd6f48/Trivante-Stewart"
2024,"Salernitana","Serie A","Loum Tchaouna","FRA","FW,MF","20-265",2003,23.3,20,10,5,13,2,10,20,50,10,20,1,19,4,24,16,1,"https://fbref.com/en/players/a3c8b4d3/Loum-Tchaouna"
2024,"Salernitana","Serie A","Emanuel Vignato","ITA","MF,FW","23-280",2000,3.5,10,7,4,5,1,5,6,83.3,1,1,0,1,1,11,7,0,"https://fbref.com/en/players/ec5dae45/Emanuel-Vignato"
2024,"Salernitana","Serie A","Shon Weissman","ISR","FW,DF","28-106",1996,5.5,4,3,2,0,2,0,4,0,4,2,1,1,3,7,4,0,"https://fbref.com/en/players/379dc075/Shon-Weissman"
2024,"Salernitana","Serie A","Alessandro Zanoli","ITA","DF","23-240",2000,10.2,16,13,9,7,0,7,12,58.3,5,10,2,8,1,17,17,0,"https://fbref.com/en/players/3b12b11f/Alessandro-Zanoli"
2024,"Salernitana","Serie A","Mateusz Łęgowski","POL","MF","21-122",2003,12.7,23,12,8,12,3,11,26,42.3,15,13,2,11,7,30,16,0,"https://fbref.com/en/players/75c62731/Mateusz-Legowski"
2024,"Sassuolo","Serie A","Nedim Bajrami","ALB","MF,FW","25-092",1999,14.6,13,6,6,3,4,5,13,38.5,8,5,1,4,6,19,8,0,"https://fbref.com/en/players/f42d6c13/Nedim-Bajrami"
2024,"Sassuolo","Serie A","Domenico Berardi","ITA","FW","29-303",1994,15.9,17,8,7,9,1,2,21,9.5,19,17,0,17,13,30,9,0,"https://fbref.com/en/players/53a0e358/Domenico-Berardi"
2024,"Sassuolo","Serie A","Daniel Boloca","ROU","MF","25-160",1998,22.5,48,33,18,25,5,27,46,58.7,19,23,13,10,14,62,33,2,"https://fbref.com/en/players/85f7ed25/Daniel-Boloca"
2024,"Sassuolo","Serie A","Samu Castillejo","ESP","FW,MF","29-133",1995,6,12,10,5,5,2,7,19,36.8,12,16,1,15,1,13,3,0,"https://fbref.com/en/players/130a7a3f/Samu-Castillejo"
2024,"Sassuolo","Serie A","Emil Ceide","NOR","FW,MF","22-270",2001,2,2,2,1,1,0,1,1,100,0,6,1,5,0,2,0,0,"https://fbref.com/en/players/98a84572/Emil-Ceide"
2024,"Sassuolo","Serie A","Andrea Consigli","ITA","GK","37-124",1987,35,0,0,0,0,0,0,0,NA,0,1,0,1,1,1,19,1,"https://fbref.com/en/players/8cabdc1e/Andrea-Consigli"
2024,"Sassuolo","Serie A","Alessio Cragno","ITA","GK","29-337",1994,3,0,0,0,0,0,0,0,NA,0,0,0,0,0,0,3,1,"https://fbref.com/en/players/f554e29b/Alessio-Cragno"
2024,"Sassuolo","Serie A","Grégoire Defrel","MTQ","FW,MF","32-348",1991,8.4,17,8,7,5,5,7,15,46.7,8,10,0,10,3,20,9,0,"https://fbref.com/en/players/854ee61a/Gregoire-Defrel"
2024,"Sassuolo","Serie A","Josh Doig","SCO","DF","22-012",2002,14.9,25,17,16,9,0,15,27,55.6,12,31,10,21,16,41,38,0,"https://fbref.com/en/players/2f69d881/Josh-Doig"
2024,"Sassuolo","Serie A","Martin Erlic","CRO","DF","26-127",1998,29.1,37,22,26,8,3,20,30,66.7,10,31,16,15,28,65,128,1,"https://fbref.com/en/players/0fee6bda/Martin-Erlic"
2024,"Sassuolo","Serie A","Matheus Henrique","BRA","MF","26-163",1997,27.8,43,29,21,18,4,18,43,41.9,25,18,8,10,25,68,31,6,"https://fbref.com/en/players/a2d9f138/Matheus-Henrique"
2024,"Sassuolo","Serie A","Marash Kumbulla","ALB","DF","24-112",2000,4,3,2,2,1,0,1,2,50,1,8,6,2,0,3,22,0,"https://fbref.com/en/players/a40819d9/Marash-Kumbulla"
2024,"Sassuolo","Serie A","Justin Kumi","ITA","FW","19-319",2004,0,0,0,0,0,0,0,0,NA,0,0,0,0,0,0,0,0,"https://fbref.com/en/players/2d5f2ff0/Justin-Kumi"
2024,"Sassuolo","Serie A","Armand Lauriente","FRA","FW","25-178",1998,32.3,31,20,8,14,9,13,44,29.5,31,29,4,25,15,46,11,0,"https://fbref.com/en/players/2d22cea7/Armand-Lauriente"
2024,"Sassuolo","Serie A","Luca Lipani","ITA","MF","19-012",2005,4.3,9,7,4,3,2,3,11,27.3,8,9,2,7,6,15,7,0,"https://fbref.com/en/players/1dc5a029/Luca-Lipani"
2024,"Sassuolo","Serie A","Maxime Lopez","FRA","MF","26-178",1997,1.6,2,1,1,1,0,1,2,50,1,1,1,0,2,4,0,0,"https://fbref.com/en/players/20094685/Maxime-Lopez"
2024,"Sassuolo","Serie A","Gian Marco Ferrari","ITA","DF","32-105",1992,25.2,22,10,11,11,0,12,18,66.7,6,28,17,11,25,47,76,0,"https://fbref.com/en/players/8650af85/Gian-Marco-Ferrari"
2024,"Sassuolo","Serie A","Kevin Miranda","ITA","DF","21-081",2003,0.2,0,0,0,0,0,0,0,NA,0,0,0,0,0,0,1,0,"https://fbref.com/en/players/9bd97418/Kevin-Miranda"
2024,"Sassuolo","Serie A","Filippo Missori","ITA","DF","20-067",2004,3,6,3,2,4,0,4,11,36.4,7,3,2,1,4,10,8,0,"https://fbref.com/en/players/2d3d7c0d/Filippo-Missori"
2024,"Sassuolo","Serie A","Samuele Mulattieri","ITA","FW,MF","23-236",2000,5.1,1,1,0,0,1,1,2,50,1,7,2,5,1,2,2,0,"https://fbref.com/en/players/30297946/Samuele-Mulattieri"
2024,"Sassuolo","Serie A","Pedro Obiang","EQG","MF","32-064",1992,5,8,4,3,4,1,2,10,20,8,6,4,2,8,16,10,0,"https://fbref.com/en/players/ba1e04b3/Pedro-Obiang"
2024,"Sassuolo","Serie A","Marcus Pedersen","NOR","DF","23-319",2000,17.9,36,24,25,5,6,21,25,84,4,19,5,14,10,46,51,0,"https://fbref.com/en/players/596cc50e/Marcus-Pedersen"
2024,"Sassuolo","Serie A","Andrea Pinamonti","ITA","FW","25-011",1999,34.2,13,8,1,6,6,5,22,22.7,17,19,2,17,1,14,40,0,"https://fbref.com/en/players/08aa9cd1/Andrea-Pinamonti"
2024,"Sassuolo","Serie A","Uroš Račić","SRB","MF","26-074",1998,9.1,10,4,6,4,0,0,9,0,9,16,7,9,7,17,22,0,"https://fbref.com/en/players/faed84db/Uros-Racic"
2024,"Sassuolo","Serie A","Ruan","BRA","DF","24-358",1999,16.8,25,15,11,10,4,10,18,55.6,8,18,15,3,24,49,68,2,"https://fbref.com/en/players/a378a02a/Ruan"
2024,"Sassuolo","Serie A","Kristian Thorstvedt","NOR","MF","25-078",1999,26.6,40,22,7,28,5,22,44,50,22,25,9,16,21,61,36,0,"https://fbref.com/en/players/76ff8d0d/Kristian-Thorstvedt"
2024,"Sassuolo","Serie A","Jeremy Toljan","GER","DF","29-296",1994,23.1,13,10,8,4,1,9,15,60,6,17,5,12,16,29,49,1,"https://fbref.com/en/players/a96e5dc0/Jeremy-Toljan"
2024,"Sassuolo","Serie A","Matías Viña","URU","DF","26-203",1997,11.3,34,21,22,7,5,20,36,55.6,16,12,2,10,9,43,34,0,"https://fbref.com/en/players/08eb3b58/Matias-Vina"
2024,"Sassuolo","Serie A","Mattia Viti","ITA","DF","22-127",2002,10.9,24,15,14,7,3,10,22,45.5,12,20,10,10,10,34,44,0,"https://fbref.com/en/players/75438a9a/Mattia-Viti"
2024,"Sassuolo","Serie A","Cristian Volpato","ITA","MF,FW","20-197",2003,7.2,16,8,9,6,1,9,25,36,16,7,0,7,1,17,5,0,"https://fbref.com/en/players/72f87f25/Cristian-Volpato"
2024,"Sevilla","La Liga","Marcos Acuña","ARG","DF","32-215",1991,14.4,33,21,20,12,1,9,14,64.3,5,12,2,10,4,37,25,0,"https://fbref.com/en/players/81442ecb/Marcos-Acuna"
2024,"Sevilla","La Liga","Lucien Agoume","FRA","MF","22-111",2002,8.6,23,18,7,14,2,9,12,75,3,6,1,5,7,30,8,0,"https://fbref.com/en/players/8bc8829a/Lucien-Agoume"
2024,"Sevilla","La Liga","Loïc Bade","FRA","DF","24-049",2000,25.3,65,41,53,12,0,30,49,61.2,19,23,15,8,38,103,116,2,"https://fbref.com/en/players/114bbdee/Loic-Bade"
2024,"Sevilla","La Liga","Isaac Bernal","ESP","FW","24-012",2000,11.5,6,3,2,2,2,5,9,55.6,4,12,0,12,0,6,11,0,"https://fbref.com/en/players/be719093/Isaac-Bernal"
2024,"Sevilla","La Liga","Yassine Bounou","MAR","GK","33-055",1991,1,0,0,0,0,0,0,0,NA,0,0,0,0,0,0,0,0,"https://fbref.com/en/players/f6798fc3/Yassine-Bounou"
2024,"Sevilla","La Liga","Jesús Corona","MEX","MF,DF","31-145",1993,0.2,0,0,0,0,0,0,0,NA,0,0,0,0,1,1,0,0,"https://fbref.com/en/players/fb938d24/Jesus-Corona"
2024,"Sevilla","La Liga","Marko Dmitrović","SRB","GK","32-127",1992,13,1,1,1,0,0,1,2,50,1,0,0,0,1,2,5,0,"https://fbref.com/en/players/ac295d9e/Marko-Dmitrovic"
2024,"Sevilla","La Liga","Youssef En-Nesyri","MAR","FW","26-364",1997,28.6,10,7,3,4,3,0,10,0,10,9,1,8,7,17,29,1,"https://fbref.com/en/players/04e17fd5/Youssef-En-Nesyri"
2024,"Sevilla","La Liga","Fernando","BRA","MF","36-310",1987,5.1,9,8,2,4,3,5,9,55.6,4,2,0,2,7,16,9,0,"https://fbref.com/en/players/41f32541/Fernando"
2024,"Sevilla","La Liga","Federico Gattoni","ARG","DF,FW","25-104",1999,0.1,1,0,1,0,0,1,1,100,0,0,0,0,0,1,1,0,"https://fbref.com/en/players/86087757/Federico-Gattoni"
2024,"Sevilla","La Liga","Nemanja Gudelj","SRB","DF,MF","32-196",1991,19.4,31,24,18,10,3,17,31,54.8,14,17,9,8,27,58,56,0,"https://fbref.com/en/players/0076ab7f/Nemanja-Gudelj"
2024,"Sevilla","La Liga","Diego Iturralde","ESP","DF","21-044",2003,0.4,0,0,0,0,0,0,0,NA,0,1,1,0,0,0,2,0,"https://fbref.com/en/players/9d33c71a/Diego-Iturralde"
2024,"Sevilla","La Liga","Adnan Januzaj","BEL","FW,MF","29-115",1995,2.1,3,3,2,0,1,0,1,0,1,2,0,2,1,4,0,0,"https://fbref.com/en/players/4737cebe/Adnan-Januzaj"
2024,"Sevilla","La Liga","Joan Jordán","ESP","MF","29-329",1994,4.2,8,7,3,3,2,7,15,46.7,8,4,2,2,4,12,2,0,"https://fbref.com/en/players/2a0c8ba4/Joan-Jordan"
2024,"Sevilla","La Liga","Érik Lamela","ARG","FW,MF","32-087",1992,5.1,21,14,4,10,7,10,15,66.7,5,12,0,12,1,22,5,0,"https://fbref.com/en/players/abe66106/Erik-Lamela"
2024,"Sevilla","La Liga","Dodi Lukebakio","BEL","FW,MF","26-249",1997,12.5,5,2,2,2,1,1,6,16.7,5,9,2,7,2,7,5,0,"https://fbref.com/en/players/0c61c77c/Dodi-Lukebakio"
2024,"Sevilla","La Liga","Marcão","BRA","DF","27-360",1996,3.9,9,6,5,4,0,6,10,60,4,8,6,2,4,13,11,1,"https://fbref.com/en/players/133faa84/Marcao"
2024,"Sevilla","La Liga","Mariano","DOM","FW,MF","30-303",1993,2.7,1,1,0,1,0,0,1,0,1,1,0,1,0,1,2,0,"https://fbref.com/en/players/5c4dc0ff/Mariano"
2024,"Sevilla","La Liga","Hannibal Mejbri","TUN","MF","21-130",2003,1.2,3,3,1,2,0,0,1,0,1,1,0,1,0,3,0,0,"https://fbref.com/en/players/ca22ccb0/Hannibal-Mejbri"
2024,"Sevilla","La Liga","Rafa Mir","ESP","FW,MF","26-347",1997,4.3,2,2,1,1,0,1,2,50,1,2,0,2,1,3,1,0,"https://fbref.com/en/players/bbf5c11b/Rafa-Mir"
2024,"Sevilla","La Liga","Jesús Navas","ESP","DF","38-191",1985,22.3,37,27,21,14,2,22,40,55,18,15,7,8,22,59,48,0,"https://fbref.com/en/players/3f10bd22/Jesus-Navas"
2024,"Sevilla","La Liga","Tanguy Nianzou","FRA","DF","21-358",2002,3.5,12,8,9,2,1,8,11,72.7,3,2,0,2,3,15,9,1,"https://fbref.com/en/players/5853ac44/Tanguy-Nianzou"
2024,"Sevilla","La Liga","Ørjan Nyland","NOR","GK","33-263",1990,24,0,0,0,0,0,0,1,0,1,0,0,0,0,0,9,1,"https://fbref.com/en/players/bdedffac/Orjan-Nyland"
2024,"Sevilla","La Liga","Lucas Ocampos","ARG","FW,MF","29-324",1994,31.9,66,47,22,27,17,29,58,50,29,34,1,33,21,87,29,0,"https://fbref.com/en/players/a08b974a/Lucas-Ocampos"
2024,"Sevilla","La Liga","Adrià Pedrosa","ESP","DF","26-017",1998,19.5,46,26,28,14,4,23,34,67.6,11,26,6,20,15,61,54,0,"https://fbref.com/en/players/112521d1/Adria-Pedrosa"
2024,"Sevilla","La Liga","Ivan Rakitić","CRO","MF","36-081",1988,15.8,30,16,9,12,9,11,19,57.9,8,16,5,11,14,44,12,0,"https://fbref.com/en/players/89f951b5/Ivan-Rakitic"
2024,"Sevilla","La Liga","Sergio Ramos","ESP","DF","38-061",1986,28,45,30,32,11,2,27,40,67.5,13,35,30,5,41,86,156,0,"https://fbref.com/en/players/08511d65/Sergio-Ramos"
2024,"Sevilla","La Liga","Kike Salas","ESP","DF","22-037",2002,17.8,41,23,26,12,3,22,36,61.1,14,25,14,11,26,67,91,1,"https://fbref.com/en/players/0a69de7b/Kike-Salas"
2024,"Sevilla","La Liga","Juanlu Sánchez","ESP","DF","20-289",2003,13.1,56,35,34,18,4,34,58,58.6,24,24,7,17,12,68,36,0,"https://fbref.com/en/players/cc6de655/Juanlu-Sanchez"
2024,"Sevilla","La Liga","Manuel Sebastián","ESP","MF","19-308",2004,1.3,4,2,4,0,0,3,3,100,0,3,0,3,0,4,1,0,"https://fbref.com/en/players/c5642098/Manuel-Sebastian"
2024,"Sevilla","La Liga","Boubakary Soumaré","FRA","MF","25-093",1999,25.4,39,28,24,14,1,14,26,53.8,12,25,7,18,26,65,20,1,"https://fbref.com/en/players/ae59b359/Boubakary-Soumare"
2024,"Sevilla","La Liga","Djibril Sow","SUI","MF","27-114",1997,16.2,28,21,15,8,5,9,25,36,16,20,3,17,17,45,8,1,"https://fbref.com/en/players/4c6facae/Djibril-Sow"
2024,"Sevilla","La Liga","Suso","ESP","MF,FW","30-193",1993,16.9,24,17,14,8,2,8,28,28.6,20,9,0,9,5,29,4,0,"https://fbref.com/en/players/4e219ad2/Suso"
2024,"Sevilla","La Liga","Óliver Torres","ESP","MF","29-202",1994,18,37,22,17,15,5,22,57,38.6,35,40,4,36,6,43,6,0,"https://fbref.com/en/players/58a9a4d9/Oliver-Torres"
2024,"Sevilla","La Liga","Alejo Véliz","ARG","FW","20-254",2003,0.4,1,0,0,1,0,1,2,50,1,0,0,0,0,1,1,0,"https://fbref.com/en/players/3f7bafbe/Alejo-Veliz"
2024,"Sheffield Utd","Premier League","Bénie Adama Traore","CIV","FW,MF","21-182",2002,4.3,4,2,1,2,1,0,4,0,4,4,1,3,1,5,1,0,"https://fbref.com/en/players/77816c91/Benie-Adama-Traore"
2024,"Sheffield Utd","Premier League","Anel Ahmedhodžić","BIH","DF","25-065",1999,29.4,64,36,48,14,2,30,49,61.2,19,43,26,17,35,99,137,2,"https://fbref.com/en/players/eab957a3/Anel-Ahmedhodzic"
2024,"Sheffield Utd","Premier League","Oliver Arblaster","ENG","MF","20-025",2004,10.5,23,14,11,8,4,7,15,46.7,8,17,7,10,15,38,9,0,"https://fbref.com/en/players/afe1a491/Oliver-Arblaster"
2024,"Sheffield Utd","Premier League","Cameron Archer","ENG","FW,MF","22-314",2001,20.4,18,13,6,6,6,8,18,44.4,10,22,3,19,1,19,11,0,"https://fbref.com/en/players/05e8ca6d/Cameron-Archer"
2024,"Sheffield Utd","Premier League","George Baldock","GRE","DF","31-082",1993,10.8,18,10,10,7,1,6,15,40,9,14,8,6,10,28,33,0,"https://fbref.com/en/players/394854c4/George-Baldock"
2024,"Sheffield Utd","Premier League","Chris Basham","ENG","DF,MF","35-315",1988,3.6,7,2,4,3,0,2,9,22.2,7,9,4,5,5,12,17,0,"https://fbref.com/en/players/1aa84968/Chris-Basham"
2024,"Sheffield Utd","Premier League","Anis Ben Slimane","TUN","MF","23-075",2001,4.7,11,6,5,2,4,4,10,40,6,7,1,6,5,16,7,0,"https://fbref.com/en/players/9ade9ce1/Anis-Ben-Slimane"
2024,"Sheffield Utd","Premier League","Jayden Bogle","ENG","DF","23-308",2000,31,66,36,43,21,2,35,70,50,35,42,11,31,32,98,97,0,"https://fbref.com/en/players/ae5019e6/Jayden-Bogle"
2024,"Sheffield Utd","Premier League","Ben Brereton","CHI","FW,MF","25-042",1999,12.3,9,4,4,4,1,4,10,40,6,9,3,6,3,12,12,0,"https://fbref.com/en/players/57827369/Ben-Brereton"
2024,"Sheffield Utd","Premier League","Rhian Brewster","ENG","FW,MF","24-059",2000,3.8,5,1,1,2,2,0,2,0,2,2,0,2,1,6,2,0,"https://fbref.com/en/players/30e81a88/Rhian-Brewster"
2024,"Sheffield Utd","Premier League","Andre Brooks","ENG","MF,DF","20-284",2003,10.4,22,13,7,11,4,9,21,42.9,12,13,1,12,14,36,20,0,"https://fbref.com/en/players/5f346071/Andre-Brooks"
2024,"Sheffield Utd","Premier League","Sam Curtis","IRL","DF","18-181",2005,0.3,1,0,1,0,0,1,2,50,1,2,0,2,0,1,0,0,"https://fbref.com/en/players/7d42865e/Sam-Curtis"
2024,"Sheffield Utd","Premier League","Tom Davies","ENG","MF","25-335",1998,2.5,10,5,4,3,3,3,9,33.3,6,2,1,1,3,13,6,1,"https://fbref.com/en/players/9228b07c/Tom-Davies"
2024,"Sheffield Utd","Premier League","John Egan","IRL","DF","31-223",1992,5.4,6,4,4,2,0,4,11,36.4,7,10,4,6,13,19,39,1,"https://fbref.com/en/players/debe38a0/John-Egan"
2024,"Sheffield Utd","Premier League","John Fleck","SCO","MF,DF","32-280",1991,1,1,0,0,1,0,0,1,0,1,0,0,0,0,1,1,0,"https://fbref.com/en/players/b63e789d/John-Fleck"
2024,"Sheffield Utd","Premier League","Wes Foderingham","ENG","GK","33-137",1991,29.4,5,3,5,0,0,5,6,83.3,1,0,0,0,0,5,18,6,"https://fbref.com/en/players/96cf7b61/Wes-Foderingham"
2024,"Sheffield Utd","Premier League","Ivo Grbić","CRO","GK","28-133",1996,8.6,0,0,0,0,0,0,1,0,1,1,0,1,0,0,9,1,"https://fbref.com/en/players/3f034750/Ivo-Grbic"
2024,"Sheffield Utd","Premier League","Antwoine Hackford","ENG","FW","20-071",2004,0.1,0,0,0,0,0,0,0,NA,0,0,0,0,0,0,0,0,"https://fbref.com/en/players/a7588cdc/Antwoine-Hackford"
2024,"Sheffield Utd","Premier League","Gustavo Hamer","NED","MF","26-341",1997,32.3,39,21,17,15,7,16,59,27.1,43,33,9,24,29,68,35,0,"https://fbref.com/en/players/eebacc07/Gustavo-Hamer"
2024,"Sheffield Utd","Premier League","Mason Holgate","ENG","DF","27-221",1996,7.9,12,7,5,6,1,5,12,41.7,7,12,5,7,11,23,40,0,"https://fbref.com/en/players/d0042ab9/Mason-Holgate"
2024,"Sheffield Utd","Premier League","Daniel Jebbison","ENG","FW","20-291",2003,0.2,0,0,0,0,0,0,0,NA,0,1,0,1,0,0,0,0,"https://fbref.com/en/players/03edb878/Daniel-Jebbison"
2024,"Sheffield Utd","Premier League","Yasser Larouci","ALG","DF","23-150",2001,5.9,17,9,10,5,2,10,14,71.4,4,6,1,5,7,24,20,1,"https://fbref.com/en/players/0ed063d6/Yasser-Larouci"
2024,"Sheffield Utd","Premier League","Max Lowe","ENG","DF,MF","27-019",1997,5.6,21,10,13,5,3,8,15,53.3,7,10,4,6,5,26,15,0,"https://fbref.com/en/players/7af88b33/Max-Lowe"
2024,"Sheffield Utd","Premier League","James Mcatee","ENG","MF,FW","21-225",2002,20.2,32,21,9,13,10,13,33,39.4,20,20,0,20,11,43,18,0,"https://fbref.com/en/players/96593e89/James-Mcatee"
2024,"Sheffield Utd","Premier League","Oliver McBurnie","SCO","FW","27-361",1996,14.2,17,7,4,7,6,5,12,41.7,7,18,2,16,5,22,28,0,"https://fbref.com/en/players/78b8ac63/Oliver-McBurnie"
2024,"Sheffield Utd","Premier League","Rhys Norrington-Davies","WAL","DF","25-038",1999,1.2,1,1,1,0,0,0,1,0,1,2,0,2,1,2,2,0,"https://fbref.com/en/players/ca76b087/Rhys-Norrington-Davies"
2024,"Sheffield Utd","Premier League","Oliver Norwood","NIR","MF","33-048",1991,16,41,26,18,18,5,20,47,42.6,27,24,9,15,21,62,39,0,"https://fbref.com/en/players/43439614/Oliver-Norwood"
2024,"Sheffield Utd","Premier League","Ryan One","SCO","FW","17-339",2006,0.1,0,0,0,0,0,0,0,NA,0,0,0,0,0,0,0,0,"https://fbref.com/en/players/d4aa4582/Ryan-One"
2024,"Sheffield Utd","Premier League","Ben Osborn","ENG","DF,MF","29-299",1994,15.2,22,9,11,9,2,8,17,47.1,9,18,2,16,8,30,30,0,"https://fbref.com/en/players/79bc4c45/Ben-Osborn"
2024,"Sheffield Utd","Premier League","William Osula","DEN","FW","20-300",2003,8.7,2,2,1,0,1,1,2,50,1,3,1,2,2,4,9,0,"https://fbref.com/en/players/7b355808/William-Osula"
2024,"Sheffield Utd","Premier League","Sydie Peck","ENG","MF","19-260",2004,0.1,0,0,0,0,0,0,0,NA,0,0,0,0,0,0,0,0,"https://fbref.com/en/players/767d9605/Sydie-Peck"
2024,"Sheffield Utd","Premier League","Jack Robinson","ENG","DF","30-272",1993,32.1,43,28,29,14,0,25,39,64.1,14,49,33,16,33,76,132,2,"https://fbref.com/en/players/7399c7a8/Jack-Robinson"
2024,"Sheffield Utd","Premier League","Vinicius Souza","BRA","MF","24-348",1999,29.6,125,76,59,51,15,41,74,55.4,33,57,17,40,32,157,75,1,"https://fbref.com/en/players/6a8a7af8/Vinicius-Souza"
2024,"Sheffield Utd","Premier League","Luke Thomas","ENG","DF","22-355",2001,10.2,20,9,13,6,1,8,14,57.1,6,23,5,18,10,30,27,0,"https://fbref.com/en/players/fc027d02/Luke-Thomas"
2024,"Sheffield Utd","Premier League","Auston Trusty","USA","DF","25-292",1998,28.6,47,30,31,13,3,21,43,48.8,22,41,22,19,35,82,153,3,"https://fbref.com/en/players/cddf767b/Auston-Trusty"
2024,"Strasbourg","Ligue 1","Aboubacar Ali","FRA","MF,FW","18-058",2006,1.4,2,0,0,2,0,0,0,NA,0,1,0,1,1,3,2,0,"https://fbref.com/en/players/133d2aa5/Aboubacar-Ali"
2024,"Strasbourg","Ligue 1","Dilane Bakwa","FRA","FW,MF","21-278",2002,24.2,30,22,12,13,5,11,40,27.5,29,26,1,25,20,50,11,0,"https://fbref.com/en/players/2b5a35e5/Dilane-Bakwa"
2024,"Strasbourg","Ligue 1","Steven Baseya","FRA","DF","19-137",2005,0.1,2,1,1,1,0,1,1,100,0,0,0,0,0,2,1,0,"https://fbref.com/en/players/a329a732/Steven-Baseya"
2024,"Strasbourg","Ligue 1","Mohamed Bechikh","FRA","FW,MF","18-322",2005,0.2,0,0,0,0,0,0,0,NA,0,0,0,0,0,0,0,0,"https://fbref.com/en/players/548756f2/Mohamed-Bechikh"
2024,"Strasbourg","Ligue 1","Alaa Bellaarouch","MAR","GK","22-150",2002,15,0,0,0,0,0,0,0,NA,0,0,0,0,1,1,11,2,"https://fbref.com/en/players/0595569d/Alaa-Bellaarouch"
2024,"Strasbourg","Ligue 1","Jean-Ricner Bellegarde","FRA","MF,FW","25-338",1998,3,5,3,3,2,0,3,6,50,3,4,0,4,4,9,0,0,"https://fbref.com/en/players/10f0fdd3/Jean-Ricner-Bellegarde"
2024,"Strasbourg","Ligue 1","Ângelo Borges","BRA","FW,MF","19-161",2004,12.2,24,11,9,7,8,11,31,35.5,20,18,0,18,9,33,2,0,"https://fbref.com/en/players/737945d9/Angelo-Borges"
2024,"Strasbourg","Ligue 1","Thomas Delaine","FRA","DF,MF","32-067",1992,22.7,38,19,29,8,1,20,42,47.6,22,18,2,16,17,55,51,0,"https://fbref.com/en/players/8332db56/Thomas-Delaine"
2024,"Strasbourg","Ligue 1","Jessy Deminguet","FRA","MF,FW","26-144",1998,7.7,14,9,6,8,0,6,18,33.3,12,8,0,8,9,23,5,1,"https://fbref.com/en/players/a6138e4a/Jessy-Deminguet"
2024,"Strasbourg","Ligue 1","Habib Diarra","SEN","MF,FW","20-148",2004,25.6,30,23,8,20,2,9,33,27.3,24,23,4,19,17,47,15,0,"https://fbref.com/en/players/6d0fe035/Habib-Diarra"
2024,"Strasbourg","Ligue 1","Ismaël Doukouré","FRA","MF,DF","20-311",2003,18.4,23,16,7,14,2,13,21,61.9,8,19,7,12,19,42,29,2,"https://fbref.com/en/players/0512a60a/Ismael-Doukoure"
2024,"Strasbourg","Ligue 1","Emanuel Emegha","NED","FW","21-117",2003,23.1,8,5,2,4,2,4,9,44.4,5,13,3,10,2,10,25,0,"https://fbref.com/en/players/a0c590b9/Emanuel-Emegha"
2024,"Strasbourg","Ligue 1","Kévin Gameiro","FRA","FW,MF","37-021",1987,15,10,10,5,3,2,2,17,11.8,15,9,0,9,3,13,7,0,"https://fbref.com/en/players/42276181/Kevin-Gameiro"
2024,"Strasbourg","Ligue 1","Frederic Guilbert","FRA","DF,MF","29-158",1994,27.7,87,50,49,30,8,47,72,65.3,25,39,10,29,71,158,99,1,"https://fbref.com/en/players/5d8d7454/Frederic-Guilbert"
2024,"Strasbourg","Ligue 1","Dion Moise Sahi","CIV","MF,FW","22-162",2001,7,5,5,1,2,2,0,3,0,3,11,1,10,1,6,7,0,"https://fbref.com/en/players/cdc4458b/Dion-Moise-Sahi"
2024,"Strasbourg","Ligue 1","Lebo Mothiba","RSA","FW","28-123",1996,6.9,5,2,1,4,0,3,4,75,1,6,1,5,0,5,11,0,"https://fbref.com/en/players/3eaf8817/Lebo-Mothiba"
2024,"Strasbourg","Ligue 1","Junior Mwanga","FRA","MF,FW","21-019",2003,16.1,40,20,23,12,5,12,24,50,12,20,5,15,18,58,19,0,"https://fbref.com/en/players/ee158be5/Junior-Mwanga"
2024,"Strasbourg","Ligue 1","Gerzino Nyamsi","FRA","DF","27-129",1997,12.1,18,14,13,5,0,12,18,66.7,6,19,11,8,10,28,43,0,"https://fbref.com/en/players/6043997c/Gerzino-Nyamsi"
2024,"Strasbourg","Ligue 1","Rabby Nzingoula","CGO","MF,FW","18-187",2005,1.5,3,3,0,3,0,3,4,75,1,4,0,4,5,8,0,0,"https://fbref.com/en/players/627c7a3d/Rabby-Nzingoula"
2024,"Strasbourg","Ligue 1","Patrick Ouotro","CIV","FW","18-260",2005,0.1,0,0,0,0,0,0,0,NA,0,0,0,0,0,0,0,0,"https://fbref.com/en/players/28e85bea/Patrick-Ouotro"
2024,"Strasbourg","Ligue 1","Lucas Perrin","FRA","DF","25-193",1998,30.3,47,30,33,14,0,28,46,60.9,18,45,32,13,28,75,113,0,"https://fbref.com/en/players/49070d66/Lucas-Perrin"
2024,"Strasbourg","Ligue 1","Sanjin Prcić","BIH","MF","30-192",1993,1,0,0,0,0,0,0,1,0,1,2,1,1,3,3,1,0,"https://fbref.com/en/players/51c30111/Sanjin-Prcic"
2024,"Strasbourg","Ligue 1","Andrey Santos","BRA","MF","20-027",2004,9.2,29,18,15,13,1,17,26,65.4,9,8,0,8,10,39,11,1,"https://fbref.com/en/players/dd745366/Andrey-Santos"
2024,"Strasbourg","Ligue 1","Jérémy Sebas","MTQ","FW,MF","21-046",2003,4.4,7,1,2,3,2,3,5,60,2,3,1,2,1,8,1,0,"https://fbref.com/en/players/0b6911e4/Jeremy-Sebas"
2024,"Strasbourg","Ligue 1","Matz Sels","BEL","GK","32-094",1992,19,0,0,0,0,0,0,0,NA,0,2,0,2,0,0,13,1,"https://fbref.com/en/players/834b5c4c/Matz-Sels"
2024,"Strasbourg","Ligue 1","Marvin Senaya","TOG","DF,MF","23-123",2001,23.8,72,53,38,25,9,42,68,61.8,26,40,13,27,41,113,68,0,"https://fbref.com/en/players/1d383c10/Marvin-Senaya"
2024,"Strasbourg","Ligue 1","Ibrahima Sissoko","MLI","MF","26-216",1997,18.2,47,33,13,25,9,23,30,76.7,7,21,8,13,19,66,30,0,"https://fbref.com/en/players/0f8418aa/Ibrahima-Sissoko"
2024,"Strasbourg","Ligue 1","Eduard Sobol","UKR","DF","29-040",1995,0.3,0,0,0,0,0,0,0,NA,0,0,0,0,0,0,1,0,"https://fbref.com/en/players/2ccd89a3/Eduard-Sobol"
2024,"Strasbourg","Ligue 1","Saidou Sow","GUI","DF","21-331",2002,8,20,12,17,3,0,9,13,69.2,4,7,4,3,12,32,36,3,"https://fbref.com/en/players/f6b94e8d/Saidou-Sow"
2024,"Strasbourg","Ligue 1","Abakar Sylla","CIV","DF","21-157",2002,19.9,54,23,30,19,5,29,40,72.5,11,40,11,29,26,80,70,2,"https://fbref.com/en/players/29c91632/Abakar-Sylla"
2024,"Stuttgart","Bundesliga","Waldemar Anton","GER","DF","27-315",1996,32.1,39,25,21,16,2,23,42,54.8,19,33,20,13,40,79,150,1,"https://fbref.com/en/players/5e66fa06/Waldemar-Anton"
2024,"Stuttgart","Bundesliga","Fabian Bredlow","GER","GK","29-089",1995,4,0,0,0,0,0,0,1,0,1,0,0,0,0,0,3,0,"https://fbref.com/en/players/d28339cb/Fabian-Bredlow"
2024,"Stuttgart","Bundesliga","Mahmoud Dahoud","GER","MF","28-150",1996,2.5,5,1,1,4,0,3,7,42.9,4,4,0,4,0,5,1,0,"https://fbref.com/en/players/db4ed67b/Mahmoud-Dahoud"
2024,"Stuttgart","Bundesliga","Samuele Di Benedetto","GER","MF","18-319",2005,0.1,0,0,0,0,0,0,0,NA,0,0,0,0,1,1,0,0,"https://fbref.com/en/players/7c254c75/Samuele-Di-Benedetto"
2024,"Stuttgart","Bundesliga","Lilian Egloff","GER","MF,DF","21-284",2002,1.2,4,1,3,1,0,2,4,50,2,3,1,2,1,5,0,0,"https://fbref.com/en/players/2f7fec15/Lilian-Egloff"
2024,"Stuttgart","Bundesliga","Chris Führich","GER","FW,MF","26-142",1998,28.5,30,19,6,14,10,16,37,43.2,21,31,0,31,7,37,7,0,"https://fbref.com/en/players/0cf778df/Chris-Fuhrich"
2024,"Stuttgart","Bundesliga","Serhou Guirassy","GUI","FW","28-079",1996,24.5,6,3,1,4,1,2,5,40,3,8,1,7,6,12,29,0,"https://fbref.com/en/players/923f4dda/Serhou-Guirassy"
2024,"Stuttgart","Bundesliga","Genki Haraguchi","JPN","MF","33-021",1991,0.3,1,1,1,0,0,0,0,NA,0,0,0,0,0,1,1,0,"https://fbref.com/en/players/f24ea523/Genki-Haraguchi"
2024,"Stuttgart","Bundesliga","Hiroki Ito","JPN","DF","25-018",1999,24.8,19,18,13,6,0,11,26,42.3,15,29,17,12,29,48,86,2,"https://fbref.com/en/players/204dded0/Hiroki-Ito"
2024,"Stuttgart","Bundesliga","Atakan Karazor","GER","MF","27-230",1996,29.1,72,44,23,38,11,29,60,48.3,31,37,8,29,27,99,43,0,"https://fbref.com/en/players/5762be5c/Atakan-Karazor"
2024,"Stuttgart","Bundesliga","Silas Katompa","COD","FW,MF","25-237",1998,10,5,3,3,2,0,3,12,25,9,9,0,9,0,5,4,0,"https://fbref.com/en/players/de4cac2d/Silas-Katompa"
2024,"Stuttgart","Bundesliga","Jamie Leweling","GER","FW,MF","23-094",2001,16.9,18,10,4,6,8,5,17,29.4,12,21,1,20,5,23,13,0,"https://fbref.com/en/players/13fe7b69/Jamie-Leweling"
2024,"Stuttgart","Bundesliga","Roberto Massimo","GER","FW,DF","23-231",2000,0.9,1,0,1,0,0,1,2,50,1,0,0,0,0,1,1,0,"https://fbref.com/en/players/fc62fdf4/Roberto-Massimo"
2024,"Stuttgart","Bundesliga","Enzo Millot","FRA","MF,FW","21-318",2002,24.9,40,22,9,21,10,18,39,46.2,21,24,2,22,16,56,7,1,"https://fbref.com/en/players/f76022e7/Enzo-Millot"
2024,"Stuttgart","Bundesliga","Jovan Milošević","SRB","FW,MF","18-304",2005,0.3,0,0,0,0,0,0,0,NA,0,0,0,0,0,0,0,0,"https://fbref.com/en/players/fdbe14c8/Jovan-Milosevic"
2024,"Stuttgart","Bundesliga","Maximilian Mittelstädt","GER","DF","27-073",1997,23.4,91,51,46,39,6,53,89,59.6,36,36,6,30,46,137,65,0,"https://fbref.com/en/players/88d4144a/Maximilian-Mittelstadt"
2024,"Stuttgart","Bundesliga","Alexander Nübel","GER","GK","27-243",1996,30,2,2,2,0,0,2,4,50,2,0,0,0,0,2,13,4,"https://fbref.com/en/players/afb0c500/Alexander-Nubel"
2024,"Stuttgart","Bundesliga","Luca Raimund","GER","FW,MF","19-051",2005,0.3,3,1,2,1,0,0,0,NA,0,2,0,2,0,3,0,0,"https://fbref.com/en/players/df1665d7/Luca-Raimund"
2024,"Stuttgart","Bundesliga","Anthony Rouault","FRA","DF","23-001",2001,11.2,21,12,14,5,2,13,21,61.9,8,14,8,6,8,29,28,0,"https://fbref.com/en/players/9b545925/Anthony-Rouault"
2024,"Stuttgart","Bundesliga","Borna Sosa","CRO","FW,DF","26-130",1998,0.5,0,0,0,0,0,0,1,0,1,0,0,0,0,0,0,0,"https://fbref.com/en/players/af0d79a9/Borna-Sosa"
2024,"Stuttgart","Bundesliga","Pascal Stenzel","GER","DF","28-071",1996,11.8,18,8,7,9,2,10,30,33.3,20,22,8,14,15,33,26,0,"https://fbref.com/en/players/99f7e9aa/Pascal-Stenzel"
2024,"Stuttgart","Bundesliga","Leonidas Stergiou","SUI","DF","22-088",2002,6.6,15,8,7,7,1,9,13,69.2,4,8,1,7,5,20,13,0,"https://fbref.com/en/players/08391d76/Leonidas-Stergiou"
2024,"Stuttgart","Bundesliga","Angelo Stiller","GER","MF","23-056",2001,29.9,55,33,15,34,6,24,42,57.1,18,41,13,28,28,83,25,2,"https://fbref.com/en/players/3b1ed320/Angelo-Stiller"
2024,"Stuttgart","Bundesliga","Deniz Undav","GER","FW,MF","27-316",1996,23.2,28,13,6,8,14,4,15,26.7,11,17,0,17,6,34,5,0,"https://fbref.com/en/players/dd549382/Deniz-Undav"
2024,"Stuttgart","Bundesliga","Josha Vagnoman","GER","DF","23-171",2000,13.1,28,18,15,11,2,15,30,50,15,11,5,6,2,30,16,1,"https://fbref.com/en/players/fb377d11/Josha-Vagnoman"
2024,"Stuttgart","Bundesliga","Jeong Woo-yeong","KOR","MF,FW","24-253",1999,7,15,9,6,8,1,6,8,75,2,5,0,5,7,22,5,0,"https://fbref.com/en/players/6190474d/Jeong-Woo-yeong"
2024,"Stuttgart","Bundesliga","Dan-Axel Zagadou","FRA","DF","24-362",1999,16.1,21,14,16,5,0,4,8,50,4,23,18,5,20,41,78,1,"https://fbref.com/en/players/a4effc55/Dan-Axel-Zagadou"
2024,"Torino","Serie A","Raoul Bellanova","ITA","DF","24-013",2000,33.8,36,26,15,17,4,18,31,58.1,13,21,4,17,15,51,36,3,"https://fbref.com/en/players/e3756e72/Raoul-Bellanova"
2024,"Torino","Serie A","Alessandro Buongiorno","ITA","DF","24-359",1999,28.1,70,39,43,24,3,24,34,70.6,10,20,12,8,69,139,131,0,"https://fbref.com/en/players/4ae67f27/Alessandro-Buongiorno"
2024,"Torino","Serie A","Alessandro Dellavalle","ITA","DF","20-019",2004,0.2,0,0,0,0,0,0,0,NA,0,1,1,0,1,1,0,0,"https://fbref.com/en/players/227f25be/Alessandro-Dellavalle"
2024,"Torino","Serie A","Koffi Djidji","CIV","DF","31-182",1992,8.4,14,9,9,5,0,3,4,75,1,10,5,5,10,24,20,0,"https://fbref.com/en/players/933d3b51/Koffi-Djidji"
2024,"Torino","Serie A","Luca Gemello","ITA","GK","23-332",2000,2,0,0,0,0,0,0,1,0,1,0,0,0,0,0,1,1,"https://fbref.com/en/players/53e494ec/Luca-Gemello"
2024,"Torino","Serie A","Gvidas Gineitis","LTU","MF","20-045",2004,6,11,7,3,8,0,4,7,57.1,3,10,4,6,4,15,9,1,"https://fbref.com/en/players/548bd0de/Gvidas-Gineitis"
2024,"Torino","Serie A","Ivan Ilić","SRB","MF","23-074",2001,23.3,22,8,9,10,3,13,27,48.1,14,20,7,13,20,42,31,0,"https://fbref.com/en/players/bb376bed/Ivan-Ilic"
2024,"Torino","Serie A","Yann Karamoh","FRA","MF,FW","25-327",1998,1.8,1,0,0,0,1,0,0,NA,0,0,0,0,0,1,1,0,"https://fbref.com/en/players/8b66d9cc/Yann-Karamoh"
2024,"Torino","Serie A","Valentino Lazaro","AUT","DF,MF","28-067",1996,22.2,18,11,7,9,2,13,19,68.4,6,14,1,13,8,26,29,0,"https://fbref.com/en/players/016ff750/Valentino-Lazaro"
2024,"Torino","Serie A","Karol Linetty","POL","MF","29-118",1995,20.6,30,21,9,20,1,9,29,31,20,24,8,16,23,53,27,1,"https://fbref.com/en/players/d023d70f/Karol-Linetty"
2024,"Torino","Serie A","Matteo Lovato","ITA","DF","24-106",2000,6,10,7,5,5,0,4,5,80,1,9,5,4,13,23,10,0,"https://fbref.com/en/players/5fa57166/Matteo-Lovato"
2024,"Torino","Serie A","Adam Masina","MAR","DF","30-149",1994,11.4,17,12,8,8,1,5,20,25,15,12,6,6,11,28,30,0,"https://fbref.com/en/players/de0f152c/Adam-Masina"
2024,"Torino","Serie A","Vanja Milinković-Savić","SRB","GK","27-100",1997,36,1,0,1,0,0,1,1,100,0,0,0,0,1,2,14,4,"https://fbref.com/en/players/9fa26bc2/Vanja-Milinkovic-Savic"
2024,"Torino","Serie A","David Okereke","NGA","FW,MF","26-275",1997,2.8,3,1,1,1,1,0,3,0,3,2,0,2,1,4,0,0,"https://fbref.com/en/players/d125f22f/David-Okereke"
2024,"Torino","Serie A","Pietro Pellegri","ITA","FW","23-074",2001,8.4,5,1,1,4,0,1,5,20,4,4,1,3,2,7,3,0,"https://fbref.com/en/players/a44d3a3c/Pietro-Pellegri"
2024,"Torino","Serie A","Nemanja Radonjić","SRB","MF,FW","28-105",1996,4.2,1,1,0,0,1,1,3,33.3,2,3,0,3,0,1,0,0,"https://fbref.com/en/players/0630eb63/Nemanja-Radonjic"
2024,"Torino","Serie A","Samuele Ricci","ITA","MF","22-283",2001,26.6,33,18,17,12,4,15,23,65.2,8,21,3,18,27,60,25,0,"https://fbref.com/en/players/9823be92/Samuele-Ricci"
2024,"Torino","Serie A","Ricardo Rodríguez","SUI","DF","31-279",1992,30.8,45,26,21,22,2,28,45,62.2,17,22,9,13,24,69,64,2,"https://fbref.com/en/players/7f78ad23/Ricardo-Rodriguez"
2024,"Torino","Serie A","Antonio Sanabria","PAR","FW,MF","28-087",1996,23.7,18,15,5,9,4,4,9,44.4,5,7,1,6,6,24,12,0,"https://fbref.com/en/players/0a447501/Antonio-Sanabria"
2024,"Torino","Serie A","Zanos Savva","CYP","DF,MF","18-186",2005,0.3,1,1,0,1,0,1,3,33.3,2,0,0,0,0,1,1,0,"https://fbref.com/en/players/82f8d2f4/Zanos-Savva"
2024,"Torino","Serie A","Saba Sazonov","GEO","DF","22-119",2002,4,9,7,4,5,0,3,3,100,0,8,5,3,3,12,22,0,"https://fbref.com/en/players/645dffbf/Saba-Sazonov"
2024,"Torino","Serie A","Perr Schuurs","NED","DF","24-186",1999,8.6,20,12,11,8,1,3,9,33.3,6,10,2,8,9,29,23,0,"https://fbref.com/en/players/e613313c/Perr-Schuurs"
2024,"Torino","Serie A","Demba Seck","SEN","MF","23-110",2001,4.7,5,3,1,4,0,3,4,75,1,1,0,1,1,6,0,0,"https://fbref.com/en/players/16463a79/Demba-Seck"
2024,"Torino","Serie A","Brandon Soppy","FRA","DF","22-099",2002,2,2,2,1,1,0,2,6,33.3,4,2,0,2,0,2,3,1,"https://fbref.com/en/players/28f66c2e/Brandon-Soppy"
2024,"Torino","Serie A","Adrien Tameze","CMR","DF,MF","30-116",1994,23.8,35,16,13,18,4,18,37,48.6,19,24,11,13,47,82,25,2,"https://fbref.com/en/players/8da74c05/Adrien-Tameze"
2024,"Torino","Serie A","Simone Verdi","ITA","FW","31-323",1992,0,0,0,0,0,0,0,0,NA,0,0,0,0,0,0,0,0,"https://fbref.com/en/players/0375723e/Simone-Verdi"
2024,"Torino","Serie A","Nikola Vlašić","CRO","MF,FW","26-239",1997,29,28,16,6,14,8,4,30,13.3,26,26,7,19,11,39,16,0,"https://fbref.com/en/players/aa8e289e/Nikola-Vlasic"
2024,"Torino","Serie A","Mërgim Vojvoda","KVX","DF","29-119",1995,15.3,17,8,7,6,4,11,16,68.8,5,12,2,10,13,30,28,0,"https://fbref.com/en/players/be2706c0/Mergim-Vojvoda"
2024,"Torino","Serie A","Duván Zapata","COL","FW","33-059",1991,32,18,7,9,2,7,3,12,25,9,20,6,14,7,25,26,0,"https://fbref.com/en/players/d3de9af0/Duvan-Zapata"
2024,"Torino","Serie A","David Zima","CZE","DF","23-204",2000,1,1,1,1,0,0,0,0,NA,0,0,0,0,3,4,7,0,"https://fbref.com/en/players/acf7e795/David-Zima"
2024,"Tottenham","Premier League","Rodrigo Bentancur","URU","MF","26-340",1997,11.2,23,15,10,11,2,10,24,41.7,14,15,4,11,17,40,16,1,"https://fbref.com/en/players/3b8674e6/Rodrigo-Bentancur"
2024,"Tottenham","Premier League","Yves Bissouma","MLI","MF","27-274",1996,23,80,52,32,36,12,41,61,67.2,20,28,5,23,37,117,43,3,"https://fbref.com/en/players/6c203af0/Yves-Bissouma"
2024,"Tottenham","Premier League","Ben Davies","WAL","DF","31-036",1993,12.1,24,17,13,8,3,16,21,76.2,5,17,15,2,10,34,35,0,"https://fbref.com/en/players/44781702/Ben-Davies"
2024,"Tottenham","Premier League","Eric Dier","ENG","DF","30-136",1994,2.2,2,1,2,0,0,2,2,100,0,3,3,0,2,4,12,0,"https://fbref.com/en/players/ac861941/Eric-Dier"
2024,"Tottenham","Premier League","Jamie Donley","ENG","FW","19-148",2005,0,0,0,0,0,0,0,0,NA,0,0,0,0,0,0,3,0,"https://fbref.com/en/players/5e4d9b48/Jamie-Donley"
2024,"Tottenham","Premier League","Radu Drăgușin","ROU","DF","22-117",2002,4.8,5,3,5,0,0,3,3,100,0,5,4,1,8,13,19,0,"https://fbref.com/en/players/620922ed/Radu-Dragusin"
2024,"Tottenham","Premier League","Emerson","BRA","DF","25-137",1999,12.9,36,24,23,10,3,21,43,48.8,22,23,10,13,20,56,50,1,"https://fbref.com/en/players/df8b52a5/Emerson"
2024,"Tottenham","Premier League","Bryan Gil","ESP","FW,MF","23-109",2001,2.3,1,0,0,0,1,1,4,25,3,3,0,3,3,4,4,0,"https://fbref.com/en/players/7b5ab7f2/Bryan-Gil"
2024,"Tottenham","Premier League","Son Heung-min","KOR","FW","31-327",1992,32.6,21,13,6,7,8,10,21,47.6,11,4,1,3,8,29,4,0,"https://fbref.com/en/players/92e7e919/Son-Heung-min"
2024,"Tottenham","Premier League","Pierre Højbjerg","DEN","MF","28-299",1995,14.6,32,18,13,17,2,13,34,38.2,21,21,7,14,19,51,30,3,"https://fbref.com/en/players/8b04d6c1/Pierre-Hojbjerg"
2024,"Tottenham","Premier League","Brennan Johnson","WAL","FW","23-007",2001,23.2,26,15,14,5,7,12,31,38.7,19,37,1,36,10,36,12,1,"https://fbref.com/en/players/0cd31129/Brennan-Johnson"
2024,"Tottenham","Premier League","Dejan Kulusevski","SWE","FW,MF","24-035",2000,30.7,62,33,19,20,23,25,67,37.3,42,24,1,23,18,80,2,1,"https://fbref.com/en/players/df3cda47/Dejan-Kulusevski"
2024,"Tottenham","Premier League","Giovani Lo Celso","ARG","MF","28-051",1996,5.6,22,13,10,8,4,9,14,64.3,5,4,1,3,5,27,2,0,"https://fbref.com/en/players/d7553721/Giovani-Lo-Celso"
2024,"Tottenham","Premier League","James Maddison","ENG","MF","27-189",1996,23.7,33,19,5,18,10,15,29,51.7,14,15,3,12,13,46,10,1,"https://fbref.com/en/players/ee38d9c5/James-Maddison"
2024,"Tottenham","Premier League","Pape Matar Sarr","SEN","MF","21-259",2002,23,34,24,11,17,6,15,36,41.7,21,21,5,16,31,65,28,1,"https://fbref.com/en/players/feb5d972/Pape-Matar-Sarr"
2024,"Tottenham","Premier League","Mikey Moore","ENG","MF","16-293",2007,0,0,0,0,0,0,0,0,NA,0,0,0,0,0,0,1,0,"https://fbref.com/en/players/00953a9d/Mikey-Moore"
2024,"Tottenham","Premier League","Ivan Perišić","CRO","FW","35-118",1989,1.1,3,2,1,1,1,3,5,60,2,1,0,1,2,5,1,0,"https://fbref.com/en/players/6fe90922/Ivan-Perisic"
2024,"Tottenham","Premier League","Pedro Porro","ESP","DF","24-260",1999,34.3,91,63,43,34,14,62,120,51.7,58,63,18,45,34,125,102,3,"https://fbref.com/en/players/27d0a506/Pedro-Porro"
2024,"Tottenham","Premier League","Richarlison","BRA","FW","27-020",1997,16.6,16,11,4,8,4,2,10,20,8,32,6,26,8,24,23,0,"https://fbref.com/en/players/fa031b34/Richarlison"
2024,"Tottenham","Premier League","Cristian Romero","ARG","DF","26-033",1998,31,66,40,35,25,6,32,44,72.7,12,46,22,24,44,110,106,1,"https://fbref.com/en/players/a3d94a58/Cristian-Romero"
2024,"Tottenham","Premier League","Davinson Sánchez","COL","DF","27-353",1996,0.9,0,0,0,0,0,0,0,NA,0,3,2,1,1,1,2,0,"https://fbref.com/en/players/da7b447d/Davinson-Sanchez"
2024,"Tottenham","Premier League","Dane Scarlett","ENG","FW","20-067",2004,0.2,1,1,0,0,1,0,1,0,1,0,0,0,0,1,0,0,"https://fbref.com/en/players/21945a9e/Dane-Scarlett"
2024,"Tottenham","Premier League","Oliver Skipp","ENG","MF,DF","23-257",2000,7.9,18,12,9,6,3,11,18,61.1,7,12,1,11,3,21,9,0,"https://fbref.com/en/players/6250083a/Oliver-Skipp"
2024,"Tottenham","Premier League","Manor Solomon","ISR","FW","24-311",1999,2.2,3,3,1,1,1,1,2,50,1,4,0,4,3,6,2,0,"https://fbref.com/en/players/886f9aac/Manor-Solomon"
2024,"Tottenham","Premier League","Destiny Udogie","ITA","DF","21-184",2002,26.6,68,33,41,16,11,27,49,55.1,22,27,8,19,37,105,80,5,"https://fbref.com/en/players/7cd520e8/Destiny-Udogie"
2024,"Tottenham","Premier League","Alejo Véliz","ARG","FW","20-254",2003,0.6,1,0,1,0,0,0,0,NA,0,0,0,0,0,1,0,0,"https://fbref.com/en/players/3f7bafbe/Alejo-Veliz"
2024,"Tottenham","Premier League","Micky van de Ven","NED","DF","23-041",2001,26,49,35,34,12,3,24,33,72.7,9,25,15,10,18,67,78,1,"https://fbref.com/en/players/8fe2a392/Micky-van-de-Ven"
2024,"Tottenham","Premier League","Guglielmo Vicario","ITA","GK","27-236",1996,38,0,0,0,0,0,0,1,0,1,0,0,0,1,1,31,2,"https://fbref.com/en/players/77d6fd4d/Guglielmo-Vicario"
2024,"Tottenham","Premier League","Timo Werner","GER","FW","28-085",1996,9,7,4,3,4,0,5,18,27.8,13,12,0,12,3,10,2,0,"https://fbref.com/en/players/49fe9070/Timo-Werner"
2024,"Toulouse","Ligue 1","Zakaria Aboukhlal","MAR","MF,FW","24-102",2000,8.4,9,8,1,5,3,3,12,25,9,9,1,8,1,10,2,0,"https://fbref.com/en/players/c2a6033c/Zakaria-Aboukhlal"
2024,"Toulouse","Ligue 1","Shavy Babicka","GAB","FW,MF","23-364",2000,4.1,11,8,2,7,2,2,5,40,3,6,1,5,0,11,2,0,"https://fbref.com/en/players/c6f0d5d4/Shavy-Babicka"
2024,"Toulouse","Ligue 1","Mamady Bangré","BFA","FW,MF","22-350",2001,1.1,4,2,2,2,0,3,4,75,1,0,0,0,4,8,3,0,"https://fbref.com/en/players/69e930e4/Mamady-Bangre"
2024,"Toulouse","Ligue 1","Yanis Begraoui","MAR","FW,MF","22-331",2001,3.3,5,3,1,3,1,3,9,33.3,6,4,0,4,5,10,5,0,"https://fbref.com/en/players/5e6355f8/Yanis-Begraoui"
2024,"Toulouse","Ligue 1","Cristian Cásseres Jr.","VEN","MF","24-131",2000,21.6,70,34,31,33,6,29,61,47.5,32,34,4,30,27,97,33,1,"https://fbref.com/en/players/f86fe8c1/Cristian-Casseres-Jr"
2024,"Toulouse","Ligue 1","Fares Chaïbi","ALG","FW,MF","21-184",2002,0.6,0,0,0,0,0,0,0,NA,0,0,0,0,0,0,2,0,"https://fbref.com/en/players/357103bd/Fares-Chaibi"
2024,"Toulouse","Ligue 1","Ibrahim Cissoko","NED","FW,MF","21-065",2003,2.7,4,3,3,1,0,1,3,33.3,2,3,0,3,1,5,0,0,"https://fbref.com/en/players/abddf25d/Ibrahim-Cissoko"
2024,"Toulouse","Ligue 1","Logan Costa","CPV","DF","23-059",2001,29.4,40,24,31,9,0,15,24,62.5,9,42,27,15,23,63,120,1,"https://fbref.com/en/players/bfb2056e/Logan-Costa"
2024,"Toulouse","Ligue 1","Thijs Dallinga","NED","FW","23-301",2000,27.9,29,15,6,11,12,9,15,60,6,11,4,7,3,32,35,0,"https://fbref.com/en/players/b70afb45/Thijs-Dallinga"
2024,"Toulouse","Ligue 1","Mikkel Desler","DEN","DF","29-101",1995,17.2,18,12,8,7,3,9,17,52.9,8,32,13,19,19,37,38,0,"https://fbref.com/en/players/1d5c96f8/Mikkel-Desler"
2024,"Toulouse","Ligue 1","Moussa Diarra","MLI","DF","23-202",2000,15.5,32,12,16,15,1,13,27,48.1,14,30,14,16,20,52,43,0,"https://fbref.com/en/players/698f11e3/Moussa-Diarra"
2024,"Toulouse","Ligue 1","Aron Dønnum","NOR","FW,MF","26-040",1998,17.7,16,10,3,8,5,7,22,31.8,15,13,0,13,8,24,16,1,"https://fbref.com/en/players/10cff752/Aron-Donnum"
2024,"Toulouse","Ligue 1","Yann Gboho","FRA","MF,FW","23-137",2001,13.3,14,4,6,6,2,8,23,34.8,15,21,1,20,4,18,2,0,"https://fbref.com/en/players/6be41a31/Yann-Gboho"
2024,"Toulouse","Ligue 1","Gelabert","ESP","MF,FW","23-212",2000,8.4,14,8,5,6,3,7,20,35,13,8,2,6,5,19,8,0,"https://fbref.com/en/players/ed55b838/Gelabert"
2024,"Toulouse","Ligue 1","Denis Genreau","AUS","MF,FW","25-009",1999,5.2,12,9,6,6,0,8,15,53.3,7,8,1,7,6,18,8,0,"https://fbref.com/en/players/badcdcae/Denis-Genreau"
2024,"Toulouse","Ligue 1","Waren Kamanzi","NOR","DF,FW","23-201",2000,13.2,36,24,16,16,4,13,23,56.5,10,11,3,8,9,45,35,0,"https://fbref.com/en/players/a426a912/Waren-Kamanzi"
2024,"Toulouse","Ligue 1","Kévin Keben Biakolo","CMR","DF","20-125",2004,5.8,4,2,4,0,0,3,6,50,3,7,0,7,8,12,17,0,"https://fbref.com/en/players/c43a8336/Kevin-Keben-Biakolo"
2024,"Toulouse","Ligue 1","Frank Magri","CMR","FW,MF","24-269",1999,16,22,14,5,12,5,15,21,71.4,6,16,4,12,4,26,17,0,"https://fbref.com/en/players/42fdb11d/Frank-Magri"
2024,"Toulouse","Ligue 1","Christian Mawissa","FRA","DF","19-042",2005,12.4,22,15,14,4,4,9,23,39.1,14,22,11,11,22,44,41,1,"https://fbref.com/en/players/2c70d915/Christian-Mawissa"
2024,"Toulouse","Ligue 1","Rasmus Nicolaisen","DEN","DF","27-075",1997,32.5,50,30,39,11,0,26,44,59.1,18,44,33,11,42,92,158,1,"https://fbref.com/en/players/3f319bb9/Rasmus-Nicolaisen"
2024,"Toulouse","Ligue 1","Guillaume Restes","FRA","GK","19-080",2005,34,0,0,0,0,0,0,3,0,3,0,0,0,0,0,19,1,"https://fbref.com/en/players/6b91b999/Guillaume-Restes"
2024,"Toulouse","Ligue 1","Niklas Schmidt","GER","MF","26-090",1998,14.1,36,21,13,19,4,16,33,48.5,17,14,7,7,4,40,13,0,"https://fbref.com/en/players/b9ae8560/Niklas-Schmidt"
2024,"Toulouse","Ligue 1","Vincent Sierro","SUI","MF","28-235",1995,25.1,41,24,15,20,6,27,77,35.1,50,37,13,24,27,68,33,0,"https://fbref.com/en/players/92ffb8f9/Vincent-Sierro"
2024,"Toulouse","Ligue 1","Naatan Skyttä","FIN","MF,FW","22-023",2002,1.3,4,4,2,1,1,1,1,100,0,0,0,0,0,4,0,0,"https://fbref.com/en/players/d7547531/Naatan-Skytta"
2024,"Toulouse","Ligue 1","Stijn Spierings","NED","MF","28-079",1996,16.8,53,40,26,20,7,29,52,55.8,23,22,5,17,26,79,32,0,"https://fbref.com/en/players/a08985b8/Stijn-Spierings"
2024,"Toulouse","Ligue 1","Gabriel Suazo","CHI","DF","26-295",1997,26.2,66,32,40,19,7,38,86,44.2,48,37,4,33,26,92,33,0,"https://fbref.com/en/players/39b326ed/Gabriel-Suazo"
2024,"Udinese","Serie A","Marley Aké","FRA","FW","23-146",2001,0.1,0,0,0,0,0,0,0,NA,0,0,0,0,0,0,0,0,"https://fbref.com/en/players/414e1f69/Marley-Ake"
2024,"Udinese","Serie A","Beto","GNB","FW","26-120",1998,0.8,1,0,0,0,1,0,0,NA,0,0,0,0,0,1,0,0,"https://fbref.com/en/players/ed5c0319/Beto"
2024,"Udinese","Serie A","Jaka Bijol","SVN","DF","25-115",1999,23.2,43,27,34,9,0,22,35,62.9,13,36,21,15,23,66,140,1,"https://fbref.com/en/players/6fdac234/Jaka-Bijol"
2024,"Udinese","Serie A","Brenner","BRA","MF,FW","24-135",2000,2.1,8,7,1,5,2,4,7,57.1,3,2,0,2,0,8,2,0,"https://fbref.com/en/players/279508bf/Brenner"
2024,"Udinese","Serie A","Keinan Davis","ENG","FW,MF","26-107",1998,2.1,0,0,0,0,0,0,0,NA,0,0,0,0,0,0,3,0,"https://fbref.com/en/players/9deaf2c8/Keinan-Davis"
2024,"Udinese","Serie A","Festy Ebosele","IRL","DF","21-302",2002,18.9,33,20,23,9,1,21,35,60,14,33,2,31,10,43,27,0,"https://fbref.com/en/players/dbfa4f16/Festy-Ebosele"
2024,"Udinese","Serie A","Enzo Ebosse","CMR","DF","25-080",1999,0.1,1,1,1,0,0,0,1,0,1,0,0,0,1,2,0,0,"https://fbref.com/en/players/9ba7b4fa/Enzo-Ebosse"
2024,"Udinese","Serie A","Kingsley Ehizibue","NED","DF","29-005",1995,10.6,22,14,16,4,2,11,18,61.1,7,21,3,18,8,30,36,0,"https://fbref.com/en/players/76b2817e/Kingsley-Ehizibue"
2024,"Udinese","Serie A","João Ferreira","POR","DF","23-069",2001,20.2,58,42,36,18,4,34,58,58.6,24,27,6,21,29,87,89,0,"https://fbref.com/en/players/fb37a645/Joao-Ferreira"
2024,"Udinese","Serie A","Lautaro Gianetti","ARG","DF","30-199",1993,7,9,4,7,2,0,4,5,80,1,10,6,4,19,28,39,0,"https://fbref.com/en/players/e08ac719/Lautaro-Gianetti"
2024,"Udinese","Serie A","Axel Guessand","FRA","DF","19-206",2004,0.5,1,1,0,1,0,1,1,100,0,1,0,1,0,1,0,0,"https://fbref.com/en/players/e04dca4a/Axel-Guessand"
2024,"Udinese","Serie A","Christian Kabasele","BEL","DF","33-096",1991,9.6,10,7,4,5,1,2,11,18.2,9,15,9,6,12,22,56,0,"https://fbref.com/en/players/914ab9a1/Christian-Kabasele"
2024,"Udinese","Serie A","Hassane Kamara","CIV","DF","30-086",1994,24.7,45,32,26,13,6,25,38,65.8,13,29,2,27,26,71,66,0,"https://fbref.com/en/players/19a12bed/Hassane-Kamara"
2024,"Udinese","Serie A","Thomas Kristensen","DEN","DF","22-134",2002,23.3,35,24,25,10,0,21,33,63.6,12,29,20,9,29,64,118,0,"https://fbref.com/en/players/fadf9a05/Thomas-Kristensen"
2024,"Udinese","Serie A","Sandi Lovrić","SVN","MF","26-063",1998,22.1,25,12,9,11,5,9,23,39.1,14,21,2,19,21,46,24,0,"https://fbref.com/en/players/966eea58/Sandi-Lovric"
2024,"Udinese","Serie A","Lorenzo Lucca","ITA","FW","23-263",2000,28.8,19,11,4,11,4,5,20,25,15,18,3,15,3,22,36,1,"https://fbref.com/en/players/83c06f3a/Lorenzo-Lucca"
2024,"Udinese","Serie A","Adam Masina","MAR","DF","30-149",1994,0.7,4,0,2,2,0,2,4,50,2,2,1,1,2,6,5,0,"https://fbref.com/en/players/de0f152c/Adam-Masina"
2024,"Udinese","Serie A","Maduka Okoye","NGA","GK","24-276",1999,21,0,0,0,0,0,0,0,NA,0,0,0,0,1,1,4,2,"https://fbref.com/en/players/ab5c36dd/Maduka-Okoye"
2024,"Udinese","Serie A","Simone Pafundi","ITA","MF","18-106",2006,0.1,0,0,0,0,0,0,0,NA,0,0,0,0,0,0,0,0,"https://fbref.com/en/players/8daee720/Simone-Pafundi"
2024,"Udinese","Serie A","Martín Payero","ARG","MF","25-262",1998,20,54,32,28,19,7,19,46,41.3,27,25,7,18,15,69,21,0,"https://fbref.com/en/players/bdbff2b5/Martin-Payero"
2024,"Udinese","Serie A","Roberto Pereyra","ARG","FW,MF","33-144",1991,20.6,19,9,11,5,3,11,29,37.9,18,20,4,16,7,26,18,0,"https://fbref.com/en/players/75f2c59f/Roberto-Pereyra"
2024,"Udinese","Serie A","Nehuén Pérez","ARG","DF","23-341",2000,36,72,48,42,28,2,39,48,81.3,9,53,26,27,45,117,158,1,"https://fbref.com/en/players/f7c491f1/Nehuen-Perez"
2024,"Udinese","Serie A","Domingos Quina","POR","MF","24-194",1999,0.1,1,1,1,0,0,0,0,NA,0,0,0,0,0,1,0,0,"https://fbref.com/en/players/41fb0f4e/Domingos-Quina"
2024,"Udinese","Serie A","Lazar Samardzic","SRB","MF","22-096",2002,26.4,40,19,18,18,4,16,39,41,23,26,6,20,10,50,25,0,"https://fbref.com/en/players/217c93a1/Lazar-Samardzic"
2024,"Udinese","Serie A","Vivaldo Semedo","POR","FW","19-123",2005,0.1,0,0,0,0,0,0,0,NA,0,0,0,0,0,0,0,0,"https://fbref.com/en/players/b6baba31/Vivaldo-Semedo"
2024,"Udinese","Serie A","Marco Silvestri","ITA","GK","33-089",1991,17,0,0,0,0,0,0,3,0,3,1,0,1,0,0,5,3,"https://fbref.com/en/players/0d422df7/Marco-Silvestri"
2024,"Udinese","Serie A","Isaac Success","NGA","FW,MF","28-144",1996,9.8,6,4,0,5,1,1,3,33.3,2,6,1,5,2,8,11,0,"https://fbref.com/en/players/f573a8bf/Isaac-Success"
2024,"Udinese","Serie A","Florian Thauvin","FRA","FW","31-125",1993,19,7,4,2,4,1,4,13,30.8,9,9,1,8,3,10,2,0,"https://fbref.com/en/players/2b9fdeea/Florian-Thauvin"
2024,"Udinese","Serie A","Antonio Tikvić","CRO","DF","20-039",2004,0,0,0,0,0,0,0,0,NA,0,0,0,0,0,0,0,0,"https://fbref.com/en/players/d1ac669b/Antonio-Tikvic"
2024,"Udinese","Serie A","Walace","BRA","MF","29-056",1995,36,66,43,40,26,0,36,77,46.8,41,43,6,37,43,109,66,1,"https://fbref.com/en/players/26db8853/Walace"
2024,"Udinese","Serie A","Oier Zarraga","ESP","MF","25-147",1999,4.5,3,3,2,1,0,1,5,20,4,5,2,3,5,8,16,1,"https://fbref.com/en/players/968a1c2f/Oier-Zarraga"
2024,"Udinese","Serie A","Jordan Zemura","ZIM","DF","24-198",1999,11.5,24,16,13,7,4,11,19,57.9,8,5,1,4,13,37,21,0,"https://fbref.com/en/players/e8271ad9/Jordan-Zemura"
2024,"Union Berlin","Bundesliga","Brenden Aaronson","USA","MF,FW","23-221",2000,14.1,32,18,13,13,6,16,32,50,16,26,1,25,2,34,4,0,"https://fbref.com/en/players/5bc43860/Brenden-Aaronson"
2024,"Union Berlin","Bundesliga","Sheraldo Becker","SUR","FW,MF","29-111",1995,7.2,3,3,0,2,1,0,2,0,2,2,0,2,0,3,2,0,"https://fbref.com/en/players/8eb55dbb/Sheraldo-Becker"
2024,"Union Berlin","Bundesliga","Chris Bedia","CIV","FW,MF","28-086",1996,1.6,2,1,0,2,0,0,1,0,1,3,0,3,0,2,2,0,"https://fbref.com/en/players/ec11ecf8/Chris-Bedia"
2024,"Union Berlin","Bundesliga","Kevin Behrens","GER","FW","33-117",1991,14,13,10,3,7,3,1,4,25,3,7,2,5,6,19,19,0,"https://fbref.com/en/players/30ae134d/Kevin-Behrens"
2024,"Union Berlin","Bundesliga","Leonardo Bonucci","ITA","DF","37-029",1987,5.1,6,5,2,4,0,4,4,100,0,5,3,2,7,13,16,0,"https://fbref.com/en/players/52ec54d0/Leonardo-Bonucci"
2024,"Union Berlin","Bundesliga","David Datro Fofana","CIV","FW,MF","21-160",2002,7.6,10,7,3,5,2,4,9,44.4,5,4,0,4,0,10,5,0,"https://fbref.com/en/players/e82900ef/David-Datro-Fofana"
2024,"Union Berlin","Bundesliga","Danilho Doekhi","NED","DF","25-335",1998,24,34,23,18,16,0,15,21,71.4,6,46,25,21,38,72,111,1,"https://fbref.com/en/players/f67c9d29/Danilho-Doekhi"
2024,"Union Berlin","Bundesliga","Robin Gosens","GER","DF,MF","29-330",1994,25.4,63,44,25,31,7,30,44,68.2,14,52,9,43,36,99,75,0,"https://fbref.com/en/players/2d970560/Robin-Gosens"
2024,"Union Berlin","Bundesliga","Janik Haberer","GER","MF,DF","30-058",1994,13.6,36,24,16,13,7,22,45,48.9,23,21,4,17,12,48,18,0,"https://fbref.com/en/players/70dcf94d/Janik-Haberer"
2024,"Union Berlin","Bundesliga","Benedict Hollerbach","GER","FW,MF","23-013",2001,14.2,17,11,5,7,5,7,22,31.8,15,28,0,28,4,21,3,0,"https://fbref.com/en/players/2a158218/Benedict-Hollerbach"
2024,"Union Berlin","Bundesliga","Paul Jaeckel","GER","DF","25-313",1998,2.6,7,2,4,3,0,5,9,55.6,4,3,2,1,4,11,7,0,"https://fbref.com/en/players/a93b6f4e/Paul-Jaeckel"
2024,"Union Berlin","Bundesliga","Josip Juranović","CRO","DF","28-288",1995,14.4,20,14,11,7,2,10,21,47.6,11,17,3,14,12,32,27,1,"https://fbref.com/en/players/0a084b35/Josip-Juranovic"
2024,"Union Berlin","Bundesliga","Mikkel Kaufmann","DEN","FW","23-148",2001,5.4,6,3,2,3,1,3,10,30,7,12,0,12,1,7,4,0,"https://fbref.com/en/players/6e269dd3/Mikkel-Kaufmann"
2024,"Union Berlin","Bundesliga","Aljoscha Kemlein","GER","MF","19-302",2004,0.3,0,0,0,0,0,0,3,0,3,1,0,1,0,0,0,0,"https://fbref.com/en/players/4658e309/Aljoscha-Kemlein"
2024,"Union Berlin","Bundesliga","Rani Khedira","GER","MF","30-124",1994,14.9,35,22,15,19,1,17,26,65.4,9,12,5,7,22,57,38,0,"https://fbref.com/en/players/59e4b92e/Rani-Khedira"
2024,"Union Berlin","Bundesliga","Robin Knoche","GER","DF","32-008",1992,21.3,34,22,27,7,0,19,30,63.3,11,27,19,8,13,47,73,0,"https://fbref.com/en/players/6bd5cd5d/Robin-Knoche"
2024,"Union Berlin","Bundesliga","Alex Král","CZE","MF","26-011",1998,15.2,19,14,7,10,2,8,20,40,12,15,4,11,11,30,30,0,"https://fbref.com/en/players/e717705a/Alex-Kral"
2024,"Union Berlin","Bundesliga","Aïssa Laïdouni","TUN","MF","27-169",1996,11.9,21,12,4,12,5,4,12,33.3,8,26,2,24,12,33,14,2,"https://fbref.com/en/players/22798128/Aissa-Laidouni"
2024,"Union Berlin","Bundesliga","Diogo Leite","POR","DF","25-128",1999,30,52,36,31,15,6,25,51,49,26,48,22,26,47,99,155,1,"https://fbref.com/en/players/c4987edc/Diogo-Leite"
2024,"Union Berlin","Bundesliga","Miloš Pantović","SRB","MF","27-328",1996,0.2,0,0,0,0,0,0,0,NA,0,0,0,0,0,0,0,0,"https://fbref.com/en/players/5dc15574/Milos-Pantovic"
2024,"Union Berlin","Bundesliga","Jordan Pefok","USA","FW","28-034",1996,0.3,0,0,0,0,0,0,0,NA,0,1,1,0,0,0,0,0,"https://fbref.com/en/players/b684a484/Jordan-Pefok"
2024,"Union Berlin","Bundesliga","Jérôme Roussillon","FRA","DF","31-145",1993,8.4,16,9,6,7,3,8,12,66.7,4,13,4,9,5,21,26,0,"https://fbref.com/en/players/13203c45/Jerome-Roussillon"
2024,"Union Berlin","Bundesliga","Frederik Rønnow","DEN","GK","31-300",1992,33,1,1,1,0,0,0,0,NA,0,0,0,0,1,2,20,2,"https://fbref.com/en/players/a70b8345/Frederik-Ronnow"
2024,"Union Berlin","Bundesliga","András Schäfer","HUN","MF","25-047",1999,13.5,29,16,9,15,5,11,20,55,9,25,4,21,20,49,25,0,"https://fbref.com/en/players/049751d7/Andras-Schafer"
2024,"Union Berlin","Bundesliga","Alexander Schwolow","GER","GK","31-363",1992,1,0,0,0,0,0,0,0,NA,0,0,0,0,0,0,2,0,"https://fbref.com/en/players/0d55d942/Alexander-Schwolow"
2024,"Union Berlin","Bundesliga","Lucas Tousart","FRA","MF","27-031",1997,17.5,35,20,14,17,4,17,37,45.9,20,32,9,23,25,60,41,0,"https://fbref.com/en/players/71ec39ef/Lucas-Tousart"
2024,"Union Berlin","Bundesliga","Christopher Trimmel","AUT","DF","37-096",1987,18.3,23,15,12,10,1,13,33,39.4,20,16,3,13,13,36,57,0,"https://fbref.com/en/players/056d2d95/Christopher-Trimmel"
2024,"Union Berlin","Bundesliga","Yorbe Vertessen","BEL","FW,MF","23-143",2001,6.6,3,2,0,3,0,1,4,25,3,8,0,8,1,4,3,0,"https://fbref.com/en/players/e8ef59da/Yorbe-Vertessen"
2024,"Union Berlin","Bundesliga","Kevin Vogt","GER","DF","32-250",1991,14.7,10,9,6,4,0,6,12,50,6,22,15,7,7,17,72,2,"https://fbref.com/en/players/1d8e9add/Kevin-Vogt"
2024,"Union Berlin","Bundesliga","Kevin Volland","GER","FW,MF","31-305",1992,14.9,22,9,8,8,6,8,20,40,12,8,0,8,6,28,12,0,"https://fbref.com/en/players/64f69877/Kevin-Volland"
2024,"Valencia","La Liga","Domingos André Ribeiro Almeida","POR","FW,MF","24-000",2000,10.7,25,15,9,12,4,9,19,47.4,10,13,1,12,6,31,5,0,"https://fbref.com/en/players/e6697917/Domingos-Andre-Ribeiro-Almeida"
2024,"Valencia","La Liga","Selim Amallah","MAR","FW,MF","27-197",1996,6.7,17,12,7,7,3,3,9,33.3,6,13,0,13,11,28,6,0,"https://fbref.com/en/players/00eba9c9/Selim-Amallah"
2024,"Valencia","La Liga","Sergi Canós","ESP","MF,FW","27-118",1997,13.7,23,13,7,11,5,10,24,41.7,14,14,2,12,11,34,9,0,"https://fbref.com/en/players/1137759d/Sergi-Canos"
2024,"Valencia","La Liga","Thierry Correia","POR","DF","25-082",1999,23.9,63,35,39,20,4,28,49,57.1,21,39,16,23,33,96,61,0,"https://fbref.com/en/players/c78b352d/Thierry-Correia"
2024,"Valencia","La Liga","Cristian","ESP","GK","26-070",1998,0.6,0,0,0,0,0,0,0,NA,0,0,0,0,0,0,0,0,"https://fbref.com/en/players/9ad74b4d/Cristian"
2024,"Valencia","La Liga","Mouctar Diakhaby","GUI","DF,MF","27-163",1996,11.9,18,11,9,9,0,11,13,84.6,2,17,7,10,11,29,62,0,"https://fbref.com/en/players/d2110326/Mouctar-Diakhaby"
2024,"Valencia","La Liga","Jaume Doménech","ESP","GK","33-207",1990,0.9,0,0,0,0,0,0,0,NA,0,0,0,0,0,0,0,0,"https://fbref.com/en/players/c9cb972b/Jaume-Domenech"
2024,"Valencia","La Liga","Mario Dominguez","ESP","FW","20-110",2004,0.3,0,0,0,0,0,0,0,NA,0,0,0,0,0,0,0,0,"https://fbref.com/en/players/d709cd5c/Mario-Dominguez"
2024,"Valencia","La Liga","Hugo Duro","ESP","FW","24-202",1999,33.1,16,8,5,8,3,9,29,31,20,24,5,19,5,21,27,0,"https://fbref.com/en/players/37e103f8/Hugo-Duro"
2024,"Valencia","La Liga","Dimitri Foulquier","FRA","DF,MF","31-068",1993,20.5,39,22,22,13,4,18,26,69.2,8,10,1,9,16,55,49,1,"https://fbref.com/en/players/45e17712/Dimitri-Foulquier"
2024,"Valencia","La Liga","Hugo González","ESP","MF,FW","21-113",2003,1,2,1,0,2,0,0,0,NA,0,0,0,0,0,2,0,0,"https://fbref.com/en/players/2cfb6e88/Hugo-Gonzalez"
2024,"Valencia","La Liga","Peter González","DOM","MF,FW","21-310",2002,7.2,5,3,3,1,1,1,10,10,9,11,0,11,7,12,10,0,"https://fbref.com/en/players/1ccd3dae/Peter-Gonzalez"
2024,"Valencia","La Liga","Pablo Gozalbez","ESP","MF,FW","23-030",2001,1.1,1,0,0,0,1,1,6,16.7,5,0,0,0,1,2,2,0,"https://fbref.com/en/players/f33b6ee6/Pablo-Gozalbez"
2024,"Valencia","La Liga","Javier Guerra","ESP","MF","21-150",2003,27.8,54,24,25,22,7,22,58,37.9,36,27,7,20,18,72,44,0,"https://fbref.com/en/players/3828f130/Javier-Guerra"
2024,"Valencia","La Liga","Hugo Guillamón","ESP","MF","24-120",2000,14.6,24,15,7,14,3,11,17,64.7,6,8,3,5,12,36,25,2,"https://fbref.com/en/players/f7c12fbf/Hugo-Guillamon"
2024,"Valencia","La Liga","Yarek Hernandis","ESP","DF","19-139",2005,8.2,22,12,14,5,3,13,19,68.4,6,15,8,7,15,37,50,1,"https://fbref.com/en/players/20a65cdf/Yarek-Hernandis"
2024,"Valencia","La Liga","Ruben Lendinez","ESP","DF","21-077",2003,0.1,2,2,0,2,0,1,1,100,0,0,0,0,0,2,1,0,"https://fbref.com/en/players/755da865/Ruben-Lendinez"
2024,"Valencia","La Liga","Diego López","ESP","MF,FW","22-017",2002,29.5,37,25,14,16,7,13,56,23.2,43,23,1,22,20,57,12,0,"https://fbref.com/en/players/c487901c/Diego-Lopez"
2024,"Valencia","La Liga","José Luis Gayà","ESP","DF","29-005",1995,19.9,71,36,44,23,4,43,67,64.2,24,18,3,15,11,82,42,0,"https://fbref.com/en/players/b05e2dbd/Jose-Luis-Gaya"
2024,"Valencia","La Liga","Giorgi Mamardashvili","GEO","GK","23-244",2000,36.5,4,3,4,0,0,4,4,100,0,1,0,1,2,6,22,2,"https://fbref.com/en/players/d4b73232/Giorgi-Mamardashvili"
2024,"Valencia","La Liga","Alberto Marí","ESP","FW","22-324",2001,3.1,4,2,0,1,3,1,1,100,0,3,0,3,0,4,5,0,"https://fbref.com/en/players/44330c36/Alberto-Mari"
2024,"Valencia","La Liga","Cristhian Mosquera","COL","DF","19-338",2004,34.2,57,34,36,18,3,25,39,64.1,14,42,23,19,36,93,137,2,"https://fbref.com/en/players/dc1ce4f5/Cristhian-Mosquera"
2024,"Valencia","La Liga","Cenk Özkacar","TUR","DF","23-237",2000,17.8,26,15,22,4,0,15,23,65.2,8,18,7,11,18,44,84,1,"https://fbref.com/en/players/9a93efc9/Cenk-Ozkacar"
2024,"Valencia","La Liga","Gabriel Paulista","BRA","DF","33-186",1990,15.5,10,7,8,2,0,6,11,54.5,5,15,7,8,24,34,78,0,"https://fbref.com/en/players/b7ca5c51/Gabriel-Paulista"
2024,"Valencia","La Liga","Francisco Perez","ESP","MF,FW","21-264",2002,22.8,30,17,10,14,6,15,44,34.1,29,19,0,19,14,44,5,0,"https://fbref.com/en/players/3d79a68c/Francisco-Perez"
2024,"Valencia","La Liga","César Tárrega","ESP","DF","22-094",2002,0.1,0,0,0,0,0,0,0,NA,0,0,0,0,0,0,2,0,"https://fbref.com/en/players/59c29820/Cesar-Tarrega"
2024,"Valencia","La Liga","José Luis García Vayá","ESP","MF","25-293",1998,36.7,78,53,36,36,6,37,71,52.1,34,41,10,31,49,127,71,0,"https://fbref.com/en/players/27dc1378/Jose-Luis-Garcia-Vaya"
2024,"Valencia","La Liga","Jesus Vazquez","ESP","DF,MF","21-149",2003,8,24,12,13,8,3,10,16,62.5,6,17,4,13,3,27,24,0,"https://fbref.com/en/players/106c142c/Jesus-Vazquez"
2024,"Valencia","La Liga","Roman Yaremchuk","UKR","FW","28-185",1995,10.3,5,2,1,2,2,3,6,50,3,4,0,4,1,6,9,0,"https://fbref.com/en/players/cb641b9d/Roman-Yaremchuk"
2024,"Villarreal","La Liga","Ilias Akhomach","MAR","MF,FW","20-044",2004,16.8,36,21,11,16,9,10,20,50,10,10,2,8,13,49,13,0,"https://fbref.com/en/players/b8bd60fe/Ilias-Akhomach"
2024,"Villarreal","La Liga","Raúl Albiol","ESP","DF","38-269",1985,22.6,25,14,15,9,1,18,27,66.7,9,31,24,7,16,41,102,0,"https://fbref.com/en/players/4bd414c1/Raul-Albiol"
2024,"Villarreal","La Liga","Adrià Altimira","ESP","DF,MF","23-063",2001,8.6,16,7,9,6,1,9,24,37.5,15,18,5,13,5,21,18,0,"https://fbref.com/en/players/757a3431/Adria-Altimira"
2024,"Villarreal","La Liga","Alex Baena","ESP","MF,FW","22-315",2001,28.7,34,21,10,16,8,20,47,42.6,27,23,2,21,13,47,17,1,"https://fbref.com/en/players/518f2234/Alex-Baena"
2024,"Villarreal","La Liga","Eric Bailly","CIV","DF","30-048",1994,9.3,5,3,4,1,0,2,2,100,0,8,8,0,9,14,38,2,"https://fbref.com/en/players/a1232f4e/Eric-Bailly"
2024,"Villarreal","La Liga","Ben Brereton","CHI","FW,MF","25-042",1999,3,2,2,1,0,1,0,2,0,2,0,0,0,0,2,0,0,"https://fbref.com/en/players/57827369/Ben-Brereton"
2024,"Villarreal","La Liga","Étienne Capoue","FRA","MF","35-324",1988,16.2,32,18,17,12,3,15,22,68.2,7,20,4,16,22,54,24,1,"https://fbref.com/en/players/5acc4a10/Etienne-Capoue"
2024,"Villarreal","La Liga","Santi Comesaña","ESP","MF","27-238",1996,18.4,44,26,15,21,8,19,38,50,19,33,9,24,22,66,27,1,"https://fbref.com/en/players/5ae499d0/Santi-Comesana"
2024,"Villarreal","La Liga","Francis Coquelin","FRA","MF","33-017",1991,10.1,20,12,8,10,2,5,13,38.5,8,14,4,10,16,36,15,0,"https://fbref.com/en/players/a6951bf8/Francis-Coquelin"
2024,"Villarreal","La Liga","Jorge Cuenca","ESP","DF","24-195",1999,21.8,42,29,26,10,6,19,30,63.3,11,26,15,11,21,63,114,0,"https://fbref.com/en/players/0abc51f2/Jorge-Cuenca"
2024,"Villarreal","La Liga","Kiko Femenía","ESP","DF","33-118",1991,17.6,35,25,19,13,3,19,34,55.9,15,21,6,15,31,66,45,0,"https://fbref.com/en/players/e5d01ecf/Kiko-Femenia"
2024,"Villarreal","La Liga","Juan Foyth","ARG","DF","26-139",1998,11.8,26,15,18,8,0,12,27,44.4,15,17,4,13,12,38,44,0,"https://fbref.com/en/players/6c7762c3/Juan-Foyth"
2024,"Villarreal","La Liga","Matteo Gabbia","ITA","DF","24-222",1999,5.3,10,6,4,6,0,5,8,62.5,3,5,2,3,8,18,36,1,"https://fbref.com/en/players/c235e803/Matteo-Gabbia"
2024,"Villarreal","La Liga","Gonçalo Guedes","POR","FW,MF","27-183",1996,10.6,6,4,1,2,3,2,7,28.6,5,8,0,8,2,8,3,0,"https://fbref.com/en/players/e6bc67d7/Goncalo-Guedes"
2024,"Villarreal","La Liga","Filip Jørgensen","DEN","GK","22-044",2002,36,3,1,3,0,0,3,4,75,1,0,0,0,2,5,10,3,"https://fbref.com/en/players/0107757e/Filip-Jorgensen"
2024,"Villarreal","La Liga","Stefan Lekovic","SRB","DF","20-142",2004,0.3,0,0,0,0,0,0,0,NA,0,1,1,0,0,0,1,0,"https://fbref.com/en/players/d633fd46/Stefan-Lekovic"
2024,"Villarreal","La Liga","José Luis Morales","ESP","FW,MF","36-312",1987,11.6,5,3,1,4,0,3,13,23.1,10,9,1,8,7,12,4,0,"https://fbref.com/en/players/4a478107/Jose-Luis-Morales"
2024,"Villarreal","La Liga","Aïssa Mandi","ALG","DF","32-221",1991,12.4,13,8,8,5,0,7,14,50,7,10,7,3,8,21,41,0,"https://fbref.com/en/players/fbd6378b/Aissa-Mandi"
2024,"Villarreal","La Liga","Alberto Moreno","ESP","DF","31-330",1992,16.5,31,21,19,10,2,10,30,33.3,20,12,2,10,24,55,33,0,"https://fbref.com/en/players/11b9265b/Alberto-Moreno"
2024,"Villarreal","La Liga","Gerard Moreno","ESP","FW","32-053",1992,24.6,25,12,10,7,8,11,25,44,14,24,7,17,9,34,24,0,"https://fbref.com/en/players/81f0781e/Gerard-Moreno"
2024,"Villarreal","La Liga","Yerson Mosquera","COL","DF","23-028",2001,13.7,27,13,18,7,2,12,15,80,3,12,2,10,17,44,65,0,"https://fbref.com/en/players/1e159d70/Yerson-Mosquera"
2024,"Villarreal","La Liga","Daniel Parejo","ESP","MF","35-044",1989,28.7,43,30,16,21,6,20,46,43.5,26,25,9,16,21,64,29,3,"https://fbref.com/en/players/7460ca0d/Daniel-Parejo"
2024,"Villarreal","La Liga","Pascu","ESP","FW","21-051",2003,0.2,0,0,0,0,0,0,0,NA,0,0,0,0,0,0,0,0,"https://fbref.com/en/players/a2d9cf74/Pascu"
2024,"Villarreal","La Liga","Alfonso Pedraza","ESP","DF","28-051",1996,12.4,25,9,18,5,2,9,17,52.9,8,16,7,9,13,38,19,0,"https://fbref.com/en/players/63f04c6c/Alfonso-Pedraza"
2024,"Villarreal","La Liga","Yeremi Pino","ESP","MF,FW","21-223",2002,5.3,25,18,12,10,3,9,18,50,9,11,1,10,5,30,5,0,"https://fbref.com/en/players/540ec57b/Yeremi-Pino"
2024,"Villarreal","La Liga","Pepe Reina","ESP","GK","41-273",1982,2,0,0,0,0,0,0,0,NA,0,0,0,0,0,0,1,0,"https://fbref.com/en/players/e358587b/Pepe-Reina"
2024,"Villarreal","La Liga","Carlos Romero","ESP","DF","22-214",2001,2.9,11,5,8,1,2,7,12,58.3,5,3,0,3,1,12,11,0,"https://fbref.com/en/players/23cbf863/Carlos-Romero"
2024,"Villarreal","La Liga","Denis Suárez","ESP","MF,FW","30-145",1994,1.5,0,0,0,0,0,0,2,0,2,2,2,0,0,0,4,0,"https://fbref.com/en/players/12c50af5/Denis-Suarez"
2024,"Villarreal","La Liga","Alexander Sørloth","NOR","FW","28-177",1995,27.7,6,3,1,2,3,2,6,33.3,4,9,4,5,0,6,26,0,"https://fbref.com/en/players/e92cd3f7/Alexander-Sorloth"
2024,"Villarreal","La Liga","Ramón Terrats","ESP","MF,DF","23-225",2000,8.7,17,13,8,8,1,7,15,46.7,8,11,1,10,3,20,9,0,"https://fbref.com/en/players/f36016a5/Ramon-Terrats"
2024,"Villarreal","La Liga","Bertrand Traoré","BFA","MF","28-267",1995,6.3,5,4,2,1,2,1,4,25,3,6,0,6,1,6,2,0,"https://fbref.com/en/players/c47541e0/Bertrand-Traore"
2024,"Villarreal","La Liga","Manu Trigueros","ESP","MF","32-226",1991,3.4,7,5,6,1,0,4,10,40,6,1,1,0,3,10,9,0,"https://fbref.com/en/players/963829d0/Manu-Trigueros"
2024,"Werder Bremen","Bundesliga","Felix Agu","GER","DF,MF","24-246",1999,17.9,45,29,28,13,4,29,41,70.7,12,27,7,20,13,58,41,0,"https://fbref.com/en/players/cb6d81b3/Felix-Agu"
2024,"Werder Bremen","Bundesliga","Skelly Alvero","FRA","MF","22-026",2002,1.4,6,4,1,5,0,3,3,100,0,3,1,2,1,7,1,0,"https://fbref.com/en/players/add37c13/Skelly-Alvero"
2024,"Werder Bremen","Bundesliga","Leonardo Bittencourt","GER","MF","30-163",1993,17.5,42,18,20,17,5,15,39,38.5,24,18,1,17,13,55,6,0,"https://fbref.com/en/players/dc62fbee/Leonardo-Bittencourt"
2024,"Werder Bremen","Bundesliga","Rafael Borré","COL","FW","28-258",1995,11,10,7,2,4,4,5,16,31.3,11,8,2,6,2,12,10,0,"https://fbref.com/en/players/c68da769/Rafael-Borre"
2024,"Werder Bremen","Bundesliga","Oliver Burke","SCO","FW","27-053",1997,0.4,0,0,0,0,0,0,2,0,2,0,0,0,0,0,0,0,"https://fbref.com/en/players/f631c17f/Oliver-Burke"
2024,"Werder Bremen","Bundesliga","Olivier Deman","BEL","DF","24-054",2000,15.2,28,15,21,4,3,18,38,47.4,20,24,8,16,14,42,49,1,"https://fbref.com/en/players/13210854/Olivier-Deman"
2024,"Werder Bremen","Bundesliga","Marvin Ducksch","GER","FW","30-084",1994,30,8,3,4,3,1,6,14,42.9,8,2,0,2,4,12,25,0,"https://fbref.com/en/players/638a4d71/Marvin-Ducksch"
2024,"Werder Bremen","Bundesliga","Marco Friedl","AUT","DF","26-075",1998,24.4,53,32,38,15,0,36,48,75,12,45,29,16,35,88,129,0,"https://fbref.com/en/players/f86ad3f5/Marco-Friedl"
2024,"Werder Bremen","Bundesliga","Niclas Füllkrug","GER","FW","31-111",1993,2,1,1,0,1,0,1,1,100,0,2,1,1,0,1,1,0,"https://fbref.com/en/players/4f16405e/Niclas-Fullkrug"
2024,"Werder Bremen","Bundesliga","Christian Groß","GER","DF,MF","35-112",1989,8.9,21,16,11,9,1,11,25,44,14,17,6,11,13,34,28,1,"https://fbref.com/en/players/14a7af33/Christian-Gross"
2024,"Werder Bremen","Bundesliga","Ilia Gruev","BUL","MF","24-024",2000,0,0,0,0,0,0,0,0,NA,0,0,0,0,0,0,0,0,"https://fbref.com/en/players/1fc4f3d1/Ilia-Gruev"
2024,"Werder Bremen","Bundesliga","Isak Hansen-Aarøen","NOR","MF","19-282",2004,0.3,0,0,0,0,0,0,1,0,1,1,0,1,1,1,0,0,"https://fbref.com/en/players/4f96ed39/Isak-Hansen-Aaroen"
2024,"Werder Bremen","Bundesliga","Joel Imasuen","USA","FW","19-216",2004,0,0,0,0,0,0,0,0,NA,0,0,0,0,0,0,0,0,"https://fbref.com/en/players/fb6316d5/Joel-Imasuen"
2024,"Werder Bremen","Bundesliga","Anthony Jung","GER","DF","32-209",1991,28.7,37,23,21,14,2,18,33,54.5,15,39,17,22,24,61,102,0,"https://fbref.com/en/players/de838f86/Anthony-Jung"
2024,"Werder Bremen","Bundesliga","Naby Keïta","GUI","MF,DF","29-110",1995,1.2,1,1,1,0,0,0,1,0,1,2,0,2,2,3,1,0,"https://fbref.com/en/players/f25c8e3a/Naby-Keita"
2024,"Werder Bremen","Bundesliga","Dawid Kownacki","POL","FW","27-077",1997,4.2,1,1,1,0,0,1,4,25,3,3,1,2,0,1,1,0,"https://fbref.com/en/players/be5e1c4c/Dawid-Kownacki"
2024,"Werder Bremen","Bundesliga","Senne Lynen","BEL","MF","25-101",1999,20,64,38,33,27,4,30,70,42.9,40,41,8,33,41,105,56,0,"https://fbref.com/en/players/0ed60738/Senne-Lynen"
2024,"Werder Bremen","Bundesliga","Julián Malatini","ARG","DF","22-365",2001,6.7,18,13,12,3,3,16,24,66.7,8,8,1,7,13,31,26,0,"https://fbref.com/en/players/8b84b707/Julian-Malatini"
2024,"Werder Bremen","Bundesliga","Justin Njinmah","GER","FW","23-197",2000,11.3,5,1,2,2,1,3,9,33.3,6,9,1,8,2,7,6,0,"https://fbref.com/en/players/a45241d5/Justin-Njinmah"
2024,"Werder Bremen","Bundesliga","Leon Opitz","GER","FW,DF","19-049",2005,0.2,2,2,1,1,0,2,3,66.7,1,0,0,0,0,2,0,0,"https://fbref.com/en/players/319fa018/Leon-Opitz"
2024,"Werder Bremen","Bundesliga","Jiří Pavlenka","CZE","GK","32-046",1992,7,0,0,0,0,0,0,0,NA,0,0,0,0,0,0,2,0,"https://fbref.com/en/players/0a1cb833/Jiri-Pavlenka"
2024,"Werder Bremen","Bundesliga","Amos Pieper","GER","DF","26-134",1998,6.6,14,11,8,6,0,7,13,53.8,6,12,7,5,9,23,36,1,"https://fbref.com/en/players/526ea7cc/Amos-Pieper"
2024,"Werder Bremen","Bundesliga","Nicolai Rapp","GER","DF","27-169",1996,0.8,3,2,2,1,0,2,2,100,0,2,0,2,2,5,8,0,"https://fbref.com/en/players/c8b3a472/Nicolai-Rapp"
2024,"Werder Bremen","Bundesliga","Romano Schmid","AUT","MF,FW","24-124",2000,28.9,35,20,7,22,6,14,46,30.4,32,36,7,29,11,46,17,2,"https://fbref.com/en/players/220ace7e/Romano-Schmid"
2024,"Werder Bremen","Bundesliga","Jens Stage","DEN","MF","27-204",1996,25.9,52,22,21,23,8,18,50,36,32,42,23,19,23,75,55,0,"https://fbref.com/en/players/1fffae99/Jens-Stage"
2024,"Werder Bremen","Bundesliga","Niklas Stark","GER","DF","29-046",1995,12.1,26,15,13,11,2,12,18,66.7,6,14,7,7,19,45,61,1,"https://fbref.com/en/players/aad48be9/Niklas-Stark"
2024,"Werder Bremen","Bundesliga","Miloš Veljković","SRB","DF","28-247",1995,21.3,31,15,17,13,1,16,31,51.6,15,31,20,11,17,48,57,0,"https://fbref.com/en/players/a5ae8f8e/Milos-Veljkovic"
2024,"Werder Bremen","Bundesliga","Mitchell Weiser","GER","DF,MF","30-039",1994,29.3,64,38,29,25,10,31,53,58.5,22,36,6,30,20,84,43,0,"https://fbref.com/en/players/30c220c3/Mitchell-Weiser"
2024,"Werder Bremen","Bundesliga","Nick Woltemade","GER","FW,MF","22-106",2002,13.2,34,23,7,20,7,15,21,71.4,6,12,0,12,5,39,17,0,"https://fbref.com/en/players/7ca196eb/Nick-Woltemade"
2024,"Werder Bremen","Bundesliga","Michael Zetterer","GER","GK","28-323",1995,27,3,1,3,0,0,3,3,100,0,0,0,0,0,3,7,3,"https://fbref.com/en/players/9b688ae1/Michael-Zetterer"
2024,"West Ham","Premier League","Nayef Aguerd","MAR","DF","28-061",1996,20.6,26,14,19,7,0,16,22,72.7,6,33,24,9,17,43,85,2,"https://fbref.com/en/players/288e1e13/Nayef-Aguerd"
2024,"West Ham","Premier League","Edson Álvarez","MEX","MF","26-219",1997,26.4,80,39,47,26,7,31,66,47,35,59,20,39,42,122,81,0,"https://fbref.com/en/players/8b3ab7ad/Edson-Alvarez"
2024,"West Ham","Premier League","Michail Antonio","JAM","FW","34-063",1990,18.8,15,8,5,6,4,3,11,27.3,8,16,3,13,4,19,4,0,"https://fbref.com/en/players/ac05f970/Michail-Antonio"
2024,"West Ham","Premier League","Alphonse Areola","FRA","GK","31-093",1993,30,1,1,1,0,0,1,3,33.3,2,0,0,0,1,2,16,0,"https://fbref.com/en/players/2f965a72/Alphonse-Areola"
2024,"West Ham","Premier League","Saïd Benrahma","ALG","FW,MF","28-294",1995,6.9,8,4,5,3,0,4,15,26.7,11,8,0,8,5,13,7,0,"https://fbref.com/en/players/5a04fd92/Said-Benrahma"
2024,"West Ham","Premier League","Jarrod Bowen","ENG","FW","27-162",1996,33.5,42,28,14,14,14,13,35,37.1,22,37,5,32,19,61,14,0,"https://fbref.com/en/players/79c84d1c/Jarrod-Bowen"
2024,"West Ham","Premier League","Kaelan Casey","ENG","DF","19-215",2004,0,0,0,0,0,0,0,0,NA,0,0,0,0,0,0,1,0,"https://fbref.com/en/players/cd4b2c5f/Kaelan-Casey"
2024,"West Ham","Premier League","Maxwel Cornet","CIV","MF,FW","27-246",1996,1.2,3,2,3,0,0,1,5,20,4,2,0,2,2,5,1,0,"https://fbref.com/en/players/beb391dd/Maxwel-Cornet"
2024,"West Ham","Premier League","Vladimír Coufal","CZE","DF","31-282",1992,34.8,64,41,50,12,2,38,75,50.7,37,49,15,34,43,107,97,0,"https://fbref.com/en/players/fdf3cb77/Vladimir-Coufal"
2024,"West Ham","Premier League","Aaron Cresswell","ENG","DF,FW","34-167",1989,4.8,3,2,1,1,1,2,3,66.7,1,5,3,2,3,6,7,0,"https://fbref.com/en/players/4f974391/Aaron-Cresswell"
2024,"West Ham","Premier League","George Earthy","ENG","FW","19-268",2004,0.4,0,0,0,0,0,0,1,0,1,0,0,0,1,1,0,0,"https://fbref.com/en/players/123d2733/George-Earthy"
2024,"West Ham","Premier League","Łukasz Fabiański","POL","GK","39-042",1985,8,1,0,1,0,0,1,2,50,1,0,0,0,1,2,4,0,"https://fbref.com/en/players/9328b835/Lukasz-Fabianski"
2024,"West Ham","Premier League","Pablo Fornals","ESP","MF,FW","28-098",1996,4.7,10,6,4,3,3,5,16,31.3,11,8,1,7,6,16,7,0,"https://fbref.com/en/players/82927de4/Pablo-Fornals"
2024,"West Ham","Premier League","Danny Ings","ENG","FW","31-312",1992,4.5,6,2,0,6,0,4,13,30.8,9,4,1,3,3,9,7,0,"https://fbref.com/en/players/07802f7f/Danny-Ings"
2024,"West Ham","Premier League","Ben Johnson","ENG","DF,FW","24-127",2000,6,11,7,7,3,1,9,14,64.3,5,2,1,1,5,16,14,0,"https://fbref.com/en/players/9319781b/Ben-Johnson"
2024,"West Ham","Premier League","Thilo Kehrer","GER","DF,MF","27-252",1996,0.2,1,1,0,1,0,0,0,NA,0,2,2,0,0,1,0,0,"https://fbref.com/en/players/51dbeea9/Thilo-Kehrer"
2024,"West Ham","Premier League","Mohammed Kudus","GHA","FW,MF","23-302",2000,27.6,65,47,27,27,11,20,40,50,20,25,0,25,11,76,9,1,"https://fbref.com/en/players/b62878a5/Mohammed-Kudus"
2024,"West Ham","Premier League","Konstantinos Mavropanos","GRE","DF","26-171",1997,16.7,28,16,17,9,2,17,21,81,4,21,13,8,23,51,79,3,"https://fbref.com/en/players/00963611/Konstantinos-Mavropanos"
2024,"West Ham","Premier League","Divin Mubama","ENG","FW","19-218",2004,0.9,0,0,0,0,0,0,0,NA,0,0,0,0,0,0,0,0,"https://fbref.com/en/players/92868cb5/Divin-Mubama"
2024,"West Ham","Premier League","Angelo Ogbonna","ITA","DF","36-007",1988,7.1,11,5,9,2,0,6,7,85.7,1,13,10,3,3,14,29,0,"https://fbref.com/en/players/74b2cd7e/Angelo-Ogbonna"
2024,"West Ham","Premier League","Emerson Palmieri","ITA","DF","29-301",1994,34.9,106,68,48,42,16,57,90,63.3,33,47,15,32,43,149,96,0,"https://fbref.com/en/players/e0bc6fdc/Emerson-Palmieri"
2024,"West Ham","Premier League","Lucas Paquetá","BRA","FW,MF","26-277",1997,29.1,71,48,38,26,7,25,52,48.1,27,28,1,27,21,92,28,2,"https://fbref.com/en/players/9b6f7fd5/Lucas-Paqueta"
2024,"West Ham","Premier League","Kalvin Phillips","ENG","MF","28-180",1995,3.4,11,6,2,8,1,5,9,55.6,4,4,1,3,4,15,2,1,"https://fbref.com/en/players/4f565d77/Kalvin-Phillips"
2024,"West Ham","Premier League","Tomáš Souček","CZE","MF","29-093",1995,31.9,53,35,24,26,3,21,47,44.7,26,55,28,27,37,90,109,0,"https://fbref.com/en/players/6613c819/Tomas-Soucek"
2024,"West Ham","Premier League","James Ward-Prowse","ENG","MF","29-211",1994,33.3,45,29,14,23,8,18,44,40.9,26,31,9,22,38,83,49,0,"https://fbref.com/en/players/3515d404/James-Ward-Prowse"
2024,"West Ham","Premier League","Kurt Zouma","FRA","DF","29-216",1994,31.5,23,17,14,9,0,10,16,62.5,6,38,28,10,29,52,160,0,"https://fbref.com/en/players/ce4246f5/Kurt-Zouma"
2024,"Wolfsburg","Bundesliga","Kofi Amoako","GER","MF","19-024",2005,0,0,0,0,0,0,0,0,NA,0,0,0,0,0,0,0,0,"https://fbref.com/en/players/b8e17ca3/Kofi-Amoako"
2024,"Wolfsburg","Bundesliga","Maximilian Arnold","GER","MF","30-003",1994,27.8,51,31,15,27,9,28,57,49.1,29,23,4,19,24,75,60,0,"https://fbref.com/en/players/86e119e0/Maximilian-Arnold"
2024,"Wolfsburg","Bundesliga","Ridle Baku","GER","DF,MF","26-052",1998,22.4,37,20,24,7,6,21,46,45.7,25,27,1,26,21,58,45,1,"https://fbref.com/en/players/442b56fa/Ridle-Baku"
2024,"Wolfsburg","Bundesliga","Kevin Behrens","GER","FW","33-117",1991,6.8,2,1,0,1,1,0,2,0,2,9,0,9,3,5,6,0,"https://fbref.com/en/players/30ae134d/Kevin-Behrens"
2024,"Wolfsburg","Bundesliga","Sebastiaan Bornauw","BEL","DF","25-069",1999,15.9,26,12,19,7,0,13,19,68.4,6,21,12,9,18,44,81,0,"https://fbref.com/en/players/01834aa0/Sebastiaan-Bornauw"
2024,"Wolfsburg","Bundesliga","Bennit Bröger","GER","FW","17-334",2006,0.1,0,0,0,0,0,0,0,NA,0,0,0,0,0,0,0,0,"https://fbref.com/en/players/2d6b4904/Bennit-Broger"
2024,"Wolfsburg","Bundesliga","Koen Casteels","BEL","GK","31-340",1992,25,2,1,2,0,0,2,3,66.7,1,0,0,0,0,2,16,5,"https://fbref.com/en/players/db401046/Koen-Casteels"
2024,"Wolfsburg","Bundesliga","Václav Černý","CZE","FW,MF","26-226",1997,10.2,8,3,3,4,1,2,14,14.3,12,13,0,13,8,16,6,0,"https://fbref.com/en/players/bb1cf301/Vaclav-Cerny"
2024,"Wolfsburg","Bundesliga","Nicolas Cozza","FRA","DF","25-143",1999,3.1,8,6,4,4,0,2,7,28.6,5,3,0,3,4,12,6,0,"https://fbref.com/en/players/8f325097/Nicolas-Cozza"
2024,"Wolfsburg","Bundesliga","Kilian Fischer","GER","DF,MF","23-231",2000,3.2,8,6,4,3,1,2,5,40,3,8,1,7,1,9,12,0,"https://fbref.com/en/players/79f7302a/Kilian-Fischer"
2024,"Wolfsburg","Bundesliga","Yannick Gerhardt","GER","MF,DF","30-078",1994,18.1,31,20,16,12,3,9,32,28.1,23,15,2,13,7,38,35,0,"https://fbref.com/en/players/62ab9184/Yannick-Gerhardt"
2024,"Wolfsburg","Bundesliga","Moritz Jenz","GER","DF","25-030",1999,19.4,34,24,21,11,2,14,21,66.7,7,29,17,12,26,60,94,0,"https://fbref.com/en/players/ee644761/Moritz-Jenz"
2024,"Wolfsburg","Bundesliga","Jakub Kamiński","POL","FW,MF","21-360",2002,5.3,14,5,12,2,0,3,6,50,3,3,0,3,2,16,5,0,"https://fbref.com/en/players/202b3b68/Jakub-Kaminski"
2024,"Wolfsburg","Bundesliga","Maxence Lacroix","FRA","DF","24-054",2000,26.2,48,29,28,18,2,29,41,70.7,12,35,12,23,24,72,121,0,"https://fbref.com/en/players/277c49ed/Maxence-Lacroix"
2024,"Wolfsburg","Bundesliga","Lovro Majer","CRO","MF,FW","26-134",1998,23.4,39,18,17,22,0,12,31,38.7,19,20,1,19,12,51,13,0,"https://fbref.com/en/players/fc46aab1/Lovro-Majer"
2024,"Wolfsburg","Bundesliga","Joakim Mæhle","DEN","DF,MF","27-010",1997,27.2,62,39,33,18,11,41,64,64.1,23,43,5,38,29,91,65,0,"https://fbref.com/en/players/c459a650/Joakim-Maehle"
2024,"Wolfsburg","Bundesliga","Lukas Nmecha","GER","FW","25-168",1998,0.5,1,1,0,0,1,0,0,NA,0,1,0,1,0,1,0,0,"https://fbref.com/en/players/0cc5f4a5/Lukas-Nmecha"
2024,"Wolfsburg","Bundesliga","Kevin Paredes","USA","FW,MF","21-023",2003,15.9,42,21,22,13,7,20,34,58.8,14,27,2,25,23,65,26,0,"https://fbref.com/en/players/5c50fdbc/Kevin-Paredes"
2024,"Wolfsburg","Bundesliga","Dženan Pejčinović","GER","FW","19-105",2005,0.4,0,0,0,0,0,0,0,NA,0,1,0,1,0,0,0,0,"https://fbref.com/en/players/80f252f6/Dzenan-Pejcinovic"
2024,"Wolfsburg","Bundesliga","Pavao Pervan","AUT","GK","36-199",1987,9,0,0,0,0,0,0,0,NA,0,0,0,0,0,0,4,0,"https://fbref.com/en/players/c89e8aae/Pavao-Pervan"
2024,"Wolfsburg","Bundesliga","Rogério","BRA","DF","26-138",1998,10.1,14,6,7,5,2,10,14,71.4,4,16,5,11,5,19,23,1,"https://fbref.com/en/players/10e7f486/Rogerio"
2024,"Wolfsburg","Bundesliga","Amin Sarr","SWE","FW,MF","23-080",2001,4.3,3,2,1,2,0,1,2,50,1,6,1,5,2,5,1,0,"https://fbref.com/en/players/d5326924/Amin-Sarr"
2024,"Wolfsburg","Bundesliga","Mattias Svanberg","SWE","MF","25-146",1999,19.1,37,17,8,19,10,12,38,31.6,26,25,5,20,21,58,28,0,"https://fbref.com/en/players/92d83c27/Mattias-Svanberg"
2024,"Wolfsburg","Bundesliga","Tiago Tomás","POR","FW,MF","21-349",2002,11.5,5,2,3,0,2,1,6,16.7,5,13,0,13,3,8,9,0,"https://fbref.com/en/players/b492126a/Tiago-Tomas"
2024,"Wolfsburg","Bundesliga","Aster Vranckx","BEL","MF","21-239",2002,12.8,32,15,11,11,10,15,28,53.6,13,17,6,11,14,46,29,0,"https://fbref.com/en/players/f86cd5df/Aster-Vranckx"
2024,"Wolfsburg","Bundesliga","Patrick Wimmer","AUT","FW,MF","23-000",2001,6.5,14,5,5,5,4,8,18,44.4,10,14,0,14,3,17,7,0,"https://fbref.com/en/players/cb11b429/Patrick-Wimmer"
2024,"Wolfsburg","Bundesliga","Jonas Wind","DEN","FW","25-113",1999,29.5,13,10,4,6,3,7,17,41.2,10,13,4,9,3,16,21,0,"https://fbref.com/en/players/2077ae86/Jonas-Wind"
2024,"Wolfsburg","Bundesliga","Cedric Zesiger","SUI","DF","25-341",1998,18.2,19,9,13,4,2,10,22,45.5,12,32,21,11,15,34,88,1,"https://fbref.com/en/players/2bab583c/Cedric-Zesiger"
2024,"Wolves","Premier League","Rayan Aït-Nouri","ALG","DF,MF","22-359",2001,25.9,71,44,41,23,7,28,49,57.1,21,32,6,26,15,86,38,0,"https://fbref.com/en/players/9b398aea/Rayan-Ait-Nouri"
2024,"Wolves","Premier League","Jean-Ricner Bellegarde","FRA","MF,FW","25-338",1998,10.6,17,10,9,6,2,7,15,46.7,8,18,2,16,8,25,14,0,"https://fbref.com/en/players/10f0fdd3/Jean-Ricner-Bellegarde"
2024,"Wolves","Premier League","Daniel Bentley","ENG","GK","30-322",1993,4.3,0,0,0,0,0,0,1,0,1,0,0,0,0,0,1,0,"https://fbref.com/en/players/68db6358/Daniel-Bentley"
2024,"Wolves","Premier League","Hugo Bueno","ESP","DF,MF","21-255",2002,8.2,21,14,12,7,2,12,19,63.2,7,17,4,13,6,27,24,0,"https://fbref.com/en/players/bfc3b3a0/Hugo-Bueno"
2024,"Wolves","Premier League","Santiago Bueno","URU","DF","25-203",1998,9.1,13,7,5,7,1,5,11,45.5,6,22,12,10,6,19,33,0,"https://fbref.com/en/players/edc98fac/Santiago-Bueno"
2024,"Wolves","Premier League","Jonny Castro","ESP","MF","30-088",1994,0.1,0,0,0,0,0,0,1,0,1,1,1,0,0,0,0,0,"https://fbref.com/en/players/e28868f3/Jonny-Castro"
2024,"Wolves","Premier League","Tawanda Chirewa","ENG","MF,FW","20-232",2003,1.6,7,3,3,3,1,2,3,66.7,1,0,0,0,1,8,0,0,"https://fbref.com/en/players/34721c11/Tawanda-Chirewa"
2024,"Wolves","Premier League","Leon Chiwome","ENG","FW","18-141",2006,1.9,2,1,0,1,1,1,2,50,1,3,1,2,0,2,2,0,"https://fbref.com/en/players/a2852b4f/Leon-Chiwome"
2024,"Wolves","Premier League","Matheus Cunha","BRA","FW,MF","25-003",1999,27.1,30,16,8,17,5,13,35,37.1,22,28,7,21,13,43,21,1,"https://fbref.com/en/players/dc62b55d/Matheus-Cunha"
2024,"Wolves","Premier League","Craig Dawson","ENG","DF","34-024",1990,24.5,30,20,23,6,1,22,34,64.7,12,51,39,12,16,46,120,1,"https://fbref.com/en/players/3e9e06cb/Craig-Dawson"
2024,"Wolves","Premier League","Matt Doherty","IRL","DF,MF","32-135",1992,12.8,31,18,17,10,4,12,23,52.2,11,15,5,10,7,38,47,0,"https://fbref.com/en/players/d557d734/Matt-Doherty"
2024,"Wolves","Premier League","Tommy Doyle","ENG","MF","22-226",2001,13.6,26,13,11,10,5,14,23,60.9,9,22,9,13,12,38,18,0,"https://fbref.com/en/players/5526deb1/Tommy-Doyle"
2024,"Wolves","Premier League","Nathan Fraser","IRL","FW","19-098",2005,2.1,5,2,2,1,2,1,3,33.3,2,2,1,1,1,6,2,0,"https://fbref.com/en/players/00b77ecf/Nathan-Fraser"
2024,"Wolves","Premier League","João Gomes","BRA","MF","23-108",2001,29.4,128,74,67,49,12,44,99,44.4,55,51,8,43,18,146,29,2,"https://fbref.com/en/players/8b57ad2c/Joao-Gomes"
2024,"Wolves","Premier League","Toti Gomes","POR","DF","25-135",1999,30.8,44,25,32,8,4,24,37,64.9,13,40,19,21,26,70,93,2,"https://fbref.com/en/players/f0caab96/Toti-Gomes"
2024,"Wolves","Premier League","Enso Gonzalez","PAR","MF,DF","19-131",2005,0,0,0,0,0,0,0,1,0,1,0,0,0,0,0,0,0,"https://fbref.com/en/players/7e5bebeb/Enso-Gonzalez"
2024,"Wolves","Premier League","Hwang Hee-chan","KOR","FW,MF","28-125",1996,23.5,20,10,11,8,1,9,24,37.5,15,19,1,18,10,30,9,0,"https://fbref.com/en/players/169fd162/Hwang-Hee-chan"
2024,"Wolves","Premier League","Sasa Kalajdzic","AUT","FW","26-328",1997,1.8,6,2,3,2,1,1,2,50,1,3,0,3,1,7,6,0,"https://fbref.com/en/players/15f24fe7/Sasa-Kalajdzic"
2024,"Wolves","Premier League","Max Kilman","ENG","DF","27-007",1997,38,47,21,40,6,1,24,32,75,8,64,37,27,39,86,182,4,"https://fbref.com/en/players/d0f72bf1/Max-Kilman"
2024,"Wolves","Premier League","Mario Lemina","GAB","MF","30-272",1993,33,90,58,46,33,11,25,47,53.2,22,36,9,27,41,131,64,0,"https://fbref.com/en/players/2b471f99/Mario-Lemina"
2024,"Wolves","Premier League","Pedro Neto","POR","FW,MF","24-082",2000,16.8,7,3,3,2,2,5,15,33.3,10,5,1,4,5,12,2,0,"https://fbref.com/en/players/7ba2eaa9/Pedro-Neto"
2024,"Wolves","Premier League","Matheus Nunes","POR","MF","25-277",1998,2,3,1,3,0,0,2,6,33.3,4,0,0,0,6,9,1,0,"https://fbref.com/en/players/e6af02e0/Matheus-Nunes"
2024,"Wolves","Premier League","José Sá","POR","GK","31-134",1993,33.7,0,0,0,0,0,0,1,0,1,3,0,3,0,0,21,5,"https://fbref.com/en/players/903b6e8b/Jose-Sa"
2024,"Wolves","Premier League","Pablo Sarabia","ESP","MF,FW","32-019",1992,19.4,20,13,8,8,4,12,36,33.3,24,17,1,16,10,30,9,0,"https://fbref.com/en/players/9744ff80/Pablo-Sarabia"
2024,"Wolves","Premier League","Nélson Semedo","POR","DF,MF","30-196",1993,34.3,79,48,52,19,8,38,64,59.4,26,44,8,36,36,115,85,1,"https://fbref.com/en/players/d04b94db/Nelson-Semedo"
2024,"Wolves","Premier League","Fábio Silva","POR","FW","21-316",2002,2.9,7,4,3,4,0,2,3,66.7,1,1,0,1,2,9,0,0,"https://fbref.com/en/players/e7aa9d7c/Fabio-Silva"
2024,"Wolves","Premier League","Boubacar Traoré","MLI","MF","22-284",2001,9.1,35,23,16,17,2,9,21,42.9,12,12,2,10,5,40,7,0,"https://fbref.com/en/players/999ceb5f/Boubacar-Traore"
2025,"Alavés","La Liga","Abdel Abqar","MAR","DF","25-221",1999,7.5,8,5,3,5,0,2,6,33.3,4,6,3,3,18,26,33,0,"https://fbref.com/en/players/2bc7f211/Abdel-Abqar"
2025,"Alavés","La Liga","Carlos Benavídez","URU","MF","26-201",1998,2.4,5,3,2,2,1,0,3,0,3,1,1,0,5,10,3,1,"https://fbref.com/en/players/9fb45456/Carlos-Benavidez"
2025,"Alavés","La Liga","Antonio Blanco","ESP","MF","24-086",2000,5.8,11,7,4,7,0,8,14,57.1,6,8,2,6,7,18,4,0,"https://fbref.com/en/players/506daeac/Antonio-Blanco"
2025,"Alavés","La Liga","Tomás Conechny","ARG","MF,FW","26-201",1998,4.3,4,2,2,2,0,2,10,20,8,7,1,6,3,7,3,0,"https://fbref.com/en/players/f61143dd/Tomas-Conechny"
2025,"Alavés","La Liga","Moussa Diarra","MLI","DF","23-342",2000,4.2,10,7,5,5,0,6,10,60,4,2,0,2,4,14,2,0,"https://fbref.com/en/players/698f11e3/Moussa-Diarra"
2025,"Alavés","La Liga","Ander Guevara","ESP","MF","27-102",1997,5.4,9,5,4,4,1,5,13,38.5,8,6,0,6,2,11,10,0,"https://fbref.com/en/players/8e48dc61/Ander-Guevara"
2025,"Alavés","La Liga","Jon Guridi","ESP","MF","29-232",1995,4.2,6,3,3,2,1,3,8,37.5,5,1,0,1,4,10,4,0,"https://fbref.com/en/players/4c0a6a48/Jon-Guridi"
2025,"Alavés","La Liga","Joan Jordán","ESP","MF","30-103",1994,2.4,8,6,2,4,2,4,8,50,4,2,0,2,0,8,4,0,"https://fbref.com/en/players/2a0c8ba4/Joan-Jordan"
2025,"Alavés","La Liga","Kiké","ESP","FW","34-327",1989,4.7,2,2,0,2,0,1,2,50,1,0,0,0,0,2,3,0,"https://fbref.com/en/players/e897d8ba/Kike"
2025,"Alavés","La Liga","Carlos Martín","ESP","FW,MF","22-178",2002,2,5,2,1,3,1,2,6,33.3,4,5,1,4,0,5,3,0,"https://fbref.com/en/players/64035864/Carlos-Martin"
2025,"Alavés","La Liga","Toni Martínez","ESP","FW","27-109",1997,3,3,2,0,1,2,0,1,0,1,3,1,2,0,3,4,0,"https://fbref.com/en/players/f3945e07/Toni-Martinez"
2025,"Alavés","La Liga","Santiago Mouriño","URU","DF","22-247",2002,2.7,11,8,10,1,0,6,12,50,6,1,0,1,4,15,9,0,"https://fbref.com/en/players/91ee5785/Santiago-Mourino"
2025,"Alavés","La Liga","Hugo Novoa","ESP","DF,FW","21-290",2003,2.5,8,5,4,3,1,5,5,100,0,2,1,1,0,8,6,0,"https://fbref.com/en/players/5458f670/Hugo-Novoa"
2025,"Alavés","La Liga","Pica","ESP","DF","22-290",2002,1.5,2,2,2,0,0,2,4,50,2,4,4,0,2,4,5,0,"https://fbref.com/en/players/9b30eda5/Pica"
2025,"Alavés","La Liga","Abderrahman Rebbach","ALG","FW,MF","26-067",1998,2.3,0,0,0,0,0,0,3,0,3,2,0,2,0,0,3,0,"https://fbref.com/en/players/9a796115/Abderrahman-Rebbach"
2025,"Alavés","La Liga","Luis Rioja","ESP","FW","31-001",1993,0.3,2,1,0,1,1,1,2,50,1,2,0,2,0,2,0,0,"https://fbref.com/en/players/eb3dd471/Luis-Rioja"
2025,"Alavés","La Liga","Luka Romero","ARG","FW,MF","19-334",2004,1.7,4,4,1,1,2,2,3,66.7,1,1,0,1,1,5,0,0,"https://fbref.com/en/players/ca6edaa0/Luka-Romero"
2025,"Alavés","La Liga","Manu Sánchez","ESP","DF","24-054",2000,6.5,9,5,3,3,3,5,10,50,5,14,2,12,8,17,15,0,"https://fbref.com/en/players/ffacd3d5/Manu-Sanchez"
2025,"Alavés","La Liga","Aleksandar Sedlar","SRB","DF","32-309",1991,4.5,15,9,5,10,0,7,9,77.8,2,2,1,1,7,22,7,1,"https://fbref.com/en/players/a35134ae/Aleksandar-Sedlar"
2025,"Alavés","La Liga","Antonio Sivera","ESP","GK","28-067",1996,9,0,0,0,0,0,0,0,NA,0,0,0,0,0,0,4,0,"https://fbref.com/en/players/9970da54/Antonio-Sivera"
2025,"Alavés","La Liga","Stoichkov","ESP","MF,FW","30-347",1993,5.6,12,7,5,6,1,5,10,50,5,1,0,1,1,13,5,0,"https://fbref.com/en/players/4e257184/Stoichkov"
2025,"Alavés","La Liga","Nahuel Tenaglia","ARG","DF","28-239",1996,6.5,19,9,14,3,2,10,15,66.7,5,3,2,1,8,27,23,0,"https://fbref.com/en/players/66654daa/Nahuel-Tenaglia"
2025,"Alavés","La Liga","Carlos Vicente","ESP","FW,MF","25-177",1999,7.9,10,7,6,2,2,4,5,80,1,3,0,3,3,13,6,0,"https://fbref.com/en/players/90df343e/Carlos-Vicente"
2025,"Alavés","La Liga","Asier Villalibre","ESP","FW","27-017",1997,2,0,0,0,0,0,0,0,NA,0,1,0,1,1,1,4,0,"https://fbref.com/en/players/57be54ec/Asier-Villalibre"
2025,"Angers","Ligue 1","Himad Abdelli","ALG","MF,FW","24-335",1999,6.9,13,9,2,5,6,5,12,41.7,7,6,0,6,6,19,6,0,"https://fbref.com/en/players/7978cbf0/Himad-Abdelli"
2025,"Angers","Ligue 1","Jean-Eudes Aholou","CIV","MF","30-211",1994,5.1,13,10,6,4,3,6,13,46.2,7,5,2,3,8,21,6,0,"https://fbref.com/en/players/48b28bfd/Jean-Eudes-Aholou"
2025,"Angers","Ligue 1","Jim Allevinah","GAB","FW","29-233",1995,2.5,2,1,1,0,1,0,2,0,2,1,0,1,1,3,3,0,"https://fbref.com/en/players/1956b948/Jim-Allevinah"
2025,"Angers","Ligue 1","Carlens Arcus","HAI","DF","28-111",1996,5.3,14,6,8,5,1,8,18,44.4,10,8,1,7,10,24,8,1,"https://fbref.com/en/players/5e837126/Carlens-Arcus"
2025,"Angers","Ligue 1","Abdoulaye Bamba","CIV","DF","34-175",1990,2.7,5,2,4,1,0,2,3,66.7,1,1,1,0,4,9,12,0,"https://fbref.com/en/players/7fecbcdb/Abdoulaye-Bamba"
2025,"Angers","Ligue 1","Haris Belkebla","ALG","MF","30-263",1994,3.9,8,6,6,2,0,3,8,37.5,5,5,1,4,2,10,4,1,"https://fbref.com/en/players/2b1bed19/Haris-Belkebla"
2025,"Angers","Ligue 1","Yassin Belkhdim","FRA","MF","22-246",2002,3.2,11,5,3,5,3,3,5,60,2,5,1,4,6,17,4,0,"https://fbref.com/en/players/e21d1928/Yassin-Belkhdim"
2025,"Angers","Ligue 1","Emmanuel Biumla","FRA","DF","19-162",2005,4.1,10,5,6,4,0,8,10,80,2,5,1,4,4,14,12,0,"https://fbref.com/en/players/e5a94f46/Emmanuel-Biumla"
2025,"Angers","Ligue 1","Pierrick Capelle","FRA","MF","37-185",1987,2,6,3,3,2,1,3,6,50,3,1,1,0,3,9,0,1,"https://fbref.com/en/players/79b2399c/Pierrick-Capelle"
2025,"Angers","Ligue 1","Sidiki Cherif","FRA","FW","17-307",2006,3.1,4,4,0,3,1,3,4,75,1,2,0,2,0,4,0,1,"https://fbref.com/en/players/78430598/Sidiki-Cherif"
2025,"Angers","Ligue 1","Bamba Dieng","SEN","FW","24-208",2000,2.3,2,0,0,1,1,0,0,NA,0,1,0,1,0,2,2,0,"https://fbref.com/en/players/40774c6b/Bamba-Dieng"
2025,"Angers","Ligue 1","Lois Diony","FRA","FW","31-302",1992,0.2,0,0,0,0,0,0,0,NA,0,0,0,0,0,0,0,0,"https://fbref.com/en/players/4be0b467/Lois-Diony"
2025,"Angers","Ligue 1","Jacques Ekomie","GAB","DF","21-059",2003,2.5,5,5,2,2,1,2,4,50,2,6,0,6,2,7,6,0,"https://fbref.com/en/players/8d5016e6/Jacques-Ekomie"
2025,"Angers","Ligue 1","Zinedine Ferhat","ALG","FW,MF","31-230",1993,2.3,1,0,0,1,0,0,2,0,2,1,0,1,2,3,2,0,"https://fbref.com/en/players/005c0807/Zinedine-Ferhat"
2025,"Angers","Ligue 1","Yahia Fofana","CIV","GK","24-057",2000,7,0,0,0,0,0,0,0,NA,0,0,0,0,0,0,8,0,"https://fbref.com/en/players/9d420dad/Yahia-Fofana"
2025,"Angers","Ligue 1","Florent Hanin","ALG","DF","34-256",1990,4.4,14,11,8,4,2,6,10,60,4,1,0,1,6,20,12,1,"https://fbref.com/en/players/6bfb4303/Florent-Hanin"
2025,"Angers","Ligue 1","Cédric Hountondji","BEN","DF","30-272",1994,3,6,4,4,2,0,3,7,42.9,4,3,3,0,4,10,14,0,"https://fbref.com/en/players/00891164/Cedric-Hountondji"
2025,"Angers","Ligue 1","Jordan Lefort","FRA","DF","31-069",1993,7,16,13,13,3,0,10,14,71.4,4,12,4,8,9,25,28,1,"https://fbref.com/en/players/c3e4ecbb/Jordan-Lefort"
2025,"Angers","Ligue 1","Esteban Lepaul","FRA","FW","24-182",2000,1.3,1,1,0,0,1,0,3,0,3,0,0,0,0,1,2,0,"https://fbref.com/en/players/85ce1949/Esteban-Lepaul"
2025,"Angers","Ligue 1","Farid El Melali","ALG","FW,DF","27-165",1997,4.3,6,1,1,2,3,3,10,30,7,4,1,3,3,9,3,1,"https://fbref.com/en/players/d21e361a/Farid-El-Melali"
2025,"Angers","Ligue 1","Ibrahima Niane","SEN","FW,MF","25-220",1999,1.2,1,1,1,0,0,1,1,100,0,2,1,1,0,1,3,1,"https://fbref.com/en/players/46faabfa/Ibrahima-Niane"
2025,"Angers","Ligue 1","Zinédine Ould Khaled","FRA","MF","24-277",2000,0.6,1,1,1,0,0,0,1,0,1,2,0,2,0,1,1,0,"https://fbref.com/en/players/6b4436ba/Zinedine-Ould-Khaled"
2025,"Angers","Ligue 1","Lilian Raolisoa","FRA","DF","24-123",2000,1.1,3,2,1,1,1,1,3,33.3,2,1,1,0,1,4,3,0,"https://fbref.com/en/players/79a793b7/Lilian-Raolisoa"
2025,"Arsenal","Premier League","Riccardo Calafiori","ITA","DF","22-151",2002,3.3,9,6,5,3,1,7,11,63.6,4,6,2,4,4,13,7,0,"https://fbref.com/en/players/aded8e6f/Riccardo-Calafiori"
2025,"Arsenal","Premier League","Kai Havertz","GER","FW,MF","25-128",1999,7,7,5,2,2,3,3,9,33.3,6,9,2,7,4,11,15,1,"https://fbref.com/en/players/fed7cb61/Kai-Havertz"
2025,"Arsenal","Premier League","Gabriel Jesus","BRA","FW,MF","27-197",1997,0.9,3,2,3,0,0,2,3,66.7,1,3,1,2,2,5,0,0,"https://fbref.com/en/players/b66315ae/Gabriel-Jesus"
2025,"Arsenal","Premier League","Jorginho","ITA","MF","32-302",1991,1.7,2,1,0,1,1,2,4,50,2,0,0,0,0,2,0,1,"https://fbref.com/en/players/45db685d/Jorginho"
2025,"Arsenal","Premier League","Jakub Kiwior","POL","DF","24-245",2000,0.2,0,0,0,0,0,0,0,NA,0,1,1,0,0,0,1,0,"https://fbref.com/en/players/dc3e663e/Jakub-Kiwior"
2025,"Arsenal","Premier League","Myles Lewis-Skelly","ENG","DF","18-021",2006,0,0,0,0,0,0,0,0,NA,0,0,0,0,0,0,1,0,"https://fbref.com/en/players/5dff6c28/Myles-Lewis-Skelly"
2025,"Arsenal","Premier League","Gabriel Magalhães","BRA","DF","26-303",1997,7,6,3,4,2,0,4,7,57.1,3,17,12,5,4,10,27,1,"https://fbref.com/en/players/67ac5bb8/Gabriel-Magalhaes"
2025,"Arsenal","Premier League","Gabriel Martinelli","BRA","MF,FW","23-121",2001,4.9,6,5,0,1,5,3,6,50,3,2,0,2,0,6,8,0,"https://fbref.com/en/players/48a5a5d6/Gabriel-Martinelli"
2025,"Arsenal","Premier League","Mikel Merino","ESP","MF","28-117",1996,0.3,3,2,0,2,1,2,2,100,0,2,2,0,2,5,0,0,"https://fbref.com/en/players/d080ed5e/Mikel-Merino"
2025,"Arsenal","Premier League","Reiss Nelson","ENG","FW","24-312",1999,0,1,0,0,1,0,0,1,0,1,0,0,0,0,1,1,0,"https://fbref.com/en/players/c5bdb6e3/Reiss-Nelson"
2025,"Arsenal","Premier League","Ethan Nwaneri","ENG","MF,FW","17-210",2007,0.1,0,0,0,0,0,0,0,NA,0,1,1,0,0,0,1,0,"https://fbref.com/en/players/7f94982c/Ethan-Nwaneri"
2025,"Arsenal","Premier League","Thomas Partey","GHA","MF,DF","31-126",1993,6.9,20,13,8,6,6,11,17,64.7,6,6,4,2,11,31,14,1,"https://fbref.com/en/players/529f49ab/Thomas-Partey"
2025,"Arsenal","Premier League","David Raya","ESP","GK","29-032",1995,7,0,0,0,0,0,0,0,NA,0,0,0,0,1,1,2,0,"https://fbref.com/en/players/98ea5115/David-Raya"
2025,"Arsenal","Premier League","Declan Rice","ENG","MF","25-277",1999,5.5,4,2,0,4,0,3,6,50,3,6,4,2,5,9,9,0,"https://fbref.com/en/players/1c7012b8/Declan-Rice"
2025,"Arsenal","Premier League","Bukayo Saka","ENG","MF,FW","23-042",2001,6.3,12,8,5,2,5,7,15,46.7,8,10,0,10,1,13,5,0,"https://fbref.com/en/players/bc7dc64d/Bukayo-Saka"
2025,"Arsenal","Premier League","William Saliba","FRA","DF","23-207",2001,7,20,11,12,8,0,8,9,88.9,1,5,2,3,5,25,23,1,"https://fbref.com/en/players/972aeb2a/William-Saliba"
2025,"Arsenal","Premier League","Raheem Sterling","ENG","MF,FW","29-314",1994,1,0,0,0,0,0,0,0,NA,0,1,0,1,0,0,0,0,"https://fbref.com/en/players/b400bde0/Raheem-Sterling"
2025,"Arsenal","Premier League","Jurriën Timber","NED","DF","23-122",2001,5,13,8,4,7,2,4,7,57.1,3,5,2,3,3,16,12,1,"https://fbref.com/en/players/41034650/Jurrien-Timber"
2025,"Arsenal","Premier League","Takehiro Tomiyasu","JPN","DF","25-347",1998,0.1,0,0,0,0,0,0,0,NA,0,0,0,0,0,0,1,0,"https://fbref.com/en/players/b3af9be1/Takehiro-Tomiyasu"
2025,"Arsenal","Premier League","Leandro Trossard","BEL","FW","29-318",1994,3.8,6,5,2,3,1,4,9,44.4,5,4,0,4,3,9,1,0,"https://fbref.com/en/players/38ceb24a/Leandro-Trossard"
2025,"Arsenal","Premier League","Ben White","ENG","DF","27-009",1997,4.5,7,5,5,1,1,6,13,46.2,7,4,3,1,6,13,13,0,"https://fbref.com/en/players/35e413f1/Ben-White"
2025,"Arsenal","Premier League","Oleksandr Zinchenko","UKR","DF","27-307",1996,0.9,0,0,0,0,0,0,0,NA,0,1,0,1,2,2,2,0,"https://fbref.com/en/players/51cf8561/Oleksandr-Zinchenko"
2025,"Arsenal","Premier League","Martin Ødegaard","NOR","MF","25-305",1998,2.8,5,3,1,3,1,1,4,25,3,0,0,0,1,6,0,0,"https://fbref.com/en/players/79300479/Martin-Odegaard"
2025,"Aston Villa","Premier League","Leon Bailey","JAM","FW,MF","27-069",1997,3.9,2,0,0,1,1,0,0,NA,0,1,0,1,0,2,4,0,"https://fbref.com/en/players/3a233281/Leon-Bailey"
2025,"Aston Villa","Premier League","Ross Barkley","ENG","MF","30-317",1993,2.4,5,2,3,2,0,4,6,66.7,2,3,1,2,1,6,2,0,"https://fbref.com/en/players/3a24769f/Ross-Barkley"
2025,"Aston Villa","Premier League","Lamare Bogarde","NED","DF","20-286",2004,1.9,8,4,2,5,1,5,9,55.6,4,1,0,1,1,9,4,0,"https://fbref.com/en/players/bca5c4a7/Lamare-Bogarde"
2025,"Aston Villa","Premier League","Emi Buendía","ARG","MF,FW","27-297",1996,0.2,1,1,1,0,0,0,1,0,1,2,0,2,0,1,0,0,"https://fbref.com/en/players/66b76d44/Emi-Buendia"
2025,"Aston Villa","Premier League","Diego Carlos","BRA","DF","31-216",1993,2.9,1,0,1,0,0,0,1,0,1,3,2,1,2,3,13,1,"https://fbref.com/en/players/b4a014b1/Diego-Carlos"
2025,"Aston Villa","Premier League","Matty Cash","POL","DF","27-071",1997,2.1,3,1,0,3,0,0,3,0,3,2,1,1,2,5,7,0,"https://fbref.com/en/players/2389cdc2/Matty-Cash"
2025,"Aston Villa","Premier League","Lucas Digne","FRA","DF","31-089",1993,5.8,20,14,11,6,3,12,19,63.2,7,7,2,5,9,29,14,0,"https://fbref.com/en/players/1b84dbe1/Lucas-Digne"
2025,"Aston Villa","Premier League","Jhon Durán","COL","FW","20-309",2003,2.1,3,3,1,0,2,1,3,33.3,2,2,0,2,0,3,4,0,"https://fbref.com/en/players/414184f7/Jhon-Duran"
2025,"Aston Villa","Premier League","Ezri Konsa","ENG","DF","26-360",1997,6.1,7,5,4,2,1,4,6,66.7,2,3,0,3,3,10,23,0,"https://fbref.com/en/players/0313a347/Ezri-Konsa"
2025,"Aston Villa","Premier League","Ian Maatsen","NED","DF,MF","22-221",2002,1.4,5,3,1,4,0,1,2,50,1,1,0,1,0,5,3,1,"https://fbref.com/en/players/cab9634e/Ian-Maatsen"
2025,"Aston Villa","Premier League","Emiliano Martínez","ARG","GK","32-045",1992,7,0,0,0,0,0,0,0,NA,0,0,0,0,0,0,6,2,"https://fbref.com/en/players/7956236f/Emiliano-Martinez"
2025,"Aston Villa","Premier League","John McGinn","SCO","FW,MF","29-365",1994,3.9,4,3,1,3,0,2,3,66.7,1,3,0,3,1,5,1,0,"https://fbref.com/en/players/90f91999/John-McGinn"
2025,"Aston Villa","Premier League","Kosta Nedeljković","SRB","DF","18-306",2005,1.1,7,5,1,3,3,2,3,66.7,1,1,0,1,0,7,3,0,"https://fbref.com/en/players/c70be9cf/Kosta-Nedeljkovic"
2025,"Aston Villa","Premier League","Amadou Onana","BEL","MF","23-062",2001,4.7,16,10,6,8,2,5,10,50,5,6,4,2,8,24,9,1,"https://fbref.com/en/players/828657ff/Amadou-Onana"
2025,"Aston Villa","Premier League","Jaden Philogene Bidace","ENG","FW,MF","22-252",2002,1.5,5,3,1,4,0,2,3,66.7,1,0,0,0,0,5,2,0,"https://fbref.com/en/players/19f4d211/Jaden-Philogene-Bidace"
2025,"Aston Villa","Premier League","Jacob Ramsey","ENG","FW,MF","23-142",2001,3.7,6,2,2,3,1,2,4,50,2,1,0,1,0,6,1,0,"https://fbref.com/en/players/1544f145/Jacob-Ramsey"
2025,"Aston Villa","Premier League","Morgan Rogers","ENG","MF,FW","22-083",2002,6.7,5,3,2,1,2,2,5,40,3,7,2,5,1,6,5,0,"https://fbref.com/en/players/2e5915f1/Morgan-Rogers"
2025,"Aston Villa","Premier League","Youri Tielemans","BEL","MF","27-163",1997,6.9,19,14,9,9,1,11,15,73.3,4,6,2,4,5,24,6,0,"https://fbref.com/en/players/56f7a928/Youri-Tielemans"
2025,"Aston Villa","Premier League","Pau Torres","ESP","DF","27-275",1997,7,6,5,3,3,0,2,3,66.7,1,5,3,2,3,9,14,0,"https://fbref.com/en/players/532e1e4f/Pau-Torres"
2025,"Aston Villa","Premier League","Ollie Watkins","ENG","FW","28-292",1995,5.9,2,1,0,2,0,0,3,0,3,4,0,4,2,4,0,0,"https://fbref.com/en/players/aed3a70f/Ollie-Watkins"
2025,"Atalanta","Serie A","Mitchel Bakker","NED","MF","24-119",2000,0.2,1,0,1,0,0,1,1,100,0,0,0,0,0,1,0,0,"https://fbref.com/en/players/a8567629/Mitchel-Bakker"
2025,"Atalanta","Serie A","Raoul Bellanova","ITA","DF","24-153",2000,4.2,4,2,0,3,1,1,1,100,0,2,0,2,3,7,5,0,"https://fbref.com/en/players/e3756e72/Raoul-Bellanova"
2025,"Atalanta","Serie A","Marco Brescianini","ITA","MF","24-271",2000,4.1,2,1,1,1,0,1,2,50,1,5,1,4,0,2,2,0,"https://fbref.com/en/players/dfd56738/Marco-Brescianini"
2025,"Atalanta","Serie A","Marco Carnesecchi","ITA","GK","24-108",2000,6,0,0,0,0,0,0,0,NA,0,0,0,0,0,0,4,1,"https://fbref.com/en/players/8ec56e62/Marco-Carnesecchi"
2025,"Atalanta","Serie A","Federico Cassa","ITA","MF,FW","18-259",2006,0.2,0,0,0,0,0,0,0,NA,0,1,0,1,0,0,0,0,"https://fbref.com/en/players/5f209d47/Federico-Cassa"
2025,"Atalanta","Serie A","Juan Cuadrado","COL","DF","36-144",1988,0.7,1,0,0,0,1,1,2,50,1,0,0,0,0,1,2,0,"https://fbref.com/en/players/0ab1f153/Juan-Cuadrado"
2025,"Atalanta","Serie A","Charles De Ketelaere","BEL","MF,FW","23-221",2001,5.2,2,2,0,1,1,0,1,0,1,2,2,0,0,2,1,0,"https://fbref.com/en/players/2ef7c612/Charles-De-Ketelaere"
2025,"Atalanta","Serie A","Berat Djimsiti","ALB","DF","31-241",1993,6,13,7,5,8,0,6,8,75,2,9,7,2,12,25,21,1,"https://fbref.com/en/players/6eee05f1/Berat-Djimsiti"
2025,"Atalanta","Serie A","Éderson","BRA","MF","25-102",1999,6.6,3,2,1,2,0,1,2,50,1,2,0,2,9,12,7,0,"https://fbref.com/en/players/a9202def/Ederson"
2025,"Atalanta","Serie A","Ben Godfrey","ENG","DF","26-276",1998,0.3,0,0,0,0,0,0,1,0,1,1,1,0,0,0,0,0,"https://fbref.com/en/players/9f7c837d/Ben-Godfrey"
2025,"Atalanta","Serie A","Isak Hien","SWE","DF","25-278",1999,3.3,3,3,2,1,0,1,4,25,3,6,5,1,7,10,9,1,"https://fbref.com/en/players/12806697/Isak-Hien"
2025,"Atalanta","Serie A","Sead Kolašinac","BIH","DF","31-119",1993,3.9,7,5,2,5,0,2,4,50,2,1,0,1,6,13,8,0,"https://fbref.com/en/players/3935e52e/Sead-Kolasinac"
2025,"Atalanta","Serie A","Odilon Kossounou","CIV","DF","23-287",2001,1.7,3,3,1,2,0,1,2,50,1,2,1,1,1,4,0,0,"https://fbref.com/en/players/1f3afdcb/Odilon-Kossounou"
2025,"Atalanta","Serie A","Ademola Lookman","NGA","MF,FW","26-363",1997,3.1,5,3,4,1,0,2,3,66.7,1,6,0,6,1,6,0,0,"https://fbref.com/en/players/7c104bb7/Ademola-Lookman"
2025,"Atalanta","Serie A","Alberto Manzoni","ITA","MF","19-114",2005,0.1,0,0,0,0,0,0,0,NA,0,0,0,0,0,0,0,0,"https://fbref.com/en/players/08cda374/Alberto-Manzoni"
2025,"Atalanta","Serie A","Juan Musso","ARG","GK","30-164",1994,1,0,0,0,0,0,0,0,NA,0,0,0,0,0,0,0,0,"https://fbref.com/en/players/a111cf41/Juan-Musso"
2025,"Atalanta","Serie A","Marco Palestra","ITA","DF","19-228",2005,0.5,2,1,1,1,0,1,1,100,0,0,0,0,0,2,0,0,"https://fbref.com/en/players/1f1828dd/Marco-Palestra"
2025,"Atalanta","Serie A","Mario Pašalić","CRO","MF","29-251",1995,4.9,3,2,0,3,0,1,4,25,3,3,1,2,2,5,6,0,"https://fbref.com/en/players/e599253a/Mario-Pasalic"
2025,"Atalanta","Serie A","Mateo Retegui","ITA","FW","25-171",1999,5.3,5,3,0,1,4,2,4,50,2,1,0,1,1,6,4,0,"https://fbref.com/en/players/e7695e6c/Mateo-Retegui"
2025,"Atalanta","Serie A","Marten de Roon","NED","DF,MF","33-202",1991,7,22,12,11,10,1,9,15,60,6,17,2,15,11,33,13,0,"https://fbref.com/en/players/2a1beb34/Marten-de-Roon"
2025,"Atalanta","Serie A","Matteo Ruggeri","ITA","DF","22-098",2002,4.6,5,2,1,3,1,2,2,100,0,4,0,4,5,10,5,1,"https://fbref.com/en/players/ae9898c5/Matteo-Ruggeri"
2025,"Atalanta","Serie A","Lazar Samardzic","SRB","MF,FW","22-236",2002,2.4,2,2,0,1,1,2,3,66.7,1,2,1,1,0,2,0,0,"https://fbref.com/en/players/217c93a1/Lazar-Samardzic"
2025,"Atalanta","Serie A","Ibrahim Sulemana","GHA","MF","21-148",2003,0.2,0,0,0,0,0,0,0,NA,0,0,0,0,0,0,0,0,"https://fbref.com/en/players/230c3f3a/Ibrahim-Sulemana"
2025,"Atalanta","Serie A","Rafael Tolói","ITA","DF","34-007",1990,0.4,1,1,1,0,0,1,1,100,0,0,0,0,0,1,0,0,"https://fbref.com/en/players/c56dc39e/Rafael-Toloi"
2025,"Atalanta","Serie A","Vanja Vlahović","SRB","MF,FW","20-208",2004,0.3,0,0,0,0,0,0,0,NA,0,0,0,0,0,0,0,0,"https://fbref.com/en/players/2af3f55c/Vanja-Vlahovic"
2025,"Atalanta","Serie A","Nicolò Zaniolo","ITA","MF,FW","25-107",1999,0.6,0,0,0,0,0,0,0,NA,0,0,0,0,0,0,0,0,"https://fbref.com/en/players/9907b1c8/Nicolo-Zaniolo"
2025,"Atalanta","Serie A","Davide Zappacosta","ITA","DF","32-128",1992,4.5,3,3,2,1,0,3,8,37.5,5,3,1,2,1,4,3,0,"https://fbref.com/en/players/7fe90ccd/Davide-Zappacosta"
2025,"Athletic Club","La Liga","Julen Agirrezabala","ESP","GK","23-296",2000,5.4,0,0,0,0,0,0,1,0,1,0,0,0,0,0,1,0,"https://fbref.com/en/players/a2c1a8d3/Julen-Agirrezabala"
2025,"Athletic Club","La Liga","Yeray Álvarez","ESP","DF","29-267",1995,4,6,4,3,2,1,3,5,60,2,3,1,2,9,15,15,1,"https://fbref.com/en/players/3ecc11d8/Yeray-Alvarez"
2025,"Athletic Club","La Liga","Adu Ares","ESP","FW","23-005",2001,0.2,0,0,0,0,0,0,1,0,1,0,0,0,0,0,0,0,"https://fbref.com/en/players/a461f098/Adu-Ares"
2025,"Athletic Club","La Liga","Yuri Berchiche","ESP","DF","34-250",1990,5.4,8,5,6,1,1,4,9,44.4,5,7,2,5,5,13,14,0,"https://fbref.com/en/players/b6e50615/Yuri-Berchiche"
2025,"Athletic Club","La Liga","Álex Berenguer","ESP","FW","29-105",1995,5.6,6,2,2,2,2,4,7,57.1,3,5,2,3,4,10,3,0,"https://fbref.com/en/players/dc1c2fce/Alex-Berenguer"
2025,"Athletic Club","La Liga","Adama Boiro","ESP","DF","22-117",2002,2.4,7,4,3,4,0,2,3,66.7,1,4,3,1,3,10,6,0,"https://fbref.com/en/players/e7992f7b/Adama-Boiro"
2025,"Athletic Club","La Liga","Peio Canales","ESP","MF","19-274",2005,0.2,1,1,0,0,1,0,0,NA,0,0,0,0,1,2,1,0,"https://fbref.com/en/players/3b5d2ab7/Peio-Canales"
2025,"Athletic Club","La Liga","Álvaro djaló","ESP","FW","25-062",1999,2.1,1,0,0,1,0,0,1,0,1,1,0,1,0,1,1,0,"https://fbref.com/en/players/45c29ae7/Alvaro-djalo"
2025,"Athletic Club","La Liga","Iñigo Ruiz de Galarreta","ESP","MF","31-072",1993,2.6,2,1,0,2,0,1,4,25,3,2,0,2,3,5,1,0,"https://fbref.com/en/players/91f7631f/Inigo-Ruiz-de-Galarreta"
2025,"Athletic Club","La Liga","Unai Gómez","ESP","MF,FW","21-145",2003,3.2,1,1,0,1,0,1,1,100,0,1,0,1,0,1,4,0,"https://fbref.com/en/players/37db6cae/Unai-Gomez"
2025,"Athletic Club","La Liga","Andoni Gorosabel","ESP","DF","28-074",1996,2,2,0,1,1,0,0,3,0,3,2,0,2,0,2,10,0,"https://fbref.com/en/players/6f5f82c0/Andoni-Gorosabel"
2025,"Athletic Club","La Liga","Gorka Guruzeta","ESP","FW","28-035",1996,5.6,3,2,0,3,0,2,7,28.6,5,7,1,6,2,5,8,0,"https://fbref.com/en/players/6b5ea2f4/Gorka-Guruzeta"
2025,"Athletic Club","La Liga","Ander Herrera","ESP","MF","35-064",1989,2.4,6,4,0,6,0,2,5,40,3,0,0,0,2,8,8,0,"https://fbref.com/en/players/436a9dd0/Ander-Herrera"
2025,"Athletic Club","La Liga","Mikel Jauregizar","ESP","MF","20-340",2003,4.3,18,9,5,9,4,11,18,61.1,7,3,1,2,5,23,2,1,"https://fbref.com/en/players/2f5c78ca/Mikel-Jauregizar"
2025,"Athletic Club","La Liga","Iñigo Lekue","ESP","DF","31-166",1993,3.5,4,3,3,1,0,3,6,50,3,2,1,1,3,7,13,2,"https://fbref.com/en/players/59b7d823/Inigo-Lekue"
2025,"Athletic Club","La Liga","Óscar de Marcos","ESP","DF","35-186",1989,4.6,13,6,7,6,0,8,12,66.7,4,6,0,6,10,23,10,0,"https://fbref.com/en/players/9f323c71/Oscar-de-Marcos"
2025,"Athletic Club","La Liga","Javi Martón","ESP","FW","25-164",1999,0.2,0,0,0,0,0,0,0,NA,0,0,0,0,0,0,0,0,"https://fbref.com/en/players/2381eead/Javi-Marton"
2025,"Athletic Club","La Liga","Unai Núñez","ESP","DF","27-261",1997,2,1,1,0,1,0,0,1,0,1,2,2,0,11,12,9,1,"https://fbref.com/en/players/be170419/Unai-Nunez"
2025,"Athletic Club","La Liga","Alex Padilla","ESP","GK","21-046",2003,3.6,0,0,0,0,0,0,0,NA,0,0,0,0,0,0,2,1,"https://fbref.com/en/players/a275838a/Alex-Padilla"
2025,"Athletic Club","La Liga","Aitor Paredes","ESP","DF","24-171",2000,4.9,3,2,1,2,0,2,5,40,3,8,6,2,4,7,33,1,"https://fbref.com/en/players/b906757a/Aitor-Paredes"
2025,"Athletic Club","La Liga","Beñat Prados","ESP","MF","23-252",2001,4.8,8,8,2,6,0,3,13,23.1,10,8,1,7,7,15,5,0,"https://fbref.com/en/players/1f60244a/Benat-Prados"
2025,"Athletic Club","La Liga","Oihan Sancet","ESP","MF","24-175",2000,6,3,1,1,1,1,2,7,28.6,5,3,0,3,2,5,3,0,"https://fbref.com/en/players/bdb624a3/Oihan-Sancet"
2025,"Athletic Club","La Liga","Mikel Vesga","ESP","MF","31-149",1993,3.5,5,3,2,3,0,2,10,20,8,4,0,4,6,11,5,0,"https://fbref.com/en/players/b0fce72c/Mikel-Vesga"
2025,"Athletic Club","La Liga","Daniel Vivian","ESP","DF","25-094",1999,7.1,11,8,7,4,0,8,9,88.9,1,6,3,3,10,21,43,0,"https://fbref.com/en/players/ab7bf91d/Daniel-Vivian"
2025,"Athletic Club","La Liga","Iñaki Williams","GHA","FW","30-124",1994,8,3,0,2,0,1,1,5,20,4,7,1,6,5,8,10,0,"https://fbref.com/en/players/6a99e0b1/Inaki-Williams"
2025,"Athletic Club","La Liga","Nico Williams","ESP","FW","22-097",2002,4.8,8,4,2,5,1,4,6,66.7,2,0,0,0,1,9,2,0,"https://fbref.com/en/players/afdc14d7/Nico-Williams"
2025,"Atlético Madrid","La Liga","Julián Álvarez","ARG","FW,MF","24-260",2000,5.7,2,1,1,0,1,1,4,25,3,6,0,6,0,2,3,0,"https://fbref.com/en/players/15ab5a2b/Julian-Alvarez"
2025,"Atlético Madrid","La Liga","César Azpilicueta","ESP","DF","35-050",1989,4.3,8,3,4,4,0,8,12,66.7,4,2,1,1,1,9,11,0,"https://fbref.com/en/players/53cad200/Cesar-Azpilicueta"
2025,"Atlético Madrid","La Liga","Pablo Barrios","ESP","MF","21-124",2003,4.5,9,5,4,5,0,4,11,36.4,7,1,1,0,7,16,5,2,"https://fbref.com/en/players/45736cec/Pablo-Barrios"
2025,"Atlético Madrid","La Liga","Ángel Correa","ARG","FW,MF","29-222",1995,2.1,1,0,1,0,0,1,3,33.3,2,2,0,2,1,2,1,0,"https://fbref.com/en/players/01eb744d/Angel-Correa"
2025,"Atlético Madrid","La Liga","Rodrigo De Paul","ARG","MF","30-146",1994,4.1,4,3,1,3,0,4,7,57.1,3,2,0,2,1,5,5,1,"https://fbref.com/en/players/162efffd/Rodrigo-De-Paul"
2025,"Atlético Madrid","La Liga","Javi Galán","ESP","DF","29-333",1994,1.1,4,3,3,1,0,3,8,37.5,5,1,0,1,3,7,1,0,"https://fbref.com/en/players/a4b00319/Javi-Galan"
2025,"Atlético Madrid","La Liga","Conor Gallagher","ENG","MF","24-254",2000,5.6,18,12,6,10,2,7,14,50,7,7,1,6,7,25,8,0,"https://fbref.com/en/players/c2731c10/Conor-Gallagher"
2025,"Atlético Madrid","La Liga","Antoine Griezmann","FRA","FW,MF","33-210",1991,7.4,5,3,5,0,0,1,7,14.3,6,8,0,8,3,8,7,0,"https://fbref.com/en/players/df69b544/Antoine-Griezmann"
2025,"Atlético Madrid","La Liga","Koke","ESP","MF","32-283",1992,7.1,14,9,7,4,3,7,14,50,7,9,0,9,7,21,8,0,"https://fbref.com/en/players/55126f3b/Koke"
2025,"Atlético Madrid","La Liga","Robin Le Normand","ESP","DF","27-341",1996,7,11,8,11,0,0,3,5,60,2,3,2,1,2,13,25,0,"https://fbref.com/en/players/9a64e67e/Robin-Le-Normand"
2025,"Atlético Madrid","La Liga","Clément Lenglet","FRA","DF","29-122",1995,1,0,0,0,0,0,0,1,0,1,1,0,1,1,1,10,0,"https://fbref.com/en/players/4f28a6ff/Clement-Lenglet"
2025,"Atlético Madrid","La Liga","Samuel Lino","BRA","DF,MF","24-299",1999,4.6,9,3,6,2,1,6,17,35.3,11,7,1,6,4,13,3,0,"https://fbref.com/en/players/2a295d33/Samuel-Lino"
2025,"Atlético Madrid","La Liga","Marcos Llorente","ESP","DF,MF","29-261",1995,7,16,12,10,4,2,9,13,69.2,4,6,1,5,5,21,13,1,"https://fbref.com/en/players/02c15616/Marcos-Llorente"
2025,"Atlético Madrid","La Liga","Reinildo Mandava","MOZ","DF","30-270",1994,5.1,9,5,4,4,1,4,7,57.1,3,6,3,3,8,17,18,0,"https://fbref.com/en/players/c20bdcd7/Reinildo-Mandava"
2025,"Atlético Madrid","La Liga","José María Giménez","URU","DF","29-271",1995,7,7,4,5,2,0,6,9,66.7,3,7,5,2,7,14,33,0,"https://fbref.com/en/players/f0da930c/Jose-Maria-Gimenez"
2025,"Atlético Madrid","La Liga","Nahuel Molina","ARG","DF","26-194",1998,4.3,11,4,7,4,0,8,12,66.7,4,7,0,7,4,15,16,0,"https://fbref.com/en/players/23610943/Nahuel-Molina"
2025,"Atlético Madrid","La Liga","Juan Musso","ARG","GK","30-164",1994,1,0,0,0,0,0,0,0,NA,0,0,0,0,0,0,0,0,"https://fbref.com/en/players/a111cf41/Juan-Musso"
2025,"Atlético Madrid","La Liga","Jan Oblak","SVN","GK","31-284",1993,8,0,0,0,0,0,0,0,NA,0,0,0,0,0,0,2,1,"https://fbref.com/en/players/ee8508c0/Jan-Oblak"
2025,"Atlético Madrid","La Liga","Rodrigo Riquelme","ESP","DF,MF","24-198",2000,2.7,3,2,3,0,0,2,2,100,0,0,0,0,1,4,3,0,"https://fbref.com/en/players/65154df0/Rodrigo-Riquelme"
2025,"Atlético Madrid","La Liga","Giuliano Simeone","ARG","MF,DF","21-304",2002,1,2,2,0,1,1,2,3,66.7,1,3,1,2,0,2,2,0,"https://fbref.com/en/players/a6536561/Giuliano-Simeone"
2025,"Atlético Madrid","La Liga","Alexander Sørloth","NOR","FW","28-317",1995,4.8,1,0,0,0,1,0,0,NA,0,2,1,1,0,1,7,0,"https://fbref.com/en/players/e92cd3f7/Alexander-Sorloth"
2025,"Atlético Madrid","La Liga","Axel Witsel","BEL","DF","35-279",1989,3.5,2,1,1,1,0,1,2,50,1,2,2,0,2,4,20,0,"https://fbref.com/en/players/5dfc6ad5/Axel-Witsel"
2025,"Augsburg","Bundesliga","Maximilian Bauer","GER","DF","24-251",2000,3.8,9,4,4,4,1,5,9,55.6,4,5,1,4,4,13,23,1,"https://fbref.com/en/players/44a20f0c/Maximilian-Bauer"
2025,"Augsburg","Bundesliga","Tim Breithaupt","GER","MF","22-253",2002,1.3,1,1,0,1,0,0,4,0,4,1,0,1,2,3,0,0,"https://fbref.com/en/players/ed98c321/Tim-Breithaupt"
2025,"Augsburg","Bundesliga","Alexis Claude-Maurice","FRA","FW","26-133",1998,0.4,1,1,1,0,0,0,0,NA,0,0,0,0,0,1,0,0,"https://fbref.com/en/players/741418c3/Alexis-Claude-Maurice"
2025,"Augsburg","Bundesliga","Niklas Dorsch","GER","MF","26-276",1998,0.4,0,0,0,0,0,0,0,NA,0,1,0,1,0,0,0,0,"https://fbref.com/en/players/7f73bdf4/Niklas-Dorsch"
2025,"Augsburg","Bundesliga","Arne Engels","BEL","MF,FW","21-039",2003,0.9,0,0,0,0,0,0,0,NA,0,1,1,0,0,0,0,0,"https://fbref.com/en/players/554bcc91/Arne-Engels"
2025,"Augsburg","Bundesliga","Samuel Essende","COD","FW","26-268",1998,3.6,0,0,0,0,0,0,0,NA,0,3,1,2,0,0,1,0,"https://fbref.com/en/players/821550ce/Samuel-Essende"
2025,"Augsburg","Bundesliga","Dimitris Giannoulis","GRE","DF","29-000",1995,5.8,11,8,5,5,1,10,15,66.7,5,10,1,9,11,22,10,0,"https://fbref.com/en/players/112c495e/Dimitris-Giannoulis"
2025,"Augsburg","Bundesliga","Jeffrey Gouweleeuw","NED","DF","33-099",1991,6,8,4,3,2,3,5,9,55.6,4,5,1,4,7,15,22,0,"https://fbref.com/en/players/1025db8e/Jeffrey-Gouweleeuw"
2025,"Augsburg","Bundesliga","Kristijan Jakić","CRO","MF","27-156",1997,3.9,6,1,1,4,1,0,4,0,4,10,0,10,4,10,2,0,"https://fbref.com/en/players/a8ee54ad/Kristijan-Jakic"
2025,"Augsburg","Bundesliga","Fredrik Jensen","FIN","MF,DF","27-038",1997,1.3,1,1,0,0,1,1,1,100,0,2,0,2,0,1,1,0,"https://fbref.com/en/players/3eeb80e0/Fredrik-Jensen"
2025,"Augsburg","Bundesliga","Yusuf Kabadayı","GER","MF,FW","20-258",2004,0.4,1,0,0,1,0,0,0,NA,0,1,0,1,0,1,0,0,"https://fbref.com/en/players/a4a94bb2/Yusuf-Kabadayi"
2025,"Augsburg","Bundesliga","Mert Kömür","GER","MF","19-092",2005,0.3,0,0,0,0,0,0,0,NA,0,1,1,0,0,0,0,1,"https://fbref.com/en/players/ec68a918/Mert-Komur"
2025,"Augsburg","Bundesliga","Henri Koudossou","GER","DF","25-044",1999,0.7,1,1,0,1,0,1,3,33.3,2,1,1,0,0,1,5,0,"https://fbref.com/en/players/2b9745cb/Henri-Koudossou"
2025,"Augsburg","Bundesliga","Nediljko Labrović","CRO","GK","25-007",1999,6,0,0,0,0,0,0,0,NA,0,0,0,0,0,0,7,0,"https://fbref.com/en/players/208fc867/Nediljko-Labrovic"
2025,"Augsburg","Bundesliga","Arne Maier","GER","MF","25-283",1999,1.9,1,0,0,1,0,1,1,100,0,3,0,3,0,1,0,0,"https://fbref.com/en/players/ab700320/Arne-Maier"
2025,"Augsburg","Bundesliga","Chrislain Matsima","FRA","DF","22-155",2002,0.6,0,0,0,0,0,0,0,NA,0,3,3,0,3,3,5,0,"https://fbref.com/en/players/cf1ef7ec/Chrislain-Matsima"
2025,"Augsburg","Bundesliga","Steve Mounié","BEN","FW","30-018",1994,2,2,2,0,0,2,0,1,0,1,1,1,0,0,2,1,0,"https://fbref.com/en/players/19ba6c6d/Steve-Mounie"
2025,"Augsburg","Bundesliga","Frank Onyeka","NGA","MF","26-290",1998,3.9,13,12,5,6,2,4,6,66.7,2,4,2,2,6,19,4,0,"https://fbref.com/en/players/2944f86f/Frank-Onyeka"
2025,"Augsburg","Bundesliga","Mads Pedersen","DEN","DF","28-046",1996,1.8,5,4,3,1,1,3,3,100,0,3,0,3,1,6,5,0,"https://fbref.com/en/players/582a5247/Mads-Pedersen"
2025,"Augsburg","Bundesliga","Elvis Rexhbeçaj","KVX","MF","26-351",1997,5.6,8,7,1,5,2,5,13,38.5,8,9,1,8,4,12,6,0,"https://fbref.com/en/players/1ae836b1/Elvis-Rexhbecaj"
2025,"Augsburg","Bundesliga","Keven Schlotterbeck","GER","DF","27-172",1997,5.4,4,3,1,3,0,2,2,100,0,5,3,2,8,12,20,1,"https://fbref.com/en/players/f6bdc830/Keven-Schlotterbeck"
2025,"Augsburg","Bundesliga","Phillip Tietz","GER","FW","27-100",1997,3.8,4,3,1,2,1,2,2,100,0,2,0,2,2,6,8,0,"https://fbref.com/en/players/3397e7b5/Phillip-Tietz"
2025,"Augsburg","Bundesliga","Ruben Vargas","SUI","MF","26-073",1998,2.6,2,1,1,1,0,1,4,25,3,1,0,1,1,3,0,1,"https://fbref.com/en/players/6ecbddf6/Ruben-Vargas"
2025,"Augsburg","Bundesliga","Marius Wolf","GER","DF","29-143",1995,3.5,4,2,1,2,1,1,6,16.7,5,4,0,4,2,6,8,0,"https://fbref.com/en/players/fa661778/Marius-Wolf"
2025,"Auxerre","Ligue 1","Clément Akpa","CIV","DF","22-328",2001,4.8,7,4,3,1,3,4,9,44.4,5,7,2,5,7,14,17,1,"https://fbref.com/en/players/0abb5072/Clement-Akpa"
2025,"Auxerre","Ligue 1","Florian Ayé","FRA","FW","27-272",1997,1.7,0,0,0,0,0,0,1,0,1,3,0,3,1,1,3,0,"https://fbref.com/en/players/718b8afd/Florian-Aye"
2025,"Auxerre","Ligue 1","Theo Bair","CAN","FW","25-051",1999,2.4,1,0,0,1,0,0,0,NA,0,2,1,1,0,1,2,0,"https://fbref.com/en/players/c724745e/Theo-Bair"
2025,"Auxerre","Ligue 1","Lasso Coulibaly","GHA","FW,MF","21-364",2002,0.4,0,0,0,0,0,0,0,NA,0,0,0,0,0,0,0,0,"https://fbref.com/en/players/78310540/Lasso-Coulibaly"
2025,"Auxerre","Ligue 1","Kévin Danois","FRA","MF,DF","20-111",2004,3.5,12,10,5,6,1,5,11,45.5,6,0,0,0,7,19,3,0,"https://fbref.com/en/players/e76f6fbe/Kevin-Danois"
2025,"Auxerre","Ligue 1","Sinaly Diomande","CIV","DF","23-191",2001,4.3,6,4,1,5,0,5,7,71.4,2,4,3,1,5,11,13,0,"https://fbref.com/en/players/6de23ab0/Sinaly-Diomande"
2025,"Auxerre","Ligue 1","Assane Dioussé","SEN","MF","27-027",1997,0.1,0,0,0,0,0,0,0,NA,0,0,0,0,0,0,0,0,"https://fbref.com/en/players/7f622eef/Assane-Diousse"
2025,"Auxerre","Ligue 1","Ki-Jana Hoever","NED","DF","22-273",2002,3.9,6,5,4,1,1,2,4,50,2,6,0,6,2,8,14,0,"https://fbref.com/en/players/9a71e978/Ki-Jana-Hoever"
2025,"Auxerre","Ligue 1","Paul Joly","FRA","DF","24-132",2000,4.4,16,11,11,5,0,8,15,53.3,7,5,0,5,11,27,14,3,"https://fbref.com/en/players/5b4bc323/Paul-Joly"
2025,"Auxerre","Ligue 1","Jubal","BRA","DF","31-049",1993,5.4,8,6,7,1,0,5,11,45.5,6,9,3,6,4,12,28,0,"https://fbref.com/en/players/56ae428b/Jubal"
2025,"Auxerre","Ligue 1","Hamed Junior Traorè","CIV","MF","24-244",2000,4.6,9,5,2,4,3,2,9,22.2,7,3,0,3,3,12,6,0,"https://fbref.com/en/players/570bb4b9/Hamed-Junior-Traore"
2025,"Auxerre","Ligue 1","Donovan Léon","GUF","GK","31-349",1992,7,0,0,0,0,0,0,0,NA,0,0,0,0,0,0,5,1,"https://fbref.com/en/players/51c83a90/Donovan-Leon"
2025,"Auxerre","Ligue 1","Eros Maddy","NED","DF","23-255",2001,0.1,0,0,0,0,0,0,0,NA,0,0,0,0,0,0,0,0,"https://fbref.com/en/players/0ed50019/Eros-Maddy"
2025,"Auxerre","Ligue 1","Gideon Mensah","GHA","DF","26-091",1998,1.3,4,2,3,0,1,1,4,25,3,1,0,1,2,6,3,0,"https://fbref.com/en/players/9bdd8118/Gideon-Mensah"
2025,"Auxerre","Ligue 1","Ado Onaiwu","JPN","FW,MF","28-344",1995,3.6,5,4,0,5,0,2,3,66.7,1,1,0,1,1,6,3,0,"https://fbref.com/en/players/ff4df82e/Ado-Onaiwu"
2025,"Auxerre","Ligue 1","Gabriel Osho","NGA","DF","26-064",1998,6.4,6,5,6,0,0,3,6,50,3,16,11,5,4,10,35,0,"https://fbref.com/en/players/cd889153/Gabriel-Osho"
2025,"Auxerre","Ligue 1","Elisha Owusu","GHA","MF","26-345",1997,6.6,25,14,9,16,0,11,17,64.7,6,9,2,7,12,37,10,0,"https://fbref.com/en/players/e2781082/Elisha-Owusu"
2025,"Auxerre","Ligue 1","Théo Pellenard","FRA","DF","30-227",1994,0.5,3,2,2,1,0,1,3,33.3,2,1,0,1,0,3,3,0,"https://fbref.com/en/players/97fb4608/Theo-Pellenard"
2025,"Auxerre","Ligue 1","Gaëtan Perrin","FRA","MF,FW","28-132",1996,4,11,3,8,1,2,6,11,54.5,5,0,0,0,2,13,1,0,"https://fbref.com/en/players/10dd88f9/Gaetan-Perrin"
2025,"Auxerre","Ligue 1","Rayan Raveloson","MAD","MF,DF","27-275",1997,4.4,3,2,1,2,0,2,10,20,8,2,1,1,2,5,9,0,"https://fbref.com/en/players/fb3236a7/Rayan-Raveloson"
2025,"Auxerre","Ligue 1","Lassine Sinayoko","MLI","FW,MF","24-314",1999,6.6,9,5,4,1,4,3,6,50,3,4,0,4,4,13,16,0,"https://fbref.com/en/players/5e5249c8/Lassine-Sinayoko"
2025,"Auxerre","Ligue 1","Ben Viadere","FRA","MF","19-045",2005,0.1,0,0,0,0,0,0,0,NA,0,0,0,0,0,0,0,0,"https://fbref.com/en/players/88fe0c2d/Ben-Viadere"
2025,"Auxerre","Ligue 1","Aristide Zossou","CIV","MF","19-125",2005,0.1,0,0,0,0,0,0,0,NA,0,0,0,0,0,0,0,0,"https://fbref.com/en/players/3dcd9017/Aristide-Zossou"
2025,"Barcelona","La Liga","Alejandro Balde","ESP","DF","20-365",2003,6.1,5,4,2,2,1,3,4,75,1,3,2,1,2,7,9,0,"https://fbref.com/en/players/5ccc9672/Alejandro-Balde"
2025,"Barcelona","La Liga","Marc Bernal","ESP","MF","17-144",2007,2.7,8,6,2,5,1,7,8,87.5,1,5,1,4,1,9,4,0,"https://fbref.com/en/players/29117812/Marc-Bernal"
2025,"Barcelona","La Liga","Marc Casado","ESP","MF","21-033",2003,5.3,14,9,2,8,4,7,13,53.8,6,3,1,2,2,16,8,0,"https://fbref.com/en/players/2ef08833/Marc-Casado"
2025,"Barcelona","La Liga","Andreas Christensen","DEN","DF","28-190",1996,0.3,0,0,0,0,0,0,0,NA,0,0,0,0,0,0,2,0,"https://fbref.com/en/players/1cb49278/Andreas-Christensen"
2025,"Barcelona","La Liga","Pau Cubarsí","ESP","DF","17-269",2007,7.4,5,4,4,1,0,2,5,40,3,2,1,1,3,8,22,0,"https://fbref.com/en/players/cc7888f3/Pau-Cubarsi"
2025,"Barcelona","La Liga","Sergi Dominguez","ESP","DF","19-199",2005,1.9,1,1,1,0,0,0,0,NA,0,0,0,0,3,4,7,0,"https://fbref.com/en/players/88507352/Sergi-Dominguez"
2025,"Barcelona","La Liga","Ansu Fati","ESP","FW","21-352",2002,0.3,0,0,0,0,0,0,0,NA,0,0,0,0,0,0,0,1,"https://fbref.com/en/players/0ba976e4/Ansu-Fati"
2025,"Barcelona","La Liga","Héctor Fort","ESP","DF","18-076",2006,1.3,3,2,1,2,0,3,4,75,1,2,0,2,0,3,2,0,"https://fbref.com/en/players/2e31f3a6/Hector-Fort"
2025,"Barcelona","La Liga","Eric García","ESP","MF","23-282",2001,4.9,10,4,2,6,2,4,6,66.7,2,8,3,5,4,14,9,0,"https://fbref.com/en/players/2bed3eab/Eric-Garcia"
2025,"Barcelona","La Liga","Frenkie de Jong","NED","MF","27-158",1997,0.1,0,0,0,0,0,0,0,NA,0,0,0,0,0,0,0,0,"https://fbref.com/en/players/1bacc518/Frenkie-de-Jong"
2025,"Barcelona","La Liga","Jules Koundé","FRA","DF","25-340",1998,8.3,17,11,9,6,2,13,16,81.3,3,10,2,8,4,21,23,1,"https://fbref.com/en/players/4d1666ff/Jules-Kounde"
2025,"Barcelona","La Liga","Robert Lewandowski","POL","FW","36-057",1988,8.2,4,1,0,3,1,1,2,50,1,2,0,2,1,5,5,0,"https://fbref.com/en/players/8d78e732/Robert-Lewandowski"
2025,"Barcelona","La Liga","Fermin López","ESP","MF","21-159",2003,0.7,2,2,1,0,1,1,3,33.3,2,1,0,1,1,3,0,0,"https://fbref.com/en/players/c1fe5f0b/Fermin-Lopez"
2025,"Barcelona","La Liga","Gerard Martín","ESP","DF","22-290",2002,2.9,5,2,3,2,0,4,6,66.7,2,5,1,4,2,7,9,0,"https://fbref.com/en/players/b792c59d/Gerard-Martin"
2025,"Barcelona","La Liga","Iñigo Martínez","ESP","DF","33-153",1991,7.8,7,4,5,2,0,3,3,100,0,3,3,0,3,10,27,0,"https://fbref.com/en/players/3fc45c73/Inigo-Martinez"
2025,"Barcelona","La Liga","Dani Olmo","ESP","MF","26-163",1998,2.1,3,1,1,1,1,1,6,16.7,5,0,0,0,1,4,0,0,"https://fbref.com/en/players/ae44e8e2/Dani-Olmo"
2025,"Barcelona","La Liga","Pedri","ESP","MF","21-327",2002,6.5,15,9,5,9,1,5,15,33.3,10,8,1,7,6,21,7,1,"https://fbref.com/en/players/0d9b2d31/Pedri"
2025,"Barcelona","La Liga","Iñaki Peña","ESP","GK","25-229",1999,3.5,0,0,0,0,0,0,2,0,2,0,0,0,0,0,6,0,"https://fbref.com/en/players/cc1c5035/Inaki-Pena"
2025,"Barcelona","La Liga","Raphinha","BRA","FW,MF","27-308",1996,8.4,12,6,3,8,1,4,9,44.4,5,5,0,5,2,14,7,0,"https://fbref.com/en/players/3423f250/Raphinha"
2025,"Barcelona","La Liga","Marc-André ter Stegen","GER","GK","32-170",1992,5.5,0,0,0,0,0,0,1,0,1,0,0,0,0,0,2,2,"https://fbref.com/en/players/6f51e382/Marc-Andre-ter-Stegen"
2025,"Barcelona","La Liga","Pablo Torre","ESP","MF","21-197",2003,2.1,5,4,1,3,1,2,2,100,0,0,0,0,1,6,3,0,"https://fbref.com/en/players/04e531b6/Pablo-Torre"
2025,"Barcelona","La Liga","Ferrán Torres","ESP","FW","24-231",2000,3.6,3,1,1,1,1,1,2,50,1,2,0,2,0,3,1,0,"https://fbref.com/en/players/9e1035f8/Ferran-Torres"
2025,"Barcelona","La Liga","Pau Victor Delgado","ESP","FW","22-326",2001,1.3,1,1,0,1,0,0,3,0,3,5,1,4,1,2,4,0,"https://fbref.com/en/players/e6e7c819/Pau-Victor-Delgado"
2025,"Barcelona","La Liga","Lamine Yamal","ESP","FW","17-096",2007,8,16,13,2,7,7,3,6,50,3,5,0,5,6,22,0,0,"https://fbref.com/en/players/82ec26c1/Lamine-Yamal"
2025,"Bayern Munich","Bundesliga","Sacha Boey","FRA","DF","24-034",2000,1.4,3,0,2,0,1,2,3,66.7,1,1,0,1,0,3,4,0,"https://fbref.com/en/players/6c8ddd52/Sacha-Boey"
2025,"Bayern Munich","Bundesliga","Kingsley Coman","FRA","FW,MF","28-126",1996,2.5,8,4,3,2,3,3,4,75,1,4,0,4,2,10,5,0,"https://fbref.com/en/players/042e8a49/Kingsley-Coman"
2025,"Bayern Munich","Bundesliga","Alphonso Davies","CAN","DF","23-350",2000,4.3,8,4,2,4,2,5,6,83.3,1,3,0,3,3,11,5,0,"https://fbref.com/en/players/d781d855/Alphonso-Davies"
2025,"Bayern Munich","Bundesliga","Eric Dier","ENG","DF","30-276",1994,0.1,0,0,0,0,0,0,0,NA,0,0,0,0,0,0,1,0,"https://fbref.com/en/players/ac861941/Eric-Dier"
2025,"Bayern Munich","Bundesliga","Serge Gnabry","GER","FW,MF","29-095",1995,4.3,6,5,3,1,2,3,6,50,3,3,0,3,4,10,2,0,"https://fbref.com/en/players/88e357ef/Serge-Gnabry"
2025,"Bayern Munich","Bundesliga","Leon Goretzka","GER","DF","29-254",1995,0,0,0,0,0,0,0,0,NA,0,0,0,0,0,0,2,0,"https://fbref.com/en/players/cc86b9a3/Leon-Goretzka"
2025,"Bayern Munich","Bundesliga","Raphaël Guerreiro","POR","DF","30-300",1993,3.9,7,5,5,1,1,5,6,83.3,1,1,0,1,3,10,4,0,"https://fbref.com/en/players/048a1cbc/Raphael-Guerreiro"
2025,"Bayern Munich","Bundesliga","Harry Kane","ENG","FW","31-081",1993,5.6,2,2,0,1,1,0,1,0,1,3,0,3,0,2,2,0,"https://fbref.com/en/players/21a66f6a/Harry-Kane"
2025,"Bayern Munich","Bundesliga","Joshua Kimmich","GER","MF,DF","29-252",1995,6,7,4,2,3,2,6,9,66.7,3,2,0,2,5,12,7,2,"https://fbref.com/en/players/49296448/Joshua-Kimmich"
2025,"Bayern Munich","Bundesliga","Konrad Laimer","AUT","DF,MF","27-143",1997,1.3,4,4,0,4,0,2,4,50,2,1,0,1,1,5,1,0,"https://fbref.com/en/players/c1b7847c/Konrad-Laimer"
2025,"Bayern Munich","Bundesliga","Kim Min-jae","KOR","DF","27-337",1996,5.9,8,5,2,6,0,2,3,66.7,1,6,2,4,11,19,11,1,"https://fbref.com/en/players/e0f8151c/Kim-Min-jae"
2025,"Bayern Munich","Bundesliga","Thomas Müller","GER","MF,FW","35-034",1989,2.4,3,1,0,2,1,2,4,50,2,2,0,2,0,3,2,0,"https://fbref.com/en/players/3c6089ab/Thomas-Muller"
2025,"Bayern Munich","Bundesliga","Jamal Musiala","GER","MF","21-234",2003,4.3,7,5,2,3,2,1,6,16.7,5,4,0,4,3,10,2,0,"https://fbref.com/en/players/2c0558b8/Jamal-Musiala"
2025,"Bayern Munich","Bundesliga","Manuel Neuer","GER","GK","38-204",1986,5,0,0,0,0,0,0,0,NA,0,0,0,0,0,0,3,1,"https://fbref.com/en/players/8778c910/Manuel-Neuer"
2025,"Bayern Munich","Bundesliga","Michael Olise","FRA","FW,MF","22-310",2001,4.6,7,4,2,4,1,3,6,50,3,4,0,4,1,8,2,0,"https://fbref.com/en/players/c4486bac/Michael-Olise"
2025,"Bayern Munich","Bundesliga","João Palhinha","POR","MF","29-100",1995,1.4,1,1,1,0,0,0,2,0,2,4,0,4,2,3,2,0,"https://fbref.com/en/players/a78ff07f/Joao-Palhinha"
2025,"Bayern Munich","Bundesliga","Aleksandar Pavlovic","GER","MF","20-167",2004,4.6,11,6,2,6,3,5,8,62.5,3,6,1,5,0,11,6,0,"https://fbref.com/en/players/2658c82f/Aleksandar-Pavlovic"
2025,"Bayern Munich","Bundesliga","Leroy Sané","GER","FW","28-280",1996,0.4,0,0,0,0,0,0,0,NA,0,0,0,0,0,0,0,0,"https://fbref.com/en/players/2b114be3/Leroy-Sane"
2025,"Bayern Munich","Bundesliga","Mathys Tel","FRA","MF,FW","19-173",2005,1,0,0,0,0,0,0,0,NA,0,0,0,0,1,1,0,0,"https://fbref.com/en/players/829aa60c/Mathys-Tel"
2025,"Bayern Munich","Bundesliga","Sven Ulreich","GER","GK","36-075",1988,1,0,0,0,0,0,0,0,NA,0,0,0,0,0,0,0,0,"https://fbref.com/en/players/7d3e7da6/Sven-Ulreich"
2025,"Bayern Munich","Bundesliga","Dayot Upamecano","FRA","DF","25-356",1998,6,10,6,3,6,1,6,11,54.5,5,3,1,2,12,22,10,0,"https://fbref.com/en/players/d248cd8f/Dayot-Upamecano"
2025,"Betis","La Liga","Sergi Altimira","ESP","MF","23-053",2001,3.9,6,4,3,2,1,4,9,44.4,5,3,0,3,2,8,4,0,"https://fbref.com/en/players/94acdd4e/Sergi-Altimira"
2025,"Betis","La Liga","Ezequiel Ávila","ARG","FW","30-254",1994,2.3,3,1,1,1,1,1,3,33.3,2,2,0,2,1,4,1,0,"https://fbref.com/en/players/253a06b9/Ezequiel-Avila"
2025,"Betis","La Liga","Cédric Bakambu","COD","FW","33-189",1991,1.5,0,0,0,0,0,0,0,NA,0,2,0,2,0,0,0,0,"https://fbref.com/en/players/0af4dcf0/Cedric-Bakambu"
2025,"Betis","La Liga","Marc Bartra","ESP","DF","33-276",1991,1.9,2,2,2,0,0,2,2,100,0,4,3,1,2,4,5,0,"https://fbref.com/en/players/b742cc0d/Marc-Bartra"
2025,"Betis","La Liga","Héctor Bellerín","ESP","DF","29-212",1995,4.3,11,6,6,3,2,8,12,66.7,4,2,1,1,2,13,14,0,"https://fbref.com/en/players/f874dd44/Hector-Bellerin"
2025,"Betis","La Liga","Johnny Cardoso","USA","MF","23-027",2001,2.7,8,5,2,6,0,4,11,36.4,7,4,1,3,4,12,5,0,"https://fbref.com/en/players/7426f085/Johnny-Cardoso"
2025,"Betis","La Liga","William Carvalho","POR","MF","32-193",1992,2.7,3,2,0,3,0,2,4,50,2,4,1,3,3,6,4,0,"https://fbref.com/en/players/dee86451/William-Carvalho"
2025,"Betis","La Liga","Assane Diao","ESP","FW","19-040",2005,1.9,3,1,0,2,1,2,4,50,2,1,0,1,0,3,1,0,"https://fbref.com/en/players/8ae7d0ec/Assane-Diao"
2025,"Betis","La Liga","Abde Ezzalzouli","MAR","FW","22-305",2001,7.1,13,8,8,5,0,3,6,50,3,4,0,4,4,17,3,0,"https://fbref.com/en/players/bed68338/Abde-Ezzalzouli"
2025,"Betis","La Liga","Nabil Fekir","FRA","MF","31-091",1993,2,3,2,1,1,1,1,2,50,1,2,0,2,0,3,0,0,"https://fbref.com/en/players/bece776f/Nabil-Fekir"
2025,"Betis","La Liga","Pablo Fornals","ESP","FW,MF","28-238",1996,6.8,10,7,5,5,0,3,11,27.3,8,13,0,13,7,17,3,1,"https://fbref.com/en/players/82927de4/Pablo-Fornals"
2025,"Betis","La Liga","Juanmi","ESP","FW","31-150",1993,1.6,6,3,3,2,1,3,5,60,2,4,0,4,1,7,4,0,"https://fbref.com/en/players/84399660/Juanmi"
2025,"Betis","La Liga","Diego Llorente","ESP","DF","31-062",1993,9,12,5,7,5,0,4,10,40,6,10,10,0,14,26,39,1,"https://fbref.com/en/players/bba30585/Diego-Llorente"
2025,"Betis","La Liga","Giovani Lo Celso","ARG","MF","28-191",1996,5.1,10,6,3,2,5,6,9,66.7,3,3,0,3,1,11,1,0,"https://fbref.com/en/players/d7553721/Giovani-Lo-Celso"
2025,"Betis","La Liga","Iker Losada","ESP","FW,MF","23-077",2001,1,5,4,1,1,3,2,4,50,2,1,0,1,1,6,1,0,"https://fbref.com/en/players/41521385/Iker-Losada"
2025,"Betis","La Liga","Natan","BRA","DF","23-254",2001,7.1,8,6,6,1,1,6,6,100,0,9,5,4,9,17,32,0,"https://fbref.com/en/players/94bccc82/Natan"
2025,"Betis","La Liga","Romain Perraud","FRA","DF","27-025",1997,5.3,9,4,5,1,3,6,17,35.3,11,3,0,3,4,13,14,0,"https://fbref.com/en/players/6dfd8f05/Romain-Perraud"
2025,"Betis","La Liga","Marc Roca","ESP","MF","27-326",1996,8.1,14,8,8,6,0,8,15,53.3,7,16,5,11,8,22,9,1,"https://fbref.com/en/players/da27e268/Marc-Roca"
2025,"Betis","La Liga","Rodri","ESP","FW","24-154",2000,1.3,2,1,1,1,0,1,2,50,1,2,1,1,1,3,1,1,"https://fbref.com/en/players/85bed4ee/Rodri"
2025,"Betis","La Liga","Ricardo Rodríguez","SUI","DF","32-053",1992,3.7,9,7,6,1,2,5,9,55.6,4,2,0,2,3,12,11,0,"https://fbref.com/en/players/7f78ad23/Ricardo-Rodriguez"
2025,"Betis","La Liga","Vitor Roque","BRA","FW","19-232",2005,3.4,0,0,0,0,0,0,1,0,1,1,0,1,1,1,1,0,"https://fbref.com/en/players/cb00f1e6/Vitor-Roque"
2025,"Betis","La Liga","Aitor Ruibal","ESP","FW,DF","28-209",1996,3.8,3,2,0,1,2,2,6,33.3,4,2,1,1,3,6,2,0,"https://fbref.com/en/players/a55d8df5/Aitor-Ruibal"
2025,"Betis","La Liga","Youssouf Sabaly","SEN","DF","31-226",1993,3.7,8,5,5,2,1,5,6,83.3,1,3,0,3,2,10,13,0,"https://fbref.com/en/players/fbbb9269/Youssouf-Sabaly"
2025,"Betis","La Liga","Rui Silva","POR","GK","30-253",1994,9,0,0,0,0,0,0,0,NA,0,0,0,0,0,0,5,0,"https://fbref.com/en/players/ea83bfa6/Rui-Silva"
2025,"Bochum","Bundesliga","Aliou Badara Baldé","GUI","MF,FW","21-310",2002,1,1,1,1,0,0,0,0,NA,0,2,0,2,0,1,0,0,"https://fbref.com/en/players/7362a6f2/Aliou-Badara-Balde"
2025,"Bochum","Bundesliga","Samuel Bamba","GER","FW,MF","20-247",2004,0.1,0,0,0,0,0,0,0,NA,0,0,0,0,0,0,0,0,"https://fbref.com/en/players/489d4867/Samuel-Bamba"
2025,"Bochum","Bundesliga","Matúš Bero","SVK","MF","29-041",1995,5.7,11,6,5,2,4,5,16,31.3,11,12,2,10,2,13,6,1,"https://fbref.com/en/players/b5e0af76/Matus-Bero"
2025,"Bochum","Bundesliga","Myron Boadu","NED","FW","23-277",2001,3.9,0,0,0,0,0,0,1,0,1,1,0,1,0,0,3,0,"https://fbref.com/en/players/5b479568/Myron-Boadu"
2025,"Bochum","Bundesliga","Moritz Broschinski","GER","FW","24-024",2000,3.1,3,2,1,2,0,0,3,0,3,3,0,3,0,3,4,0,"https://fbref.com/en/players/bbd79358/Moritz-Broschinski"
2025,"Bochum","Bundesliga","Lukas Daschner","GER","MF,FW","26-016",1998,2.3,1,1,0,0,1,0,6,0,6,3,0,3,0,1,3,0,"https://fbref.com/en/players/93a8c4f9/Lukas-Daschner"
2025,"Bochum","Bundesliga","Patrick Drewes","GER","GK","31-256",1993,6,0,0,0,0,0,0,1,0,1,0,0,0,0,0,6,1,"https://fbref.com/en/players/a8403737/Patrick-Drewes"
2025,"Bochum","Bundesliga","Philipp Hofmann","GER","FW","31-201",1993,4.5,3,2,2,0,1,1,3,33.3,2,1,0,1,0,3,7,0,"https://fbref.com/en/players/877bc844/Philipp-Hofmann"
2025,"Bochum","Bundesliga","Moritz-Broni Kwarteng","GHA","MF","26-172",1998,0.7,0,0,0,0,0,0,1,0,1,0,0,0,0,0,0,0,"https://fbref.com/en/players/1e2057aa/Moritz-Broni-Kwarteng"
2025,"Bochum","Bundesliga","Anthony Losilla","FRA","MF","38-221",1986,3.8,7,7,3,4,0,3,8,37.5,5,9,3,6,8,15,5,0,"https://fbref.com/en/players/07c7eb0c/Anthony-Losilla"
2025,"Bochum","Bundesliga","Erhan Mašović","SRB","DF","25-330",1998,3.2,3,3,2,1,0,2,4,50,2,6,5,1,4,7,14,0,"https://fbref.com/en/players/a396fb61/Erhan-Masovic"
2025,"Bochum","Bundesliga","Jakov Medić","CRO","DF","26-040",1998,5.8,4,3,2,2,0,2,6,33.3,4,13,11,2,6,10,33,1,"https://fbref.com/en/players/5f5ebdae/Jakov-Medic"
2025,"Bochum","Bundesliga","Koji Miyoshi","JPN","MF","27-205",1997,0.9,2,2,0,1,1,0,2,0,2,2,1,1,0,2,1,0,"https://fbref.com/en/players/77bf714c/Koji-Miyoshi"
2025,"Bochum","Bundesliga","Tim Oermann","GER","DF","21-011",2003,1.2,1,1,1,0,0,0,1,0,1,2,2,0,3,4,2,0,"https://fbref.com/en/players/57ec75bf/Tim-Oermann"
2025,"Bochum","Bundesliga","Ivan Ordets","UKR","DF","32-101",1992,1,0,0,0,0,0,0,0,NA,0,1,1,0,1,1,3,0,"https://fbref.com/en/players/86c75897/Ivan-Ordets"
2025,"Bochum","Bundesliga","Mats Pannewig","GER","MF","19-355",2004,0.4,0,0,0,0,0,0,0,NA,0,3,0,3,0,0,2,0,"https://fbref.com/en/players/2420dbac/Mats-Pannewig"
2025,"Bochum","Bundesliga","Felix Passlack","GER","DF","26-141",1998,6,12,7,8,2,2,7,14,50,7,12,5,7,5,17,12,0,"https://fbref.com/en/players/5c899683/Felix-Passlack"
2025,"Bochum","Bundesliga","Ibrahima Sissoko","MLI","MF,DF","26-356",1997,5.8,17,12,9,7,1,6,11,54.5,5,4,2,2,9,26,12,0,"https://fbref.com/en/players/0f8418aa/Ibrahima-Sissoko"
2025,"Bochum","Bundesliga","Dani de Wit","NED","MF","26-263",1998,4.6,9,7,5,4,0,4,10,40,6,5,1,4,5,14,10,0,"https://fbref.com/en/players/48a2b92a/Dani-de-Wit"
2025,"Bochum","Bundesliga","Maximilian Wittek","GER","DF","29-057",1995,6,10,8,4,5,1,8,15,53.3,7,14,3,11,9,19,18,0,"https://fbref.com/en/players/edb2712b/Maximilian-Wittek"
2025,"Bologna","Serie A","Michel Aebischer","SUI","MF","27-285",1997,4.2,7,4,1,4,2,4,8,50,4,3,1,2,5,12,2,0,"https://fbref.com/en/players/f9c927de/Michel-Aebischer"
2025,"Bologna","Serie A","Sam Beukema","NED","DF","25-335",1998,6.5,10,4,4,5,1,3,9,33.3,6,6,4,2,6,16,14,0,"https://fbref.com/en/players/de13cee5/Sam-Beukema"
2025,"Bologna","Serie A","Nicolò Cambiaghi","ITA","FW","23-294",2000,0.2,1,0,0,1,0,0,0,NA,0,1,0,1,0,1,0,0,"https://fbref.com/en/players/91ff775f/Nicolo-Cambiaghi"
2025,"Bologna","Serie A","Nicolò Casale","ITA","DF","26-246",1998,1.8,2,1,1,1,0,1,2,50,1,4,3,1,1,3,3,1,"https://fbref.com/en/players/3f5f38fb/Nicolo-Casale"
2025,"Bologna","Serie A","Santiago Castro","ARG","FW","20-018",2004,6,5,2,2,3,0,0,2,0,2,4,0,4,1,6,8,0,"https://fbref.com/en/players/ee5565ae/Santiago-Castro"
2025,"Bologna","Serie A","Thijs Dallinga","NED","FW,MF","24-075",2000,1.3,3,2,0,1,2,1,1,100,0,1,1,0,0,3,4,0,"https://fbref.com/en/players/b70afb45/Thijs-Dallinga"
2025,"Bologna","Serie A","Lorenzo De Silvestri","ITA","DF","36-147",1988,1,2,1,1,0,1,1,3,33.3,2,2,0,2,0,2,1,0,"https://fbref.com/en/players/e74f0e59/Lorenzo-De-Silvestri"
2025,"Bologna","Serie A","Martin Erlic","CRO","DF","26-267",1998,2.5,2,0,0,2,0,1,2,50,1,5,4,1,1,3,5,0,"https://fbref.com/en/players/0fee6bda/Martin-Erlic"
2025,"Bologna","Serie A","Giovanni Fabbian","ITA","MF","21-277",2003,3.3,6,5,1,2,3,3,5,60,2,0,0,0,1,7,1,0,"https://fbref.com/en/players/f97f9188/Giovanni-Fabbian"
2025,"Bologna","Serie A","Remo Freuler","SUI","MF","32-185",1992,7,20,10,14,4,2,10,17,58.8,7,9,1,8,4,24,14,1,"https://fbref.com/en/players/98d2c2c4/Remo-Freuler"
2025,"Bologna","Serie A","Emil Holm","SWE","DF,MF","24-157",2000,1.1,4,4,2,2,0,3,5,60,2,1,1,0,0,4,2,0,"https://fbref.com/en/players/c2357b65/Emil-Holm"
2025,"Bologna","Serie A","Samuel Iling-Junior","ENG","FW,MF","21-013",2003,1,2,1,1,1,0,0,0,NA,0,0,0,0,2,4,0,0,"https://fbref.com/en/players/ba492306/Samuel-Iling-Junior"
2025,"Bologna","Serie A","Jesper Karlsson","SWE","FW","26-084",1998,1,0,0,0,0,0,0,1,0,1,0,0,0,0,0,0,0,"https://fbref.com/en/players/7952d0c2/Jesper-Karlsson"
2025,"Bologna","Serie A","Jhon Lucumí","COL","DF","26-113",1998,3.4,5,3,4,1,0,3,6,50,3,6,3,3,3,8,11,0,"https://fbref.com/en/players/80490d7f/Jhon-Lucumi"
2025,"Bologna","Serie A","Charalambos Lykogiannis","GRE","DF","30-361",1993,4.5,5,2,3,2,0,3,7,42.9,4,1,1,0,3,8,13,0,"https://fbref.com/en/players/5efc5389/Charalambos-Lykogiannis"
2025,"Bologna","Serie A","Juan Miranda","ESP","DF","24-272",2000,2.5,9,5,3,4,2,4,6,66.7,2,2,0,2,2,11,1,0,"https://fbref.com/en/players/ead61f73/Juan-Miranda"
2025,"Bologna","Serie A","Nikola Moro","CRO","MF","26-219",1998,3.2,7,7,3,4,0,4,7,57.1,3,6,3,3,2,9,3,0,"https://fbref.com/en/players/ff579c7e/Nikola-Moro"
2025,"Bologna","Serie A","Dan Ndoye","SUI","FW,MF","23-358",2000,4.6,1,1,1,0,0,0,4,0,4,4,0,4,0,1,0,0,"https://fbref.com/en/players/8e697a8f/Dan-Ndoye"
2025,"Bologna","Serie A","Jens Odgaard","DEN","FW,MF","25-200",1999,2.4,3,2,0,3,0,1,2,50,1,3,1,2,1,4,0,0,"https://fbref.com/en/players/75374ee7/Jens-Odgaard"
2025,"Bologna","Serie A","Riccardo Orsolini","ITA","FW,MF","27-267",1997,4.2,2,2,1,0,1,1,2,50,1,2,0,2,2,4,1,0,"https://fbref.com/en/players/e14ec482/Riccardo-Orsolini"
2025,"Bologna","Serie A","Tommaso Pobega","ITA","MF","25-094",1999,1,5,3,3,0,2,2,4,50,2,3,1,2,0,5,1,0,"https://fbref.com/en/players/55a1cac2/Tommaso-Pobega"
2025,"Bologna","Serie A","Stefan Posch","AUT","DF","27-156",1997,5.1,17,11,7,6,4,9,18,50,9,12,3,9,3,20,11,0,"https://fbref.com/en/players/7f609bfc/Stefan-Posch"
2025,"Bologna","Serie A","Federico Ravaglia","ITA","GK","24-341",1999,2,0,0,0,0,0,0,0,NA,0,0,0,0,0,0,0,0,"https://fbref.com/en/players/6662d731/Federico-Ravaglia"
2025,"Bologna","Serie A","Łukasz Skorupski","POL","GK","33-165",1991,5,0,0,0,0,0,0,0,NA,0,0,0,0,0,0,1,0,"https://fbref.com/en/players/ab4449d6/Lukasz-Skorupski"
2025,"Bologna","Serie A","Kacper Urbanski","POL","MF","20-040",2004,1.8,5,2,4,0,1,4,6,66.7,2,4,0,4,1,6,4,0,"https://fbref.com/en/players/2d9d9e42/Kacper-Urbanski"
2025,"Bournemouth","Premier League","Julian Araujo","MEX","DF","23-065",2001,3,5,2,3,2,0,3,9,33.3,6,1,0,1,3,8,9,0,"https://fbref.com/en/players/8f4541c2/Julian-Araujo"
2025,"Bournemouth","Premier League","Kepa Arrizabalaga","ESP","GK","30-014",1994,4,0,0,0,0,0,0,1,0,1,0,0,0,0,0,3,1,"https://fbref.com/en/players/28d596a0/Kepa-Arrizabalaga"
2025,"Bournemouth","Premier League","Philip Billing","DEN","MF","28-128",1996,0.3,1,0,1,0,0,0,0,NA,0,0,0,0,1,2,0,0,"https://fbref.com/en/players/d328a254/Philip-Billing"
2025,"Bournemouth","Premier League","David Brooks","WAL","MF","27-101",1997,0.1,0,0,0,0,0,0,0,NA,0,0,0,0,0,0,0,0,"https://fbref.com/en/players/dc4cae05/David-Brooks"
2025,"Bournemouth","Premier League","Ryan Christie","SCO","MF","29-238",1995,5.1,7,3,2,4,1,2,7,28.6,5,13,3,10,4,11,8,1,"https://fbref.com/en/players/26ce2263/Ryan-Christie"
2025,"Bournemouth","Premier League","Lewis Cook","ENG","MF","27-257",1997,6.9,20,10,10,9,1,7,18,38.9,11,10,2,8,12,32,10,0,"https://fbref.com/en/players/2afc7272/Lewis-Cook"
2025,"Bournemouth","Premier League","Evanilson","BRA","FW","25-011",1999,4.8,4,2,0,1,3,2,3,66.7,1,4,1,3,0,4,4,0,"https://fbref.com/en/players/6f3cc2fe/Evanilson"
2025,"Bournemouth","Premier League","Dean Huijsen","ESP","DF","19-186",2005,2.2,2,1,2,0,0,0,0,NA,0,2,1,1,3,5,7,0,"https://fbref.com/en/players/87278bce/Dean-Huijsen"
2025,"Bournemouth","Premier League","Daniel Jebbison","ENG","FW","21-065",2003,0.3,0,0,0,0,0,0,1,0,1,0,0,0,0,0,1,0,"https://fbref.com/en/players/03edb878/Daniel-Jebbison"
2025,"Bournemouth","Premier League","Milos Kerkez","HUN","DF","20-345",2003,6.4,10,4,3,5,2,4,8,50,4,7,3,4,7,17,15,0,"https://fbref.com/en/players/0ad53bdc/Milos-Kerkez"
2025,"Bournemouth","Premier League","Justin Kluivert","NED","MF,FW","25-165",1999,4.3,7,4,3,2,2,1,3,33.3,2,4,0,4,4,11,8,0,"https://fbref.com/en/players/4c3a6744/Justin-Kluivert"
2025,"Bournemouth","Premier League","Neto","BRA","GK","35-090",1989,2,0,0,0,0,0,0,0,NA,0,0,0,0,0,0,1,1,"https://fbref.com/en/players/a9dc785c/Neto"
2025,"Bournemouth","Premier League","Dango Ouattara","BFA","FW,DF","22-249",2002,2.9,9,9,2,4,3,5,9,55.6,4,4,0,4,2,11,8,0,"https://fbref.com/en/players/2f9e4435/Dango-Ouattara"
2025,"Bournemouth","Premier League","Alex Scott","ENG","MF","21-057",2003,2.2,16,7,8,4,4,12,15,80,3,6,1,5,4,20,4,0,"https://fbref.com/en/players/104d0bb8/Alex-Scott"
2025,"Bournemouth","Premier League","Antoine Semenyo","GHA","FW","24-284",2000,6.7,11,7,5,2,4,3,9,33.3,6,14,2,12,1,12,4,0,"https://fbref.com/en/players/efd2ec23/Antoine-Semenyo"
2025,"Bournemouth","Premier League","Marcos Senesi","ARG","DF","27-160",1997,4.8,17,8,12,4,1,7,15,46.7,8,10,5,5,7,24,24,0,"https://fbref.com/en/players/35141f4c/Marcos-Senesi"
2025,"Bournemouth","Premier League","Luis Sinisterra","COL","FW,MF","25-122",1999,2,4,1,1,1,2,0,4,0,4,3,0,3,0,4,4,0,"https://fbref.com/en/players/8e16dd48/Luis-Sinisterra"
2025,"Bournemouth","Premier League","Adam Smith","ENG","DF","33-171",1991,3.6,5,2,2,1,2,3,6,50,3,2,1,1,4,9,11,0,"https://fbref.com/en/players/20b104bc/Adam-Smith"
2025,"Bournemouth","Premier League","Marcus Tavernier","ENG","MF,FW","25-209",1999,6.7,13,8,3,6,4,3,6,50,3,4,0,4,1,14,4,0,"https://fbref.com/en/players/5c0da4a4/Marcus-Tavernier"
2025,"Bournemouth","Premier League","Mark Travers","IRL","GK","25-152",1999,1,0,0,0,0,0,0,0,NA,0,0,0,0,0,0,1,0,"https://fbref.com/en/players/fe558029/Mark-Travers"
2025,"Bournemouth","Premier League","Enes Ünal","TUR","FW","27-160",1997,0.6,0,0,0,0,0,0,0,NA,0,1,0,1,0,0,0,0,"https://fbref.com/en/players/f8eca1b6/Enes-Unal"
2025,"Bournemouth","Premier League","Illia Zabarnyi","UKR","DF","22-046",2002,7,10,6,4,6,0,4,8,50,4,8,2,6,8,18,33,0,"https://fbref.com/en/players/88968486/Illia-Zabarnyi"
2025,"Brentford","Premier League","Kristoffer Ajer","NOR","DF","26-183",1998,6.1,5,4,5,0,0,1,6,16.7,5,8,1,7,6,11,17,0,"https://fbref.com/en/players/a8c0acb7/Kristoffer-Ajer"
2025,"Brentford","Premier League","Fabio Carvalho","POR","FW,MF","22-048",2002,2.7,9,6,3,2,4,3,5,60,2,5,1,4,2,11,1,0,"https://fbref.com/en/players/966e28d0/Fabio-Carvalho"
2025,"Brentford","Premier League","Nathan Collins","IRL","DF","23-170",2001,7,11,6,7,3,1,8,10,80,2,22,17,5,6,17,28,0,"https://fbref.com/en/players/a8c19eb8/Nathan-Collins"
2025,"Brentford","Premier League","Mikkel Damsgaard","DEN","MF","24-106",2000,5.1,19,10,9,5,5,7,12,58.3,5,13,1,12,9,28,7,1,"https://fbref.com/en/players/215f3907/Mikkel-Damsgaard"
2025,"Brentford","Premier League","Sepp van den Berg","NED","DF","22-302",2001,4.2,10,7,7,1,2,3,5,60,2,10,5,5,1,11,12,1,"https://fbref.com/en/players/7bf9400b/Sepp-van-den-Berg"
2025,"Brentford","Premier League","Yunus Emre Konak","TUR","MF,FW","18-281",2006,0.2,1,1,0,1,0,0,1,0,1,0,0,0,0,1,0,0,"https://fbref.com/en/players/e02b5b36/Yunus-Emre-Konak"
2025,"Brentford","Premier League","Mark Flekken","NED","GK","31-126",1993,7,1,1,1,0,0,1,2,50,1,0,0,0,0,1,8,0,"https://fbref.com/en/players/a92ab7be/Mark-Flekken"
2025,"Brentford","Premier League","Vitaly Janelt","GER","MF,DF","26-160",1998,6.2,9,7,4,3,2,6,10,60,4,9,1,8,6,15,16,0,"https://fbref.com/en/players/8449d35e/Vitaly-Janelt"
2025,"Brentford","Premier League","Mathias Jensen","DEN","MF","28-290",1996,2.6,1,1,1,0,0,0,3,0,3,3,1,2,2,3,2,0,"https://fbref.com/en/players/0f134faf/Mathias-Jensen"
2025,"Brentford","Premier League","Keane Lewis-Potter","ENG","DF,MF","23-238",2001,5.1,11,5,4,5,2,6,10,60,4,6,2,4,3,14,7,0,"https://fbref.com/en/players/41f08ac8/Keane-Lewis-Potter"
2025,"Brentford","Premier League","Bryan Mbeumo","CMR","FW","25-071",1999,7,8,6,5,1,2,3,4,75,1,3,1,2,2,10,4,0,"https://fbref.com/en/players/6afaebf2/Bryan-Mbeumo"
2025,"Brentford","Premier League","Ben Mee","ENG","DF","35-026",1989,0,0,0,0,0,0,0,0,NA,0,0,0,0,0,0,0,0,"https://fbref.com/en/players/8df7a2fb/Ben-Mee"
2025,"Brentford","Premier League","Christian Nørgaard","DEN","MF","30-221",1994,4.8,13,7,6,7,0,9,12,75,3,9,1,8,9,22,12,0,"https://fbref.com/en/players/df0a4c90/Christian-Norgaard"
2025,"Brentford","Premier League","Frank Onyeka","NGA","MF","26-290",1998,0.3,0,0,0,0,0,0,0,NA,0,0,0,0,0,0,0,0,"https://fbref.com/en/players/2944f86f/Frank-Onyeka"
2025,"Brentford","Premier League","Ethan Pinnock","JAM","DF","31-141",1993,7,19,10,9,7,3,7,10,70,3,9,5,4,10,29,34,2,"https://fbref.com/en/players/e541326e/Ethan-Pinnock"
2025,"Brentford","Premier League","Mads Roerslev","DEN","DF","25-115",1999,2.9,3,1,3,0,0,1,4,25,3,2,0,2,2,5,5,0,"https://fbref.com/en/players/57c94db2/Mads-Roerslev"
2025,"Brentford","Premier League","Kevin Schade","GER","FW,MF","22-325",2001,4.2,11,9,2,4,5,5,6,83.3,1,1,1,0,0,11,3,0,"https://fbref.com/en/players/52afb588/Kevin-Schade"
2025,"Brentford","Premier League","Ryan Trevitt","ENG","MF","21-219",2003,0,1,1,1,0,0,0,0,NA,0,0,0,0,0,1,0,0,"https://fbref.com/en/players/732327ae/Ryan-Trevitt"
2025,"Brentford","Premier League","Yoane Wissa","COD","FW","28-044",1996,3.2,1,1,0,0,1,0,1,0,1,2,0,2,2,3,2,0,"https://fbref.com/en/players/2500cef9/Yoane-Wissa"
2025,"Brentford","Premier League","Yehor Yarmoliuk","UKR","MF","20-230",2004,1.3,1,0,1,0,0,0,3,0,3,3,2,1,3,4,2,0,"https://fbref.com/en/players/907a5d7c/Yehor-Yarmoliuk"
2025,"Brest","Ligue 1","Ludovic Ajorque","FRA","FW","30-235",1994,5.5,4,2,0,2,2,2,5,40,3,3,1,2,1,5,5,0,"https://fbref.com/en/players/462475ed/Ludovic-Ajorque"
2025,"Brest","Ligue 1","Jordan Amavi","FRA","DF","30-222",1994,3.8,14,10,5,6,3,9,13,69.2,4,5,2,3,6,20,8,0,"https://fbref.com/en/players/22721b88/Jordan-Amavi"
2025,"Brest","Ligue 1","Marco Bizot","NED","GK","33-221",1991,7,0,0,0,0,0,0,0,NA,0,0,0,0,0,0,5,0,"https://fbref.com/en/players/3d214e5f/Marco-Bizot"
2025,"Brest","Ligue 1","Mahdi Camara","FRA","MF","26-109",1998,5.8,17,8,2,11,4,6,9,66.7,3,11,1,10,9,26,8,0,"https://fbref.com/en/players/8577e60a/Mahdi-Camara"
2025,"Brest","Ligue 1","Axel Camblan","FRA","MF,FW","21-048",2003,0.3,1,1,0,0,1,1,2,50,1,1,0,1,0,1,0,0,"https://fbref.com/en/players/9f4a940f/Axel-Camblan"
2025,"Brest","Ligue 1","Brendan Chardonnet","FRA","DF","29-300",1994,6,12,9,5,5,2,8,13,61.5,5,6,5,1,6,18,35,1,"https://fbref.com/en/players/16aa7d4c/Brendan-Chardonnet"
2025,"Brest","Ligue 1","Soumaïla Coulibaly","FRA","DF","21-003",2003,1.6,1,1,0,1,0,0,0,NA,0,3,1,2,4,5,9,0,"https://fbref.com/en/players/9dff291c/Soumaila-Coulibaly"
2025,"Brest","Ligue 1","Romain Del Castillo","FRA","FW","28-202",1996,4.7,8,5,3,1,4,4,5,80,1,9,0,9,1,9,0,0,"https://fbref.com/en/players/0be95d34/Romain-Del-Castillo"
2025,"Brest","Ligue 1","Kamory Doumbia","MLI","MF,FW","21-242",2003,2.1,7,6,1,5,1,4,5,80,1,1,0,1,3,10,2,0,"https://fbref.com/en/players/9226aa22/Kamory-Doumbia"
2025,"Brest","Ligue 1","Romain Faivre","FRA","MF,FW","26-095",1998,2.9,6,6,2,3,1,2,5,40,3,1,0,1,3,9,0,0,"https://fbref.com/en/players/745ca0a3/Romain-Faivre"
2025,"Brest","Ligue 1","Edimilson Fernandes","SUI","MF","28-185",1996,1.6,2,2,1,1,0,2,3,66.7,1,5,2,3,3,5,4,0,"https://fbref.com/en/players/3bb625ac/Edimilson-Fernandes"
2025,"Brest","Ligue 1","Massadio Haïdara","MLI","DF","31-320",1992,2.7,3,2,1,2,0,1,3,33.3,2,2,0,2,3,6,13,0,"https://fbref.com/en/players/5167c97e/Massadio-Haidara"
2025,"Brest","Ligue 1","Kenny Lala","MAD","DF","33-014",1991,6,17,12,10,7,0,13,18,72.2,5,11,6,5,6,23,13,0,"https://fbref.com/en/players/770d7eb8/Kenny-Lala"
2025,"Brest","Ligue 1","Julien Le Cardinal","FRA","DF","27-075",1997,4.8,6,3,3,3,0,3,6,50,3,7,6,1,9,15,27,0,"https://fbref.com/en/players/547a72ad/Julien-Le-Cardinal"
2025,"Brest","Ligue 1","Jérémy Le Douaron","FRA","FW","26-179",1998,1.1,1,0,0,0,1,0,1,0,1,1,0,1,0,1,0,0,"https://fbref.com/en/players/88c4d190/Jeremy-Le-Douaron"
2025,"Brest","Ligue 1","Pierre Lees-Melou","FRA","MF","31-145",1993,0.5,2,1,0,1,1,0,0,NA,0,0,0,0,1,3,1,0,"https://fbref.com/en/players/f5044e54/Pierre-Lees-Melou"
2025,"Brest","Ligue 1","Hugo Magnetti","FRA","MF","26-140",1998,5.3,5,1,3,2,0,4,9,44.4,5,5,1,4,5,10,9,0,"https://fbref.com/en/players/d4d35152/Hugo-Magnetti"
2025,"Brest","Ligue 1","Hianga Mananga Mbock","FRA","MF","24-294",1999,0.2,0,0,0,0,0,0,0,NA,0,0,0,0,1,1,0,0,"https://fbref.com/en/players/0f86995c/Hianga-Mananga-Mbock"
2025,"Brest","Ligue 1","Jonas Martin","FRA","MF,FW","34-191",1990,3,5,3,4,1,0,2,4,50,2,3,0,3,6,11,4,0,"https://fbref.com/en/players/468fdbad/Jonas-Martin"
2025,"Brest","Ligue 1","Abdoulaye Niakhate Ndiaye","SEN","DF","22-190",2002,1.6,3,2,1,2,0,2,2,100,0,3,0,3,2,5,14,0,"https://fbref.com/en/players/b8cd2ae4/Abdoulaye-Niakhate-Ndiaye"
2025,"Brest","Ligue 1","Mathias Pereira Lage","POR","MF,FW","27-322",1996,3,4,2,1,2,1,0,1,0,1,4,0,4,4,8,5,0,"https://fbref.com/en/players/8846a40f/Mathias-Pereira-Lage"
2025,"Brest","Ligue 1","Ibrahim Salah","MAR","FW","23-048",2001,1.4,1,0,0,0,1,1,1,100,0,0,0,0,1,2,0,0,"https://fbref.com/en/players/cad3fd4d/Ibrahim-Salah"
2025,"Brest","Ligue 1","Mama Samba Baldé","GNB","FW","28-346",1995,1.9,3,3,1,0,2,1,2,50,1,2,0,2,1,4,3,0,"https://fbref.com/en/players/fb14aa28/Mama-Samba-Balde"
2025,"Brest","Ligue 1","Abdallah Sima","SEN","FW,MF","23-122",2001,2.6,2,2,0,2,0,2,2,100,0,1,0,1,1,3,3,0,"https://fbref.com/en/players/fdbde523/Abdallah-Sima"
2025,"Brest","Ligue 1","Luc Zogbé","CIV","DF","19-207",2005,1.3,7,5,4,2,1,3,5,60,2,2,0,2,2,9,4,0,"https://fbref.com/en/players/3725b44f/Luc-Zogbe"
2025,"Brighton","Premier League","Simon Adingra","CIV","FW,MF","22-290",2002,1.5,4,2,2,2,0,3,5,60,2,3,0,3,2,6,0,0,"https://fbref.com/en/players/4dcec659/Simon-Adingra"
2025,"Brighton","Premier League","Yasin Ayari","SWE","MF","21-011",2003,2.2,9,5,1,7,1,3,6,50,3,2,1,1,2,11,0,0,"https://fbref.com/en/players/f173303a/Yasin-Ayari"
2025,"Brighton","Premier League","Carlos Baleba","CMR","MF","20-288",2004,4.7,15,8,1,8,6,8,13,61.5,5,6,1,5,10,25,1,0,"https://fbref.com/en/players/a1390d2f/Carlos-Baleba"
2025,"Brighton","Premier League","Lewis Dunk","ENG","DF","32-331",1991,6.8,1,0,1,0,0,1,1,100,0,7,4,3,7,8,15,0,"https://fbref.com/en/players/282f75f3/Lewis-Dunk"
2025,"Brighton","Premier League","Julio Enciso","PAR","MF,FW","20-268",2004,0.9,0,0,0,0,0,0,1,0,1,0,0,0,0,0,0,0,"https://fbref.com/en/players/9cfbad36/Julio-Enciso"
2025,"Brighton","Premier League","Pervis Estupiñán","ECU","DF","26-270",1998,2.6,6,3,3,3,0,2,3,66.7,1,0,0,0,3,9,4,0,"https://fbref.com/en/players/d38fdf53/Pervis-Estupinan"
2025,"Brighton","Premier League","Evan Ferguson","IRL","FW","19-364",2004,0.3,0,0,0,0,0,0,0,NA,0,0,0,0,0,0,0,0,"https://fbref.com/en/players/4596da74/Evan-Ferguson"
2025,"Brighton","Premier League","Billy Gilmour","SCO","MF","23-128",2001,1.1,3,3,2,1,0,3,4,75,1,1,0,1,0,3,1,0,"https://fbref.com/en/players/df10e27c/Billy-Gilmour"
2025,"Brighton","Premier League","Brajan Gruda","GER","FW","20-139",2004,0,0,0,0,0,0,0,0,NA,0,0,0,0,0,0,0,0,"https://fbref.com/en/players/ae9b998d/Brajan-Gruda"
2025,"Brighton","Premier League","Jan Paul van Hecke","NED","DF","24-131",2000,5,9,5,6,3,0,5,8,62.5,3,2,1,1,5,14,12,0,"https://fbref.com/en/players/4fd08daa/Jan-Paul-van-Hecke"
2025,"Brighton","Premier League","Jack Hinshelwood","ENG","DF,MF","19-189",2005,6.7,7,4,2,3,2,4,9,44.4,5,1,0,1,3,10,9,1,"https://fbref.com/en/players/e98211e7/Jack-Hinshelwood"
2025,"Brighton","Premier League","Igor","BRA","DF","26-253",1998,1.3,1,1,0,0,1,1,2,50,1,4,1,3,0,1,0,0,"https://fbref.com/en/players/a4e85758/Igor"
2025,"Brighton","Premier League","João Pedro","BRA","MF,FW","23-021",2001,3.1,5,3,1,3,1,1,3,33.3,2,2,0,2,1,6,2,0,"https://fbref.com/en/players/e8832875/Joao-Pedro"
2025,"Brighton","Premier League","Ferdi Kadioglu","TUR","DF","25-010",1999,1.5,3,1,1,2,0,2,7,28.6,5,0,0,0,5,8,6,0,"https://fbref.com/en/players/66c52a77/Ferdi-Kadioglu"
2025,"Brighton","Premier League","James Milner","ENG","MF","38-287",1986,1.9,5,2,1,3,1,3,3,100,0,4,2,2,2,7,2,1,"https://fbref.com/en/players/2f90f6b8/James-Milner"
2025,"Brighton","Premier League","Yankuba Minteh","GAM","FW,MF","20-087",2004,4.5,5,3,1,1,3,3,11,27.3,8,7,0,7,3,8,4,0,"https://fbref.com/en/players/c3cf087d/Yankuba-Minteh"
2025,"Brighton","Premier League","Kaoru Mitoma","JPN","FW,MF","27-150",1997,6.9,12,6,4,4,4,8,14,57.1,6,11,0,11,3,15,1,0,"https://fbref.com/en/players/74618572/Kaoru-Mitoma"
2025,"Brighton","Premier League","Georginio Rutter","FRA","FW,MF","22-180",2002,3.3,2,0,1,1,0,1,8,12.5,7,6,0,6,2,4,1,1,"https://fbref.com/en/players/c64c01fc/Georginio-Rutter"
2025,"Brighton","Premier League","Jeremy Sarmiento","ECU","MF","22-123",2002,0.1,0,0,0,0,0,0,0,NA,0,0,0,0,0,0,0,0,"https://fbref.com/en/players/ac0d576d/Jeremy-Sarmiento"
2025,"Brighton","Premier League","Jason Steele","ENG","GK","34-060",1990,2,0,0,0,0,0,0,0,NA,0,0,0,0,0,0,1,0,"https://fbref.com/en/players/28300a16/Jason-Steele"
2025,"Brighton","Premier League","Joël Veltman","NED","DF","32-276",1992,5.8,16,10,9,5,2,11,21,52.4,10,7,2,5,6,22,16,0,"https://fbref.com/en/players/dad4b285/Joel-Veltman"
2025,"Brighton","Premier League","Bart Verbruggen","NED","GK","22-060",2002,5,0,0,0,0,0,0,1,0,1,0,0,0,0,0,3,2,"https://fbref.com/en/players/cf134113/Bart-Verbruggen"
2025,"Brighton","Premier League","Adam Webster","ENG","DF","29-287",1995,0.9,0,0,0,0,0,0,2,0,2,4,3,1,1,1,3,1,"https://fbref.com/en/players/c40b6180/Adam-Webster"
2025,"Brighton","Premier League","Danny Welbeck","ENG","FW","33-326",1990,6.6,6,4,2,3,1,1,3,33.3,2,6,1,5,2,8,4,0,"https://fbref.com/en/players/ce5143da/Danny-Welbeck"
2025,"Brighton","Premier League","Mats Wieffer","NED","MF","24-336",1999,2.1,6,3,1,3,2,2,5,40,3,5,1,4,2,8,4,1,"https://fbref.com/en/players/4876c9ab/Mats-Wieffer"
2025,"Cagliari","Serie A","Tommaso Augello","ITA","DF,FW","30-048",1994,5.5,10,5,5,3,2,7,9,77.8,2,8,3,5,5,15,26,0,"https://fbref.com/en/players/3cd3b384/Tommaso-Augello"
2025,"Cagliari","Serie A","Paulo Azzi","BRA","DF","30-094",1994,3.7,8,7,1,6,1,3,5,60,2,4,2,2,4,12,8,0,"https://fbref.com/en/players/967ac202/Paulo-Azzi"
2025,"Cagliari","Serie A","Alessandro Deiola","ITA","MF","29-077",1995,4.4,9,4,3,6,0,3,8,37.5,5,4,2,2,2,11,8,0,"https://fbref.com/en/players/7f267d66/Alessandro-Deiola"
2025,"Cagliari","Serie A","Mattia Felici","ITA","DF","23-183",2001,0.3,0,0,0,0,0,0,0,NA,0,0,0,0,2,2,0,0,"https://fbref.com/en/players/38aa2612/Mattia-Felici"
2025,"Cagliari","Serie A","Gianluca Gaetano","ITA","MF,FW","24-165",2000,1.5,3,2,1,2,0,2,3,66.7,1,2,0,2,1,4,1,0,"https://fbref.com/en/players/3b387cc7/Gianluca-Gaetano"
2025,"Cagliari","Serie A","Gianluca Lapadula","PER","FW,MF","34-253",1990,1,1,0,0,0,1,0,0,NA,0,0,0,0,0,1,1,0,"https://fbref.com/en/players/2ead2809/Gianluca-Lapadula"
2025,"Cagliari","Serie A","José Luis Palomino","ARG","DF","34-286",1990,1,1,1,0,0,1,0,1,0,1,1,1,0,0,1,3,0,"https://fbref.com/en/players/921f6058/Jose-Luis-Palomino"
2025,"Cagliari","Serie A","Sebastiano Luperto","ITA","DF","28-041",1996,7,9,6,7,1,1,3,6,50,3,7,5,2,8,17,29,0,"https://fbref.com/en/players/997fff07/Sebastiano-Luperto"
2025,"Cagliari","Serie A","Zito Luvumbo","ANG","FW,MF","22-222",2002,5.3,1,0,1,0,0,0,4,0,4,1,0,1,0,1,1,0,"https://fbref.com/en/players/b09e0873/Zito-Luvumbo"
2025,"Cagliari","Serie A","Antoine Makoumbou","CGO","MF","26-091",1998,2.4,3,2,2,1,0,1,2,50,1,7,1,6,3,6,3,0,"https://fbref.com/en/players/f37f3522/Antoine-Makoumbou"
2025,"Cagliari","Serie A","Răzvan Marin","ROU","MF","28-147",1996,5.1,9,5,2,6,1,6,11,54.5,5,3,0,3,1,10,8,1,"https://fbref.com/en/players/7fac99d4/Razvan-Marin"
2025,"Cagliari","Serie A","Yerry Mina","COL","DF","30-024",1994,5.5,12,4,5,6,1,9,12,75,3,12,6,6,6,18,24,1,"https://fbref.com/en/players/6d5701f2/Yerry-Mina"
2025,"Cagliari","Serie A","Kingstone Mutandwa","ZAM","MF,FW","21-286",2003,0.5,0,0,0,0,0,0,0,NA,0,0,0,0,0,0,0,0,"https://fbref.com/en/players/cbe32194/Kingstone-Mutandwa"
2025,"Cagliari","Serie A","Michel Ndary Adopo","FRA","MF","24-090",2000,2.9,7,3,3,4,0,1,4,25,3,0,0,0,4,11,1,0,"https://fbref.com/en/players/599d91d0/Michel-Ndary-Adopo"
2025,"Cagliari","Serie A","Adam Obert","SVK","DF","22-055",2002,1.8,2,2,1,1,0,1,4,25,3,4,1,3,5,7,10,1,"https://fbref.com/en/players/aa25ce92/Adam-Obert"
2025,"Cagliari","Serie A","Leonardo Pavoletti","ITA","FW,MF","35-326",1988,1.1,0,0,0,0,0,0,0,NA,0,1,1,0,0,0,1,0,"https://fbref.com/en/players/d37b0350/Leonardo-Pavoletti"
2025,"Cagliari","Serie A","Roberto Piccoli","ITA","FW","23-264",2001,6.4,1,0,0,0,1,1,1,100,0,2,1,1,1,2,6,0,"https://fbref.com/en/players/1cadaf34/Roberto-Piccoli"
2025,"Cagliari","Serie A","Matteo Prati","ITA","MF","20-294",2003,1.9,4,2,1,2,1,2,6,33.3,4,0,0,0,2,6,2,1,"https://fbref.com/en/players/d8363914/Matteo-Prati"
2025,"Cagliari","Serie A","Simone Scuffet","ITA","GK","28-139",1996,7,0,0,0,0,0,0,1,0,1,0,0,0,0,0,6,1,"https://fbref.com/en/players/41bd99ea/Simone-Scuffet"
2025,"Cagliari","Serie A","Nicolas Viola","ITA","MF,FW","35-005",1989,1.9,2,2,1,1,0,0,3,0,3,0,0,0,1,3,2,0,"https://fbref.com/en/players/45392b06/Nicolas-Viola"
2025,"Cagliari","Serie A","Mateusz Wieteska","POL","DF","27-249",1997,1,1,0,0,1,0,1,1,100,0,2,1,1,6,7,4,0,"https://fbref.com/en/players/3ecc8c5f/Mateusz-Wieteska"
2025,"Cagliari","Serie A","Gabriele Zappa","ITA","DF","24-300",1999,6.5,9,6,5,4,0,5,7,71.4,2,11,7,4,5,14,19,0,"https://fbref.com/en/players/ca3db240/Gabriele-Zappa"
2025,"Cagliari","Serie A","Nadir Zortea","ITA","DF,FW","25-120",1999,3.2,6,2,5,1,0,2,3,66.7,1,1,0,1,2,8,5,0,"https://fbref.com/en/players/82598b71/Nadir-Zortea"
2025,"Celta Vigo","La Liga","Joseph Aidoo","GHA","DF","29-018",1995,0,1,0,1,0,0,0,0,NA,0,0,0,0,0,1,0,0,"https://fbref.com/en/players/18abe173/Joseph-Aidoo"
2025,"Celta Vigo","La Liga","Alfon","ESP","FW,MF","25-166",1999,2.1,1,0,0,1,0,0,1,0,1,2,0,2,1,2,1,0,"https://fbref.com/en/players/1c772b46/Alfon"
2025,"Celta Vigo","La Liga","Marcos Alonso","ESP","DF,MF","33-294",1990,4.1,3,1,2,1,0,2,5,40,3,4,2,2,6,9,12,0,"https://fbref.com/en/players/f4290206/Marcos-Alonso"
2025,"Celta Vigo","La Liga","Hugo Álvarez","ESP","MF,DF","21-107",2003,7.5,14,5,8,5,1,6,10,60,4,8,1,7,4,18,13,1,"https://fbref.com/en/players/6f392eb8/Hugo-Alvarez"
2025,"Celta Vigo","La Liga","Iago Aspas","ESP","FW,MF","37-077",1987,7,6,3,2,2,2,5,10,50,5,5,0,5,1,7,4,0,"https://fbref.com/en/players/7dcf86f6/Iago-Aspas"
2025,"Celta Vigo","La Liga","Jonathan Bamba","CIV","FW,MF","28-205",1996,2.8,4,1,1,2,1,2,4,50,2,2,0,2,3,7,3,0,"https://fbref.com/en/players/b2bd0f6c/Jonathan-Bamba"
2025,"Celta Vigo","La Liga","Fran Beltrán","ESP","MF","25-257",1999,5.6,11,6,6,4,1,5,9,55.6,4,7,3,4,4,15,7,0,"https://fbref.com/en/players/ed5c5fa3/Fran-Beltran"
2025,"Celta Vigo","La Liga","Sergio Carreira","ESP","MF,DF","24-004",2000,2.6,6,4,3,2,1,2,4,50,2,2,0,2,1,7,9,0,"https://fbref.com/en/players/8d6a9c93/Sergio-Carreira"
2025,"Celta Vigo","La Liga","Franco Cervi","ARG","DF","30-144",1994,0.1,0,0,0,0,0,0,2,0,2,0,0,0,1,1,0,0,"https://fbref.com/en/players/5e1028e5/Franco-Cervi"
2025,"Celta Vigo","La Liga","Carlos Dominguez","ESP","DF","23-249",2001,3.8,7,4,4,3,0,4,7,57.1,3,4,4,0,4,11,22,0,"https://fbref.com/en/players/3521abfe/Carlos-Dominguez"
2025,"Celta Vigo","La Liga","Anastasios Douvikas","GRE","FW","25-076",1999,3.9,5,1,1,4,0,1,3,33.3,2,4,2,2,3,8,5,0,"https://fbref.com/en/players/853ca71c/Anastasios-Douvikas"
2025,"Celta Vigo","La Liga","Pablo Durán","ESP","FW,MF","23-145",2001,1.9,3,2,0,2,1,2,4,50,2,1,1,0,2,5,2,0,"https://fbref.com/en/players/6db116ec/Pablo-Duran"
2025,"Celta Vigo","La Liga","Vicente Guaita","ESP","GK","37-281",1987,5,0,0,0,0,0,0,0,NA,0,0,0,0,0,0,1,0,"https://fbref.com/en/players/ab13a5aa/Vicente-Guaita"
2025,"Celta Vigo","La Liga","Borja Iglesias","ESP","FW","31-274",1993,5.1,3,3,1,1,1,0,1,0,1,3,1,2,3,6,4,0,"https://fbref.com/en/players/75645f0e/Borja-Iglesias"
2025,"Celta Vigo","La Liga","Javier Manquillo","ESP","DF","30-165",1994,2.7,3,2,2,1,0,1,3,33.3,2,3,2,1,3,6,9,0,"https://fbref.com/en/players/758dd7f0/Javier-Manquillo"
2025,"Celta Vigo","La Liga","Óscar Mingueza","ESP","MF,DF","25-157",1999,6.5,10,5,4,6,0,7,13,53.8,6,11,3,8,1,11,12,1,"https://fbref.com/en/players/056269d7/Oscar-Mingueza"
2025,"Celta Vigo","La Liga","Ilaix Moriba","GUI","MF","21-272",2003,3.4,7,5,2,5,0,6,15,40,9,3,1,2,4,11,3,0,"https://fbref.com/en/players/f4c69aa6/Ilaix-Moriba"
2025,"Celta Vigo","La Liga","Damián Rodríguez","ESP","MF","21-214",2003,5.8,7,4,2,4,1,2,7,28.6,5,3,1,2,4,11,8,0,"https://fbref.com/en/players/22371dee/Damian-Rodriguez"
2025,"Celta Vigo","La Liga","Javi Rodríguez","ESP","DF","21-113",2003,5.9,8,5,7,1,0,6,8,75,2,4,1,3,4,12,17,0,"https://fbref.com/en/players/08ec5e71/Javi-Rodriguez"
2025,"Celta Vigo","La Liga","Jailson Siqueira","BRA","DF,MF","29-040",1995,5,7,7,5,2,0,5,6,83.3,1,5,3,2,8,15,18,1,"https://fbref.com/en/players/b4819112/Jailson-Siqueira"
2025,"Celta Vigo","La Liga","Hugo Sotelo","ESP","MF","20-303",2003,2.8,5,4,3,1,1,0,2,0,2,1,0,1,0,5,3,0,"https://fbref.com/en/players/3aa74860/Hugo-Sotelo"
2025,"Celta Vigo","La Liga","Carl Starfelt","SWE","DF","29-138",1995,6.2,4,3,3,1,0,1,4,25,3,10,8,2,11,15,34,0,"https://fbref.com/en/players/5cfec13d/Carl-Starfelt"
2025,"Celta Vigo","La Liga","Williot Swedberg","SWE","FW,MF","20-259",2004,4.2,4,3,1,2,1,3,4,75,1,4,0,4,0,4,3,0,"https://fbref.com/en/players/184fe4b2/Williot-Swedberg"
2025,"Celta Vigo","La Liga","Iván Villar","ESP","GK","27-100",1997,4,0,0,0,0,0,0,0,NA,0,0,0,0,0,0,3,0,"https://fbref.com/en/players/cde52ef5/Ivan-Villar"
2025,"Chelsea","Premier League","Tosin Adarabioyo","ENG","DF","27-023",1997,1.3,2,2,2,0,0,1,1,100,0,2,2,0,1,3,6,0,"https://fbref.com/en/players/c81d773d/Tosin-Adarabioyo"
2025,"Chelsea","Premier League","Moisés Caicedo","ECU","MF","22-350",2001,6.8,27,16,14,11,2,19,27,70.4,8,11,3,8,10,37,11,0,"https://fbref.com/en/players/16264a81/Moises-Caicedo"
2025,"Chelsea","Premier League","Levi Colwill","ENG","DF","21-234",2003,7,4,2,4,0,0,1,3,33.3,2,11,8,3,10,14,27,0,"https://fbref.com/en/players/700783e7/Levi-Colwill"
2025,"Chelsea","Premier League","Marc Cucurella","ESP","DF","26-087",1998,6.6,9,6,6,3,0,4,11,36.4,7,10,4,6,6,15,24,0,"https://fbref.com/en/players/1daec722/Marc-Cucurella"
2025,"Chelsea","Premier League","Kiernan Dewsbury-Hall","ENG","MF","26-041",1998,0.5,0,0,0,0,0,0,0,NA,0,1,0,1,1,1,1,1,"https://fbref.com/en/players/5c74c0f5/Kiernan-Dewsbury-Hall"
2025,"Chelsea","Premier League","Axel Disasi","FRA","DF","26-220",1998,1,1,1,1,0,0,1,3,33.3,2,1,0,1,1,2,3,0,"https://fbref.com/en/players/ad82197c/Axel-Disasi"
2025,"Chelsea","Premier League","João Félix","POR","MF,FW","24-342",1999,1.4,2,0,1,0,1,1,2,50,1,1,0,1,1,3,2,0,"https://fbref.com/en/players/8aafd64f/Joao-Felix"
2025,"Chelsea","Premier League","Enzo Fernández","ARG","MF","23-274",2001,5.7,14,6,3,6,5,9,22,40.9,13,6,1,5,2,16,5,2,"https://fbref.com/en/players/5ff4ab71/Enzo-Fernandez"
2025,"Chelsea","Premier League","Wesley Fofana","FRA","DF","23-305",2000,6.6,7,6,2,5,0,2,7,28.6,5,8,5,3,9,16,27,1,"https://fbref.com/en/players/132a82f1/Wesley-Fofana"
2025,"Chelsea","Premier League","Marc Guiu","ESP","FW","18-287",2006,0.3,0,0,0,0,0,0,0,NA,0,0,0,0,0,0,0,0,"https://fbref.com/en/players/d3d774cc/Marc-Guiu"
2025,"Chelsea","Premier League","Malo Gusto","FRA","DF","21-151",2003,4.8,13,8,9,3,1,7,18,38.9,11,10,3,7,3,16,11,1,"https://fbref.com/en/players/d56b9520/Malo-Gusto"
2025,"Chelsea","Premier League","Nicolas Jackson","SEN","FW","23-119",2001,5.8,1,1,0,0,1,0,2,0,2,6,0,6,1,2,6,0,"https://fbref.com/en/players/9c36ed83/Nicolas-Jackson"
2025,"Chelsea","Premier League","Roméo Lavia","BEL","MF","20-285",2004,0.9,3,1,0,2,1,0,1,0,1,0,0,0,3,6,1,0,"https://fbref.com/en/players/ecad9aa5/Romeo-Lavia"
2025,"Chelsea","Premier League","Noni Madueke","ENG","FW","22-221",2002,5.3,8,6,2,5,1,4,10,40,6,2,0,2,3,11,4,0,"https://fbref.com/en/players/bf34eebd/Noni-Madueke"
2025,"Chelsea","Premier League","Mykhailo Mudryk","UKR","FW","23-286",2001,0.9,0,0,0,0,0,0,0,NA,0,1,1,0,0,0,0,0,"https://fbref.com/en/players/049a888d/Mykhailo-Mudryk"
2025,"Chelsea","Premier League","Pedro Neto","POR","FW","24-222",2000,2.7,4,2,1,3,0,2,2,100,0,2,0,2,1,5,2,0,"https://fbref.com/en/players/7ba2eaa9/Pedro-Neto"
2025,"Chelsea","Premier League","Christopher Nkunku","FRA","FW","26-338",1997,1.5,3,3,0,1,2,2,2,100,0,3,1,2,1,4,1,0,"https://fbref.com/en/players/7c56da38/Christopher-Nkunku"
2025,"Chelsea","Premier League","Cole Palmer","ENG","MF,FW","22-164",2002,6.6,7,5,3,4,0,3,6,50,3,2,1,1,2,9,5,0,"https://fbref.com/en/players/dc7f8a28/Cole-Palmer"
2025,"Chelsea","Premier League","Robert Sánchez","ESP","GK","26-334",1997,7,0,0,0,0,0,0,0,NA,0,0,0,0,0,0,4,2,"https://fbref.com/en/players/6a713852/Robert-Sanchez"
2025,"Chelsea","Premier League","Jadon Sancho","ENG","FW","24-206",2000,2.9,1,1,1,0,0,1,3,33.3,2,0,0,0,0,1,0,0,"https://fbref.com/en/players/dbf053da/Jadon-Sancho"
2025,"Chelsea","Premier League","Renato Veiga","POR","MF,DF","21-080",2003,1.4,8,5,5,3,0,4,8,50,4,3,1,2,1,9,1,0,"https://fbref.com/en/players/fc8fcbd1/Renato-Veiga"
2025,"Como","Serie A","Oliver Abildgaard","DEN","MF","28-129",1996,0.1,0,0,0,0,0,0,0,NA,0,1,0,1,0,0,0,0,"https://fbref.com/en/players/8f5cdf66/Oliver-Abildgaard"
2025,"Como","Serie A","Emil Audero","ITA","GK","27-273",1997,4,0,0,0,0,0,0,0,NA,0,0,0,0,0,0,2,0,"https://fbref.com/en/players/649b01d8/Emil-Audero"
2025,"Como","Serie A","Federico Barba","ITA","DF","31-046",1993,2,0,0,0,0,0,0,1,0,1,1,1,0,3,3,9,0,"https://fbref.com/en/players/c010b898/Federico-Barba"
2025,"Como","Serie A","Daniele Baselli","ITA","MF","32-219",1992,0.2,0,0,0,0,0,0,0,NA,0,0,0,0,1,1,1,0,"https://fbref.com/en/players/ea06dd97/Daniele-Baselli"
2025,"Como","Serie A","Andrea Belotti","ITA","FW","30-302",1993,2.3,4,3,1,2,1,0,2,0,2,1,0,1,1,5,2,0,"https://fbref.com/en/players/d705ba44/Andrea-Belotti"
2025,"Como","Serie A","Matthias Braunöder","AUT","MF","22-204",2002,1.5,5,2,3,1,1,5,7,71.4,2,0,0,0,0,5,3,0,"https://fbref.com/en/players/bce728e1/Matthias-Braunoder"
2025,"Como","Serie A","Alberto Cerri","ITA","FW","28-184",1996,0.7,0,0,0,0,0,0,0,NA,0,1,0,1,0,0,1,0,"https://fbref.com/en/players/1079c685/Alberto-Cerri"
2025,"Como","Serie A","Patrick Cutrone","ITA","FW","26-288",1998,6.2,6,5,0,3,3,2,3,66.7,1,2,0,2,1,7,4,0,"https://fbref.com/en/players/a4fe8cda/Patrick-Cutrone"
2025,"Como","Serie A","Lucas Da Cunha","FRA","MF,FW","23-130",2001,2.2,5,2,3,1,1,2,3,66.7,1,5,0,5,0,5,1,0,"https://fbref.com/en/players/007faf7a/Lucas-Da-Cunha"
2025,"Como","Serie A","Alberto Dossena","ITA","DF","26-004",1998,5.7,12,7,9,3,0,5,8,62.5,3,3,1,2,8,20,26,1,"https://fbref.com/en/players/61efb926/Alberto-Dossena"
2025,"Como","Serie A","Yannik Engelhardt","GER","MF","23-253",2001,0.9,1,0,1,0,0,1,3,33.3,2,0,0,0,0,1,0,0,"https://fbref.com/en/players/fac66db3/Yannik-Engelhardt"
2025,"Como","Serie A","Alieu Fadera","GAM","FW,MF","22-349",2001,3.5,15,12,7,5,3,8,19,42.1,11,5,1,4,0,15,0,0,"https://fbref.com/en/players/53210e42/Alieu-Fadera"
2025,"Como","Serie A","Alessandro Gabrielloni","ITA","FW,MF","30-099",1994,0.6,0,0,0,0,0,0,1,0,1,0,0,0,0,0,0,0,"https://fbref.com/en/players/181cb492/Alessandro-Gabrielloni"
2025,"Como","Serie A","Edoardo Goldaniga","ITA","DF","30-350",1993,1.4,2,1,2,0,0,0,0,NA,0,1,1,0,2,4,5,0,"https://fbref.com/en/players/4b029b31/Edoardo-Goldaniga"
2025,"Como","Serie A","Alessio Iovine","ITA","DF","33-259",1991,2.5,1,0,0,1,0,1,3,33.3,2,4,1,3,2,3,17,0,"https://fbref.com/en/players/083d7173/Alessio-Iovine"
2025,"Como","Serie A","Ali Jasim","IRQ","FW","20-271",2004,0,0,0,0,0,0,0,0,NA,0,0,0,0,0,0,0,0,"https://fbref.com/en/players/1a927a6f/Ali-Jasim"
2025,"Como","Serie A","Marc-Oliver Kempf","GER","DF","29-263",1995,5,3,3,0,3,0,1,2,50,1,4,2,2,10,13,23,0,"https://fbref.com/en/players/815c314f/Marc-Oliver-Kempf"
2025,"Como","Serie A","Luca Mazzitelli","ITA","MF","28-337",1995,1.9,6,3,3,3,0,3,5,60,2,5,2,3,2,8,6,0,"https://fbref.com/en/players/dc61b402/Luca-Mazzitelli"
2025,"Como","Serie A","Alberto Moreno","ESP","DF","32-104",1992,7,10,4,6,4,0,3,8,37.5,5,7,1,6,6,16,11,1,"https://fbref.com/en/players/11b9265b/Alberto-Moreno"
2025,"Como","Serie A","Nicolás Paz","ARG","MF,FW","20-039",2004,4.6,8,7,3,3,2,4,6,66.7,2,9,1,8,4,12,2,0,"https://fbref.com/en/players/01bb93d5/Nicolas-Paz"
2025,"Como","Serie A","Máximo Perrone","ARG","MF","21-284",2003,5.3,9,6,6,3,0,3,16,18.8,13,3,0,3,6,15,13,0,"https://fbref.com/en/players/53552942/Maximo-Perrone"
2025,"Como","Serie A","Pepe Reina","ESP","GK","42-047",1982,3,0,0,0,0,0,0,0,NA,0,0,0,0,0,0,0,1,"https://fbref.com/en/players/e358587b/Pepe-Reina"
2025,"Como","Serie A","Sergi Roberto","ESP","MF","32-253",1992,4.5,9,6,3,3,3,4,5,80,1,3,1,2,9,18,6,0,"https://fbref.com/en/players/335fa267/Sergi-Roberto"
2025,"Como","Serie A","Marco Sala","ITA","DF","25-135",1999,1,3,2,1,1,1,1,1,100,0,1,0,1,1,4,2,0,"https://fbref.com/en/players/0c57be8b/Marco-Sala"
2025,"Como","Serie A","Gabriel Strefezza","BRA","FW,MF","27-182",1997,6.6,16,12,5,6,5,6,15,40,9,5,1,4,2,18,1,0,"https://fbref.com/en/players/ac4a4508/Gabriel-Strefezza"
2025,"Como","Serie A","Ignace Van Der Brempt","BEL","DF","22-199",2002,3.4,14,9,11,3,0,8,11,72.7,3,4,2,2,4,18,6,0,"https://fbref.com/en/players/2bf50b37/Ignace-Van-Der-Brempt"
2025,"Como","Serie A","Simone Verdi","ITA","MF,FW","32-097",1992,0.6,0,0,0,0,0,0,1,0,1,0,0,0,0,0,0,0,"https://fbref.com/en/players/0375723e/Simone-Verdi"
2025,"Crystal Palace","Premier League","Joachim Andersen","DEN","DF","28-139",1996,1,1,1,1,0,0,1,2,50,1,0,0,0,0,1,7,0,"https://fbref.com/en/players/e34fc66d/Joachim-Andersen"
2025,"Crystal Palace","Premier League","Jordan Ayew","GHA","FW,MF","33-036",1991,0.2,1,0,0,0,1,0,0,NA,0,0,0,0,0,1,0,0,"https://fbref.com/en/players/da052c14/Jordan-Ayew"
2025,"Crystal Palace","Premier League","Trevoh Chalobah","ENG","DF","25-104",1999,1,1,0,1,0,0,0,0,NA,0,0,0,0,2,3,1,0,"https://fbref.com/en/players/5515376c/Trevoh-Chalobah"
2025,"Crystal Palace","Premier League","Nathaniel Clyne","ENG","DF,MF","33-195",1991,2.5,9,6,6,2,1,5,6,83.3,1,0,0,0,1,10,10,1,"https://fbref.com/en/players/0442183b/Nathaniel-Clyne"
2025,"Crystal Palace","Premier League","Cheick Doucouré","MLI","MF","24-283",2000,1,6,3,1,4,1,1,2,50,1,2,0,2,2,8,1,0,"https://fbref.com/en/players/ce4f40c7/Cheick-Doucoure"
2025,"Crystal Palace","Premier League","Odsonne Édouard","FRA","MF,FW","26-275",1998,1.3,1,0,0,1,0,0,2,0,2,1,0,1,0,1,1,0,"https://fbref.com/en/players/0562b7f1/Odsonne-Edouard"
2025,"Crystal Palace","Premier League","Eberechi Eze","ENG","MF,FW","26-110",1998,7,10,7,4,5,1,4,10,40,6,4,0,4,3,13,2,1,"https://fbref.com/en/players/ae4fc6a4/Eberechi-Eze"
2025,"Crystal Palace","Premier League","Marc Guéhi","ENG","DF","24-096",2000,7,6,3,6,0,0,4,5,80,1,13,9,4,5,11,46,1,"https://fbref.com/en/players/d0706b27/Marc-Guehi"
2025,"Crystal Palace","Premier League","Dean Henderson","ENG","GK","27-219",1997,7,1,0,1,0,0,1,2,50,1,0,0,0,0,1,6,0,"https://fbref.com/en/players/e5a76dfe/Dean-Henderson"
2025,"Crystal Palace","Premier League","Will Hughes","ENG","MF","29-183",1995,2.6,10,4,1,4,5,3,5,60,2,1,0,1,2,12,1,0,"https://fbref.com/en/players/a0666d3e/Will-Hughes"
2025,"Crystal Palace","Premier League","Daichi Kamada","JPN","MF","28-073",1996,4.1,12,6,3,7,2,4,10,40,6,6,1,5,3,15,4,0,"https://fbref.com/en/players/15b287da/Daichi-Kamada"
2025,"Crystal Palace","Premier League","Maxence Lacroix","FRA","DF","24-194",2000,4,7,4,5,1,1,2,6,33.3,4,6,2,4,7,14,15,0,"https://fbref.com/en/players/277c49ed/Maxence-Lacroix"
2025,"Crystal Palace","Premier League","Jefferson Lerma","COL","MF,DF","29-358",1994,3.4,3,2,1,1,1,2,4,50,2,3,1,2,5,8,7,0,"https://fbref.com/en/players/9b5ce51a/Jefferson-Lerma"
2025,"Crystal Palace","Premier League","Jean-Philippe Mateta","FRA","FW","27-111",1997,5.1,1,0,0,1,0,0,2,0,2,3,0,3,0,1,2,0,"https://fbref.com/en/players/50e6dc35/Jean-Philippe-Mateta"
2025,"Crystal Palace","Premier League","Tyrick Mitchell","ENG","DF,MF","25-046",1999,6.6,23,17,13,9,1,3,6,50,3,12,3,9,4,27,17,1,"https://fbref.com/en/players/5cbd1eb0/Tyrick-Mitchell"
2025,"Crystal Palace","Premier League","Daniel Muñoz","COL","DF,MF","28-144",1996,6.1,20,14,10,9,1,7,13,53.8,6,6,1,5,5,25,16,0,"https://fbref.com/en/players/778ef829/Daniel-Munoz"
2025,"Crystal Palace","Premier League","Eddie Nketiah","ENG","MF,FW","25-140",1999,3.5,2,1,2,0,0,0,1,0,1,3,0,3,1,3,3,0,"https://fbref.com/en/players/a53649b7/Eddie-Nketiah"
2025,"Crystal Palace","Premier League","Chadi Riad","MAR","DF","21-122",2003,1,5,2,2,2,1,2,3,66.7,1,0,0,0,2,7,0,0,"https://fbref.com/en/players/b3b9b8b8/Chadi-Riad"
2025,"Crystal Palace","Premier League","Chris Richards","USA","DF","24-203",2000,3.8,10,5,5,4,1,6,11,54.5,5,7,1,6,3,13,17,0,"https://fbref.com/en/players/0a3d6d2b/Chris-Richards"
2025,"Crystal Palace","Premier League","Ismaila Sarr","SEN","FW,MF","26-235",1998,2.5,0,0,0,0,0,0,3,0,3,2,0,2,2,2,1,0,"https://fbref.com/en/players/bfdb33aa/Ismaila-Sarr"
2025,"Crystal Palace","Premier League","Jeffrey Schlupp","GHA","MF,DF","31-299",1992,0.4,0,0,0,0,0,0,1,0,1,1,0,1,0,0,1,0,"https://fbref.com/en/players/3312f911/Jeffrey-Schlupp"
2025,"Crystal Palace","Premier League","Adam Wharton","ENG","MF","20-137",2004,5.9,14,8,7,7,0,8,23,34.8,15,3,0,3,7,21,9,0,"https://fbref.com/en/players/4b542852/Adam-Wharton"
2025,"Dortmund","Bundesliga","Karim Adeyemi","GER","FW,MF","22-273",2002,3.4,7,5,3,1,3,2,2,100,0,6,0,6,1,8,0,0,"https://fbref.com/en/players/501055d8/Karim-Adeyemi"
2025,"Dortmund","Bundesliga","Waldemar Anton","GER","DF","28-089",1996,6,12,9,7,4,1,4,5,80,1,11,8,3,6,18,25,1,"https://fbref.com/en/players/5e66fa06/Waldemar-Anton"
2025,"Dortmund","Bundesliga","Maximilian Beier","GER","FW","22-000",2002,2.5,3,1,0,2,1,2,4,50,2,2,0,2,0,3,2,0,"https://fbref.com/en/players/5db45ee5/Maximilian-Beier"
2025,"Dortmund","Bundesliga","Ramy Bensebaini","ALG","DF,FW","29-184",1995,2,1,0,1,0,0,0,3,0,3,7,0,7,3,4,5,1,"https://fbref.com/en/players/378825c7/Ramy-Bensebaini"
2025,"Dortmund","Bundesliga","Julian Brandt","GER","MF","28-168",1996,5.2,3,0,2,1,0,1,2,50,1,2,0,2,1,4,3,0,"https://fbref.com/en/players/a167537f/Julian-Brandt"
2025,"Dortmund","Bundesliga","Emre Can","GER","MF,DF","30-279",1994,4.1,7,3,2,4,1,3,6,50,3,5,3,2,2,9,9,1,"https://fbref.com/en/players/a65ce836/Emre-Can"
2025,"Dortmund","Bundesliga","Yan Couto","BRA","DF","22-136",2002,2.6,5,3,4,1,0,4,7,57.1,3,6,0,6,2,7,6,1,"https://fbref.com/en/players/1944818c/Yan-Couto"
2025,"Dortmund","Bundesliga","Julien Duranville","BEL","FW","18-165",2006,0.3,0,0,0,0,0,0,0,NA,0,0,0,0,0,0,0,0,"https://fbref.com/en/players/b06a7ae9/Julien-Duranville"
2025,"Dortmund","Bundesliga","Jamie Gittens","ENG","FW","20-070",2004,3.2,6,2,1,3,2,0,1,0,1,3,0,3,2,8,0,0,"https://fbref.com/en/players/10745192/Jamie-Gittens"
2025,"Dortmund","Bundesliga","Pascal Groß","GER","MF","33-124",1991,5.2,8,4,1,6,1,1,8,12.5,7,4,1,3,2,10,4,1,"https://fbref.com/en/players/8aec0537/Pascal-Gross"
2025,"Dortmund","Bundesliga","Serhou Guirassy","GUI","FW","28-219",1996,3.8,0,0,0,0,0,0,0,NA,0,0,0,0,0,0,4,0,"https://fbref.com/en/players/923f4dda/Serhou-Guirassy"
2025,"Dortmund","Bundesliga","Gregor Kobel","SUI","GK","26-316",1997,6,0,0,0,0,0,0,0,NA,0,0,0,0,0,0,3,1,"https://fbref.com/en/players/cd59b9df/Gregor-Kobel"
2025,"Dortmund","Bundesliga","Donyell Malen","NED","FW,DF","25-282",1999,2.1,0,0,0,0,0,0,0,NA,0,2,0,2,1,1,1,0,"https://fbref.com/en/players/116c35df/Donyell-Malen"
2025,"Dortmund","Bundesliga","Felix Nmecha","GER","MF","24-007",2000,2.1,3,3,0,2,1,2,3,66.7,1,1,0,1,2,5,5,0,"https://fbref.com/en/players/091c86e2/Felix-Nmecha"
2025,"Dortmund","Bundesliga","Gio Reyna","USA","MF","21-339",2002,0.1,1,0,0,0,1,1,1,100,0,0,0,0,0,1,0,0,"https://fbref.com/en/players/7fa4e703/Gio-Reyna"
2025,"Dortmund","Bundesliga","Julian Ryerson","NOR","DF","26-335",1997,5.3,4,4,1,2,1,4,7,57.1,3,4,1,3,8,12,5,0,"https://fbref.com/en/players/009a4f60/Julian-Ryerson"
2025,"Dortmund","Bundesliga","Marcel Sabitzer","AUT","MF,FW","30-214",1994,3.4,5,3,0,5,0,3,6,50,3,6,3,3,1,6,4,0,"https://fbref.com/en/players/e280527c/Marcel-Sabitzer"
2025,"Dortmund","Bundesliga","Nico Schlotterbeck","GER","DF","24-321",1999,4.8,11,7,6,5,0,9,13,69.2,4,5,1,4,8,19,16,0,"https://fbref.com/en/players/34e12499/Nico-Schlotterbeck"
2025,"Dortmund","Bundesliga","Niklas Süle","GER","DF","29-044",1995,3.7,5,4,4,1,0,4,5,80,1,1,1,0,1,6,19,0,"https://fbref.com/en/players/e33c06cf/Niklas-Sule"
2025,"Eint Frankfurt","Bundesliga","Aurele Amenda","SUI","DF","21-078",2003,0.6,0,0,0,0,0,0,0,NA,0,2,2,0,1,1,4,0,"https://fbref.com/en/players/1227a22d/Aurele-Amenda"
2025,"Eint Frankfurt","Bundesliga","Fares Chaïbi","ALG","MF,FW","21-324",2002,4,6,4,2,2,2,3,6,50,3,6,0,6,5,11,15,0,"https://fbref.com/en/players/357103bd/Fares-Chaibi"
2025,"Eint Frankfurt","Bundesliga","Nnamdi Collins","GER","DF","20-281",2004,0,0,0,0,0,0,0,0,NA,0,0,0,0,0,0,0,0,"https://fbref.com/en/players/8eb5c94c/Nnamdi-Collins"
2025,"Eint Frankfurt","Bundesliga","Mahmoud Dahoud","GER","MF","28-290",1996,1.1,3,0,3,0,0,1,1,100,0,2,1,1,1,4,1,0,"https://fbref.com/en/players/db4ed67b/Mahmoud-Dahoud"
2025,"Eint Frankfurt","Bundesliga","Junior Dina Ebimbe","FRA","FW,MF","23-331",2000,1.3,1,0,0,1,0,0,1,0,1,2,0,2,2,3,4,0,"https://fbref.com/en/players/95bb6ddc/Junior-Dina-Ebimbe"
2025,"Eint Frankfurt","Bundesliga","Hugo Ekitike","FRA","FW","22-119",2002,3.9,4,1,2,1,1,2,2,100,0,2,0,2,4,8,4,0,"https://fbref.com/en/players/5b92d896/Hugo-Ekitike"
2025,"Eint Frankfurt","Bundesliga","Mario Götze","GER","FW,MF","32-136",1992,2.6,5,4,1,3,1,1,5,20,4,2,0,2,1,6,3,0,"https://fbref.com/en/players/9efa1d25/Mario-Gotze"
2025,"Eint Frankfurt","Bundesliga","Oscar Højlund","DEN","MF","19-287",2005,0.2,2,1,2,0,0,0,0,NA,0,1,0,1,1,3,0,0,"https://fbref.com/en/players/3e2bbae6/Oscar-Hojlund"
2025,"Eint Frankfurt","Bundesliga","Ansgar Knauff","GER","MF","22-281",2002,2.3,9,4,6,2,1,3,4,75,1,4,0,4,0,9,4,0,"https://fbref.com/en/players/19a967ab/Ansgar-Knauff"
2025,"Eint Frankfurt","Bundesliga","Robin Koch","GER","DF","28-092",1996,6,1,1,1,0,0,0,2,0,2,15,9,6,3,4,36,1,"https://fbref.com/en/players/ea6bc03a/Robin-Koch"
2025,"Eint Frankfurt","Bundesliga","Rasmus Kristensen","DEN","DF,MF","27-098",1997,6,16,8,12,2,2,12,21,57.1,9,7,3,4,3,19,22,0,"https://fbref.com/en/players/39769cff/Rasmus-Kristensen"
2025,"Eint Frankfurt","Bundesliga","Hugo Larsson","SWE","MF","20-112",2004,5.6,4,1,2,2,0,3,9,33.3,6,11,5,6,6,10,12,0,"https://fbref.com/en/players/00c9a283/Hugo-Larsson"
2025,"Eint Frankfurt","Bundesliga","Omar Marmoush","EGY","FW,MF","25-253",1999,5.6,5,3,0,3,2,0,2,0,2,5,1,4,1,6,1,0,"https://fbref.com/en/players/0e0102eb/Omar-Marmoush"
2025,"Eint Frankfurt","Bundesliga","Igor Matanovic","CRO","FW","21-200",2003,1.6,1,0,0,1,0,0,0,NA,0,1,0,1,0,1,3,0,"https://fbref.com/en/players/948e1292/Igor-Matanovic"
2025,"Eint Frankfurt","Bundesliga","Jean Mattéo Bahoya","FRA","MF","19-163",2005,0.3,2,2,1,1,0,2,3,66.7,1,0,0,0,0,2,0,0,"https://fbref.com/en/players/70d4c949/Jean-Matteo-Bahoya"
2025,"Eint Frankfurt","Bundesliga","Niels Nkounkou","FRA","MF,DF","23-351",2000,1.9,1,1,1,0,0,0,1,0,1,2,1,1,3,4,2,0,"https://fbref.com/en/players/f5b281e7/Niels-Nkounkou"
2025,"Eint Frankfurt","Bundesliga","Kauã Santos","BRA","GK","21-189",2003,3.5,0,0,0,0,0,0,0,NA,0,0,0,0,0,0,2,0,"https://fbref.com/en/players/c7c50cb5/Kaua-Santos"
2025,"Eint Frankfurt","Bundesliga","Ellyes Skhiri","TUN","MF","29-160",1995,4.6,5,3,2,3,0,1,9,11.1,8,12,2,10,5,10,7,0,"https://fbref.com/en/players/c2211709/Ellyes-Skhiri"
2025,"Eint Frankfurt","Bundesliga","Arthur Theate","BEL","DF","24-145",2000,5.8,5,3,2,3,0,2,9,22.2,7,9,8,1,7,12,29,0,"https://fbref.com/en/players/df8d6029/Arthur-Theate"
2025,"Eint Frankfurt","Bundesliga","Kevin Trapp","GER","GK","34-101",1990,2.5,0,0,0,0,0,0,0,NA,0,0,0,0,0,0,0,0,"https://fbref.com/en/players/ce17b5eb/Kevin-Trapp"
2025,"Eint Frankfurt","Bundesliga","Tuta","BRA","DF,MF","25-105",1999,6,15,8,10,3,2,10,13,76.9,3,15,8,7,8,23,43,0,"https://fbref.com/en/players/35d64857/Tuta"
2025,"Eint Frankfurt","Bundesliga","Can Uzun","TUR","FW,MF","18-341",2005,0.7,2,1,1,0,1,1,2,50,1,0,0,0,0,2,1,0,"https://fbref.com/en/players/1d0b134a/Can-Uzun"
2025,"Empoli","Serie A","Faustino Anjorin","ENG","MF","22-329",2001,2.4,6,1,3,3,0,1,4,25,3,5,1,4,0,6,5,0,"https://fbref.com/en/players/b105919e/Faustino-Anjorin"
2025,"Empoli","Serie A","Liberato Cacace","NZL","DF,FW","24-020",2000,1.2,1,1,1,0,0,1,2,50,1,4,2,2,0,1,6,0,"https://fbref.com/en/players/dd86e8e4/Liberato-Cacace"
2025,"Empoli","Serie A","Francesco Caputo","ITA","FW","37-072",1987,0.1,0,0,0,0,0,0,0,NA,0,0,0,0,0,0,0,0,"https://fbref.com/en/players/5bd72174/Francesco-Caputo"
2025,"Empoli","Serie A","Lorenzo Colombo","ITA","FW,MF","22-223",2002,4.8,5,3,0,3,2,1,4,25,3,4,0,4,0,5,0,0,"https://fbref.com/en/players/04df29a5/Lorenzo-Colombo"
2025,"Empoli","Serie A","Mattia De Sciglio","ITA","FW,DF","31-363",1992,0.1,0,0,0,0,0,0,0,NA,0,0,0,0,0,0,2,0,"https://fbref.com/en/players/ae4e2852/Mattia-De-Sciglio"
2025,"Empoli","Serie A","Emmanuel Ekong","SWE","MF,FW","22-114",2002,0.7,3,2,0,2,1,2,2,100,0,1,0,1,1,4,1,0,"https://fbref.com/en/players/c20892ee/Emmanuel-Ekong"
2025,"Empoli","Serie A","Sebastiano Esposito","ITA","FW,MF","22-107",2002,5,14,8,5,7,2,6,13,46.2,7,4,1,3,5,19,2,0,"https://fbref.com/en/players/7ff93107/Sebastiano-Esposito"
2025,"Empoli","Serie A","Jacopo Fazzini","ITA","MF","21-215",2003,3.3,8,4,4,4,0,3,4,75,1,4,0,4,1,9,8,0,"https://fbref.com/en/players/06b08c45/Jacopo-Fazzini"
2025,"Empoli","Serie A","Saba Goglichidze","GEO","DF","20-114",2004,5,13,9,7,6,0,7,11,63.6,4,4,2,2,6,19,17,0,"https://fbref.com/en/players/011d370e/Saba-Goglichidze"
2025,"Empoli","Serie A","Alberto Grassi","ITA","MF","29-224",1995,4.3,8,4,2,4,2,3,3,100,0,4,3,1,6,14,6,0,"https://fbref.com/en/players/6cc97b6a/Alberto-Grassi"
2025,"Empoli","Serie A","Emmanuel Gyasi","GHA","DF,FW","30-280",1994,7,11,5,7,4,0,7,9,77.8,2,10,4,6,0,11,18,0,"https://fbref.com/en/players/f9758dae/Emmanuel-Gyasi"
2025,"Empoli","Serie A","Nicolas Haas","SUI","MF","28-268",1996,1.1,4,2,3,1,0,2,2,100,0,0,0,0,1,5,4,0,"https://fbref.com/en/players/fa449bba/Nicolas-Haas"
2025,"Empoli","Serie A","Liam Henderson","SCO","MF","28-175",1996,6.1,4,1,2,2,0,2,7,28.6,5,7,4,3,5,9,11,0,"https://fbref.com/en/players/d7918b13/Liam-Henderson"
2025,"Empoli","Serie A","Ardian Ismajli","ALB","DF","28-017",1996,7,5,4,3,2,0,2,3,66.7,1,9,6,3,12,17,73,0,"https://fbref.com/en/players/6b635f5c/Ardian-Ismajli"
2025,"Empoli","Serie A","Youssef Maleh","MAR","MF","26-056",1998,3,4,3,2,2,0,1,3,33.3,2,5,2,3,3,7,3,0,"https://fbref.com/en/players/4c8845f7/Youssef-Maleh"
2025,"Empoli","Serie A","Pietro Pellegri","ITA","FW,MF","23-214",2001,0.8,1,0,0,1,0,0,0,NA,0,0,0,0,0,1,0,0,"https://fbref.com/en/players/a44d3a3c/Pietro-Pellegri"
2025,"Empoli","Serie A","Giuseppe Pezzella","ITA","DF,FW","26-323",1997,6,15,9,10,5,0,11,18,61.1,7,4,2,2,1,16,18,0,"https://fbref.com/en/players/149c5f5d/Giuseppe-Pezzella"
2025,"Empoli","Serie A","Ola Solbakken","NOR","MF,FW","26-040",1998,3.1,2,2,0,2,0,0,0,NA,0,0,0,0,0,2,4,0,"https://fbref.com/en/players/78f13530/Ola-Solbakken"
2025,"Empoli","Serie A","Petar Stojanović","SVN","MF","29-010",1995,0,0,0,0,0,0,0,0,NA,0,0,0,0,0,0,0,0,"https://fbref.com/en/players/13b44b02/Petar-Stojanovic"
2025,"Empoli","Serie A","Devis Vásquez","COL","GK","26-158",1998,7,0,0,0,0,0,0,0,NA,0,0,0,0,0,0,7,0,"https://fbref.com/en/players/fac1f795/Devis-Vasquez"
2025,"Empoli","Serie A","Mattia Viti","ITA","DF","22-267",2002,7,26,18,18,7,1,14,18,77.8,4,11,7,4,8,34,30,0,"https://fbref.com/en/players/75438a9a/Mattia-Viti"
2025,"Empoli","Serie A","Sebastian Walukiewicz","POL","DF","24-195",2000,2,1,0,1,0,0,0,1,0,1,3,3,0,1,2,15,0,"https://fbref.com/en/players/217875a4/Sebastian-Walukiewicz"
2025,"Espanyol","La Liga","Álvaro Aguado","ESP","MF","28-169",1996,2.5,4,2,2,2,0,2,4,50,2,5,0,5,1,5,5,1,"https://fbref.com/en/players/014aa7bd/Alvaro-Aguado"
2025,"Espanyol","La Liga","Antoniu","ESP","MF","22-042",2002,0.4,3,0,1,1,1,1,1,100,0,0,0,0,1,4,2,1,"https://fbref.com/en/players/af784a9e/Antoniu"
2025,"Espanyol","La Liga","Leandro Cabrera","URU","DF","33-122",1991,4.5,6,3,4,2,0,2,4,50,2,7,6,1,4,10,30,1,"https://fbref.com/en/players/69cbc8b6/Leandro-Cabrera"
2025,"Espanyol","La Liga","Fernando Calero","ESP","DF","29-033",1995,2.1,4,2,4,0,0,1,2,50,1,3,3,0,5,9,20,0,"https://fbref.com/en/players/41b3069f/Fernando-Calero"
2025,"Espanyol","La Liga","Irvin Cardona","FRA","MF,FW","27-070",1997,3.1,5,4,2,3,0,4,12,33.3,8,4,1,3,3,8,5,0,"https://fbref.com/en/players/5e080f73/Irvin-Cardona"
2025,"Espanyol","La Liga","Walid Cheddira","MAR","FW","26-269",1998,2.5,0,0,0,0,0,0,0,NA,0,1,0,1,1,1,2,0,"https://fbref.com/en/players/0545a08e/Walid-Cheddira"
2025,"Espanyol","La Liga","Joan García","ESP","GK","23-166",2001,9,0,0,0,0,0,0,0,NA,0,0,0,0,0,0,3,3,"https://fbref.com/en/players/87b498b0/Joan-Garcia"
2025,"Espanyol","La Liga","Sergi Gómez","ESP","DF","32-203",1992,4,3,2,3,0,0,2,2,100,0,7,6,1,5,8,20,0,"https://fbref.com/en/players/bc6f5f06/Sergi-Gomez"
2025,"Espanyol","La Liga","José Gragera","ESP","MF","23-322",2000,5.8,24,15,11,13,0,9,16,56.3,7,9,1,8,4,28,12,0,"https://fbref.com/en/players/ee45d138/Jose-Gragera"
2025,"Espanyol","La Liga","Omar El Hilali","MAR","DF","21-035",2003,9,25,17,19,4,2,11,20,55,9,12,2,10,9,34,40,0,"https://fbref.com/en/players/139560df/Omar-El-Hilali"
2025,"Espanyol","La Liga","Jofre","ESP","MF,FW","23-122",2001,6.1,3,3,2,1,0,1,5,20,4,1,0,1,2,5,7,0,"https://fbref.com/en/players/030ef8d6/Jofre"
2025,"Espanyol","La Liga","Alex Král","CZE","MF,FW","26-151",1998,8.4,22,15,14,8,0,6,9,66.7,3,14,8,6,10,32,19,0,"https://fbref.com/en/players/e717705a/Alex-Kral"
2025,"Espanyol","La Liga","Marash Kumbulla","ALB","DF","24-252",2000,7.7,10,6,8,1,1,3,7,42.9,4,18,13,5,8,18,50,0,"https://fbref.com/en/players/a40819d9/Marash-Kumbulla"
2025,"Espanyol","La Liga","Pol Lozano","ESP","MF","25-011",1999,4.2,13,9,6,6,1,6,11,54.5,5,3,2,1,1,14,4,0,"https://fbref.com/en/players/ea610f00/Pol-Lozano"
2025,"Espanyol","La Liga","Pere Milla","ESP","MF,FW","32-024",1992,1.6,3,1,2,0,1,0,8,0,8,5,2,3,1,4,2,0,"https://fbref.com/en/players/335039a2/Pere-Milla"
2025,"Espanyol","La Liga","Brian Oliván","ESP","DF","30-199",1994,1.9,3,3,1,2,0,0,2,0,2,1,0,1,3,6,6,0,"https://fbref.com/en/players/a3e4bf46/Brian-Olivan"
2025,"Espanyol","La Liga","Javi Puado","ESP","FW,MF","26-145",1998,7.3,6,5,2,2,2,1,1,100,0,4,0,4,1,7,8,0,"https://fbref.com/en/players/2683eda7/Javi-Puado"
2025,"Espanyol","La Liga","Carlos Romero","ESP","DF","22-354",2001,7.8,19,14,12,6,1,10,19,52.6,9,8,1,7,6,25,20,0,"https://fbref.com/en/players/23cbf863/Carlos-Romero"
2025,"Espanyol","La Liga","Álvaro Tejero","ESP","MF,DF","28-089",1996,4.5,5,3,1,3,1,2,10,20,8,5,0,5,2,7,10,0,"https://fbref.com/en/players/868ce848/Alvaro-Tejero"
2025,"Espanyol","La Liga","Naci Ünüvar","NED","MF,DF","21-126",2003,0.2,0,0,0,0,0,0,0,NA,0,0,0,0,0,0,0,0,"https://fbref.com/en/players/bf25cb29/Naci-Unuvar"
2025,"Espanyol","La Liga","Alejo Véliz","ARG","FW","21-028",2003,6.3,1,1,0,1,0,1,4,25,3,9,2,7,1,2,13,0,"https://fbref.com/en/players/3f7bafbe/Alejo-Veliz"
2025,"Everton","Premier League","Harrison Armstrong","ENG","MF","17-272",2007,0,0,0,0,0,0,0,1,0,1,0,0,0,0,0,0,0,"https://fbref.com/en/players/de59e609/Harrison-Armstrong"
2025,"Everton","Premier League","Beto","GNB","FW","26-260",1998,0.5,1,0,0,0,1,0,0,NA,0,1,0,1,0,1,0,0,"https://fbref.com/en/players/ed5c0319/Beto"
2025,"Everton","Premier League","Jarrad Branthwaite","ENG","DF","22-112",2002,1,2,2,1,1,0,0,0,NA,0,1,0,1,3,5,5,0,"https://fbref.com/en/players/c1949191/Jarrad-Branthwaite"
2025,"Everton","Premier League","Dominic Calvert-Lewin","ENG","FW","27-215",1997,6.6,3,2,1,1,1,0,0,NA,0,3,1,2,3,6,9,0,"https://fbref.com/en/players/59e6e5bf/Dominic-Calvert-Lewin"
2025,"Everton","Premier League","Séamus Coleman","IRL","DF","36-006",1988,1,1,0,0,1,0,1,2,50,1,2,1,1,0,1,2,0,"https://fbref.com/en/players/0420d84f/Seamus-Coleman"
2025,"Everton","Premier League","Roman Dixon","ENG","DF","19-296",2004,1,5,5,3,2,0,4,4,100,0,1,0,1,1,6,3,0,"https://fbref.com/en/players/6fba4dba/Roman-Dixon"
2025,"Everton","Premier League","Abdoulaye Doucouré","MLI","MF","31-290",1993,4.4,9,5,5,4,0,3,3,100,0,6,2,4,2,11,3,0,"https://fbref.com/en/players/02b29014/Abdoulaye-Doucoure"
2025,"Everton","Premier League","Idrissa Gana Gueye","SEN","MF","35-021",1989,4.2,15,9,7,6,2,3,6,50,3,8,2,6,7,22,5,0,"https://fbref.com/en/players/72c812f3/Idrissa-Gana-Gueye"
2025,"Everton","Premier League","James Garner","ENG","DF,MF","23-218",2001,2.8,10,8,6,4,0,7,10,70,3,2,2,0,4,14,9,0,"https://fbref.com/en/players/4e015693/James-Garner"
2025,"Everton","Premier League","Jack Harrison","ENG","FW","27-332",1996,4.8,7,4,3,2,2,3,9,33.3,6,2,0,2,4,11,7,1,"https://fbref.com/en/players/aa849a12/Jack-Harrison"
2025,"Everton","Premier League","Mason Holgate","ENG","FW,DF","27-361",1996,0.1,0,0,0,0,0,0,0,NA,0,0,0,0,0,0,0,0,"https://fbref.com/en/players/d0042ab9/Mason-Holgate"
2025,"Everton","Premier League","Tim Iroegbunam","ENG","MF","21-109",2003,4.3,18,9,9,4,5,7,12,58.3,5,6,0,6,8,26,5,1,"https://fbref.com/en/players/84c5ceea/Tim-Iroegbunam"
2025,"Everton","Premier League","Michael Keane","ENG","DF","31-280",1993,6,5,3,5,0,0,3,5,60,2,4,3,1,9,14,35,0,"https://fbref.com/en/players/c5b7c315/Michael-Keane"
2025,"Everton","Premier League","Jesper Lindstrøm","DEN","FW","24-231",2000,1.7,8,5,2,6,0,2,3,66.7,1,4,1,3,1,9,0,0,"https://fbref.com/en/players/37dc1a48/Jesper-Lindstrom"
2025,"Everton","Premier League","Orel Mangala","BEL","MF","26-213",1998,2.8,6,2,0,6,0,1,2,50,1,0,0,0,9,15,0,0,"https://fbref.com/en/players/a572e291/Orel-Mangala"
2025,"Everton","Premier League","Dwight McNeil","ENG","MF,FW","24-330",1999,6.9,6,4,3,3,0,3,7,42.9,4,4,0,4,4,10,1,0,"https://fbref.com/en/players/fc15fb84/Dwight-McNeil"
2025,"Everton","Premier League","Vitaliy Mykolenko","UKR","DF","25-141",1999,4.3,4,2,3,1,0,2,6,33.3,4,3,1,2,4,8,19,0,"https://fbref.com/en/players/30d4a2e5/Vitaliy-Mykolenko"
2025,"Everton","Premier League","Iliman Ndiaye","SEN","FW","24-225",2000,5.4,12,7,5,3,4,7,11,63.6,4,7,3,4,7,19,4,0,"https://fbref.com/en/players/5ed97752/Iliman-Ndiaye"
2025,"Everton","Premier League","Jake O'Brien","IRL","DF","23-155",2001,0.3,2,2,1,1,0,2,2,100,0,1,0,1,0,2,0,0,"https://fbref.com/en/players/25f2ef01/Jake-OBrien"
2025,"Everton","Premier League","Jordan Pickford","ENG","GK","30-224",1994,7,0,0,0,0,0,0,0,NA,0,0,0,0,0,0,7,1,"https://fbref.com/en/players/4806ec67/Jordan-Pickford"
2025,"Everton","Premier League","James Tarkowski","ENG","DF","31-333",1992,7,19,11,10,7,2,11,16,68.8,5,12,9,3,9,28,39,0,"https://fbref.com/en/players/15ea812b/James-Tarkowski"
2025,"Everton","Premier League","Ashley Young","ENG","DF","39-100",1985,4.7,11,6,5,4,2,5,8,62.5,3,2,1,1,6,17,14,0,"https://fbref.com/en/players/be927d03/Ashley-Young"
2025,"Fiorentina","Serie A","Yacine Adli","FRA","MF","24-080",2000,1.6,5,3,2,2,1,1,3,33.3,2,0,0,0,2,7,3,0,"https://fbref.com/en/players/26777636/Yacine-Adli"
2025,"Fiorentina","Serie A","Sofyan Amrabat","MAR","MF","28-057",1996,2,3,2,1,2,0,2,2,100,0,1,1,0,0,3,2,0,"https://fbref.com/en/players/5a2cb25d/Sofyan-Amrabat"
2025,"Fiorentina","Serie A","Antonín Barák","CZE","MF","29-319",1994,0.6,2,0,0,2,0,0,2,0,2,1,1,0,0,2,0,0,"https://fbref.com/en/players/01efac19/Antonin-Barak"
2025,"Fiorentina","Serie A","Lucas Beltrán","ARG","MF,FW","23-202",2001,1,0,0,0,0,0,0,0,NA,0,1,0,1,0,0,0,0,"https://fbref.com/en/players/482d2bc3/Lucas-Beltran"
2025,"Fiorentina","Serie A","Alessandro Bianco","ITA","MF","22-016",2002,0.2,0,0,0,0,0,0,1,0,1,0,0,0,0,0,0,0,"https://fbref.com/en/players/d65cf468/Alessandro-Bianco"
2025,"Fiorentina","Serie A","Cristiano Biraghi","ITA","DF","32-046",1992,4.7,4,4,1,3,0,2,7,28.6,5,2,0,2,4,8,9,0,"https://fbref.com/en/players/9e1577aa/Cristiano-Biraghi"
2025,"Fiorentina","Serie A","Edoardo Bove","ITA","MF,FW","22-154",2002,4.2,10,7,5,5,0,6,14,42.9,8,4,0,4,3,13,4,0,"https://fbref.com/en/players/ae94a6c5/Edoardo-Bove"
2025,"Fiorentina","Serie A","Danilo Cataldi","ITA","MF","30-072",1994,4,7,6,1,4,2,3,4,75,1,3,2,1,3,10,5,0,"https://fbref.com/en/players/ba3d3bea/Danilo-Cataldi"
2025,"Fiorentina","Serie A","Andrea Colpani","ITA","MF,FW","25-159",1999,5.1,5,2,3,2,0,0,5,0,5,2,0,2,1,6,4,0,"https://fbref.com/en/players/6499048c/Andrea-Colpani"
2025,"Fiorentina","Serie A","Pietro Comuzzo","ITA","DF","19-240",2005,5.5,12,5,7,3,2,6,9,66.7,3,7,5,2,3,15,13,0,"https://fbref.com/en/players/5e3ecc35/Pietro-Comuzzo"
2025,"Fiorentina","Serie A","Dodô","BRA","DF","25-335",1998,7,9,7,4,3,2,5,9,55.6,4,7,2,5,10,19,9,0,"https://fbref.com/en/players/b5f7d10b/Dodo"
2025,"Fiorentina","Serie A","David de Gea","ESP","GK","33-345",1990,4,0,0,0,0,0,0,0,NA,0,0,0,0,0,0,0,0,"https://fbref.com/en/players/7ba6d84e/David-de-Gea"
2025,"Fiorentina","Serie A","Robin Gosens","GER","DF","30-104",1994,5,11,5,5,2,4,4,4,100,0,1,0,1,2,13,16,0,"https://fbref.com/en/players/2d970560/Robin-Gosens"
2025,"Fiorentina","Serie A","Albert Guðmundsson","ISL","MF","27-124",1997,2.1,0,0,0,0,0,0,2,0,2,1,0,1,2,2,2,0,"https://fbref.com/en/players/b79858d5/Albert-Gudmundsson"
2025,"Fiorentina","Serie A","Jonathan Ikone","FRA","MF,FW","26-168",1998,1.2,2,1,2,0,0,0,1,0,1,1,0,1,0,2,0,0,"https://fbref.com/en/players/42eaa028/Jonathan-Ikone"
2025,"Fiorentina","Serie A","Michael Kayode","ITA","DF,FW","20-099",2004,0.2,1,1,1,0,0,0,0,NA,0,2,1,1,0,1,3,0,"https://fbref.com/en/players/e19660a8/Michael-Kayode"
2025,"Fiorentina","Serie A","Moise Kean","ITA","FW","24-232",2000,6.9,2,2,0,0,2,1,2,50,1,3,0,3,0,2,7,0,"https://fbref.com/en/players/3d50bcdb/Moise-Kean"
2025,"Fiorentina","Serie A","Christian Kouamé","CIV","MF,FW","26-316",1997,3.3,8,5,3,3,2,0,3,0,3,1,0,1,2,10,5,0,"https://fbref.com/en/players/58e933d2/Christian-Kouame"
2025,"Fiorentina","Serie A","Rolando Mandragora","ITA","MF","27-110",1997,3,1,0,0,0,1,0,1,0,1,3,1,2,5,6,4,1,"https://fbref.com/en/players/c7259b83/Rolando-Mandragora"
2025,"Fiorentina","Serie A","Lucas Martínez Quarta","ARG","DF","28-160",1996,2.4,10,5,8,2,0,7,12,58.3,5,4,2,2,1,11,17,0,"https://fbref.com/en/players/3ec3c1c9/Lucas-Martinez-Quarta"
2025,"Fiorentina","Serie A","Fabiano Parisi","ITA","DF","23-343",2000,1.4,4,2,1,2,1,0,1,0,1,1,0,1,1,5,2,0,"https://fbref.com/en/players/0967845b/Fabiano-Parisi"
2025,"Fiorentina","Serie A","Marin Pongračić","CRO","DF","27-036",1997,1,1,1,1,0,0,1,3,33.3,2,0,0,0,2,3,4,0,"https://fbref.com/en/players/2a6cd437/Marin-Pongracic"
2025,"Fiorentina","Serie A","Luca Ranieri","ITA","DF","25-177",1999,5.4,3,2,2,0,1,0,1,0,1,9,6,3,6,9,20,0,"https://fbref.com/en/players/8c63fae5/Luca-Ranieri"
2025,"Fiorentina","Serie A","Amir Richardson","MAR","MF","22-267",2002,1.4,6,2,5,1,0,2,5,40,3,1,0,1,0,6,4,0,"https://fbref.com/en/players/2b7cdb79/Amir-Richardson"
2025,"Fiorentina","Serie A","Riccardo Sottil","ITA","MF,FW","25-136",1999,0.7,0,0,0,0,0,0,0,NA,0,1,0,1,0,0,0,0,"https://fbref.com/en/players/94816803/Riccardo-Sottil"
2025,"Fiorentina","Serie A","Pietro Terracciano","ITA","GK","34-223",1990,3,0,0,0,0,0,0,0,NA,0,0,0,0,0,0,0,0,"https://fbref.com/en/players/e1b0a70d/Pietro-Terracciano"
2025,"Freiburg","Bundesliga","Junior Adamu","AUT","FW","23-133",2001,5.5,0,0,0,0,0,0,2,0,2,5,0,5,3,3,5,0,"https://fbref.com/en/players/82e12fe7/Junior-Adamu"
2025,"Freiburg","Bundesliga","Noah Atubolu","GER","GK","22-145",2002,4,0,0,0,0,0,0,0,NA,0,0,0,0,0,0,2,1,"https://fbref.com/en/players/dbd1b101/Noah-Atubolu"
2025,"Freiburg","Bundesliga","Eren Dinkçi","GER","MF","22-309",2001,2.8,7,4,3,3,1,2,6,33.3,4,6,1,5,2,9,0,0,"https://fbref.com/en/players/4ccd8957/Eren-Dinkci"
2025,"Freiburg","Bundesliga","Ritsu Doan","JPN","FW","26-123",1998,5.6,13,11,9,3,1,8,11,72.7,3,11,0,11,3,16,5,0,"https://fbref.com/en/players/d01bbb6f/Ritsu-Doan"
2025,"Freiburg","Bundesliga","Maximilian Eggestein","GER","MF","27-314",1996,5.7,7,5,1,5,1,2,6,33.3,4,6,0,6,11,18,6,0,"https://fbref.com/en/players/beb882a8/Maximilian-Eggestein"
2025,"Freiburg","Bundesliga","Matthias Ginter","GER","DF","30-272",1994,3.7,4,2,1,2,1,3,3,100,0,4,3,1,1,5,10,0,"https://fbref.com/en/players/f521b80a/Matthias-Ginter"
2025,"Freiburg","Bundesliga","Michael Gregoritsch","AUT","FW","30-182",1994,0.2,0,0,0,0,0,0,0,NA,0,0,0,0,0,0,0,0,"https://fbref.com/en/players/8e235926/Michael-Gregoritsch"
2025,"Freiburg","Bundesliga","Vincenzo Grifo","ITA","FW,MF","31-193",1993,5.3,3,3,1,2,0,0,4,0,4,4,1,3,0,3,1,0,"https://fbref.com/en/players/54e4866f/Vincenzo-Grifo"
2025,"Freiburg","Bundesliga","Christian Günter","GER","DF","31-232",1993,5.7,5,3,2,3,0,4,8,50,4,4,2,2,2,7,9,0,"https://fbref.com/en/players/8593f88c/Christian-Gunter"
2025,"Freiburg","Bundesliga","Nicolas Höfler","GER","MF","34-222",1990,0.8,2,2,1,1,0,1,2,50,1,0,0,0,1,3,6,0,"https://fbref.com/en/players/5d8e331f/Nicolas-Hofler"
2025,"Freiburg","Bundesliga","Lucas Höler","GER","MF,FW","30-099",1994,1.3,4,4,1,3,0,1,3,33.3,2,3,1,2,1,5,4,0,"https://fbref.com/en/players/ca618d23/Lucas-Holer"
2025,"Freiburg","Bundesliga","Lukas Kübler","GER","DF","32-048",1992,5.2,10,6,6,3,1,6,8,75,2,11,3,8,17,27,10,1,"https://fbref.com/en/players/2a29eb9b/Lukas-Kubler"
2025,"Freiburg","Bundesliga","Philipp Lienhart","AUT","DF","28-098",1996,5.5,5,4,3,2,0,3,6,50,3,3,3,0,9,14,14,1,"https://fbref.com/en/players/302527b2/Philipp-Lienhart"
2025,"Freiburg","Bundesliga","Jordy Makengo","FRA","DF","23-075",2001,0.3,3,2,3,0,0,2,2,100,0,0,0,0,0,3,4,0,"https://fbref.com/en/players/14b09c41/Jordy-Makengo"
2025,"Freiburg","Bundesliga","Johan Manzambi","SUI","FW","19-003",2005,0.1,0,0,0,0,0,0,0,NA,0,0,0,0,0,0,0,0,"https://fbref.com/en/players/8fcf0e12/Johan-Manzambi"
2025,"Freiburg","Bundesliga","Florian Müller","GER","GK","26-339",1997,2,0,0,0,0,0,0,0,NA,0,0,0,0,0,0,0,0,"https://fbref.com/en/players/cbac6ec9/Florian-Muller"
2025,"Freiburg","Bundesliga","Florent Muslija","KVX","FW,DF","26-103",1998,0.9,4,3,3,0,1,2,2,100,0,0,0,0,1,5,0,0,"https://fbref.com/en/players/ae961785/Florent-Muslija"
2025,"Freiburg","Bundesliga","Ifechukwu Ogbus","SUI","DF","18-305",2005,0.2,1,1,0,0,1,0,1,0,1,0,0,0,1,2,2,0,"https://fbref.com/en/players/d41472b7/Ifechukwu-Ogbus"
2025,"Freiburg","Bundesliga","Patrick Osterhage","GER","MF","24-259",2000,4.9,12,8,5,6,1,4,10,40,6,4,0,4,9,21,4,0,"https://fbref.com/en/players/9662c9ec/Patrick-Osterhage"
2025,"Freiburg","Bundesliga","Merlin Röhl","GER","MF","22-104",2002,1.8,3,3,1,2,0,1,1,100,0,1,0,1,1,4,0,0,"https://fbref.com/en/players/1f2c7b55/Merlin-Rohl"
2025,"Freiburg","Bundesliga","Max Rosenfelder","GER","DF","21-250",2003,3.3,7,4,6,1,0,5,5,100,0,4,1,3,2,9,20,0,"https://fbref.com/en/players/b6ceba6b/Max-Rosenfelder"
2025,"Freiburg","Bundesliga","Roland Sallai","HUN","FW,MF","27-148",1997,0.5,2,1,1,1,0,0,0,NA,0,0,0,0,1,3,0,0,"https://fbref.com/en/players/bf075f6b/Roland-Sallai"
2025,"Freiburg","Bundesliga","Kiliann Sildillia","FRA","FW","22-154",2002,0,0,0,0,0,0,0,0,NA,0,0,0,0,0,0,0,0,"https://fbref.com/en/players/313254a3/Kiliann-Sildillia"
2025,"Freiburg","Bundesliga","Noah Weißhaupt","GER","FW","23-027",2001,0.6,0,0,0,0,0,0,1,0,1,0,0,0,0,0,1,0,"https://fbref.com/en/players/dd676a97/Noah-Weisshaupt"
2025,"Fulham","Premier League","Joachim Andersen","DEN","DF","28-139",1996,4,4,2,4,0,0,3,6,50,3,6,4,2,6,10,31,0,"https://fbref.com/en/players/e34fc66d/Joachim-Andersen"
2025,"Fulham","Premier League","Calvin Bassey","NGA","DF","24-291",1999,7,7,5,5,2,0,1,2,50,1,14,9,5,2,9,28,1,"https://fbref.com/en/players/a36524bf/Calvin-Bassey"
2025,"Fulham","Premier League","Sander Berge","NOR","MF","26-246",1998,1.9,5,2,2,3,0,0,0,NA,0,4,1,3,4,9,4,0,"https://fbref.com/en/players/d0b6129f/Sander-Berge"
2025,"Fulham","Premier League","Tom Cairney","SCO","MF","33-271",1991,1.1,3,1,1,0,2,1,2,50,1,1,0,1,2,5,0,0,"https://fbref.com/en/players/a8748947/Tom-Cairney"
2025,"Fulham","Premier League","Timothy Castagne","BEL","DF","28-317",1995,0.2,4,2,2,2,0,3,4,75,1,0,0,0,0,4,0,0,"https://fbref.com/en/players/197640fd/Timothy-Castagne"
2025,"Fulham","Premier League","Issa Diop","FRA","DF","27-282",1997,3.1,8,5,5,3,0,3,5,60,2,3,2,1,0,8,12,0,"https://fbref.com/en/players/a712ca2b/Issa-Diop"
2025,"Fulham","Premier League","Alex Iwobi","NGA","FW,DF","28-167",1996,6.5,10,7,5,4,1,3,5,60,2,3,0,3,3,13,11,0,"https://fbref.com/en/players/6ca5ec4b/Alex-Iwobi"
2025,"Fulham","Premier League","Raúl Jiménez","MEX","FW","33-165",1991,3.8,5,2,1,3,1,0,4,0,4,1,0,1,1,6,4,0,"https://fbref.com/en/players/b561db50/Raul-Jimenez"
2025,"Fulham","Premier League","Bernd Leno","GER","GK","32-227",1992,7,0,0,0,0,0,0,0,NA,0,1,0,1,0,0,1,3,"https://fbref.com/en/players/2628fd2b/Bernd-Leno"
2025,"Fulham","Premier League","Saša Lukić","SRB","MF","28-065",1996,6.1,12,6,6,5,1,3,15,20,12,6,3,3,8,20,6,0,"https://fbref.com/en/players/c6e8cf1f/Sasa-Lukic"
2025,"Fulham","Premier League","Rodrigo Muniz","BRA","FW","23-166",2001,3.2,0,0,0,0,0,0,0,NA,0,1,1,0,1,1,4,0,"https://fbref.com/en/players/a755db8c/Rodrigo-Muniz"
2025,"Fulham","Premier League","Reiss Nelson","ENG","FW,MF","24-312",1999,0.9,4,2,2,1,1,2,4,50,2,3,0,3,0,4,0,0,"https://fbref.com/en/players/c5bdb6e3/Reiss-Nelson"
2025,"Fulham","Premier League","Andreas Pereira","BRA","MF","28-290",1996,6,3,1,1,1,1,1,8,12.5,7,4,1,3,2,5,2,0,"https://fbref.com/en/players/6639e500/Andreas-Pereira"
2025,"Fulham","Premier League","Harrison Reed","ENG","MF","29-264",1995,0.5,5,2,2,2,1,0,2,0,2,1,0,1,1,6,1,0,"https://fbref.com/en/players/803ae100/Harrison-Reed"
2025,"Fulham","Premier League","Antonee Robinson","USA","DF","27-070",1997,7,25,16,13,11,1,13,20,65,7,7,1,6,10,35,25,0,"https://fbref.com/en/players/289601e6/Antonee-Robinson"
2025,"Fulham","Premier League","Emile Smith Rowe","ENG","MF","24-081",2000,5.2,11,7,3,3,5,3,5,60,2,5,0,5,4,15,3,0,"https://fbref.com/en/players/17695062/Emile-Smith-Rowe"
2025,"Fulham","Premier League","Jay Stansfield","ENG","MF","21-328",2002,0,0,0,0,0,0,0,0,NA,0,0,0,0,0,0,0,0,"https://fbref.com/en/players/b2626673/Jay-Stansfield"
2025,"Fulham","Premier League","Kenny Tete","NED","DF","29-008",1995,6.8,15,8,7,3,5,7,13,53.8,6,9,2,7,13,28,15,0,"https://fbref.com/en/players/77d7c96f/Kenny-Tete"
2025,"Fulham","Premier League","Adama Traoré","ESP","FW,MF","28-266",1996,6.2,7,5,4,2,1,2,5,40,3,3,0,3,1,8,2,1,"https://fbref.com/en/players/9a28eba4/Adama-Traore"
2025,"Fulham","Premier League","Harry Wilson","WAL","FW","27-209",1997,0.4,0,0,0,0,0,0,1,0,1,0,0,0,0,0,0,0,"https://fbref.com/en/players/c6dc9ecd/Harry-Wilson"
2025,"Genoa","Serie A","Federico Accornero","ITA","MF","20-255",2004,0.1,0,0,0,0,0,0,0,NA,0,0,0,0,0,0,0,0,"https://fbref.com/en/players/83763653/Federico-Accornero"
2025,"Genoa","Serie A","Honest Ahanor","ITA","DF","16-237",2008,0.8,1,0,0,1,0,1,3,33.3,2,0,0,0,0,1,2,0,"https://fbref.com/en/players/42ff58c3/Honest-Ahanor"
2025,"Genoa","Serie A","David Akpan Ankeye","NGA","FW","22-246",2002,0.3,0,0,0,0,0,0,1,0,1,0,0,0,0,0,0,0,"https://fbref.com/en/players/8c4b95af/David-Akpan-Ankeye"
2025,"Genoa","Serie A","Milan Badelj","CRO","MF","35-235",1989,4.4,5,3,2,3,0,3,6,50,3,5,3,2,3,8,5,0,"https://fbref.com/en/players/e8c930bb/Milan-Badelj"
2025,"Genoa","Serie A","Mattia Bani","ITA","DF","30-312",1993,4,2,1,2,0,0,1,1,100,0,3,2,1,8,10,12,0,"https://fbref.com/en/players/0821331c/Mattia-Bani"
2025,"Genoa","Serie A","Emil Bohinen","NOR","MF","25-219",1999,1.8,4,4,3,0,1,2,5,40,3,2,0,2,1,5,6,0,"https://fbref.com/en/players/c83c203f/Emil-Bohinen"
2025,"Genoa","Serie A","Koni De Winter","BEL","DF","22-127",2002,7,12,9,6,5,1,4,6,66.7,2,2,1,1,8,20,34,0,"https://fbref.com/en/players/f4797849/Koni-De-Winter"
2025,"Genoa","Serie A","Jeff Ekhator","ITA","FW,MF","17-341",2006,0.7,0,0,0,0,0,0,0,NA,0,1,0,1,0,0,0,0,"https://fbref.com/en/players/faf739d2/Jeff-Ekhator"
2025,"Genoa","Serie A","Caleb Ekuban","GHA","FW","30-208",1994,2.3,1,1,0,1,0,0,0,NA,0,2,0,2,0,1,3,0,"https://fbref.com/en/players/7afbd2c3/Caleb-Ekuban"
2025,"Genoa","Serie A","Morten Frendrup","DEN","MF","23-193",2001,5.8,17,9,5,5,7,6,14,42.9,8,8,2,6,11,28,6,0,"https://fbref.com/en/players/f4d60499/Morten-Frendrup"
2025,"Genoa","Serie A","Pierluigi Gollini","ITA","GK","29-213",1995,7,0,0,0,0,0,0,0,NA,0,1,0,1,0,0,2,1,"https://fbref.com/en/players/f0f7f62f/Pierluigi-Gollini"
2025,"Genoa","Serie A","Lior Kasa","ISR","MF","19-020",2005,0.2,0,0,0,0,0,0,0,NA,0,0,0,0,1,1,0,0,"https://fbref.com/en/players/7987ef17/Lior-Kasa"
2025,"Genoa","Serie A","Ruslan Malinovskyi","UKR","MF,FW","31-166",1993,2.5,8,6,2,5,1,2,3,66.7,1,1,0,1,1,9,3,0,"https://fbref.com/en/players/48d5bd33/Ruslan-Malinovskyi"
2025,"Genoa","Serie A","Aarón Martín","ESP","DF","27-178",1997,5.9,16,12,8,7,1,8,10,80,2,2,0,2,4,20,13,1,"https://fbref.com/en/players/2f3e911a/Aaron-Martin"
2025,"Genoa","Serie A","Alan Matturro","URU","DF","20-006",2004,0.2,0,0,0,0,0,0,0,NA,0,0,0,0,0,0,0,0,"https://fbref.com/en/players/547c0119/Alan-Matturro"
2025,"Genoa","Serie A","Filippo Melegoni","ITA","MF","25-242",1999,0.3,0,0,0,0,0,0,2,0,2,0,0,0,0,0,0,0,"https://fbref.com/en/players/6604165d/Filippo-Melegoni"
2025,"Genoa","Serie A","Junior Messias","BRA","MF,FW","33-157",1991,2.9,4,1,3,1,0,1,1,100,0,1,1,0,3,7,5,0,"https://fbref.com/en/players/f49c4ae9/Junior-Messias"
2025,"Genoa","Serie A","Fabio Miretti","ITA","MF","21-075",2003,1.5,4,3,2,2,0,3,3,100,0,2,0,2,1,5,1,0,"https://fbref.com/en/players/34693494/Fabio-Miretti"
2025,"Genoa","Serie A","Brooke Norton-Cuffy","ENG","DF","20-279",2004,0.1,0,0,0,0,0,0,0,NA,0,0,0,0,0,0,0,0,"https://fbref.com/en/players/54f5b2bd/Brooke-Norton-Cuffy"
2025,"Genoa","Serie A","Andrea Pinamonti","ITA","FW,MF","25-151",1999,4.9,1,1,0,1,0,0,1,0,1,1,0,1,1,2,4,0,"https://fbref.com/en/players/08aa9cd1/Andrea-Pinamonti"
2025,"Genoa","Serie A","Stefano Sabelli","ITA","DF","31-278",1993,3.3,5,4,2,1,2,2,11,18.2,9,6,0,6,1,6,4,0,"https://fbref.com/en/players/0ccac09c/Stefano-Sabelli"
2025,"Genoa","Serie A","Morten Thorsby","NOR","MF,DF","28-165",1996,2.5,3,1,2,0,1,0,2,0,2,4,0,4,1,4,4,0,"https://fbref.com/en/players/d1b49282/Morten-Thorsby"
2025,"Genoa","Serie A","Johan Vásquez","MEX","DF","25-361",1998,6.3,5,2,2,2,1,2,6,33.3,4,10,6,4,11,16,23,0,"https://fbref.com/en/players/5eaed77a/Johan-Vasquez"
2025,"Genoa","Serie A","Vitinha","POR","FW","24-216",2000,5.5,10,4,4,3,3,4,15,26.7,11,5,1,4,4,14,5,0,"https://fbref.com/en/players/74d4cec6/Vitinha"
2025,"Genoa","Serie A","Alessandro Vogliacco","ITA","DF","26-033",1998,3.2,7,2,2,5,0,4,5,80,1,3,2,1,5,12,12,0,"https://fbref.com/en/players/6841f107/Alessandro-Vogliacco"
2025,"Genoa","Serie A","Alessandro Zanoli","ITA","DF","24-014",2000,3.4,1,0,1,0,0,1,1,100,0,3,2,1,1,2,8,0,"https://fbref.com/en/players/3b12b11f/Alessandro-Zanoli"
2025,"Getafe","La Liga","Nabil Aberdin","FRA","MF","22-055",2002,2.6,5,4,3,2,0,1,1,100,0,2,0,2,0,5,5,0,"https://fbref.com/en/players/cadfa7d1/Nabil-Aberdin"
2025,"Getafe","La Liga","Omar Alderete","PAR","DF","27-296",1996,8,12,8,10,1,1,6,7,85.7,1,8,6,2,6,18,46,1,"https://fbref.com/en/players/bb08bce9/Omar-Alderete"
2025,"Getafe","La Liga","Carles Aleñá","ESP","MF,FW","26-286",1998,3.4,6,3,2,3,1,4,8,50,4,7,1,6,0,6,2,0,"https://fbref.com/en/players/6c811eb7/Carles-Alena"
2025,"Getafe","La Liga","Mauro Arambarri","URU","MF,FW","29-017",1995,5.2,8,4,1,5,2,3,8,37.5,5,6,1,5,2,10,11,0,"https://fbref.com/en/players/58afe001/Mauro-Arambarri"
2025,"Getafe","La Liga","Juan Berrocal","ESP","DF","25-166",1999,4.9,8,3,6,2,0,6,8,75,2,0,0,0,6,14,25,0,"https://fbref.com/en/players/377ef3a6/Juan-Berrocal"
2025,"Getafe","La Liga","Djené","TOG","DF","32-291",1991,8.2,4,1,2,2,0,1,8,12.5,7,7,4,3,9,13,31,0,"https://fbref.com/en/players/a4971d84/Djene"
2025,"Getafe","La Liga","Peter Federico","DOM","MF,FW","22-084",2002,1.5,2,1,0,1,1,0,0,NA,0,2,0,2,0,2,1,0,"https://fbref.com/en/players/1ccd3dae/Peter-Federico"
2025,"Getafe","La Liga","Iglesias","ESP","DF","26-106",1998,7.7,26,15,12,12,2,9,26,34.6,17,6,1,5,13,39,31,0,"https://fbref.com/en/players/974322dc/Iglesias"
2025,"Getafe","La Liga","John Joe","IRL","FW,MF","20-359",2003,0.1,0,0,0,0,0,0,0,NA,0,1,1,0,0,0,1,0,"https://fbref.com/en/players/fd01216a/John-Joe"
2025,"Getafe","La Liga","Abdoulaye Keita","ESP","MF","22-046",2002,0.3,0,0,0,0,0,0,0,NA,0,1,0,1,0,0,0,0,"https://fbref.com/en/players/154b6735/Abdoulaye-Keita"
2025,"Getafe","La Liga","Borja Mayoral","ESP","FW","27-195",1997,1.4,1,1,1,0,0,0,0,NA,0,1,0,1,0,1,1,0,"https://fbref.com/en/players/64e8ed6d/Borja-Mayoral"
2025,"Getafe","La Liga","Luis Milla","ESP","MF","30-010",1994,8.8,16,12,9,6,1,10,21,47.6,11,13,0,13,6,22,8,0,"https://fbref.com/en/players/19c36442/Luis-Milla"
2025,"Getafe","La Liga","Carles Pérez","ESP","MF,FW","26-244",1998,6.7,14,10,3,6,5,11,23,47.8,12,10,1,9,2,16,7,0,"https://fbref.com/en/players/a8f21b9f/Carles-Perez"
2025,"Getafe","La Liga","Diego Rico","ESP","DF","31-237",1993,8,28,13,18,7,3,15,23,65.2,8,6,0,6,5,33,13,1,"https://fbref.com/en/players/d9ba39fc/Diego-Rico"
2025,"Getafe","La Liga","Alberto Risco","ESP","MF,FW","19-048",2005,0.8,4,4,2,0,2,1,6,16.7,5,2,0,2,0,4,0,0,"https://fbref.com/en/players/36286814/Alberto-Risco"
2025,"Getafe","La Liga","Gorka Rivera Alonso","ESP","DF,MF","20-077",2004,0.2,2,0,0,2,0,2,2,100,0,0,0,0,0,2,0,0,"https://fbref.com/en/players/f1124008/Gorka-Rivera-Alonso"
2025,"Getafe","La Liga","Álvaro Rodríguez","URU","FW","20-095",2004,0.2,0,0,0,0,0,0,0,NA,0,0,0,0,0,0,0,0,"https://fbref.com/en/players/49a6ecbb/Alvaro-Rodriguez"
2025,"Getafe","La Liga","Jesús Santiago","ESP","MF","20-145",2004,1.9,5,3,4,1,0,2,3,66.7,1,2,1,1,0,5,2,0,"https://fbref.com/en/players/bc49fd34/Jesus-Santiago"
2025,"Getafe","La Liga","Alex Sola","ESP","MF,FW","25-130",1999,6.9,13,7,8,5,0,7,17,41.2,10,6,0,6,1,14,6,0,"https://fbref.com/en/players/5fa714d5/Alex-Sola"
2025,"Getafe","La Liga","David Soria","ESP","GK","31-196",1993,9,1,1,1,0,0,1,1,100,0,0,0,0,0,1,7,1,"https://fbref.com/en/players/8f8c6934/David-Soria"
2025,"Getafe","La Liga","Chrisantus Uche","NGA","FW,MF","21-151",2003,8.3,8,5,2,3,3,1,1,100,0,6,1,5,1,9,4,0,"https://fbref.com/en/players/87941696/Chrisantus-Uche"
2025,"Getafe","La Liga","Bertuğ Yıldırım","TUR","FW","22-097",2002,5,4,2,0,3,1,0,3,0,3,3,1,2,0,4,8,0,"https://fbref.com/en/players/7410d325/Bertug-Yildirim"
2025,"Girona","La Liga","Iker Almena","ESP","FW,DF","20-166",2004,0.5,0,0,0,0,0,0,1,0,1,1,0,1,0,0,2,0,"https://fbref.com/en/players/0b32f721/Iker-Almena"
2025,"Girona","La Liga","Yaser Asprilla","COL","FW,MF","20-333",2003,3.8,8,4,4,3,1,3,7,42.9,4,0,0,0,3,11,4,0,"https://fbref.com/en/players/d139daf9/Yaser-Asprilla"
2025,"Girona","La Liga","Donny van de Beek","NED","MF,FW","27-182",1997,2.3,3,1,2,1,0,1,2,50,1,5,0,5,0,3,4,0,"https://fbref.com/en/players/50dc94ce/Donny-van-de-Beek"
2025,"Girona","La Liga","Daley Blind","NED","DF","34-222",1990,7.6,15,8,7,7,1,9,9,100,0,12,4,8,10,25,22,0,"https://fbref.com/en/players/691bef82/Daley-Blind"
2025,"Girona","La Liga","Arnaut Danjuma","NED","FW,MF","27-260",1997,3.7,5,3,2,2,1,1,3,33.3,2,2,0,2,1,6,0,0,"https://fbref.com/en/players/f08490a6/Arnaut-Danjuma"
2025,"Girona","La Liga","Alejandro Francés","ESP","DF","22-077",2002,4.9,12,7,7,4,1,12,17,70.6,5,6,2,4,8,20,16,0,"https://fbref.com/en/players/3e78a188/Alejandro-Frances"
2025,"Girona","La Liga","Paulo Gazzaniga","ARG","GK","32-289",1992,9,1,1,1,0,0,1,1,100,0,0,0,0,0,1,3,0,"https://fbref.com/en/players/63d17038/Paulo-Gazzaniga"
2025,"Girona","La Liga","Bryan Gil","ESP","FW,MF","23-249",2001,5.8,14,9,6,5,3,7,12,58.3,5,8,0,8,3,17,3,1,"https://fbref.com/en/players/7b5ab7f2/Bryan-Gil"
2025,"Girona","La Liga","Miguel Gutiérrez","ESP","DF","23-082",2001,8,17,11,7,9,1,6,10,60,4,2,1,1,8,25,11,1,"https://fbref.com/en/players/7e98cff1/Miguel-Gutierrez"
2025,"Girona","La Liga","Yangel Herrera","VEN","MF","26-277",1998,6.1,24,15,11,11,2,9,17,52.9,8,6,1,5,9,33,8,0,"https://fbref.com/en/players/5083a734/Yangel-Herrera"
2025,"Girona","La Liga","Juanpe","ESP","DF","33-170",1991,1,1,1,1,0,0,0,0,NA,0,4,2,2,0,1,4,0,"https://fbref.com/en/players/1633fc8a/Juanpe"
2025,"Girona","La Liga","Ladislav Krejčí","CZE","DF","25-180",1999,3.1,2,0,2,0,0,1,2,50,1,4,2,2,5,7,11,0,"https://fbref.com/en/players/5b5c2228/Ladislav-Krejci"
2025,"Girona","La Liga","David López","ESP","DF","35-008",1989,7.4,4,1,2,0,2,2,6,33.3,4,12,6,6,7,11,28,1,"https://fbref.com/en/players/f03f284b/David-Lopez"
2025,"Girona","La Liga","Iván Martín","ESP","MF","25-246",1999,7.3,12,7,7,4,1,5,14,35.7,9,10,1,9,5,17,3,0,"https://fbref.com/en/players/ae48c5cb/Ivan-Martin"
2025,"Girona","La Liga","Arnau Martinez","ESP","DF","21-175",2003,4.1,9,6,5,2,2,5,7,71.4,2,0,0,0,0,9,11,1,"https://fbref.com/en/players/c3e66ffe/Arnau-Martinez"
2025,"Girona","La Liga","Bojan Miovski","MKD","FW","25-115",1999,1.9,2,2,0,0,2,1,5,20,4,3,0,3,0,2,1,0,"https://fbref.com/en/players/72e442c5/Bojan-Miovski"
2025,"Girona","La Liga","Gabriel Osei Misehouy","NED","FW,MF","19-091",2005,0.7,0,0,0,0,0,0,0,NA,0,0,0,0,0,0,0,0,"https://fbref.com/en/players/349a7574/Gabriel-Osei-Misehouy"
2025,"Girona","La Liga","Portu","ESP","FW,MF","32-149",1992,1.8,3,2,1,1,1,2,2,100,0,3,0,3,0,3,1,0,"https://fbref.com/en/players/1bda5842/Portu"
2025,"Girona","La Liga","Oriol Romeu","ESP","MF","33-023",1991,3.5,12,7,3,9,0,5,6,83.3,1,6,2,4,2,14,0,0,"https://fbref.com/en/players/4b511457/Oriol-Romeu"
2025,"Girona","La Liga","Abel Ruiz","ESP","FW","24-263",2000,7.3,2,0,1,0,1,2,5,40,3,4,1,3,2,4,3,0,"https://fbref.com/en/players/6cbf8d0d/Abel-Ruiz"
2025,"Girona","La Liga","Jhon Solis","COL","MF","20-014",2004,3.2,4,4,2,2,0,3,9,33.3,6,10,1,9,3,7,4,0,"https://fbref.com/en/players/1282939a/Jhon-Solis"
2025,"Girona","La Liga","Cristhian Stuani","URU","FW","38-005",1986,1.1,0,0,0,0,0,0,0,NA,0,1,0,1,0,0,1,0,"https://fbref.com/en/players/220c11f1/Cristhian-Stuani"
2025,"Girona","La Liga","Viktor Tsyhankov","UKR","MF,FW","26-337",1997,4.9,4,3,0,2,2,2,5,40,3,0,0,0,0,4,2,0,"https://fbref.com/en/players/f7e87032/Viktor-Tsyhankov"
2025,"Gladbach","Bundesliga","Fabio Chiarodia","ITA","DF","19-134",2005,0,1,1,1,0,0,1,1,100,0,0,0,0,0,1,0,0,"https://fbref.com/en/players/48780156/Fabio-Chiarodia"
2025,"Gladbach","Bundesliga","Tomáš Čvančara","CZE","FW,MF","24-065",2000,1.6,1,1,0,1,0,1,1,100,0,2,1,1,0,1,2,0,"https://fbref.com/en/players/298c8aa1/Tomas-Cvancara"
2025,"Gladbach","Bundesliga","Nico Elvedi","SUI","DF","28-017",1996,5.5,10,5,5,2,3,6,6,100,0,10,8,2,8,18,19,0,"https://fbref.com/en/players/48035304/Nico-Elvedi"
2025,"Gladbach","Bundesliga","Marvin Friedrich","GER","DF","28-309",1995,0.5,0,0,0,0,0,0,0,NA,0,0,0,0,0,0,3,0,"https://fbref.com/en/players/b77f44a4/Marvin-Friedrich"
2025,"Gladbach","Bundesliga","Robin Hack","GER","FW,MF","26-051",1998,1.8,6,6,3,1,2,4,5,80,1,0,0,0,0,6,2,0,"https://fbref.com/en/players/0174ba21/Robin-Hack"
2025,"Gladbach","Bundesliga","Franck Honorat","FRA","FW","28-067",1996,2.6,2,1,1,0,1,0,1,0,1,3,1,2,0,2,3,0,"https://fbref.com/en/players/db7849ca/Franck-Honorat"
2025,"Gladbach","Bundesliga","Ko Itakura","JPN","DF","27-264",1997,6,14,10,7,6,1,8,10,80,2,3,3,0,5,19,33,0,"https://fbref.com/en/players/97d545ae/Ko-Itakura"
2025,"Gladbach","Bundesliga","Tim Kleindienst","GER","FW","29-047",1995,5.9,5,2,1,3,1,1,6,16.7,5,8,0,8,1,6,14,0,"https://fbref.com/en/players/258a6f4d/Tim-Kleindienst"
2025,"Gladbach","Bundesliga","Stefan Lainer","AUT","DF","32-051",1992,0.2,1,0,0,1,0,0,0,NA,0,0,0,0,2,3,0,0,"https://fbref.com/en/players/4aea5077/Stefan-Lainer"
2025,"Gladbach","Bundesliga","Nathan N'Goumou","FRA","FW","24-217",2000,2.4,5,5,3,1,1,2,4,50,2,5,0,5,2,7,3,0,"https://fbref.com/en/players/e110ea4b/Nathan-NGoumou"
2025,"Gladbach","Bundesliga","Luca Netz","GER","DF","21-155",2003,5.9,13,6,9,3,1,5,10,50,5,9,2,7,7,20,13,0,"https://fbref.com/en/players/e79269bd/Luca-Netz"
2025,"Gladbach","Bundesliga","Florian Neuhaus","GER","MF","27-215",1997,0.3,1,0,1,0,0,0,4,0,4,0,0,0,1,2,0,0,"https://fbref.com/en/players/36a59ba4/Florian-Neuhaus"
2025,"Gladbach","Bundesliga","Moritz Nicolas","GER","GK","26-362",1997,3,0,0,0,0,0,0,0,NA,0,0,0,0,0,0,2,1,"https://fbref.com/en/players/226ddf9d/Moritz-Nicolas"
2025,"Gladbach","Bundesliga","Jonas Omlin","SUI","GK","30-281",1994,3,0,0,0,0,0,0,0,NA,0,0,0,0,0,0,0,0,"https://fbref.com/en/players/c631f952/Jonas-Omlin"
2025,"Gladbach","Bundesliga","Alassane Pléa","FRA","FW,MF","31-221",1993,3.9,1,1,0,1,0,1,1,100,0,1,0,1,0,1,1,1,"https://fbref.com/en/players/bc6bd723/Alassane-Plea"
2025,"Gladbach","Bundesliga","Grant Ranos","ARM","FW","21-089",2003,0.1,1,0,0,1,0,0,1,0,1,1,0,1,0,1,0,0,"https://fbref.com/en/players/0ee6ea6a/Grant-Ranos"
2025,"Gladbach","Bundesliga","Rocco Reitz","GER","MF","22-141",2002,2.7,9,3,6,3,0,6,6,100,0,4,2,2,8,17,5,0,"https://fbref.com/en/players/cc971106/Rocco-Reitz"
2025,"Gladbach","Bundesliga","Philipp Sander","GER","MF","26-239",1998,3.4,10,6,5,4,1,5,6,83.3,1,7,1,6,5,15,6,0,"https://fbref.com/en/players/5c90bad8/Philipp-Sander"
2025,"Gladbach","Bundesliga","Joe Scally","USA","DF","21-291",2002,5.8,10,6,8,2,0,5,8,62.5,3,6,3,3,1,11,11,1,"https://fbref.com/en/players/236f02cd/Joe-Scally"
2025,"Gladbach","Bundesliga","Kevin Stöger","AUT","MF,FW","31-051",1993,5.6,10,5,5,3,2,4,11,36.4,7,10,0,10,3,13,12,0,"https://fbref.com/en/players/e5649a78/Kevin-Stoger"
2025,"Gladbach","Bundesliga","Julian Weigl","GER","MF","29-039",1995,5.6,10,4,7,2,1,7,8,87.5,1,5,2,3,12,22,12,0,"https://fbref.com/en/players/346d51d9/Julian-Weigl"
2025,"Heidenheim","Bundesliga","Adrian Beck","GER","FW,MF","27-130",1997,2.6,3,2,1,2,0,0,5,0,5,9,0,9,4,7,5,0,"https://fbref.com/en/players/616c09f5/Adrian-Beck"
2025,"Heidenheim","Bundesliga","Maximilian Breunig","GER","FW,MF","24-064",2000,2.5,4,3,1,2,1,3,4,75,1,4,2,2,1,5,3,0,"https://fbref.com/en/players/1e37c986/Maximilian-Breunig"
2025,"Heidenheim","Bundesliga","Marnon Busch","GER","DF","29-314",1994,2.7,4,2,3,1,0,4,7,57.1,3,4,3,1,1,5,12,0,"https://fbref.com/en/players/c38767ab/Marnon-Busch"
2025,"Heidenheim","Bundesliga","Sirlord Conteh","GER","FW,DF","28-100",1996,1.7,5,3,2,3,0,1,1,100,0,0,0,0,0,5,1,0,"https://fbref.com/en/players/34e09d5f/Sirlord-Conteh"
2025,"Heidenheim","Bundesliga","Niklas Dorsch","GER","MF","26-276",1998,1.4,0,0,0,0,0,0,1,0,1,3,0,3,0,0,2,0,"https://fbref.com/en/players/7f73bdf4/Niklas-Dorsch"
2025,"Heidenheim","Bundesliga","Jonas Föhrenbach","GER","DF,FW","28-265",1996,6,11,9,5,6,0,5,8,62.5,3,6,2,4,6,17,16,0,"https://fbref.com/en/players/1b4be8eb/Jonas-Fohrenbach"
2025,"Heidenheim","Bundesliga","Benedikt Gimber","GER","DF","27-241",1997,6,16,10,11,5,0,8,10,80,2,15,4,11,7,23,34,0,"https://fbref.com/en/players/e5f76710/Benedikt-Gimber"
2025,"Heidenheim","Bundesliga","Mathias Honsak","AUT","MF,FW","27-302",1996,0.9,2,2,1,1,0,1,2,50,1,0,0,0,0,2,3,0,"https://fbref.com/en/players/3dbdbb6a/Mathias-Honsak"
2025,"Heidenheim","Bundesliga","Mikkel Kaufmann","DEN","FW","23-288",2001,1.6,3,2,1,1,1,1,2,50,1,2,1,1,0,3,4,0,"https://fbref.com/en/players/6e269dd3/Mikkel-Kaufmann"
2025,"Heidenheim","Bundesliga","Luca Kerber","GER","MF,FW","22-221",2002,0.9,2,2,1,1,0,2,3,66.7,1,1,0,1,0,2,5,0,"https://fbref.com/en/players/c107935c/Luca-Kerber"
2025,"Heidenheim","Bundesliga","Patrick Mainka","GER","DF","29-346",1994,6,6,4,6,0,0,3,4,75,1,10,5,5,10,16,28,0,"https://fbref.com/en/players/dd9caa07/Patrick-Mainka"
2025,"Heidenheim","Bundesliga","Lennard Maloney","USA","MF","25-009",1999,3.9,8,3,5,2,1,6,8,75,2,5,1,4,5,13,16,0,"https://fbref.com/en/players/75402e99/Lennard-Maloney"
2025,"Heidenheim","Bundesliga","Kevin Müller","GER","GK","33-216",1991,6,0,0,0,0,0,0,0,NA,0,0,0,0,0,0,2,0,"https://fbref.com/en/players/f256f213/Kevin-Muller"
2025,"Heidenheim","Bundesliga","Marvin Pieringer","GER","FW","25-013",1999,4.7,2,0,0,1,1,1,2,50,1,5,0,5,2,4,5,0,"https://fbref.com/en/players/11407d95/Marvin-Pieringer"
2025,"Heidenheim","Bundesliga","Stefan Schimmer","GER","FW,MF","30-172",1994,0.4,1,0,0,1,0,1,1,100,0,0,0,0,0,1,0,0,"https://fbref.com/en/players/395bbb60/Stefan-Schimmer"
2025,"Heidenheim","Bundesliga","Jan Schöppner","GER","MF","25-127",1999,5.2,11,4,2,8,1,6,13,46.2,7,6,1,5,11,22,22,0,"https://fbref.com/en/players/932bfcac/Jan-Schoppner"
2025,"Heidenheim","Bundesliga","Léo Scienza","BRA","FW,MF","26-034",1998,2.9,3,3,2,1,0,0,4,0,4,1,0,1,3,6,4,0,"https://fbref.com/en/players/79064bc9/Leo-Scienza"
2025,"Heidenheim","Bundesliga","Tim Siersleben","GER","DF","24-222",2000,0.1,0,0,0,0,0,0,0,NA,0,0,0,0,1,1,2,0,"https://fbref.com/en/players/f761c901/Tim-Siersleben"
2025,"Heidenheim","Bundesliga","Omar Traoré","GER","DF,FW","26-256",1998,5.5,11,6,9,2,0,7,8,87.5,1,4,2,2,1,12,12,0,"https://fbref.com/en/players/f44e8a73/Omar-Traore"
2025,"Heidenheim","Bundesliga","Paul Wanner","GER","MF","18-299",2005,4.9,13,7,3,10,0,5,10,50,5,2,0,2,1,14,6,0,"https://fbref.com/en/players/cb64672e/Paul-Wanner"
2025,"Hellas Verona","Serie A","Faride Alidou","GER","FW,MF","23-091",2001,0.7,0,0,0,0,0,0,0,NA,0,1,0,1,0,0,2,1,"https://fbref.com/en/players/00f518d8/Faride-Alidou"
2025,"Hellas Verona","Serie A","Daniel Bandeira","POR","MF","24-189",2000,2.7,4,0,1,3,0,3,5,60,2,2,1,1,6,10,6,0,"https://fbref.com/en/players/56fca564/Daniel-Bandeira"
2025,"Hellas Verona","Serie A","Reda Belahyane","MAR","MF","20-138",2004,6.8,13,9,5,5,3,5,5,100,0,6,4,2,3,16,6,0,"https://fbref.com/en/players/705a1642/Reda-Belahyane"
2025,"Hellas Verona","Serie A","Domagoj Bradarić","CRO","DF","24-312",1999,1,0,0,0,0,0,0,2,0,2,0,0,0,0,0,1,0,"https://fbref.com/en/players/8bbe2df5/Domagoj-Bradaric"
2025,"Hellas Verona","Serie A","Alphadjo Cissè","ITA","MF","17-361",2006,0,0,0,0,0,0,0,0,NA,0,0,0,0,0,0,0,0,"https://fbref.com/en/players/d079becb/Alphadjo-Cisse"
2025,"Hellas Verona","Serie A","Diego Coppola","ITA","DF","20-294",2003,6,8,4,5,2,1,6,9,66.7,3,10,5,5,13,21,25,1,"https://fbref.com/en/players/22ae86f9/Diego-Coppola"
2025,"Hellas Verona","Serie A","Flavius Daniliuc","AUT","DF","23-173",2001,2.8,3,3,1,2,0,1,6,16.7,5,4,1,3,3,6,8,0,"https://fbref.com/en/players/7ef972c3/Flavius-Daniliuc"
2025,"Hellas Verona","Serie A","Paweł Dawidowicz","POL","DF","29-150",1995,4.2,8,6,2,6,0,3,4,75,1,2,1,1,3,11,11,0,"https://fbref.com/en/players/16bb656a/Pawel-Dawidowicz"
2025,"Hellas Verona","Serie A","Ondrej Duda","SVK","MF","29-317",1994,4.3,4,2,2,2,0,2,8,25,6,3,1,2,5,9,4,1,"https://fbref.com/en/players/79ca3e23/Ondrej-Duda"
2025,"Hellas Verona","Serie A","Davide Faraoni","ITA","MF,DF","32-358",1991,0.3,1,1,0,1,0,0,2,0,2,0,0,0,0,1,1,0,"https://fbref.com/en/players/aae9d04a/Davide-Faraoni"
2025,"Hellas Verona","Serie A","Martin Frese","DEN","DF","26-287",1998,3.7,13,7,6,7,0,5,8,62.5,3,2,1,1,6,19,14,1,"https://fbref.com/en/players/b910e9c0/Martin-Frese"
2025,"Hellas Verona","Serie A","Daniele Ghilardi","ITA","DF","21-285",2003,1,2,1,1,1,0,2,2,100,0,1,0,1,1,3,7,0,"https://fbref.com/en/players/9cedad4b/Daniele-Ghilardi"
2025,"Hellas Verona","Serie A","Abdou Harroui","NED","FW,MF","26-278",1998,1.9,2,2,1,1,0,2,2,100,0,0,0,0,0,2,4,0,"https://fbref.com/en/players/65fd099c/Abdou-Harroui"
2025,"Hellas Verona","Serie A","Grigoris Kastanos","CYP","MF,FW","26-261",1998,3.1,3,1,1,1,1,2,3,66.7,1,7,1,6,2,5,2,0,"https://fbref.com/en/players/2a82aa85/Grigoris-Kastanos"
2025,"Hellas Verona","Serie A","Mathis Lambourde","FRA","DF,MF","18-282",2006,0.1,1,0,1,0,0,0,0,NA,0,0,0,0,0,1,0,0,"https://fbref.com/en/players/0da3d7ab/Mathis-Lambourde"
2025,"Hellas Verona","Serie A","Darko Lazović","SRB","MF,FW","34-032",1990,5.7,10,3,1,7,2,5,9,55.6,4,5,0,5,4,14,10,0,"https://fbref.com/en/players/5128bde4/Darko-Lazovic"
2025,"Hellas Verona","Serie A","Dailon Livramento","CPV","FW,MF","23-166",2001,2.7,6,5,1,3,2,2,5,40,3,3,0,3,2,8,1,0,"https://fbref.com/en/players/c115db1e/Dailon-Livramento"
2025,"Hellas Verona","Serie A","Giangiacomo Magnani","ITA","DF","29-013",1995,3.3,5,5,3,2,0,1,1,100,0,6,4,2,4,9,12,0,"https://fbref.com/en/players/cce9f582/Giangiacomo-Magnani"
2025,"Hellas Verona","Serie A","Lorenzo Montipò","ITA","GK","28-240",1996,7,0,0,0,0,0,0,0,NA,0,0,0,0,0,0,2,2,"https://fbref.com/en/players/c1d95617/Lorenzo-Montipo"
2025,"Hellas Verona","Serie A","Daniel Mosquera","COL","FW,MF","24-363",1999,2.9,2,1,1,1,0,0,2,0,2,2,1,1,0,2,2,0,"https://fbref.com/en/players/091b9eb8/Daniel-Mosquera"
2025,"Hellas Verona","Serie A","Yllan Okou","FRA","DF","21-299",2002,0,0,0,0,0,0,0,0,NA,0,1,0,1,0,0,0,0,"https://fbref.com/en/players/fa753b79/Yllan-Okou"
2025,"Hellas Verona","Serie A","Amin Sarr","SWE","FW","23-220",2001,0.4,1,1,0,1,0,1,1,100,0,1,1,0,0,1,0,0,"https://fbref.com/en/players/d5326924/Amin-Sarr"
2025,"Hellas Verona","Serie A","Suat Serdar","GER","MF","27-189",1997,0.2,0,0,0,0,0,0,0,NA,0,0,0,0,0,0,0,0,"https://fbref.com/en/players/b3325a30/Suat-Serdar"
2025,"Hellas Verona","Serie A","Tomáš Suslov","SVK","FW,MF","22-132",2002,2.7,10,6,3,6,1,2,4,50,2,9,0,9,2,12,1,0,"https://fbref.com/en/players/83fe71b8/Tomas-Suslov"
2025,"Hellas Verona","Serie A","Jackson Tchatchoua","CMR","MF,DF","23-033",2001,7,11,4,9,1,1,8,10,80,2,9,5,4,6,17,11,0,"https://fbref.com/en/players/aeca7743/Jackson-Tchatchoua"
2025,"Hellas Verona","Serie A","Casper Tengstedt","DEN","FW,MF","24-138",2000,5.4,1,0,0,1,0,0,1,0,1,3,1,2,3,4,13,0,"https://fbref.com/en/players/ff2fb007/Casper-Tengstedt"
2025,"Hoffenheim","Bundesliga","Kevin Akpoguma","NGA","DF","29-181",1995,6,9,2,7,1,1,3,6,50,3,19,13,6,3,12,27,0,"https://fbref.com/en/players/6ec6fde0/Kevin-Akpoguma"
2025,"Hoffenheim","Bundesliga","Oliver Baumann","GER","GK","34-137",1990,6,0,0,0,0,0,0,1,0,1,0,0,0,0,0,4,0,"https://fbref.com/en/players/47064058/Oliver-Baumann"
2025,"Hoffenheim","Bundesliga","Mergim Berisha","GER","FW","26-159",1998,2.4,1,1,1,0,0,0,2,0,2,0,0,0,0,1,2,0,"https://fbref.com/en/players/eb6e14be/Mergim-Berisha"
2025,"Hoffenheim","Bundesliga","Tom Bischof","GER","MF","19-111",2005,2.8,13,6,5,8,0,4,6,66.7,2,5,3,2,3,16,8,0,"https://fbref.com/en/players/07d3bfec/Tom-Bischof"
2025,"Hoffenheim","Bundesliga","Jacob Bruun Larsen","DEN","DF,FW","26-028",1998,1,1,0,1,0,0,1,2,50,1,3,0,3,1,2,1,0,"https://fbref.com/en/players/4e204552/Jacob-Bruun-Larsen"
2025,"Hoffenheim","Bundesliga","Marius Bülter","GER","FW","31-202",1993,4.8,5,5,1,3,1,5,7,71.4,2,2,1,1,1,6,2,0,"https://fbref.com/en/players/ab5b7dc1/Marius-Bulter"
2025,"Hoffenheim","Bundesliga","Arthur Chaves","BRA","DF","23-262",2001,0.8,2,2,1,1,0,1,2,50,1,0,0,0,1,3,4,0,"https://fbref.com/en/players/913e4711/Arthur-Chaves"
2025,"Hoffenheim","Bundesliga","Tim Drexler","GER","DF","19-225",2005,3.7,17,7,11,6,0,9,12,75,3,6,4,2,1,18,8,0,"https://fbref.com/en/players/0911b4fc/Tim-Drexler"
2025,"Hoffenheim","Bundesliga","Dennis Geiger","GER","MF","26-129",1998,1.9,6,5,2,3,1,3,5,60,2,1,0,1,1,7,0,0,"https://fbref.com/en/players/37f606f0/Dennis-Geiger"
2025,"Hoffenheim","Bundesliga","Valentin Gendrey","FRA","DF,FW","24-118",2000,2.3,5,2,4,1,0,1,1,100,0,0,0,0,2,7,11,0,"https://fbref.com/en/players/822ed0ec/Valentin-Gendrey"
2025,"Hoffenheim","Bundesliga","Florian Grillitsch","AUT","MF,DF","29-071",1995,3.3,8,5,4,3,1,5,7,71.4,2,4,2,2,2,10,15,0,"https://fbref.com/en/players/ffbbc83b/Florian-Grillitsch"
2025,"Hoffenheim","Bundesliga","Adam Hložek","CZE","FW,MF","22-084",2002,3.3,5,2,3,0,2,2,6,33.3,4,3,1,2,0,5,6,0,"https://fbref.com/en/players/5521f419/Adam-Hlozek"
2025,"Hoffenheim","Bundesliga","Robin Hranáč","CZE","DF","24-262",2000,1,0,0,0,0,0,0,1,0,1,1,0,1,2,2,3,1,"https://fbref.com/en/players/95d5aea2/Robin-Hranac"
2025,"Hoffenheim","Bundesliga","David Jurásek","CZE","FW","24-071",2000,0.2,1,0,1,0,0,0,0,NA,0,1,0,1,0,1,0,0,"https://fbref.com/en/players/d7a03bf3/David-Jurasek"
2025,"Hoffenheim","Bundesliga","Pavel Kadeřábek","CZE","DF","32-175",1992,4.8,7,4,4,1,2,5,12,41.7,7,5,2,3,6,13,13,0,"https://fbref.com/en/players/79c90e45/Pavel-Kaderabek"
2025,"Hoffenheim","Bundesliga","Andrej Kramarić","CRO","MF","33-120",1991,4.7,1,1,0,1,0,1,3,33.3,2,3,1,2,0,1,1,0,"https://fbref.com/en/players/603cb947/Andrej-Kramaric"
2025,"Hoffenheim","Bundesliga","Florian Micheler","AUT","MF","19-153",2005,0.4,0,0,0,0,0,0,2,0,2,0,0,0,0,0,0,0,"https://fbref.com/en/players/0024cb81/Florian-Micheler"
2025,"Hoffenheim","Bundesliga","Max Moerstedt","GER","FW","",NA,0.6,0,0,0,0,0,0,0,NA,0,0,0,0,0,0,2,0,"https://fbref.com/en/players/710045fb/Max-Moerstedt"
2025,"Hoffenheim","Bundesliga","Stanley N'Soki","FRA","DF","25-191",1999,0.2,1,0,1,0,0,0,0,NA,0,1,0,1,0,1,3,0,"https://fbref.com/en/players/61590953/Stanley-NSoki"
2025,"Hoffenheim","Bundesliga","Alexander Prass","AUT","DF","23-144",2001,4.9,8,5,7,1,0,6,15,40,9,6,2,4,1,9,11,1,"https://fbref.com/en/players/6637e6a7/Alexander-Prass"
2025,"Hoffenheim","Bundesliga","Grischa Prömel","GER","MF","29-282",1995,1.9,0,0,0,0,0,0,1,0,1,1,1,0,2,2,4,0,"https://fbref.com/en/players/924f9191/Grischa-Promel"
2025,"Hoffenheim","Bundesliga","Anton Stach","GER","DF","25-337",1998,5.5,13,11,7,5,1,7,10,70,3,7,3,4,7,20,34,0,"https://fbref.com/en/players/0f59a7bf/Anton-Stach"
2025,"Hoffenheim","Bundesliga","Haris Tabakovic","BIH","FW,MF","30-119",1994,0.6,1,1,0,0,1,0,0,NA,0,1,1,0,0,1,2,0,"https://fbref.com/en/players/723b19c7/Haris-Tabakovic"
2025,"Hoffenheim","Bundesliga","Umut Tohumcu","GER","MF","20-067",2004,1.9,6,4,3,2,1,2,2,100,0,2,0,2,2,8,4,0,"https://fbref.com/en/players/e547d3cf/Umut-Tohumcu"
2025,"Holstein Kiel","Bundesliga","Jann-Fiete Arp","GER","FW,MF","24-285",2000,2,5,4,3,1,1,1,3,33.3,2,1,0,1,0,5,0,0,"https://fbref.com/en/players/c21fb312/Jann-Fiete-Arp"
2025,"Holstein Kiel","Bundesliga","Timo Becker","GER","DF","27-206",1997,6,11,5,7,4,0,6,10,60,4,8,6,2,4,15,17,0,"https://fbref.com/en/players/543ddcaf/Timo-Becker"
2025,"Holstein Kiel","Bundesliga","Alexander Bernhardsson","SWE","DF,FW","26-039",1998,1.7,1,1,0,0,1,1,1,100,0,2,0,2,0,1,2,0,"https://fbref.com/en/players/dea1d183/Alexander-Bernhardsson"
2025,"Holstein Kiel","Bundesliga","Patrick Erras","GER","DF","29-270",1995,3.5,4,3,3,1,0,1,7,14.3,6,6,5,1,3,7,32,0,"https://fbref.com/en/players/e3f6253d/Patrick-Erras"
2025,"Holstein Kiel","Bundesliga","Max Geschwill","GER","DF","23-102",2001,3.9,6,5,2,4,0,4,5,80,1,2,2,0,6,12,12,0,"https://fbref.com/en/players/0ffda76d/Max-Geschwill"
2025,"Holstein Kiel","Bundesliga","Armin Gigovic","BIH","MF","22-194",2002,2.8,5,2,3,1,1,1,4,25,3,2,0,2,5,10,7,0,"https://fbref.com/en/players/d0a0858e/Armin-Gigovic"
2025,"Holstein Kiel","Bundesliga","Lewis Holtby","GER","MF","34-029",1990,5.3,14,6,9,4,1,4,9,44.4,5,4,0,4,10,24,6,1,"https://fbref.com/en/players/410ab123/Lewis-Holtby"
2025,"Holstein Kiel","Bundesliga","Marko Ivezić","SRB","DF","22-320",2001,2,5,3,4,1,0,2,5,40,3,4,3,1,6,11,15,0,"https://fbref.com/en/players/964f4f30/Marko-Ivezic"
2025,"Holstein Kiel","Bundesliga","Dominik Javorček","SVK","DF","21-350",2002,0.5,1,0,1,0,0,1,1,100,0,1,1,0,1,2,4,1,"https://fbref.com/en/players/3a2cf67d/Dominik-Javorcek"
2025,"Holstein Kiel","Bundesliga","Carl Johansson","SWE","DF","30-147",1994,3.9,4,2,4,0,0,3,6,50,3,7,6,1,6,10,23,1,"https://fbref.com/en/players/02f7a79a/Carl-Johansson"
2025,"Holstein Kiel","Bundesliga","Andu Kelati","GER","MF","22-065",2002,1.1,1,1,1,0,0,0,1,0,1,1,0,1,2,3,1,0,"https://fbref.com/en/players/58391f96/Andu-Kelati"
2025,"Holstein Kiel","Bundesliga","Magnus Knudsen","NOR","MF","23-124",2001,5.7,16,7,9,3,4,9,15,60,6,7,4,3,6,22,11,0,"https://fbref.com/en/players/a48fb0c7/Magnus-Knudsen"
2025,"Holstein Kiel","Bundesliga","Marco Komenda","CRO","DF","27-326",1996,1.1,3,2,2,1,0,3,3,100,0,1,0,1,0,3,6,0,"https://fbref.com/en/players/e7efcdb8/Marco-Komenda"
2025,"Holstein Kiel","Bundesliga","Shuto Machino","JPN","FW,MF","25-017",1999,4.2,2,2,1,0,1,2,4,50,2,0,0,0,2,4,2,0,"https://fbref.com/en/players/964dde35/Shuto-Machino"
2025,"Holstein Kiel","Bundesliga","Benedikt Pichler","AUT","FW","27-089",1997,5.1,3,2,1,0,2,1,2,50,1,4,2,2,1,4,6,0,"https://fbref.com/en/players/c184c8c8/Benedikt-Pichler"
2025,"Holstein Kiel","Bundesliga","Finn Porath","GER","DF,MF","27-237",1997,4.7,13,7,11,1,1,10,15,66.7,5,8,4,4,4,17,10,0,"https://fbref.com/en/players/b020d807/Finn-Porath"
2025,"Holstein Kiel","Bundesliga","Tymoteusz Puchacz","POL","DF","25-268",1999,1.6,3,2,2,1,0,1,2,50,1,4,1,3,0,3,5,0,"https://fbref.com/en/players/c68b1b13/Tymoteusz-Puchacz"
2025,"Holstein Kiel","Bundesliga","Nicolai Remberg","GER","MF","24-120",2000,1.8,6,3,3,3,0,2,4,50,2,3,0,3,0,6,4,0,"https://fbref.com/en/players/625fd441/Nicolai-Remberg"
2025,"Holstein Kiel","Bundesliga","Lasse Rosenboom","GER","DF","22-272",2002,1.7,4,3,4,0,0,2,3,66.7,1,3,1,2,2,6,7,0,"https://fbref.com/en/players/1df23153/Lasse-Rosenboom"
2025,"Holstein Kiel","Bundesliga","Marvin Schulz","GER","MF","29-276",1995,0.3,1,1,1,0,0,1,2,50,1,1,1,0,0,1,3,0,"https://fbref.com/en/players/651167c8/Marvin-Schulz"
2025,"Holstein Kiel","Bundesliga","Steven Skrzybski","GER","MF,FW","31-334",1992,1.1,2,0,0,0,2,1,1,100,0,1,0,1,3,5,1,0,"https://fbref.com/en/players/58ce23e5/Steven-Skrzybski"
2025,"Holstein Kiel","Bundesliga","Timon Weiner","GER","GK","25-273",1999,6,0,0,0,0,0,0,0,NA,0,0,0,0,0,0,3,1,"https://fbref.com/en/players/1fb2d1b0/Timon-Weiner"
2025,"Inter","Serie A","Francesco Acerbi","ITA","DF","36-250",1988,6,6,4,5,1,0,2,3,66.7,1,6,6,0,10,16,23,0,"https://fbref.com/en/players/b96b595c/Francesco-Acerbi"
2025,"Inter","Serie A","Marko Arnautović","AUT","FW","35-181",1989,0.4,2,2,1,1,0,1,1,100,0,0,0,0,0,2,1,0,"https://fbref.com/en/players/00459419/Marko-Arnautovic"
2025,"Inter","Serie A","Kristjan Asllani","ALB","MF","22-222",2002,1.6,4,0,3,1,0,2,6,33.3,4,3,1,2,1,5,3,0,"https://fbref.com/en/players/0fdcef0e/Kristjan-Asllani"
2025,"Inter","Serie A","Carlos Augusto","BRA","DF","25-284",1999,2.1,3,2,2,1,0,2,4,50,2,1,1,0,1,4,6,0,"https://fbref.com/en/players/8d3cd59d/Carlos-Augusto"
2025,"Inter","Serie A","Yann Aurel Bisseck","GER","DF","23-323",2000,2.5,1,1,1,0,0,1,2,50,1,0,0,0,3,4,9,1,"https://fbref.com/en/players/3963c25b/Yann-Aurel-Bisseck"
2025,"Inter","Serie A","Nicolò Barella","ITA","MF","27-253",1997,3.5,3,3,2,0,1,1,10,10,9,5,0,5,1,4,0,0,"https://fbref.com/en/players/6928979a/Nicolo-Barella"
2025,"Inter","Serie A","Alessandro Bastoni","ITA","DF","25-187",1999,5.3,7,4,4,2,1,5,8,62.5,3,2,0,2,6,13,10,0,"https://fbref.com/en/players/75b86fb3/Alessandro-Bastoni"
2025,"Inter","Serie A","Hakan Çalhanoğlu","TUR","MF","30-252",1994,5.1,13,7,1,5,7,5,8,62.5,3,1,1,0,3,16,5,0,"https://fbref.com/en/players/cd0fa27b/Hakan-Calhanoglu"
2025,"Inter","Serie A","Joaquín Correa","ARG","MF,FW","30-065",1994,0.2,1,0,0,1,0,0,0,NA,0,0,0,0,0,1,0,0,"https://fbref.com/en/players/45b9b619/Joaquin-Correa"
2025,"Inter","Serie A","Matteo Darmian","ITA","DF","34-320",1989,5.2,13,7,5,5,3,5,10,50,5,2,2,0,1,14,11,0,"https://fbref.com/en/players/96e0490d/Matteo-Darmian"
2025,"Inter","Serie A","Federico Dimarco","ITA","DF","26-342",1997,6.3,4,2,2,2,0,2,4,50,2,6,2,4,2,6,8,0,"https://fbref.com/en/players/970b8574/Federico-Dimarco"
2025,"Inter","Serie A","Denzel Dumfries","NED","DF","28-182",1996,1.8,3,3,1,0,2,2,4,50,2,1,0,1,0,3,1,0,"https://fbref.com/en/players/481c9ece/Denzel-Dumfries"
2025,"Inter","Serie A","Davide Frattesi","ITA","MF","24-361",1999,3.9,6,3,2,4,0,4,7,57.1,3,2,1,1,2,8,1,1,"https://fbref.com/en/players/2a7d27c1/Davide-Frattesi"
2025,"Inter","Serie A","Lautaro Martínez","ARG","FW","27-056",1997,5.4,6,3,2,2,2,2,4,50,2,1,0,1,1,7,1,0,"https://fbref.com/en/players/f7036e1c/Lautaro-Martinez"
2025,"Inter","Serie A","Henrikh Mkhitaryan","ARM","MF","35-270",1989,5.9,8,4,1,4,3,4,8,50,4,5,0,5,2,10,10,0,"https://fbref.com/en/players/dd0daf32/Henrikh-Mkhitaryan"
2025,"Inter","Serie A","Benjamin Pavard","FRA","DF","28-203",1996,4.5,8,3,4,3,1,4,6,66.7,2,3,2,1,3,11,15,0,"https://fbref.com/en/players/45a03961/Benjamin-Pavard"
2025,"Inter","Serie A","Yann Sommer","SUI","GK","35-305",1988,7,0,0,0,0,0,0,0,NA,0,0,0,0,0,0,4,1,"https://fbref.com/en/players/420c18a1/Yann-Sommer"
2025,"Inter","Serie A","Mehdi Taremi","IRN","FW","32-091",1992,2.1,2,1,0,1,1,0,0,NA,0,3,0,3,0,2,3,0,"https://fbref.com/en/players/4c2a5d34/Mehdi-Taremi"
2025,"Inter","Serie A","Marcus Thuram","FRA","FW","27-072",1997,6.1,5,3,2,1,2,2,4,50,2,5,1,4,1,6,2,0,"https://fbref.com/en/players/6f8cd6d0/Marcus-Thuram"
2025,"Inter","Serie A","Stefan de Vrij","NED","DF","32-255",1992,1.3,0,0,0,0,0,0,2,0,2,0,0,0,0,0,1,0,"https://fbref.com/en/players/d0d8dd44/Stefan-de-Vrij"
2025,"Inter","Serie A","Piotr Zieliński","POL","MF","30-150",1994,0.8,3,3,1,1,1,1,3,33.3,2,0,0,0,0,3,1,0,"https://fbref.com/en/players/a5296e55/Piotr-Zielinski"
2025,"Ipswich Town","Premier League","Wes Burns","WAL","FW","29-329",1994,3.1,2,2,0,1,1,0,1,0,1,3,0,3,0,2,2,1,"https://fbref.com/en/players/b3fe23c6/Wes-Burns"
2025,"Ipswich Town","Premier League","Jens Cajuste","SWE","MF","25-068",1999,0.9,2,1,0,2,0,0,0,NA,0,0,0,0,0,2,3,0,"https://fbref.com/en/players/928a4a61/Jens-Cajuste"
2025,"Ipswich Town","Premier League","Conor Chaplin","ENG","MF,FW","27-244",1997,1.1,3,3,3,0,0,1,3,33.3,2,2,0,2,0,3,1,0,"https://fbref.com/en/players/4ec55b87/Conor-Chaplin"
2025,"Ipswich Town","Premier League","Jack Clarke","ENG","FW","23-329",2000,2.6,5,3,0,5,0,2,8,25,6,0,0,0,0,5,4,0,"https://fbref.com/en/players/e16932d8/Jack-Clarke"
2025,"Ipswich Town","Premier League","Leif Davis","ENG","DF","24-279",2000,7,14,9,13,0,1,9,14,64.3,5,6,1,5,5,19,18,0,"https://fbref.com/en/players/8574c61f/Leif-Davis"
2025,"Ipswich Town","Premier League","Liam Delap","ENG","FW","21-252",2003,6,3,1,1,1,1,0,4,0,4,2,0,2,1,4,8,0,"https://fbref.com/en/players/dd897ee7/Liam-Delap"
2025,"Ipswich Town","Premier League","George Edmundson","ENG","DF","27-047",1997,0,0,0,0,0,0,0,0,NA,0,0,0,0,0,0,0,0,"https://fbref.com/en/players/46ff3923/George-Edmundson"
2025,"Ipswich Town","Premier League","Jacob Greaves","ENG","DF","24-035",2000,7,14,6,6,8,0,7,11,63.6,4,8,6,2,8,22,41,1,"https://fbref.com/en/players/1f169636/Jacob-Greaves"
2025,"Ipswich Town","Premier League","Ali Al Hamadi","IRQ","FW","22-230",2002,0.4,1,0,0,0,1,0,1,0,1,0,0,0,0,1,2,0,"https://fbref.com/en/players/8450467d/Ali-Al-Hamadi"
2025,"Ipswich Town","Premier League","Marcus Harness","ENG","MF","28-236",1996,0.5,1,0,0,0,1,0,3,0,3,2,1,1,0,1,1,0,"https://fbref.com/en/players/90e9ca3d/Marcus-Harness"
2025,"Ipswich Town","Premier League","George Hirst","ENG","FW","25-245",1999,0.7,1,1,1,0,0,0,1,0,1,0,0,0,0,1,0,0,"https://fbref.com/en/players/78e87179/George-Hirst"
2025,"Ipswich Town","Premier League","Omari Hutchinson","ENG","MF,FW","20-353",2003,6.8,5,3,2,3,0,4,13,30.8,9,8,1,7,3,8,4,0,"https://fbref.com/en/players/bd9553e6/Omari-Hutchinson"
2025,"Ipswich Town","Premier League","Ben Johnson","ENG","DF","24-267",2000,2.5,11,8,9,2,0,7,11,63.6,4,4,1,3,3,14,3,0,"https://fbref.com/en/players/9319781b/Ben-Johnson"
2025,"Ipswich Town","Premier League","Massimo Luongo","AUS","MF","32-022",1992,1.6,5,3,5,0,0,4,6,66.7,2,3,2,1,2,7,2,0,"https://fbref.com/en/players/967ac6e1/Massimo-Luongo"
2025,"Ipswich Town","Premier League","Sam Morsy","EGY","MF","33-037",1991,6.9,20,11,10,8,2,8,14,57.1,6,8,3,5,3,23,11,1,"https://fbref.com/en/players/a23c0949/Sam-Morsy"
2025,"Ipswich Town","Premier League","Arijanet Muric","KVX","GK","25-345",1998,6,0,0,0,0,0,0,2,0,2,0,0,0,0,0,2,3,"https://fbref.com/en/players/99aa1a84/Arijanet-Muric"
2025,"Ipswich Town","Premier League","Dara O'Shea","IRL","DF","25-227",1999,4,6,3,5,1,0,2,2,100,0,7,7,0,9,15,17,0,"https://fbref.com/en/players/1d042188/Dara-OShea"
2025,"Ipswich Town","Premier League","Chiedozie Ogbene","IRL","FW","27-169",1997,2.3,7,3,1,2,4,2,4,50,2,1,0,1,1,8,3,0,"https://fbref.com/en/players/788c0277/Chiedozie-Ogbene"
2025,"Ipswich Town","Premier League","Kalvin Phillips","ENG","MF","28-320",1995,3.3,9,3,2,6,1,4,11,36.4,7,8,1,7,6,15,6,0,"https://fbref.com/en/players/4f565d77/Kalvin-Phillips"
2025,"Ipswich Town","Premier League","Sammie Szmodics","IRL","FW,MF","29-023",1995,3.4,2,1,1,1,0,0,1,0,1,2,0,2,3,5,3,0,"https://fbref.com/en/players/39944392/Sammie-Szmodics"
2025,"Ipswich Town","Premier League","Jack Taylor","IRL","MF","26-116",1998,1.3,1,0,0,1,0,1,4,25,3,1,0,1,2,3,7,0,"https://fbref.com/en/players/48eed8d5/Jack-Taylor"
2025,"Ipswich Town","Premier League","Axel Tuanzebe","COD","DF","26-338",1997,5.7,13,8,10,0,3,6,10,60,4,5,3,2,8,21,21,0,"https://fbref.com/en/players/2baec6ce/Axel-Tuanzebe"
2025,"Ipswich Town","Premier League","Christian Walton","ENG","GK","28-343",1995,1,0,0,0,0,0,0,1,0,1,0,0,0,0,0,0,0,"https://fbref.com/en/players/c666574f/Christian-Walton"
2025,"Ipswich Town","Premier League","Luke Woolfenden","ENG","DF","25-362",1998,3,0,0,0,0,0,0,1,0,1,8,3,5,6,6,20,0,"https://fbref.com/en/players/e28e9bec/Luke-Woolfenden"
2025,"Juventus","Serie A","Lorenzo Anghelè","ITA","FW","19-234",2005,0.1,0,0,0,0,0,0,0,NA,0,0,0,0,0,0,0,0,"https://fbref.com/en/players/b2f3d550/Lorenzo-Anghele"
2025,"Juventus","Serie A","Gleison Bremer","BRA","DF","27-213",1997,6,15,7,9,5,1,4,5,80,1,15,11,4,6,21,16,0,"https://fbref.com/en/players/5fd5ed86/Gleison-Bremer"
2025,"Juventus","Serie A","Andrea Cambiaso","ITA","DF,FW","24-240",2000,6.1,9,5,6,2,1,6,11,54.5,5,2,0,2,2,11,10,0,"https://fbref.com/en/players/247ed022/Andrea-Cambiaso"
2025,"Juventus","Serie A","Francisco Conceição","POR","FW","21-308",2002,1.8,4,3,3,1,0,2,3,66.7,1,1,0,1,1,5,0,0,"https://fbref.com/en/players/5ef3d210/Francisco-Conceicao"
2025,"Juventus","Serie A","Danilo","BRA","DF","33-094",1991,1.3,1,0,0,0,1,0,0,NA,0,1,1,0,2,3,2,0,"https://fbref.com/en/players/94b2001f/Danilo"
2025,"Juventus","Serie A","Juan David Cabal","COL","DF","23-283",2001,2.3,3,1,3,0,0,2,6,33.3,4,1,0,1,1,4,7,1,"https://fbref.com/en/players/ef6eef89/Juan-David-Cabal"
2025,"Juventus","Serie A","Michele Di Gregorio","ITA","GK","27-082",1997,5,0,0,0,0,0,0,0,NA,0,0,0,0,0,0,0,0,"https://fbref.com/en/players/4e0c8d66/Michele-Di-Gregorio"
2025,"Juventus","Serie A","Nicolò Fagioli","ITA","MF","23-248",2001,3.8,8,5,4,3,1,3,3,100,0,1,0,1,2,10,3,0,"https://fbref.com/en/players/366be751/Nicolo-Fagioli"
2025,"Juventus","Serie A","Federico Gatti","ITA","DF","26-115",1998,4.9,7,4,6,1,0,5,6,83.3,1,8,5,3,5,12,12,0,"https://fbref.com/en/players/18dd3219/Federico-Gatti"
2025,"Juventus","Serie A","Nicolás González","ARG","FW","26-194",1998,2.5,3,1,1,0,2,1,2,50,1,4,1,3,0,3,0,0,"https://fbref.com/en/players/2374aaca/Nicolas-Gonzalez"
2025,"Juventus","Serie A","Pierre Kalulu","FRA","DF","24-134",2000,4,4,2,4,0,0,2,2,100,0,6,2,4,3,7,4,0,"https://fbref.com/en/players/85f7d1be/Pierre-Kalulu"
2025,"Juventus","Serie A","Teun Koopmeiners","NED","MF","26-232",1998,4,6,4,0,5,1,2,4,50,2,1,1,0,0,6,2,0,"https://fbref.com/en/players/a26fb8aa/Teun-Koopmeiners"
2025,"Juventus","Serie A","Manuel Locatelli","ITA","MF","26-283",1998,5,11,9,6,4,1,3,7,42.9,4,8,1,7,2,13,11,0,"https://fbref.com/en/players/a8a874f1/Manuel-Locatelli"
2025,"Juventus","Serie A","Douglas Luiz","BRA","MF","26-161",1998,2,4,2,2,2,0,3,4,75,1,2,0,2,1,5,0,0,"https://fbref.com/en/players/6f7d826d/Douglas-Luiz"
2025,"Juventus","Serie A","Samuel Mbangula","BEL","FW","20-275",2004,3.4,9,7,7,1,1,5,7,71.4,2,4,0,4,0,9,2,0,"https://fbref.com/en/players/3e25e70c/Samuel-Mbangula"
2025,"Juventus","Serie A","Weston McKennie","USA","MF","26-050",1998,2.1,3,2,1,2,0,1,2,50,1,3,0,3,0,3,0,0,"https://fbref.com/en/players/01c3aff5/Weston-McKennie"
2025,"Juventus","Serie A","Mattia Perin","ITA","GK","31-342",1992,2,0,0,0,0,0,0,0,NA,0,0,0,0,0,0,0,0,"https://fbref.com/en/players/4c62d0c8/Mattia-Perin"
2025,"Juventus","Serie A","Jonas Rouhi","SWE","DF","20-284",2004,1,0,0,0,0,0,0,0,NA,0,1,0,1,1,1,2,0,"https://fbref.com/en/players/31908a0a/Jonas-Rouhi"
2025,"Juventus","Serie A","Nicolò Savona","ITA","DF","21-212",2003,4.3,8,5,4,3,1,3,5,60,2,1,0,1,4,12,1,0,"https://fbref.com/en/players/e041497d/Nicolo-Savona"
2025,"Juventus","Serie A","Khéphren Thuram","FRA","MF","23-205",2001,2,1,1,0,1,0,0,1,0,1,1,0,1,3,4,4,0,"https://fbref.com/en/players/7d9397f8/Khephren-Thuram"
2025,"Juventus","Serie A","Dušan Vlahović","SRB","FW","24-263",2000,6.4,1,1,0,0,1,0,0,NA,0,3,2,1,0,1,5,1,"https://fbref.com/en/players/79443529/Dusan-Vlahovic"
2025,"Juventus","Serie A","Timothy Weah","USA","FW","24-238",2000,1.3,3,1,0,1,2,1,1,100,0,2,0,2,1,4,0,0,"https://fbref.com/en/players/8eec784d/Timothy-Weah"
2025,"Juventus","Serie A","Kenan Yıldız","TUR","FW,MF","19-166",2005,5.7,13,8,2,7,4,5,6,83.3,1,9,0,9,1,14,3,0,"https://fbref.com/en/players/d8cda243/Kenan-Yildiz"
2025,"Las Palmas","La Liga","Aboubacar Bassinga","CIV","MF","19-096",2005,0,0,0,0,0,0,0,0,NA,0,0,0,0,0,0,0,0,"https://fbref.com/en/players/22a312ec/Aboubacar-Bassinga"
2025,"Las Palmas","La Liga","José Campaña","ESP","MF","31-139",1993,2.3,3,3,1,2,0,2,4,50,2,2,0,2,7,10,4,0,"https://fbref.com/en/players/61220da2/Jose-Campana"
2025,"Las Palmas","La Liga","Marc Cardona","ESP","FW","29-101",1995,0.5,0,0,0,0,0,0,0,NA,0,0,0,0,0,0,0,0,"https://fbref.com/en/players/b92b456a/Marc-Cardona"
2025,"Las Palmas","La Liga","Jasper Cillessen","NED","GK","35-178",1989,7,0,0,0,0,0,0,0,NA,0,0,0,0,0,0,6,0,"https://fbref.com/en/players/04ac8285/Jasper-Cillessen"
2025,"Las Palmas","La Liga","Dario Essugo","POR","MF","19-217",2005,3.6,8,6,5,2,1,2,4,50,2,1,1,0,5,13,6,1,"https://fbref.com/en/players/1e4319ac/Dario-Essugo"
2025,"Las Palmas","La Liga","Manuel Fuster","ESP","MF,FW","26-361",1997,1.6,1,0,0,1,0,1,3,33.3,2,1,0,1,0,1,1,0,"https://fbref.com/en/players/618f396a/Manuel-Fuster"
2025,"Las Palmas","La Liga","Fabio González","ESP","MF","27-248",1997,0.5,0,0,0,0,0,0,1,0,1,0,0,0,0,0,0,0,"https://fbref.com/en/players/5418d47c/Fabio-Gonzalez"
2025,"Las Palmas","La Liga","Juan Herzog","ESP","DF","21-157",2003,4,2,2,2,0,0,2,4,50,2,4,3,1,4,6,18,0,"https://fbref.com/en/players/3a18abe2/Juan-Herzog"
2025,"Las Palmas","La Liga","Dinko Horkaš","CRO","GK","25-221",1999,2,0,0,0,0,0,0,0,NA,0,0,0,0,0,0,2,0,"https://fbref.com/en/players/8fafc04d/Dinko-Horkas"
2025,"Las Palmas","La Liga","Adnan Januzaj","BEL","MF,FW","29-255",1995,2.1,2,1,0,2,0,1,2,50,1,1,0,1,0,2,1,0,"https://fbref.com/en/players/4737cebe/Adnan-Januzaj"
2025,"Las Palmas","La Liga","Enzo Loiodice","FRA","MF","23-325",2000,2.6,2,2,1,1,0,1,3,33.3,2,3,0,3,2,4,2,0,"https://fbref.com/en/players/6bca20fe/Enzo-Loiodice"
2025,"Las Palmas","La Liga","Mika Màrmol","ESP","DF","22-107",2002,5.5,12,4,8,3,1,4,6,66.7,2,7,2,5,8,20,16,0,"https://fbref.com/en/players/e7630876/Mika-Marmol"
2025,"Las Palmas","La Liga","Marvin","ESP","DF,FW","24-106",2000,4.5,10,5,5,3,2,5,16,31.3,11,4,1,3,5,15,13,0,"https://fbref.com/en/players/efaefda0/Marvin"
2025,"Las Palmas","La Liga","Jaime Mata","ESP","FW","35-359",1988,2.3,1,0,1,0,0,1,5,20,4,2,0,2,1,2,0,0,"https://fbref.com/en/players/02319ad7/Jaime-Mata"
2025,"Las Palmas","La Liga","Oliver McBurnie","SCO","FW","28-135",1996,7.1,5,4,2,2,1,2,4,50,2,3,1,2,3,8,6,0,"https://fbref.com/en/players/78b8ac63/Oliver-McBurnie"
2025,"Las Palmas","La Liga","Scott McKenna","SCO","DF","27-340",1996,4.1,4,3,3,1,0,3,4,75,1,6,5,1,0,4,18,0,"https://fbref.com/en/players/4e5a4cbc/Scott-McKenna"
2025,"Las Palmas","La Liga","Alberto Moleiro","ESP","FW,MF","21-017",2003,7.6,7,3,4,3,0,6,13,46.2,7,5,0,5,2,9,2,0,"https://fbref.com/en/players/c2c8897d/Alberto-Moleiro"
2025,"Las Palmas","La Liga","Álex Muñoz","ESP","DF","30-079",1994,5.7,17,14,8,8,1,11,14,78.6,3,11,4,7,7,24,23,0,"https://fbref.com/en/players/853f211e/Alex-Munoz"
2025,"Las Palmas","La Liga","Javier Muñoz","ESP","MF","29-232",1995,6.8,10,9,3,5,2,4,10,40,6,7,0,7,6,16,5,1,"https://fbref.com/en/players/ec7c84c2/Javier-Munoz"
2025,"Las Palmas","La Liga","Pejiño","ESP","FW","28-080",1996,0.2,1,1,0,1,0,1,1,100,0,0,0,0,0,1,0,0,"https://fbref.com/en/players/8c4e56cb/Pejino"
2025,"Las Palmas","La Liga","Benito Ramírez","ESP","DF,MF","29-098",1995,2.4,2,1,2,0,0,2,8,25,6,5,2,3,1,3,7,0,"https://fbref.com/en/players/db714daf/Benito-Ramirez"
2025,"Las Palmas","La Liga","Sandro Ramírez","ESP","FW,MF","29-100",1995,4.5,6,5,3,3,0,4,8,50,4,0,0,0,8,14,4,0,"https://fbref.com/en/players/833fb62e/Sandro-Ramirez"
2025,"Las Palmas","La Liga","Kirian Rodríguez","ESP","MF","28-226",1996,7.4,12,7,4,8,0,8,20,40,12,8,1,7,2,14,6,0,"https://fbref.com/en/players/9b130479/Kirian-Rodriguez"
2025,"Las Palmas","La Liga","Fábio Silva","POR","FW,MF","22-090",2002,3.9,5,1,1,2,2,1,6,16.7,5,3,0,3,1,6,1,0,"https://fbref.com/en/players/e7aa9d7c/Fabio-Silva"
2025,"Las Palmas","La Liga","Daley Sinkgraven","NED","DF","29-105",1995,1,5,1,3,2,0,1,3,33.3,2,1,0,1,1,6,2,0,"https://fbref.com/en/players/73000a79/Daley-Sinkgraven"
2025,"Las Palmas","La Liga","Álex Suárez","ESP","DF","31-213",1993,6,12,8,9,2,1,7,9,77.8,2,9,5,4,4,16,21,0,"https://fbref.com/en/players/9c137b36/Alex-Suarez"
2025,"Las Palmas","La Liga","Viti","ESP","DF","27-031",1997,3.9,11,6,6,4,1,4,6,66.7,2,5,0,5,3,14,10,0,"https://fbref.com/en/players/c56a2d27/Viti"
2025,"Lazio","Serie A","Nicolò Casale","ITA","DF","26-246",1998,1.5,5,3,4,1,0,0,0,NA,0,4,3,1,1,6,2,0,"https://fbref.com/en/players/3f5f38fb/Nicolo-Casale"
2025,"Lazio","Serie A","Valentín Castellanos","ARG","FW","26-014",1998,5.6,4,2,0,1,3,1,7,14.3,6,4,1,3,1,5,2,0,"https://fbref.com/en/players/da76bab4/Valentin-Castellanos"
2025,"Lazio","Serie A","Gaetano Castrovilli","ITA","MF","27-243",1997,1,3,1,2,0,1,0,1,0,1,1,0,1,2,5,1,0,"https://fbref.com/en/players/0728bebe/Gaetano-Castrovilli"
2025,"Lazio","Serie A","Fisayo Dele-Bashiru","NGA","MF","23-254",2001,1.8,2,2,0,1,1,0,0,NA,0,2,0,2,0,2,0,0,"https://fbref.com/en/players/121a4fb8/Fisayo-Dele-Bashiru"
2025,"Lazio","Serie A","Boulaye Dia","SEN","MF,FW","27-336",1996,4.7,4,2,1,1,2,2,3,66.7,1,1,0,1,0,4,0,1,"https://fbref.com/en/players/244bc2c8/Boulaye-Dia"
2025,"Lazio","Serie A","Mario Gila","ESP","DF","24-049",2000,4,10,8,8,2,0,7,12,58.3,5,2,1,1,4,14,13,0,"https://fbref.com/en/players/9c435456/Mario-Gila"
2025,"Lazio","Serie A","Mattéo Guendouzi","FRA","MF","25-186",1999,7,9,5,3,5,1,5,13,38.5,8,5,1,4,9,18,11,0,"https://fbref.com/en/players/5ea8ef20/Matteo-Guendouzi"
2025,"Lazio","Serie A","Elseid Hysaj","ALB","DF","30-240",1994,0.1,1,1,0,1,0,0,0,NA,0,0,0,0,0,1,1,0,"https://fbref.com/en/players/2f3452eb/Elseid-Hysaj"
2025,"Lazio","Serie A","Gustav Isaksen","DEN","FW,MF","23-181",2001,3.9,3,2,0,3,0,0,4,0,4,1,0,1,1,4,1,0,"https://fbref.com/en/players/5715bb71/Gustav-Isaksen"
2025,"Lazio","Serie A","Manuel Lazzari","ITA","DF","30-323",1993,5.5,7,6,3,3,1,4,7,57.1,3,1,1,0,1,8,6,0,"https://fbref.com/en/players/02caf6e0/Manuel-Lazzari"
2025,"Lazio","Serie A","Adam Marušić","MNE","DF","32-000",1992,3.4,5,2,2,3,0,3,6,50,3,1,0,1,4,9,8,0,"https://fbref.com/en/players/d4535821/Adam-Marusic"
2025,"Lazio","Serie A","Tijjani Noslin","NED","FW,MF","25-102",1999,2.6,1,1,0,0,1,0,3,0,3,5,0,5,0,1,4,0,"https://fbref.com/en/players/2f067cf2/Tijjani-Noslin"
2025,"Lazio","Serie A","Patric","ESP","DF","31-183",1993,2.5,4,2,3,1,0,3,6,50,3,0,0,0,2,6,6,0,"https://fbref.com/en/players/f7223718/Patric"
2025,"Lazio","Serie A","Pedro","ESP","FW,MF","37-081",1987,0.5,2,1,0,2,0,1,1,100,0,2,0,2,0,2,1,0,"https://fbref.com/en/players/3ca7254a/Pedro"
2025,"Lazio","Serie A","Luca Pellegrini","ITA","DF","25-224",1999,0.3,2,2,0,2,0,1,1,100,0,2,0,2,0,2,2,0,"https://fbref.com/en/players/3b61c9ec/Luca-Pellegrini"
2025,"Lazio","Serie A","Ivan Provedel","ITA","GK","30-214",1994,7,0,0,0,0,0,0,0,NA,0,0,0,0,0,0,5,3,"https://fbref.com/en/players/277da414/Ivan-Provedel"
2025,"Lazio","Serie A","Alessio Romagnoli","ITA","DF","29-279",1995,6,8,5,3,5,0,4,5,80,1,4,3,1,8,16,14,0,"https://fbref.com/en/players/3ead85f9/Alessio-Romagnoli"
2025,"Lazio","Serie A","Nicolò Rovella","ITA","MF","22-318",2001,4.9,21,16,6,12,3,11,14,78.6,3,2,0,2,6,27,7,1,"https://fbref.com/en/players/e58cbfd5/Nicolo-Rovella"
2025,"Lazio","Serie A","Nuno Tavares","POR","DF","24-265",2000,4.7,7,6,6,1,0,2,5,40,3,1,0,1,2,9,13,0,"https://fbref.com/en/players/a65c844b/Nuno-Tavares"
2025,"Lazio","Serie A","Loum Tchaouna","FRA","FW,MF","21-039",2003,1.6,3,1,1,1,1,1,3,33.3,2,1,0,1,1,4,1,0,"https://fbref.com/en/players/a3c8b4d3/Loum-Tchaouna"
2025,"Lazio","Serie A","Matías Vecino","URU","MF","33-054",1991,1.7,2,2,1,1,0,2,7,28.6,5,2,0,2,1,3,2,0,"https://fbref.com/en/players/44ac04e9/Matias-Vecino"
2025,"Lazio","Serie A","Mattia Zaccagni","ITA","FW,MF","29-123",1995,6.7,8,6,1,6,1,3,5,60,2,3,0,3,4,12,3,0,"https://fbref.com/en/players/d85c238b/Mattia-Zaccagni"
2025,"Le Havre","Ligue 1","Josué Casimir","FRA","FW,DF","23-023",2001,4.5,7,4,2,3,2,1,4,25,3,2,0,2,1,8,7,0,"https://fbref.com/en/players/481f76cf/Josue-Casimir"
2025,"Le Havre","Ligue 1","Arthur Desmas","FRA","GK","30-193",1994,7,0,0,0,0,0,0,0,NA,0,0,0,0,0,0,0,0,"https://fbref.com/en/players/e8c5dd4d/Arthur-Desmas"
2025,"Le Havre","Ligue 1","Kandet Diawara","GUI","FW","24-250",2000,0,0,0,0,0,0,0,0,NA,0,1,0,1,0,0,1,0,"https://fbref.com/en/players/1f038218/Kandet-Diawara"
2025,"Le Havre","Ligue 1","Samuel Grandsir","FRA","MF,FW","28-064",1996,0.6,3,3,0,2,1,2,2,100,0,2,0,2,0,3,0,0,"https://fbref.com/en/players/d2448564/Samuel-Grandsir"
2025,"Le Havre","Ligue 1","Ilyes Housni","FRA","FW,MF","19-156",2005,0.8,5,4,0,3,2,2,3,66.7,1,2,0,2,0,5,0,0,"https://fbref.com/en/players/910e3cad/Ilyes-Housni"
2025,"Le Havre","Ligue 1","Antoine Joujou","FRA","MF,FW","21-219",2003,3.4,6,5,4,1,1,2,4,50,2,8,2,6,3,9,3,0,"https://fbref.com/en/players/f9124307/Antoine-Joujou"
2025,"Le Havre","Ligue 1","Yassine Kechta","MAR","MF,FW","22-235",2002,5.5,14,9,5,7,2,7,19,36.8,12,7,0,7,5,19,1,0,"https://fbref.com/en/players/abefc3af/Yassine-Kechta"
2025,"Le Havre","Ligue 1","Daler Kuzyaev","RUS","MF","31-276",1993,3.5,6,5,3,3,0,1,4,25,3,5,3,2,4,10,3,0,"https://fbref.com/en/players/d4e93bab/Daler-Kuzyaev"
2025,"Le Havre","Ligue 1","Gautier Lloris","FRA","DF","29-091",1995,7,14,8,8,6,0,9,16,56.3,7,4,3,1,4,18,30,0,"https://fbref.com/en/players/ac89503b/Gautier-Lloris"
2025,"Le Havre","Ligue 1","Rassoul Ndiaye","SEN","MF","22-311",2001,3.3,12,8,7,5,0,1,8,12.5,7,4,0,4,3,15,0,0,"https://fbref.com/en/players/36f65bdf/Rassoul-Ndiaye"
2025,"Le Havre","Ligue 1","Loïc Nego","HUN","DF,FW","33-276",1991,5.8,15,10,10,4,1,11,16,68.8,5,4,0,4,9,24,11,0,"https://fbref.com/en/players/c3b6fa1e/Loic-Nego"
2025,"Le Havre","Ligue 1","Steve Ngoura","FRA","FW","19-238",2005,0.7,0,0,0,0,0,0,0,NA,0,1,0,1,0,0,0,0,"https://fbref.com/en/players/731f1f5a/Steve-Ngoura"
2025,"Le Havre","Ligue 1","Christopher Operi","CIV","DF,FW","27-171",1997,6,4,3,1,1,2,1,3,33.3,2,7,2,5,6,10,13,0,"https://fbref.com/en/players/914bb955/Christopher-Operi"
2025,"Le Havre","Ligue 1","Emmanuel Sabbi","USA","MF,FW","26-298",1997,1.7,4,2,3,1,0,1,2,50,1,2,0,2,1,5,0,0,"https://fbref.com/en/players/2e1b7c83/Emmanuel-Sabbi"
2025,"Le Havre","Ligue 1","Yoann Salmier","GUF","DF","31-331",1992,2.9,2,1,2,0,0,1,1,100,0,2,1,1,3,5,25,0,"https://fbref.com/en/players/c3725db2/Yoann-Salmier"
2025,"Le Havre","Ligue 1","Arouna Sangante","SEN","DF","22-188",2002,5.8,9,7,4,5,0,5,8,62.5,3,7,4,3,14,23,21,1,"https://fbref.com/en/players/17bb562c/Arouna-Sangante"
2025,"Le Havre","Ligue 1","Issa Soumaré","SEN","FW,MF","24-007",2000,3.8,2,0,0,1,1,2,6,33.3,4,3,1,2,2,4,2,0,"https://fbref.com/en/players/1d8aa290/Issa-Soumare"
2025,"Le Havre","Ligue 1","Oussama Targhalline","MAR","MF","22-150",2002,3.6,6,3,2,1,3,1,3,33.3,2,6,3,3,7,13,2,0,"https://fbref.com/en/players/abd56820/Oussama-Targhalline"
2025,"Le Havre","Ligue 1","Abdoulaye Touré","GUI","MF","30-228",1994,6.2,14,8,7,5,2,8,13,61.5,5,5,4,1,6,20,11,0,"https://fbref.com/en/players/ef7cd87a/Abdoulaye-Toure"
2025,"Le Havre","Ligue 1","Etienne Youte Kinkoue","FRA","DF","22-277",2002,3.5,2,1,1,1,0,2,3,66.7,1,4,2,2,4,6,10,0,"https://fbref.com/en/players/12a4e38c/Etienne-Youte-Kinkoue"
2025,"Le Havre","Ligue 1","Yanis Zouaoui","ALG","DF","30-099",1994,0.8,0,0,0,0,0,0,0,NA,0,0,0,0,0,0,1,0,"https://fbref.com/en/players/ec724366/Yanis-Zouaoui"
2025,"Lecce","Serie A","Lameck Banda","ZAM","FW,MF","23-262",2001,2.7,2,2,2,0,0,1,3,33.3,2,4,0,4,1,3,3,0,"https://fbref.com/en/players/8a6de8c7/Lameck-Banda"
2025,"Lecce","Serie A","Federico Baschirotto","ITA","DF","28-027",1996,7,8,6,7,1,0,5,6,83.3,1,12,9,3,8,16,25,0,"https://fbref.com/en/players/5a08ee41/Federico-Baschirotto"
2025,"Lecce","Serie A","Medon Berisha","ALB","MF,FW","20-362",2003,0.9,2,1,1,1,0,1,1,100,0,0,0,0,0,2,0,0,"https://fbref.com/en/players/9d376bef/Medon-Berisha"
2025,"Lecce","Serie A","Lassana Coulibaly","MLI","MF","28-190",1996,3.8,6,4,3,3,0,3,6,50,3,7,1,6,3,9,4,0,"https://fbref.com/en/players/85a44ecc/Lassana-Coulibaly"
2025,"Lecce","Serie A","Patrick Dorgu","DEN","FW,DF","19-357",2004,5.5,13,6,4,6,3,8,14,57.1,6,6,1,5,5,18,9,0,"https://fbref.com/en/players/e6536124/Patrick-Dorgu"
2025,"Lecce","Serie A","Wladimiro Falcone","ITA","GK","29-188",1995,7,0,0,0,0,0,0,0,NA,0,0,0,0,0,0,4,0,"https://fbref.com/en/players/9f5a610b/Wladimiro-Falcone"
2025,"Lecce","Serie A","Antonino Gallo","ITA","DF","24-286",2000,6.9,12,7,9,3,0,4,10,40,6,8,1,7,7,19,26,0,"https://fbref.com/en/players/c74d63ac/Antonino-Gallo"
2025,"Lecce","Serie A","Valentin Gendrey","FRA","DF","24-118",2000,2,2,2,1,0,1,1,1,100,0,3,1,2,2,4,1,0,"https://fbref.com/en/players/822ed0ec/Valentin-Gendrey"
2025,"Lecce","Serie A","Frederic Guilbert","FRA","DF","29-298",1994,3.2,9,4,6,2,1,2,5,40,3,3,1,2,7,16,11,0,"https://fbref.com/en/players/5d8d7454/Frederic-Guilbert"
2025,"Lecce","Serie A","Gaby Jean","FRA","DF","24-241",2000,0.2,0,0,0,0,0,0,1,0,1,1,1,0,0,0,2,0,"https://fbref.com/en/players/5f130a19/Gaby-Jean"
2025,"Lecce","Serie A","Kialonda","ANG","DF","27-020",1997,7,11,4,10,1,0,4,4,100,0,17,11,6,12,23,34,0,"https://fbref.com/en/players/34e4dc3b/Kialonda"
2025,"Lecce","Serie A","Nikola Krstović","MNE","FW","24-195",2000,6.7,8,3,3,2,3,3,6,50,3,1,0,1,1,9,3,0,"https://fbref.com/en/players/473803c9/Nikola-Krstovic"
2025,"Lecce","Serie A","Filip Marchwiński","POL","MF","22-281",2002,0.2,0,0,0,0,0,0,0,NA,0,0,0,0,0,0,0,0,"https://fbref.com/en/players/55a88fd9/Filip-Marchwinski"
2025,"Lecce","Serie A","Tete Morente","ESP","FW","27-318",1996,3.6,5,3,2,3,0,2,9,22.2,7,6,0,6,3,8,3,0,"https://fbref.com/en/players/004d185e/Tete-Morente"
2025,"Lecce","Serie A","Remi Oudin","FRA","MF,FW","27-334",1996,1.1,1,0,1,0,0,1,3,33.3,2,0,0,0,1,2,0,0,"https://fbref.com/en/players/ea02beaf/Remi-Oudin"
2025,"Lecce","Serie A","Andy Pelmard","FRA","DF","24-219",2000,0.1,0,0,0,0,0,0,0,NA,0,0,0,0,0,0,0,0,"https://fbref.com/en/players/f18d7ab2/Andy-Pelmard"
2025,"Lecce","Serie A","Santiago Pierotti","ARG","FW,MF","23-197",2001,1.7,5,4,3,2,0,4,6,66.7,2,2,1,1,2,7,1,0,"https://fbref.com/en/players/ec315772/Santiago-Pierotti"
2025,"Lecce","Serie A","Balthazar Pierret","FRA","MF","24-155",2000,4.5,12,5,8,4,0,2,6,33.3,4,6,1,5,3,15,4,0,"https://fbref.com/en/players/c269463b/Balthazar-Pierret"
2025,"Lecce","Serie A","Hamza Rafia","TUN","MF","25-198",1999,2.5,8,5,4,3,1,2,7,28.6,5,2,1,1,1,9,4,0,"https://fbref.com/en/players/6b587d3d/Hamza-Rafia"
2025,"Lecce","Serie A","Ylber Ramadani","ALB","MF","28-188",1996,6.5,14,8,6,8,0,7,10,70,3,9,3,6,6,20,8,2,"https://fbref.com/en/players/ef3c876b/Ylber-Ramadani"
2025,"Lecce","Serie A","Ante Rebić","CRO","FW,MF","31-026",1993,2.9,2,2,1,0,1,1,4,25,3,1,1,0,0,2,1,0,"https://fbref.com/en/players/536cebe5/Ante-Rebic"
2025,"Leganés","La Liga","Adrià Altimira","ESP","FW,DF","23-203",2001,3,7,3,2,4,1,4,9,44.4,5,1,1,0,5,12,4,0,"https://fbref.com/en/players/757a3431/Adria-Altimira"
2025,"Leganés","La Liga","Aritz Arambarri","ESP","DF","26-260",1998,2,1,1,1,0,0,1,1,100,0,2,2,0,3,4,8,0,"https://fbref.com/en/players/f28876e5/Aritz-Arambarri"
2025,"Leganés","La Liga","Darko Brašanac","SRB","MF","32-248",1992,5.6,8,2,2,4,2,2,3,66.7,1,6,5,1,3,11,16,0,"https://fbref.com/en/players/4accb7e0/Darko-Brasanac"
2025,"Leganés","La Liga","Julián Chicco","ARG","MF","26-278",1998,1.3,6,4,0,6,0,3,5,60,2,0,0,0,2,8,1,0,"https://fbref.com/en/players/92dacb99/Julian-Chicco"
2025,"Leganés","La Liga","Seydouba Cissé","GUI","MF","23-250",2001,6.8,13,10,6,6,1,4,9,44.4,5,7,0,7,4,17,9,0,"https://fbref.com/en/players/0d13e455/Seydouba-Cisse"
2025,"Leganés","La Liga","Juan Cruz","ESP","FW,MF","24-175",2000,5.7,6,4,2,4,0,3,6,50,3,5,1,4,4,10,6,0,"https://fbref.com/en/players/cc2dd8a5/Juan-Cruz"
2025,"Leganés","La Liga","Diego","ESP","FW,MF","24-182",2000,1.3,0,0,0,0,0,0,0,NA,0,0,0,0,0,0,3,0,"https://fbref.com/en/players/b85a5126/Diego"
2025,"Leganés","La Liga","Marko Dmitrović","SRB","GK","32-267",1992,3,0,0,0,0,0,0,0,NA,0,0,0,0,0,0,3,0,"https://fbref.com/en/players/ac295d9e/Marko-Dmitrovic"
2025,"Leganés","La Liga","Enric Franquesa","ESP","FW,DF","27-234",1997,4,12,6,8,3,1,7,8,87.5,1,5,1,4,1,13,10,0,"https://fbref.com/en/players/40883e3a/Enric-Franquesa"
2025,"Leganés","La Liga","Munir El Haddadi","MAR","MF,FW","29-046",1995,1.7,3,2,0,1,2,0,2,0,2,2,0,2,0,3,0,0,"https://fbref.com/en/players/8696bc90/Munir-El-Haddadi"
2025,"Leganés","La Liga","Sébastien Haller","CIV","FW","30-117",1994,3.6,1,0,1,0,0,1,2,50,1,1,0,1,0,1,7,0,"https://fbref.com/en/players/ba115a40/Sebastien-Haller"
2025,"Leganés","La Liga","Javi Hernández","ESP","DF","26-168",1998,6.7,12,6,5,5,2,5,13,38.5,8,6,1,5,8,20,27,0,"https://fbref.com/en/players/9a76c2e9/Javi-Hernandez"
2025,"Leganés","La Liga","Roberto López","ESP","MF","24-176",2000,3.7,6,4,3,3,0,4,12,33.3,8,4,0,4,1,7,6,1,"https://fbref.com/en/players/2a8c9f98/Roberto-Lopez"
2025,"Leganés","La Liga","Miguel","ESP","FW","25-044",1999,5.4,2,1,1,1,0,1,4,25,3,7,0,7,1,3,2,0,"https://fbref.com/en/players/6763373d/Miguel"
2025,"Leganés","La Liga","Matija Nastasić","SRB","DF","31-203",1993,3.5,3,3,2,1,0,0,2,0,2,11,8,3,5,8,17,0,"https://fbref.com/en/players/f35430a4/Matija-Nastasic"
2025,"Leganés","La Liga","Yvan Neyou","CMR","MF","27-288",1997,4.9,8,6,3,5,0,6,10,60,4,6,0,6,6,14,7,0,"https://fbref.com/en/players/0ad37003/Yvan-Neyou"
2025,"Leganés","La Liga","Dani Raba","ESP","FW,MF","28-354",1995,1.6,6,4,3,3,0,3,6,50,3,2,0,2,4,10,3,0,"https://fbref.com/en/players/ea6a7ab4/Dani-Raba"
2025,"Leganés","La Liga","Óscar Rodríguez Arnaiz","ESP","MF,FW","26-111",1998,3.5,5,2,1,3,1,1,4,25,3,1,0,1,3,8,1,0,"https://fbref.com/en/players/19709006/Oscar-Rodriguez-Arnaiz"
2025,"Leganés","La Liga","Valentin Rosier","FRA","DF","28-059",1996,8.4,27,23,19,8,0,16,24,66.7,8,12,1,11,11,38,37,0,"https://fbref.com/en/players/9b6d9b53/Valentin-Rosier"
2025,"Leganés","La Liga","Jorge Sáenz","ESP","DF","27-335",1996,5.3,13,10,5,7,1,3,5,60,2,4,2,2,8,21,36,0,"https://fbref.com/en/players/bfca375c/Jorge-Saenz"
2025,"Leganés","La Liga","Sergi","ESP","DF","32-180",1992,9,13,10,7,5,1,5,6,83.3,1,9,5,4,14,27,46,0,"https://fbref.com/en/players/65ac6ea0/Sergi"
2025,"Leganés","La Liga","Juan Soriano","ESP","GK","27-055",1997,6,1,1,1,0,0,1,1,100,0,0,0,0,0,1,2,0,"https://fbref.com/en/players/5512b1a9/Juan-Soriano"
2025,"Leganés","La Liga","Renato Tapia","PER","MF,FW","29-081",1995,3.1,13,6,4,7,2,3,7,42.9,4,6,1,5,2,15,15,0,"https://fbref.com/en/players/34269bdf/Renato-Tapia"
2025,"Leicester City","Premier League","Jordan Ayew","GHA","FW,MF","33-036",1991,4,8,4,3,4,1,1,4,25,3,4,0,4,3,11,1,0,"https://fbref.com/en/players/da052c14/Jordan-Ayew"
2025,"Leicester City","Premier League","Victor Bernth Kristiansen","DEN","DF","21-306",2002,6.9,19,13,13,6,0,8,16,50,8,14,6,8,10,29,23,0,"https://fbref.com/en/players/505486d6/Victor-Bernth-Kristiansen"
2025,"Leicester City","Premier League","Facundo Buonanotte","ARG","MF,FW","19-299",2004,4.1,12,4,4,5,3,6,17,35.3,11,8,1,7,2,14,6,0,"https://fbref.com/en/players/468a7a91/Facundo-Buonanotte"
2025,"Leicester City","Premier League","Hamza Choudhury","ENG","MF","27-016",1997,0.2,0,0,0,0,0,0,0,NA,0,0,0,0,1,1,1,0,"https://fbref.com/en/players/7d2d3329/Hamza-Choudhury"
2025,"Leicester City","Premier League","Conor Coady","ENG","DF","31-235",1993,0.1,0,0,0,0,0,0,0,NA,0,2,1,1,1,1,2,0,"https://fbref.com/en/players/2928dca2/Conor-Coady"
2025,"Leicester City","Premier League","Odsonne Édouard","FRA","FW","26-275",1998,0.3,0,0,0,0,0,0,0,NA,0,0,0,0,0,0,1,0,"https://fbref.com/en/players/0562b7f1/Odsonne-Edouard"
2025,"Leicester City","Premier League","Wout Faes","BEL","DF","26-197",1998,7,6,4,6,0,0,4,10,40,6,20,15,5,5,11,50,1,"https://fbref.com/en/players/9c221d14/Wout-Faes"
2025,"Leicester City","Premier League","Abdul Fatawu Issahaku","GHA","FW","20-223",2004,3.1,15,12,10,0,5,7,11,63.6,4,3,0,3,3,18,6,0,"https://fbref.com/en/players/bceda5ff/Abdul-Fatawu-Issahaku"
2025,"Leicester City","Premier League","Mads Hermansen","DEN","GK","24-098",2000,7,1,1,1,0,0,1,1,100,0,0,0,0,0,1,4,1,"https://fbref.com/en/players/c924b17d/Mads-Hermansen"
2025,"Leicester City","Premier League","James Justin","ENG","DF","26-237",1998,7,13,8,7,4,2,7,14,50,7,9,1,8,11,24,34,0,"https://fbref.com/en/players/fb614c44/James-Justin"
2025,"Leicester City","Premier League","Bilal El Khannouss","MAR","MF","20-160",2004,0.9,1,1,0,0,1,0,0,NA,0,0,0,0,0,1,0,0,"https://fbref.com/en/players/f7042636/Bilal-El-Khannouss"
2025,"Leicester City","Premier League","Stephy Mavididi","ENG","FW","26-139",1998,4.3,11,7,5,4,2,5,12,41.7,7,9,1,8,1,12,2,0,"https://fbref.com/en/players/30144daa/Stephy-Mavididi"
2025,"Leicester City","Premier League","Kasey McAteer","IRL","DF,FW","22-330",2001,0.1,2,1,2,0,0,1,2,50,1,4,0,4,0,2,3,0,"https://fbref.com/en/players/b2c66859/Kasey-McAteer"
2025,"Leicester City","Premier League","Wilfred Ndidi","NGA","MF","27-306",1996,6.8,28,18,16,10,2,7,14,50,7,17,5,12,4,32,20,0,"https://fbref.com/en/players/6b47c5db/Wilfred-Ndidi"
2025,"Leicester City","Premier League","Caleb Okoli","ITA","DF","23-096",2001,5,11,5,5,6,0,5,7,71.4,2,13,8,5,4,15,37,1,"https://fbref.com/en/players/8ec109e6/Caleb-Okoli"
2025,"Leicester City","Premier League","Bobby Reid","JAM","FW","31-258",1993,1.8,1,1,0,1,0,0,3,0,3,4,1,3,0,1,3,0,"https://fbref.com/en/players/0f7533cd/Bobby-Reid"
2025,"Leicester City","Premier League","Oliver Skipp","ENG","MF","24-031",2000,4,4,2,1,2,1,3,4,75,1,7,3,4,2,6,6,0,"https://fbref.com/en/players/6250083a/Oliver-Skipp"
2025,"Leicester City","Premier League","Boubakary Soumaré","FRA","MF","25-233",1999,0.2,0,0,0,0,0,0,0,NA,0,0,0,0,0,0,0,0,"https://fbref.com/en/players/ae59b359/Boubakary-Soumare"
2025,"Leicester City","Premier League","Jamie Vardy","ENG","FW","37-280",1987,6.4,3,3,2,1,0,0,2,0,2,1,0,1,1,4,7,0,"https://fbref.com/en/players/45963054/Jamie-Vardy"
2025,"Leicester City","Premier League","Jannik Vestergaard","DEN","DF","32-075",1992,2,2,1,0,2,0,0,0,NA,0,2,0,2,2,4,17,0,"https://fbref.com/en/players/1900032e/Jannik-Vestergaard"
2025,"Leicester City","Premier League","Harry Winks","ENG","MF","28-258",1996,6,9,4,5,2,2,4,10,40,6,7,2,5,3,12,7,0,"https://fbref.com/en/players/2f7acede/Harry-Winks"
2025,"Lens","Ligue 1","Ruben Aguilar","FRA","DF","31-174",1993,3,9,6,5,4,0,7,9,77.8,2,5,1,4,5,14,2,0,"https://fbref.com/en/players/3dd738a1/Ruben-Aguilar"
2025,"Lens","Ligue 1","Neil El Aynaoui","FRA","MF","23-107",2001,0.1,0,0,0,0,0,0,0,NA,0,0,0,0,0,0,0,0,"https://fbref.com/en/players/17e1261b/Neil-El-Aynaoui"
2025,"Lens","Ligue 1","Jhoanner Chávez","ECU","DF","22-175",2002,4.4,4,2,2,1,1,1,3,33.3,2,7,1,6,4,8,6,0,"https://fbref.com/en/players/649b57e9/Jhoanner-Chavez"
2025,"Lens","Ligue 1","David Costa","POR","MF","23-286",2001,1.6,1,0,0,1,0,1,2,50,1,4,1,3,1,2,0,0,"https://fbref.com/en/players/59948ef7/David-Costa"
2025,"Lens","Ligue 1","Kevin Danso","AUT","DF","26-028",1998,2,3,0,2,1,0,1,2,50,1,2,2,0,2,5,12,0,"https://fbref.com/en/players/6e33125f/Kevin-Danso"
2025,"Lens","Ligue 1","Andy Diouf","FRA","MF","21-153",2003,6,12,8,3,7,2,9,14,64.3,5,11,1,10,4,16,6,0,"https://fbref.com/en/players/9b5237b1/Andy-Diouf"
2025,"Lens","Ligue 1","Przemysław Frankowski","POL","DF","29-188",1995,4,9,7,6,3,0,6,11,54.5,5,4,0,4,0,9,10,0,"https://fbref.com/en/players/00a8d210/Przemyslaw-Frankowski"
2025,"Lens","Ligue 1","Angelo Fulgini","FRA","MF,FW","28-058",1996,2.7,3,3,1,0,2,2,3,66.7,1,5,1,4,0,3,1,0,"https://fbref.com/en/players/4b96c347/Angelo-Fulgini"
2025,"Lens","Ligue 1","Jonathan Gradit","FRA","DF","31-328",1992,5.8,11,6,5,5,1,6,10,60,4,8,3,5,8,19,23,0,"https://fbref.com/en/players/06c48679/Jonathan-Gradit"
2025,"Lens","Ligue 1","Abdukodir Khusanov","UZB","DF","20-231",2004,5.2,7,5,6,1,0,3,4,75,1,12,9,3,16,23,34,0,"https://fbref.com/en/players/d17ce930/Abdukodir-Khusanov"
2025,"Lens","Ligue 1","Rémy Labeau Lascary","GLP","FW","21-228",2003,2.7,1,0,0,1,0,0,3,0,3,2,0,2,0,1,2,0,"https://fbref.com/en/players/c90f380c/Remy-Labeau-Lascary"
2025,"Lens","Ligue 1","Deiver Machado","COL","DF","31-045",1993,2.6,2,1,2,0,0,2,2,100,0,2,0,2,1,3,4,0,"https://fbref.com/en/players/b3f8bdef/Deiver-Machado"
2025,"Lens","Ligue 1","Facundo Medina","ARG","DF,MF","25-142",1999,7,11,7,6,4,1,5,8,62.5,3,6,0,6,8,19,23,0,"https://fbref.com/en/players/6f5ec8bb/Facundo-Medina"
2025,"Lens","Ligue 1","Nampalys Mendy","SEN","MF","32-116",1992,1,4,2,3,1,0,2,4,50,2,0,0,0,1,5,0,0,"https://fbref.com/en/players/1598599e/Nampalys-Mendy"
2025,"Lens","Ligue 1","M'Bala Nzola","ANG","FW","28-060",1996,2.2,1,0,0,0,1,1,1,100,0,1,1,0,2,3,2,0,"https://fbref.com/en/players/a4948e67/MBala-Nzola"
2025,"Lens","Ligue 1","Hamzat Ojediran","NGA","MF","20-338",2003,1.2,7,4,2,5,0,2,4,50,2,1,0,1,4,11,2,0,"https://fbref.com/en/players/25124a21/Hamzat-Ojediran"
2025,"Lens","Ligue 1","Wesley Saïd","FRA","FW,MF","29-181",1995,3.9,3,2,1,2,0,1,2,50,1,0,0,0,0,3,1,0,"https://fbref.com/en/players/90fcf472/Wesley-Said"
2025,"Lens","Ligue 1","Brice Samba","FRA","GK","30-175",1994,7,0,0,0,0,0,0,0,NA,0,0,0,0,0,0,2,0,"https://fbref.com/en/players/60d90c55/Brice-Samba"
2025,"Lens","Ligue 1","Malang Sarr","FRA","DF","25-268",1999,1,0,0,0,0,0,0,0,NA,0,1,0,1,3,3,0,0,"https://fbref.com/en/players/4315f30d/Malang-Sarr"
2025,"Lens","Ligue 1","Martin Satriano","URU","FW,DF","23-240",2001,0.5,3,1,1,1,1,3,3,100,0,0,0,0,0,3,2,0,"https://fbref.com/en/players/86383d0e/Martin-Satriano"
2025,"Lens","Ligue 1","Florian Sotoca","FRA","FW","33-358",1990,4.6,6,4,0,1,5,3,4,75,1,5,1,4,1,7,11,0,"https://fbref.com/en/players/7a42d0df/Florian-Sotoca"
2025,"Lens","Ligue 1","Adrien Thomasson","FRA","MF","30-312",1993,6.2,24,13,14,4,6,15,26,57.7,11,11,0,11,7,31,10,0,"https://fbref.com/en/players/c76b7567/Adrien-Thomasson"
2025,"Lens","Ligue 1","Anass Zaroury","MAR","MF,FW","23-345",2000,2.2,1,1,0,0,1,0,3,0,3,1,0,1,0,1,0,0,"https://fbref.com/en/players/07d65234/Anass-Zaroury"
2025,"Leverkusen","Bundesliga","Amine Adli","MAR","MF,FW","24-160",2000,1.6,4,2,0,1,3,1,2,50,1,2,0,2,0,4,2,0,"https://fbref.com/en/players/dcfb17f4/Amine-Adli"
2025,"Leverkusen","Bundesliga","Robert Andrich","GER","MF,DF","30-025",1994,3.5,8,4,2,6,0,3,4,75,1,3,1,2,6,14,6,0,"https://fbref.com/en/players/e0b113a7/Robert-Andrich"
2025,"Leverkusen","Bundesliga","Arthur","BRA","DF","21-214",2003,0.1,0,0,0,0,0,0,0,NA,0,0,0,0,1,1,1,0,"https://fbref.com/en/players/8a958856/Arthur"
2025,"Leverkusen","Bundesliga","Jeanuël Belocian","FRA","DF","19-243",2005,0.5,1,1,1,0,0,1,1,100,0,0,0,0,0,1,2,0,"https://fbref.com/en/players/c678ddd7/Jeanuel-Belocian"
2025,"Leverkusen","Bundesliga","Victor Boniface","NGA","FW","23-299",2000,4.6,2,2,0,2,0,1,1,100,0,1,0,1,0,2,3,0,"https://fbref.com/en/players/b146275b/Victor-Boniface"
2025,"Leverkusen","Bundesliga","Jeremie Frimpong","NED","DF","23-312",2000,4.6,7,6,4,1,2,4,10,40,6,6,0,6,5,12,2,0,"https://fbref.com/en/players/74f2e748/Jeremie-Frimpong"
2025,"Leverkusen","Bundesliga","Aleix García","ESP","MF","27-111",1997,2.3,3,0,1,1,1,2,3,66.7,1,2,0,2,1,4,2,0,"https://fbref.com/en/players/a10361d2/Aleix-Garcia"
2025,"Leverkusen","Bundesliga","Álex Grimaldo","ESP","DF","29-027",1995,6,7,4,4,1,2,5,11,45.5,6,4,1,3,6,13,5,1,"https://fbref.com/en/players/b1f4086c/Alex-Grimaldo"
2025,"Leverkusen","Bundesliga","Piero Hincapié","ECU","DF","22-282",2002,4.7,9,8,4,4,1,6,9,66.7,3,13,6,7,6,15,11,0,"https://fbref.com/en/players/0c7a48f8/Piero-Hincapie"
2025,"Leverkusen","Bundesliga","Jonas Hofmann","GER","MF","32-095",1992,1.4,0,0,0,0,0,0,0,NA,0,1,0,1,0,0,1,0,"https://fbref.com/en/players/2903a856/Jonas-Hofmann"
2025,"Leverkusen","Bundesliga","Lukáš Hrádecký","FIN","GK","34-328",1989,5,0,0,0,0,0,0,0,NA,0,0,0,0,0,0,1,1,"https://fbref.com/en/players/ad3389d5/Lukas-Hradecky"
2025,"Leverkusen","Bundesliga","Matej Kovar","CZE","GK","24-153",2000,1,0,0,0,0,0,0,0,NA,0,0,0,0,0,0,0,0,"https://fbref.com/en/players/bc67a0e1/Matej-Kovar"
2025,"Leverkusen","Bundesliga","Nordi Mukiele","FRA","DF","26-351",1997,0.6,2,2,0,1,1,2,2,100,0,1,0,1,1,3,2,1,"https://fbref.com/en/players/ac73ec79/Nordi-Mukiele"
2025,"Leverkusen","Bundesliga","Exequiel Palacios","ARG","MF","26-012",1998,0.9,0,0,0,0,0,0,0,NA,0,1,0,1,0,0,0,0,"https://fbref.com/en/players/e82adcab/Exequiel-Palacios"
2025,"Leverkusen","Bundesliga","Patrik Schick","CZE","FW","28-267",1996,1.2,1,1,0,1,0,0,0,NA,0,1,0,1,0,1,1,0,"https://fbref.com/en/players/5d4f7d61/Patrik-Schick"
2025,"Leverkusen","Bundesliga","Jonathan Tah","GER","DF","28-249",1996,6,5,4,4,1,0,2,3,66.7,1,3,2,1,7,12,17,1,"https://fbref.com/en/players/bd142efb/Jonathan-Tah"
2025,"Leverkusen","Bundesliga","Edmond Tapsoba","BFA","DF","25-258",1999,5.9,14,11,7,6,1,5,9,55.6,4,5,3,2,4,18,15,0,"https://fbref.com/en/players/a73c8f95/Edmond-Tapsoba"
2025,"Leverkusen","Bundesliga","Nathan Tella","NGA","DF,FW","25-104",1999,0.9,0,0,0,0,0,0,1,0,1,1,0,1,0,0,1,0,"https://fbref.com/en/players/f1e94cd6/Nathan-Tella"
2025,"Leverkusen","Bundesliga","Martin Terrier","FRA","MF","27-227",1997,3.3,2,1,0,0,2,1,2,50,1,2,0,2,1,3,1,0,"https://fbref.com/en/players/5148dcc5/Martin-Terrier"
2025,"Leverkusen","Bundesliga","Florian Wirtz","GER","MF","21-167",2003,6,10,6,4,5,1,4,7,57.1,3,8,1,7,4,14,0,0,"https://fbref.com/en/players/e7fcf289/Florian-Wirtz"
2025,"Leverkusen","Bundesliga","Granit Xhaka","SUI","MF","32-020",1992,6,7,3,2,4,1,4,5,80,1,7,3,4,1,8,6,0,"https://fbref.com/en/players/e61b8aee/Granit-Xhaka"
2025,"Lille","Ligue 1","Benjamin André","FRA","MF","34-075",1990,5.9,19,7,9,9,1,11,19,57.9,8,7,0,7,8,27,6,0,"https://fbref.com/en/players/ef9c1c95/Benjamin-Andre"
2025,"Lille","Ligue 1","Hákon Arnar Haraldsson","ISL","MF","21-190",2003,1.9,5,2,2,2,1,3,7,42.9,4,0,0,0,1,6,0,0,"https://fbref.com/en/players/e2ae54db/Hakon-Arnar-Haraldsson"
2025,"Lille","Ligue 1","Mitchel Bakker","NED","DF","24-119",2000,0.8,5,4,1,2,2,2,2,100,0,0,0,0,5,10,2,0,"https://fbref.com/en/players/a8567629/Mitchel-Bakker"
2025,"Lille","Ligue 1","Ayyoub Bouaddi","FRA","MF","17-015",2007,1.5,11,7,7,3,1,4,7,57.1,3,2,0,2,0,11,0,0,"https://fbref.com/en/players/8006228f/Ayyoub-Bouaddi"
2025,"Lille","Ligue 1","Rémy Cabella","FRA","MF,FW","34-223",1990,3,9,5,1,6,2,6,10,60,4,2,0,2,3,12,0,0,"https://fbref.com/en/players/148e136f/Remy-Cabella"
2025,"Lille","Ligue 1","Lucas Chevalier","FRA","GK","22-346",2001,7,1,1,1,0,0,1,1,100,0,0,0,0,0,1,0,0,"https://fbref.com/en/players/b3d76d84/Lucas-Chevalier"
2025,"Lille","Ligue 1","Jonathan David","CAN","FW","24-277",2000,5.1,5,1,0,3,2,2,4,50,2,3,0,3,1,6,0,0,"https://fbref.com/en/players/ce50fd99/Jonathan-David"
2025,"Lille","Ligue 1","Bafodé Diakité","FRA","DF","23-285",2001,7,8,4,5,2,1,6,10,60,4,5,2,3,7,15,16,1,"https://fbref.com/en/players/1bfb6fef/Bafode-Diakite"
2025,"Lille","Ligue 1","Matias Fernandez-Pardo","BEL","FW","19-257",2005,0.5,2,1,1,1,0,2,2,100,0,2,0,2,0,2,1,0,"https://fbref.com/en/players/0cdb6a2a/Matias-Fernandez-Pardo"
2025,"Lille","Ligue 1","André Gomes","POR","MF","31-079",1993,2.2,3,3,1,1,1,1,5,20,4,0,0,0,1,4,0,0,"https://fbref.com/en/players/1961b2aa/Andre-Gomes"
2025,"Lille","Ligue 1","Angel Gomes","ENG","MF","24-047",2000,4.2,3,2,0,2,1,1,5,20,4,0,0,0,0,3,0,0,"https://fbref.com/en/players/645a3363/Angel-Gomes"
2025,"Lille","Ligue 1","Gabriel Gudmundsson","SWE","DF","25-171",1999,5.3,11,8,2,8,1,8,13,61.5,5,6,1,5,2,13,6,1,"https://fbref.com/en/players/d5d22a58/Gabriel-Gudmundsson"
2025,"Lille","Ligue 1","Ismaily","BRA","DF","34-280",1990,0.9,2,0,0,1,1,0,1,0,1,4,0,4,0,2,2,0,"https://fbref.com/en/players/cf182add/Ismaily"
2025,"Lille","Ligue 1","Mohamed Lamine Bayo","GUI","FW","26-135",1998,2.1,0,0,0,0,0,0,0,NA,0,0,0,0,0,0,0,0,"https://fbref.com/en/players/01870104/Mohamed-Lamine-Bayo"
2025,"Lille","Ligue 1","Aïssa Mandi","ALG","DF","32-361",1991,3.5,6,4,1,5,0,3,4,75,1,2,2,0,3,9,5,0,"https://fbref.com/en/players/fbd6378b/Aissa-Mandi"
2025,"Lille","Ligue 1","Ethan Mbappé","FRA","MF,FW","17-293",2006,0.9,1,0,0,1,0,0,2,0,2,4,0,4,0,1,0,0,"https://fbref.com/en/players/d595de71/Ethan-Mbappe"
2025,"Lille","Ligue 1","Thomas Meunier","BEL","DF","33-035",1991,3.7,9,6,5,3,1,5,6,83.3,1,5,2,3,4,13,10,0,"https://fbref.com/en/players/e162b013/Thomas-Meunier"
2025,"Lille","Ligue 1","Ngal'Ayel Mukau","","MF","19-322",2004,1.4,7,5,2,4,1,5,9,55.6,4,2,0,2,2,9,1,0,"https://fbref.com/en/players/bb461b8a/NgalAyel-Mukau"
2025,"Lille","Ligue 1","Alexsandro Ribeiro","BRA","DF","25-069",1999,6,9,8,4,4,1,8,11,72.7,3,1,0,1,6,15,25,0,"https://fbref.com/en/players/102c9665/Alexsandro-Ribeiro"
2025,"Lille","Ligue 1","Osame Sahraoui","MAR","MF,FW","23-128",2001,4.7,4,3,2,1,1,1,4,25,3,6,0,6,3,7,3,1,"https://fbref.com/en/players/6f9fa232/Osame-Sahraoui"
2025,"Lille","Ligue 1","Tiago Santos","POR","DF","22-086",2002,4.5,12,7,4,5,3,6,9,66.7,3,2,0,2,2,14,4,0,"https://fbref.com/en/players/3eeebc87/Tiago-Santos"
2025,"Lille","Ligue 1","Edon Zhegrova","KVX","FW,MF","25-200",1999,4.8,2,1,1,0,1,1,2,50,1,2,0,2,2,4,0,0,"https://fbref.com/en/players/34a88e3e/Edon-Zhegrova"
2025,"Liverpool","Premier League","Trent Alexander-Arnold","ENG","DF","26-010",1998,6.5,17,11,9,6,2,11,18,61.1,7,5,1,4,5,22,5,0,"https://fbref.com/en/players/cd1acf9d/Trent-Alexander-Arnold"
2025,"Liverpool","Premier League","Alisson","BRA","GK","32-015",1992,5.9,0,0,0,0,0,0,0,NA,0,0,0,0,0,0,2,0,"https://fbref.com/en/players/7a2e46a8/Alisson"
2025,"Liverpool","Premier League","Conor Bradley","NIR","DF","21-100",2003,0.9,0,0,0,0,0,0,1,0,1,0,0,0,2,2,5,0,"https://fbref.com/en/players/bbd67769/Conor-Bradley"
2025,"Liverpool","Premier League","Federico Chiesa","ITA","FW","26-358",1997,0.2,0,0,0,0,0,0,0,NA,0,0,0,0,0,0,0,0,"https://fbref.com/en/players/b0f7e36c/Federico-Chiesa"
2025,"Liverpool","Premier League","Luis Díaz","COL","FW","27-278",1997,5,7,5,4,3,0,4,9,44.4,5,5,0,5,2,9,3,0,"https://fbref.com/en/players/4a1a9578/Luis-Diaz"
2025,"Liverpool","Premier League","Harvey Elliott","ENG","FW","21-196",2003,0.1,0,0,0,0,0,0,0,NA,0,0,0,0,0,0,0,0,"https://fbref.com/en/players/b9e1436c/Harvey-Elliott"
2025,"Liverpool","Premier League","Wataru Endo","JPN","MF","31-251",1993,0,0,0,0,0,0,0,0,NA,0,1,0,1,0,0,0,0,"https://fbref.com/en/players/c149016b/Wataru-Endo"
2025,"Liverpool","Premier League","Cody Gakpo","NED","FW","25-163",1999,2.4,6,4,4,2,0,3,4,75,1,2,0,2,3,9,4,0,"https://fbref.com/en/players/1971591f/Cody-Gakpo"
2025,"Liverpool","Premier League","Joe Gomez","ENG","DF","27-147",1997,0,1,1,0,1,0,1,2,50,1,1,0,1,0,1,1,0,"https://fbref.com/en/players/7a11550b/Joe-Gomez"
2025,"Liverpool","Premier League","Ryan Gravenberch","NED","MF","22-154",2002,7,15,12,4,6,5,8,12,66.7,4,9,1,8,12,27,5,0,"https://fbref.com/en/players/b8e740fb/Ryan-Gravenberch"
2025,"Liverpool","Premier League","Vitezslav Jaros","CZE","GK","23-086",2001,0.1,0,0,0,0,0,0,0,NA,0,0,0,0,0,0,0,0,"https://fbref.com/en/players/12bb4d6a/Vitezslav-Jaros"
2025,"Liverpool","Premier League","Curtis Jones","ENG","MF","23-261",2001,1.7,3,0,1,2,0,3,3,100,0,3,2,1,0,3,3,0,"https://fbref.com/en/players/4fb9c88f/Curtis-Jones"
2025,"Liverpool","Premier League","Diogo Jota","POR","FW","27-318",1996,5.1,3,1,0,2,1,2,6,33.3,4,1,0,1,3,6,3,0,"https://fbref.com/en/players/178ae8f8/Diogo-Jota"
2025,"Liverpool","Premier League","Caoimhín Kelleher","IRL","GK","25-329",1998,1,0,0,0,0,0,0,0,NA,0,0,0,0,0,0,0,1,"https://fbref.com/en/players/62d7ef38/Caoimhin-Kelleher"
2025,"Liverpool","Premier League","Ibrahima Konaté","FRA","DF","25-145",1999,6.3,8,5,5,2,1,6,6,100,0,10,5,5,3,11,28,1,"https://fbref.com/en/players/5ed9b537/Ibrahima-Konate"
2025,"Liverpool","Premier League","Alexis Mac Allister","ARG","MF","25-298",1998,6.2,18,13,6,11,1,11,24,45.8,13,17,0,17,3,21,7,0,"https://fbref.com/en/players/83d074ff/Alexis-Mac-Allister"
2025,"Liverpool","Premier League","Darwin Núñez","URU","FW","25-115",1999,1.5,6,4,3,1,2,2,3,66.7,1,0,0,0,0,6,3,0,"https://fbref.com/en/players/4d77b365/Darwin-Nunez"
2025,"Liverpool","Premier League","Jarell Quansah","ENG","DF","21-262",2003,0.5,2,2,1,1,0,0,0,NA,0,1,1,0,1,3,3,0,"https://fbref.com/en/players/4125cb98/Jarell-Quansah"
2025,"Liverpool","Premier League","Andrew Robertson","SCO","DF","30-220",1994,5.7,5,3,3,1,1,3,6,50,3,1,0,1,3,8,3,0,"https://fbref.com/en/players/2e4f5f03/Andrew-Robertson"
2025,"Liverpool","Premier League","Mohamed Salah","EGY","FW","32-124",1992,6.7,4,4,1,1,2,2,3,66.7,1,1,0,1,1,5,4,0,"https://fbref.com/en/players/e342ad68/Mohamed-Salah"
2025,"Liverpool","Premier League","Dominik Szoboszlai","HUN","MF","23-358",2000,6,4,0,1,2,1,1,2,50,1,10,1,9,2,6,4,0,"https://fbref.com/en/players/934e1968/Dominik-Szoboszlai"
2025,"Liverpool","Premier League","Kostas Tsimikas","GRE","DF","28-158",1996,1.3,3,2,1,1,1,1,3,33.3,2,2,0,2,2,5,2,0,"https://fbref.com/en/players/f315ca93/Kostas-Tsimikas"
2025,"Liverpool","Premier League","Virgil van Dijk","NED","DF","33-101",1991,7,3,1,3,0,0,1,2,50,1,2,0,2,17,20,39,1,"https://fbref.com/en/players/e06683ca/Virgil-van-Dijk"
2025,"Lyon","Ligue 1","Abner","BRA","DF","24-143",2000,5.2,13,8,5,6,2,10,14,71.4,4,8,1,7,5,18,12,0,"https://fbref.com/en/players/7f9c5d2d/Abner"
2025,"Lyon","Ligue 1","Adryelson","BRA","DF","26-208",1998,0,0,0,0,0,0,0,0,NA,0,0,0,0,1,1,1,0,"https://fbref.com/en/players/e980e78d/Adryelson"
2025,"Lyon","Ligue 1","Saïd Benrahma","ALG","FW,MF","29-068",1995,3.8,3,2,1,1,1,2,5,40,3,4,0,4,1,4,0,0,"https://fbref.com/en/players/5a04fd92/Said-Benrahma"
2025,"Lyon","Ligue 1","Duje Ćaleta-Car","CRO","DF","28-030",1996,7,8,3,5,3,0,2,4,50,2,9,8,1,11,19,36,0,"https://fbref.com/en/players/94f8d10c/Duje-Caleta-Car"
2025,"Lyon","Ligue 1","Maxence Caqueret","FRA","MF","24-245",2000,5.3,18,9,5,9,4,3,18,16.7,15,11,2,9,6,24,1,0,"https://fbref.com/en/players/f81ef10d/Maxence-Caqueret"
2025,"Lyon","Ligue 1","Rayan Cherki","FRA","MF","21-061",2003,1.2,0,0,0,0,0,0,1,0,1,1,0,1,0,0,1,0,"https://fbref.com/en/players/b34c63a5/Rayan-Cherki"
2025,"Lyon","Ligue 1","Mahamadou Diawara","FRA","MF","19-243",2005,0.2,1,0,0,1,0,1,3,33.3,2,2,0,2,0,1,0,0,"https://fbref.com/en/players/1906b842/Mahamadou-Diawara"
2025,"Lyon","Ligue 1","Malick Fofana","BEL","FW,DF","19-200",2005,2.9,5,3,2,3,0,3,3,100,0,0,0,0,1,6,3,0,"https://fbref.com/en/players/8236f673/Malick-Fofana"
2025,"Lyon","Ligue 1","Sael Kumbedi","FRA","DF","19-205",2005,1,4,2,1,2,1,3,4,75,1,0,0,0,2,6,3,0,"https://fbref.com/en/players/c385bf49/Sael-Kumbedi"
2025,"Lyon","Ligue 1","Alexandre Lacazette","FRA","FW","33-142",1991,4.9,2,1,1,1,0,2,5,40,3,1,0,1,0,2,1,0,"https://fbref.com/en/players/9dbb75ca/Alexandre-Lacazette"
2025,"Lyon","Ligue 1","Ainsley Maitland-Niles","ENG","DF,MF","27-049",1997,5.1,23,15,8,9,6,16,20,80,4,6,1,5,11,34,10,2,"https://fbref.com/en/players/e3a5814e/Ainsley-Maitland-Niles"
2025,"Lyon","Ligue 1","Orel Mangala","BEL","MF","26-213",1998,0.7,1,0,0,0,1,0,1,0,1,2,0,2,0,1,1,0,"https://fbref.com/en/players/a572e291/Orel-Mangala"
2025,"Lyon","Ligue 1","Clinton Mata","ANG","DF","31-345",1992,6,11,6,5,5,1,8,8,100,0,6,3,3,11,22,11,2,"https://fbref.com/en/players/55abe554/Clinton-Mata"
2025,"Lyon","Ligue 1","Nemanja Matić","SRB","MF","36-077",1988,4,8,7,2,5,1,3,8,37.5,5,4,1,3,2,10,4,0,"https://fbref.com/en/players/eb7822d7/Nemanja-Matic"
2025,"Lyon","Ligue 1","Georges Mikautadze","GEO","FW","23-352",2000,3.9,3,2,1,1,1,1,1,100,0,2,0,2,1,4,0,0,"https://fbref.com/en/players/4788cb6b/Georges-Mikautadze"
2025,"Lyon","Ligue 1","Moussa Niakhate","SEN","DF","28-223",1996,5,17,10,15,2,0,8,9,88.9,1,6,3,3,2,19,22,1,"https://fbref.com/en/players/00242715/Moussa-Niakhate"
2025,"Lyon","Ligue 1","Ernest Nuamah","GHA","FW,DF","20-351",2003,1.5,2,1,1,0,1,1,2,50,1,0,0,0,1,3,2,0,"https://fbref.com/en/players/234a703c/Ernest-Nuamah"
2025,"Lyon","Ligue 1","Gift Orban","NGA","FW,DF","22-092",2002,2.1,0,0,0,0,0,0,1,0,1,0,0,0,0,0,0,0,"https://fbref.com/en/players/de17db90/Gift-Orban"
2025,"Lyon","Ligue 1","Lucas Perri","BRA","GK","26-312",1997,7,0,0,0,0,0,0,1,0,1,0,0,0,0,0,5,1,"https://fbref.com/en/players/5dbd461a/Lucas-Perri"
2025,"Lyon","Ligue 1","Mama Samba Baldé","GNB","FW","28-346",1995,0.4,2,2,0,2,0,0,0,NA,0,0,0,0,1,3,1,0,"https://fbref.com/en/players/fb14aa28/Mama-Samba-Balde"
2025,"Lyon","Ligue 1","Nicolás Tagliafico","ARG","DF","32-047",1992,2,3,1,1,1,1,2,5,40,3,3,2,1,4,7,2,0,"https://fbref.com/en/players/f0661424/Nicolas-Tagliafico"
2025,"Lyon","Ligue 1","Tanner Tessmann","USA","MF","23-023",2001,1,4,2,3,1,0,0,1,0,1,0,0,0,4,8,4,0,"https://fbref.com/en/players/ac277993/Tanner-Tessmann"
2025,"Lyon","Ligue 1","Corentin Tolisso","FRA","MF","30-075",1994,3.8,5,4,2,1,2,3,7,42.9,4,10,1,9,2,7,7,0,"https://fbref.com/en/players/652d4c37/Corentin-Tolisso"
2025,"Lyon","Ligue 1","Jordan Veretout","FRA","MF","31-230",1993,2.6,3,2,0,2,1,1,3,33.3,2,3,1,2,0,3,3,0,"https://fbref.com/en/players/4a56052c/Jordan-Veretout"
2025,"Lyon","Ligue 1","Wilfried Zaha","CIV","FW","31-342",1992,0.6,1,1,1,0,0,1,2,50,1,2,0,2,0,1,0,0,"https://fbref.com/en/players/b2bc3b1f/Wilfried-Zaha"
2025,"Mainz 05","Bundesliga","Nadiem Amiri","GER","MF","27-356",1996,4.2,6,1,3,3,0,1,7,14.3,6,5,2,3,2,8,8,0,"https://fbref.com/en/players/555d5edd/Nadiem-Amiri"
2025,"Mainz 05","Bundesliga","Aymen Barkok","MAR","MF","26-149",1998,0.8,2,1,1,1,0,1,1,100,0,1,1,0,2,4,0,0,"https://fbref.com/en/players/a2a85828/Aymen-Barkok"
2025,"Mainz 05","Bundesliga","Stefan Bell","GER","DF","33-054",1991,1.8,4,2,3,1,0,0,2,0,2,1,1,0,5,9,12,0,"https://fbref.com/en/players/857a5abe/Stefan-Bell"
2025,"Mainz 05","Bundesliga","Jonathan Burkardt","GER","FW,MF","24-098",2000,6,0,0,0,0,0,0,2,0,2,2,1,1,0,0,7,0,"https://fbref.com/en/players/05f99a4a/Jonathan-Burkardt"
2025,"Mainz 05","Bundesliga","Anthony Caci","FRA","DF","27-108",1997,5.2,7,4,2,3,2,3,5,60,2,7,2,5,6,13,17,1,"https://fbref.com/en/players/0118c54c/Anthony-Caci"
2025,"Mainz 05","Bundesliga","Andreas Hanche-Olsen","NOR","DF","27-274",1997,3.3,4,1,1,2,1,0,0,NA,0,7,6,1,3,7,20,1,"https://fbref.com/en/players/2e77d607/Andreas-Hanche-Olsen"
2025,"Mainz 05","Bundesliga","Hong Hyunseok","KOR","MF","25-123",1999,2.5,4,1,2,1,1,0,1,0,1,2,1,1,3,7,5,0,"https://fbref.com/en/players/9a234cc9/Hong-Hyunseok"
2025,"Mainz 05","Bundesliga","Lee Jae-sung","KOR","MF","32-068",1992,4.8,10,7,3,5,2,2,4,50,2,6,1,5,3,13,8,0,"https://fbref.com/en/players/34b0387f/Lee-Jae-sung"
2025,"Mainz 05","Bundesliga","Moritz Jenz","GER","DF","25-170",1999,4,6,1,4,2,0,0,3,0,3,6,6,0,3,9,32,0,"https://fbref.com/en/players/ee644761/Moritz-Jenz"
2025,"Mainz 05","Bundesliga","Dominik Kohr","GER","DF,MF","30-260",1994,5.8,19,14,12,4,3,12,17,70.6,5,14,8,6,5,24,34,0,"https://fbref.com/en/players/0fbecd11/Dominik-Kohr"
2025,"Mainz 05","Bundesliga","Maxim Leitsch","GER","DF","26-152",1998,3.1,5,1,2,2,1,3,3,100,0,5,2,3,4,9,20,0,"https://fbref.com/en/players/7e12a98d/Maxim-Leitsch"
2025,"Mainz 05","Bundesliga","Phillipp Mwene","AUT","DF","30-262",1994,5.9,13,7,5,7,1,3,6,50,3,6,1,5,7,20,15,0,"https://fbref.com/en/players/2ff76adc/Phillipp-Mwene"
2025,"Mainz 05","Bundesliga","Paul Nebel","GER","DF,MF","22-007",2002,0.7,3,1,2,0,1,2,2,100,0,3,0,3,2,5,3,0,"https://fbref.com/en/players/1b6d8083/Paul-Nebel"
2025,"Mainz 05","Bundesliga","Karim Onisiwo","AUT","MF,FW","32-214",1992,1,0,0,0,0,0,0,0,NA,0,0,0,0,0,0,0,0,"https://fbref.com/en/players/f26834c7/Karim-Onisiwo"
2025,"Mainz 05","Bundesliga","Kaishu Sano","JPN","MF","23-292",2000,5.8,11,8,5,5,1,4,11,36.4,7,12,3,9,5,16,8,0,"https://fbref.com/en/players/7a7a6361/Kaishu-Sano"
2025,"Mainz 05","Bundesliga","Armindo Sieb","GER","MF,FW","21-243",2003,2.2,2,1,0,2,0,1,2,50,1,1,0,1,1,3,2,0,"https://fbref.com/en/players/228c1d94/Armindo-Sieb"
2025,"Mainz 05","Bundesliga","Nikolas Veratschnig","AUT","MF","21-267",2003,0,0,0,0,0,0,0,0,NA,0,0,0,0,0,0,0,0,"https://fbref.com/en/players/13496b77/Nikolas-Veratschnig"
2025,"Mainz 05","Bundesliga","Nelson Weiper","GER","FW,MF","19-214",2005,0.2,0,0,0,0,0,0,0,NA,0,1,0,1,0,0,0,0,"https://fbref.com/en/players/231c67ff/Nelson-Weiper"
2025,"Mainz 05","Bundesliga","Silvan Widmer","SUI","DF","31-226",1993,1.2,2,2,1,1,0,2,3,66.7,1,1,0,1,1,3,4,0,"https://fbref.com/en/players/f68b64fc/Silvan-Widmer"
2025,"Mainz 05","Bundesliga","Robin Zentner","GER","GK","29-355",1994,6,0,0,0,0,0,0,0,NA,0,0,0,0,0,0,10,1,"https://fbref.com/en/players/5c4bf6ba/Robin-Zentner"
2025,"Mallorca","La Liga","Takuma Asano","JPN","FW","29-342",1994,3.5,5,3,1,3,1,2,3,66.7,1,3,0,3,2,7,4,0,"https://fbref.com/en/players/13ddc856/Takuma-Asano"
2025,"Mallorca","La Liga","Chiquinho","POR","MF,FW","24-255",2000,0.7,1,0,0,1,0,0,5,0,5,1,0,1,0,1,0,0,"https://fbref.com/en/players/dc6c2f02/Chiquinho"
2025,"Mallorca","La Liga","Copete","ESP","DF","25-007",1999,3.4,7,5,7,0,0,3,3,100,0,3,1,2,2,9,27,0,"https://fbref.com/en/players/0f26ffd7/Copete"
2025,"Mallorca","La Liga","Samu Costa","POR","MF","23-325",2000,9,27,14,16,10,1,11,22,50,11,10,3,7,8,35,31,0,"https://fbref.com/en/players/76c2a023/Samu-Costa"
2025,"Mallorca","La Liga","Sergi Darder","ESP","MF,FW","30-300",1993,6.6,11,6,5,2,4,1,9,11.1,8,1,0,1,2,13,5,1,"https://fbref.com/en/players/070a3904/Sergi-Darder"
2025,"Mallorca","La Liga","Marc Domenech","ESP","FW","18-290",2006,1.3,0,0,0,0,0,0,2,0,2,2,0,2,0,0,0,0,"https://fbref.com/en/players/54880c9b/Marc-Domenech"
2025,"Mallorca","La Liga","Valery Fernández","ESP","MF,FW","24-329",1999,1.2,3,3,1,0,2,2,4,50,2,2,1,1,0,3,1,0,"https://fbref.com/en/players/4acd733a/Valery-Fernandez"
2025,"Mallorca","La Liga","Dominik Greif","SVK","GK","27-194",1997,6,0,0,0,0,0,0,0,NA,0,0,0,0,0,0,1,1,"https://fbref.com/en/players/30061f53/Dominik-Greif"
2025,"Mallorca","La Liga","Cyle Larin","CAN","FW","29-183",1995,4.6,2,2,1,1,0,0,2,0,2,4,0,4,1,3,3,0,"https://fbref.com/en/players/e7af9060/Cyle-Larin"
2025,"Mallorca","La Liga","Toni Lato","ESP","DF","26-331",1997,1.9,5,4,1,0,4,1,3,33.3,2,2,0,2,2,7,7,0,"https://fbref.com/en/players/8e088e04/Toni-Lato"
2025,"Mallorca","La Liga","Pablo Maffeo","ESP","DF","27-097",1997,5.4,13,7,7,5,1,7,10,70,3,8,2,6,4,17,16,0,"https://fbref.com/en/players/5db04597/Pablo-Maffeo"
2025,"Mallorca","La Liga","Omar Mascarell","EQG","MF","31-258",1993,5.1,10,4,6,4,0,5,10,50,5,8,5,3,8,18,19,1,"https://fbref.com/en/players/11fd2b75/Omar-Mascarell"
2025,"Mallorca","La Liga","Johan Mojica","COL","DF","32-057",1992,7.1,10,6,8,1,1,6,10,60,4,3,1,2,7,17,21,0,"https://fbref.com/en/players/608f2092/Johan-Mojica"
2025,"Mallorca","La Liga","Manu Morlanes","ESP","MF","25-279",1999,3.9,5,4,2,3,0,3,5,60,2,6,3,3,10,15,5,0,"https://fbref.com/en/players/a0255c67/Manu-Morlanes"
2025,"Mallorca","La Liga","Vedat Muriqi","KVX","FW","30-176",1994,5.2,0,0,0,0,0,0,0,NA,0,0,0,0,3,3,12,0,"https://fbref.com/en/players/0cadc46d/Vedat-Muriqi"
2025,"Mallorca","La Liga","Roberto Navarro","ESP","MF,FW","22-188",2002,3.9,6,5,3,1,2,1,5,20,4,7,0,7,6,12,3,0,"https://fbref.com/en/players/c997b942/Roberto-Navarro"
2025,"Mallorca","La Liga","Abdón Prats","ESP","FW,MF","31-315",1992,1.5,1,1,1,0,0,0,0,NA,0,1,0,1,0,1,2,0,"https://fbref.com/en/players/d1b060e2/Abdon-Prats"
2025,"Mallorca","La Liga","Antonio Raillo","ESP","DF","33-009",1991,9,9,5,4,3,2,4,5,80,1,11,10,1,13,22,45,0,"https://fbref.com/en/players/b857bd29/Antonio-Raillo"
2025,"Mallorca","La Liga","Dani Rodríguez","ESP","FW,MF","36-133",1988,6.1,14,12,6,5,3,6,7,85.7,1,3,0,3,2,16,6,0,"https://fbref.com/en/players/70f8e0bd/Dani-Rodriguez"
2025,"Mallorca","La Liga","Leo Román","ESP","GK","24-103",2000,3,0,0,0,0,0,0,0,NA,0,0,0,0,0,0,0,0,"https://fbref.com/en/players/924ff27e/Leo-Roman"
2025,"Mallorca","La Liga","Antonio Sánchez","ESP","DF,FW","27-290",1997,4.7,12,8,9,2,1,7,10,70,3,5,0,5,5,17,15,0,"https://fbref.com/en/players/a254bbe0/Antonio-Sanchez"
2025,"Mallorca","La Liga","Martin Valjent","SVK","DF","28-311",1995,5.8,4,2,4,0,0,1,1,100,0,6,2,4,4,8,32,0,"https://fbref.com/en/players/f2c6ac01/Martin-Valjent"
2025,"Manchester City","Premier League","Manuel Akanji","SUI","DF","29-090",1995,6.7,5,3,2,1,2,3,6,50,3,4,2,2,3,8,20,0,"https://fbref.com/en/players/89ac64a6/Manuel-Akanji"
2025,"Manchester City","Premier League","Nathan Aké","NED","DF","29-242",1995,0,1,1,1,0,0,1,1,100,0,0,0,0,1,2,0,0,"https://fbref.com/en/players/eaeca114/Nathan-Ake"
2025,"Manchester City","Premier League","Kevin De Bruyne","BEL","MF","33-111",1991,4,2,1,2,0,0,0,3,0,3,2,0,2,2,4,0,0,"https://fbref.com/en/players/e46012d4/Kevin-De-Bruyne"
2025,"Manchester City","Premier League","Rúben Dias","POR","DF","27-156",1997,6.1,5,3,1,3,1,2,3,66.7,1,4,3,1,9,14,18,1,"https://fbref.com/en/players/31c69ef1/Ruben-Dias"
2025,"Manchester City","Premier League","Jeremy Doku","BEL","FW","22-143",2002,3.7,5,2,2,1,2,1,3,33.3,2,3,0,3,0,5,1,0,"https://fbref.com/en/players/fffea3e5/Jeremy-Doku"
2025,"Manchester City","Premier League","Ederson","BRA","GK","31-061",1993,7,0,0,0,0,0,0,0,NA,0,0,0,0,1,1,2,1,"https://fbref.com/en/players/3bb7b8b4/Ederson"
2025,"Manchester City","Premier League","Phil Foden","ENG","MF,FW","24-142",2000,1.9,0,0,0,0,0,0,1,0,1,2,1,1,2,2,2,0,"https://fbref.com/en/players/ed1e53f3/Phil-Foden"
2025,"Manchester City","Premier League","Jack Grealish","ENG","FW,MF","29-037",1995,3.6,5,2,3,0,2,1,3,33.3,2,5,1,4,0,5,3,0,"https://fbref.com/en/players/b0b4fd3e/Jack-Grealish"
2025,"Manchester City","Premier League","İlkay Gündoğan","GER","MF","33-359",1990,4.2,4,2,1,2,1,2,6,33.3,4,0,0,0,2,6,7,0,"https://fbref.com/en/players/819b3158/Ilkay-Gundogan"
2025,"Manchester City","Premier League","Joško Gvardiol","CRO","DF","22-268",2002,6.5,14,9,8,4,2,8,10,80,2,7,2,5,10,24,17,0,"https://fbref.com/en/players/5ad50391/Josko-Gvardiol"
2025,"Manchester City","Premier League","Erling Haaland","NOR","FW","24-088",2000,7,2,2,0,1,1,1,1,100,0,2,0,2,1,3,6,0,"https://fbref.com/en/players/1f44ac21/Erling-Haaland"
2025,"Manchester City","Premier League","Mateo Kovačić","CRO","MF","30-164",1994,5.8,15,11,5,8,2,5,14,35.7,9,6,0,6,2,17,5,0,"https://fbref.com/en/players/79c0821a/Mateo-Kovacic"
2025,"Manchester City","Premier League","Rico Lewis","ENG","MF,DF","19-331",2004,5.4,13,5,6,6,1,5,6,83.3,1,8,2,6,4,17,14,1,"https://fbref.com/en/players/b57e066e/Rico-Lewis"
2025,"Manchester City","Premier League","James Mcatee","ENG","FW","21-365",2002,0,0,0,0,0,0,0,0,NA,0,1,0,1,0,0,0,0,"https://fbref.com/en/players/96593e89/James-Mcatee"
2025,"Manchester City","Premier League","Matheus Nunes","POR","FW,MF","26-051",1998,0.3,0,0,0,0,0,0,0,NA,0,2,1,1,0,0,1,0,"https://fbref.com/en/players/e6af02e0/Matheus-Nunes"
2025,"Manchester City","Premier League","Rodri","ESP","MF","28-117",1996,0.7,2,1,1,1,0,0,0,NA,0,1,0,1,1,3,0,0,"https://fbref.com/en/players/6434f10d/Rodri"
2025,"Manchester City","Premier League","Sávio","BRA","FW","20-190",2004,3.2,8,5,3,1,4,2,3,66.7,1,2,0,2,0,8,1,1,"https://fbref.com/en/players/fe6e7156/Savio"
2025,"Manchester City","Premier League","Bernardo Silva","POR","MF,FW","30-068",1994,6.1,5,4,0,3,2,1,5,20,4,5,1,4,2,7,2,1,"https://fbref.com/en/players/3eb22ec9/Bernardo-Silva"
2025,"Manchester City","Premier League","John Stones","ENG","DF,MF","30-142",1994,1.7,2,2,0,2,0,1,1,100,0,1,0,1,1,3,6,1,"https://fbref.com/en/players/5eecec3d/John-Stones"
2025,"Manchester City","Premier League","Kyle Walker","ENG","DF","34-142",1990,3.2,4,2,1,2,1,3,6,50,3,2,2,0,1,5,4,0,"https://fbref.com/en/players/86dd77d1/Kyle-Walker"
2025,"Manchester Utd","Premier League","Antony","BRA","FW","24-236",2000,0.3,2,0,2,0,0,1,3,33.3,2,1,0,1,1,3,0,0,"https://fbref.com/en/players/99127249/Antony"
2025,"Manchester Utd","Premier League","Casemiro","BRA","MF","32-237",1992,3.1,13,9,6,4,3,6,10,60,4,8,2,6,1,14,6,2,"https://fbref.com/en/players/4d224fe8/Casemiro"
2025,"Manchester Utd","Premier League","Toby Collyer","ENG","MF","20-288",2004,0.5,4,3,1,3,0,2,2,100,0,0,0,0,0,4,1,0,"https://fbref.com/en/players/4f9091bc/Toby-Collyer"
2025,"Manchester Utd","Premier League","Diogo Dalot","POR","DF","25-213",1999,7,15,12,6,7,2,7,9,77.8,2,6,4,2,15,30,14,0,"https://fbref.com/en/players/d9565625/Diogo-Dalot"
2025,"Manchester Utd","Premier League","Amad Diallo","CIV","FW","22-098",2002,3.8,12,8,4,5,3,7,8,87.5,1,2,0,2,2,14,1,0,"https://fbref.com/en/players/9dc96f10/Amad-Diallo"
2025,"Manchester Utd","Premier League","Christian Eriksen","DEN","MF","32-246",1992,2.9,4,0,0,3,1,4,7,57.1,3,2,1,1,1,5,1,0,"https://fbref.com/en/players/980522ec/Christian-Eriksen"
2025,"Manchester Utd","Premier League","Jonny Evans","NIR","DF","36-288",1988,1.3,5,4,3,2,0,1,1,100,0,2,1,1,1,6,4,0,"https://fbref.com/en/players/f8fcd2a5/Jonny-Evans"
2025,"Manchester Utd","Premier League","Bruno Fernandes","POR","MF,FW","30-039",1994,6.3,15,10,1,11,3,5,13,38.5,8,8,1,7,6,21,5,0,"https://fbref.com/en/players/507c7bdf/Bruno-Fernandes"
2025,"Manchester Utd","Premier League","Alejandro Garnacho","ARG","FW","20-108",2004,4.6,7,6,3,2,2,2,3,66.7,1,2,0,2,3,10,4,0,"https://fbref.com/en/players/7aa8adfe/Alejandro-Garnacho"
2025,"Manchester Utd","Premier League","Rasmus Højlund","DEN","FW","21-256",2003,1.1,0,0,0,0,0,0,0,NA,0,2,0,2,0,0,0,0,"https://fbref.com/en/players/491a433d/Rasmus-Hojlund"
2025,"Manchester Utd","Premier League","Matthijs de Ligt","NED","DF","25-066",1999,4.5,8,3,6,2,0,5,7,71.4,2,7,5,2,7,15,15,0,"https://fbref.com/en/players/d6e53a3a/Matthijs-de-Ligt"
2025,"Manchester Utd","Premier League","Victor Lindelöf","SWE","DF","30-092",1994,0.5,3,0,3,0,0,1,1,100,0,1,0,1,1,4,3,0,"https://fbref.com/en/players/f5deef4c/Victor-Lindelof"
2025,"Manchester Utd","Premier League","Harry Maguire","ENG","DF","31-226",1993,2.7,2,1,2,0,0,2,2,100,0,2,2,0,6,8,10,0,"https://fbref.com/en/players/d8931174/Harry-Maguire"
2025,"Manchester Utd","Premier League","Kobbie Mainoo","ENG","MF","19-181",2005,6.3,16,13,12,3,1,10,15,66.7,5,5,1,4,14,30,2,1,"https://fbref.com/en/players/c6220452/Kobbie-Mainoo"
2025,"Manchester Utd","Premier League","Lisandro Martínez","ARG","DF","26-273",1998,5.8,9,6,8,0,1,5,11,45.5,6,5,2,3,17,26,14,1,"https://fbref.com/en/players/bac46a10/Lisandro-Martinez"
2025,"Manchester Utd","Premier League","Noussair Mazraoui","MAR","DF","26-338",1997,6.2,21,10,12,5,4,12,16,75,4,5,0,5,8,29,16,0,"https://fbref.com/en/players/b74277a0/Noussair-Mazraoui"
2025,"Manchester Utd","Premier League","Scott McTominay","SCO","MF","27-314",1996,0.2,0,0,0,0,0,0,1,0,1,0,0,0,0,0,1,0,"https://fbref.com/en/players/d93c2511/Scott-McTominay"
2025,"Manchester Utd","Premier League","Mason Mount","ENG","MF,FW","25-281",1999,1.6,5,1,2,3,0,4,5,80,1,3,0,3,0,5,0,0,"https://fbref.com/en/players/9674002f/Mason-Mount"
2025,"Manchester Utd","Premier League","André Onana","CMR","GK","28-198",1996,7,1,1,1,0,0,1,1,100,0,0,0,0,0,1,4,0,"https://fbref.com/en/players/e9c0c1b2/Andre-Onana"
2025,"Manchester Utd","Premier League","Marcus Rashford","ENG","FW","26-352",1997,5.3,4,2,1,1,2,2,6,33.3,4,4,0,4,3,7,3,0,"https://fbref.com/en/players/a1d5bd30/Marcus-Rashford"
2025,"Manchester Utd","Premier League","Manuel Ugarte Ribeiro","URU","MF","23-189",2001,1.2,8,4,1,5,2,1,1,100,0,0,0,0,0,8,3,0,"https://fbref.com/en/players/c9817014/Manuel-Ugarte-Ribeiro"
2025,"Manchester Utd","Premier League","Joshua Zirkzee","NED","FW","23-148",2001,4.2,2,0,2,0,0,2,2,100,0,6,2,4,2,4,1,0,"https://fbref.com/en/players/028e70b9/Joshua-Zirkzee"
2025,"Marseille","Ligue 1","Keyliane Abdallah","FRA","FW","18-195",2006,0,1,1,1,0,0,1,1,100,0,0,0,0,0,1,0,0,"https://fbref.com/en/players/7310786d/Keyliane-Abdallah"
2025,"Marseille","Ligue 1","Michael Amir Murillo","PAN","DF","28-249",1996,7,17,10,8,6,3,10,17,58.8,7,4,3,1,5,22,17,0,"https://fbref.com/en/players/349cae8f/Michael-Amir-Murillo"
2025,"Marseille","Ligue 1","Leonardo Balerdi","ARG","DF","25-265",1999,3,4,4,3,1,0,2,3,66.7,1,4,4,0,3,7,8,1,"https://fbref.com/en/players/7c3ed041/Leonardo-Balerdi"
2025,"Marseille","Ligue 1","Lilian Brassier","FRA","DF","24-350",1999,5,5,4,5,0,0,3,4,75,1,6,2,4,4,9,20,0,"https://fbref.com/en/players/5b146df3/Lilian-Brassier"
2025,"Marseille","Ligue 1","Valentin Carboni","ARG","MF,FW","19-226",2005,1.1,2,2,0,1,1,0,1,0,1,1,0,1,1,3,1,0,"https://fbref.com/en/players/707b98f1/Valentin-Carboni"
2025,"Marseille","Ligue 1","Derek Cornelius","CAN","DF","26-327",1997,4.5,7,5,5,2,0,6,8,75,2,4,1,3,3,10,19,0,"https://fbref.com/en/players/577744b8/Derek-Cornelius"
2025,"Marseille","Ligue 1","Ulisses Garcia","SUI","DF,MF","28-280",1996,1.4,4,3,3,0,1,2,5,40,3,1,0,1,0,4,6,0,"https://fbref.com/en/players/c952f633/Ulisses-Garcia"
2025,"Marseille","Ligue 1","Mason Greenwood","ENG","FW","23-016",2001,6.9,6,3,3,2,1,4,9,44.4,5,1,0,1,1,7,5,0,"https://fbref.com/en/players/58eee997/Mason-Greenwood"
2025,"Marseille","Ligue 1","Amine Harit","MAR","MF","27-121",1997,4.2,3,3,0,3,0,0,1,0,1,5,0,5,3,6,1,1,"https://fbref.com/en/players/e7d59f4f/Amine-Harit"
2025,"Marseille","Ligue 1","Luis Henrique","BRA","FW","22-308",2001,5.9,2,2,1,1,0,2,2,100,0,4,2,2,1,3,4,0,"https://fbref.com/en/players/f36d5624/Luis-Henrique"
2025,"Marseille","Ligue 1","Pierre Højbjerg","DEN","MF,DF","29-073",1995,6.9,17,12,14,3,0,15,26,57.7,11,11,3,8,15,32,15,1,"https://fbref.com/en/players/8b04d6c1/Pierre-Hojbjerg"
2025,"Marseille","Ligue 1","Geoffrey Kondogbia","CTA","MF,DF","31-245",1993,5.9,18,10,11,7,0,12,12,100,0,2,0,2,7,25,17,0,"https://fbref.com/en/players/cce181df/Geoffrey-Kondogbia"
2025,"Marseille","Ligue 1","Ismaël Koné","CAN","MF","22-133",2002,1.6,3,1,2,1,0,1,2,50,1,4,1,3,2,5,1,0,"https://fbref.com/en/players/e0220b70/Ismael-Kone"
2025,"Marseille","Ligue 1","Pol Lirola","ESP","DF,FW","27-065",1997,1.5,3,2,1,2,0,1,3,33.3,2,0,0,0,0,3,2,0,"https://fbref.com/en/players/ff800ed8/Pol-Lirola"
2025,"Marseille","Ligue 1","Neal Maupay","FRA","FW","28-064",1996,1.7,1,0,1,0,0,0,0,NA,0,1,0,1,0,1,0,0,"https://fbref.com/en/players/4bcf39f6/Neal-Maupay"
2025,"Marseille","Ligue 1","Bamo Meïté","CIV","DF,MF","22-319",2001,0.3,0,0,0,0,0,0,0,NA,0,0,0,0,0,0,1,0,"https://fbref.com/en/players/04ac78d2/Bamo-Meite"
2025,"Marseille","Ligue 1","Quentin Merlin","FRA","DF,MF","22-154",2002,3,2,1,1,0,1,1,3,33.3,2,1,1,0,2,4,3,0,"https://fbref.com/en/players/0bfca6a1/Quentin-Merlin"
2025,"Marseille","Ligue 1","Faris Pemi Moumbagna","CMR","FW","24-108",2000,0.1,0,0,0,0,0,0,0,NA,0,0,0,0,0,0,0,0,"https://fbref.com/en/players/58aae0a9/Faris-Pemi-Moumbagna"
2025,"Marseille","Ligue 1","Adrien Rabiot","FRA","MF,DF","29-197",1995,0.6,1,0,1,0,0,0,0,NA,0,0,0,0,1,2,2,0,"https://fbref.com/en/players/8794e251/Adrien-Rabiot"
2025,"Marseille","Ligue 1","Valentin Rongier","FRA","DF,MF","29-315",1994,1.8,6,3,4,2,0,1,4,25,3,4,1,3,2,8,7,0,"https://fbref.com/en/players/ed45c4a5/Valentin-Rongier"
2025,"Marseille","Ligue 1","Jon Rowe","ENG","FW,MF","21-170",2003,1.7,6,6,0,2,4,4,6,66.7,2,1,1,0,0,6,0,0,"https://fbref.com/en/players/8c12f884/Jon-Rowe"
2025,"Marseille","Ligue 1","Gerónimo Rulli","ARG","GK","32-150",1992,7,0,0,0,0,0,0,2,0,2,0,0,0,0,0,6,1,"https://fbref.com/en/players/625c144a/Geronimo-Rulli"
2025,"Marseille","Ligue 1","Enzo Sternal","FRA","FW","17-142",2007,0.1,0,0,0,0,0,0,0,NA,0,0,0,0,0,0,0,0,"https://fbref.com/en/players/c2e3ceb7/Enzo-Sternal"
2025,"Marseille","Ligue 1","Elye Wahi","FRA","FW","21-289",2003,3.8,0,0,0,0,0,0,2,0,2,0,0,0,1,1,0,0,"https://fbref.com/en/players/0d7b6576/Elye-Wahi"
2025,"Milan","Serie A","Tammy Abraham","ENG","FW","27-015",1997,3.9,4,1,0,4,0,0,0,NA,0,3,0,3,1,5,3,0,"https://fbref.com/en/players/f586779e/Tammy-Abraham"
2025,"Milan","Serie A","Davide Bartesaghi","ITA","DF","18-293",2005,0.1,0,0,0,0,0,0,0,NA,0,0,0,0,0,0,0,0,"https://fbref.com/en/players/7e0b6c50/Davide-Bartesaghi"
2025,"Milan","Serie A","Ismaël Bennacer","ALG","MF","26-321",1997,0.6,1,1,0,1,0,0,0,NA,0,0,0,0,0,1,0,0,"https://fbref.com/en/players/db092d3b/Ismael-Bennacer"
2025,"Milan","Serie A","Davide Calabria","ITA","DF","27-316",1996,1.6,4,2,4,0,0,3,5,60,2,0,0,0,3,7,4,0,"https://fbref.com/en/players/2146785a/Davide-Calabria"
2025,"Milan","Serie A","Samuel Chukwueze","NGA","FW","25-148",1999,2.1,3,2,1,1,1,1,3,33.3,2,0,0,0,0,3,0,0,"https://fbref.com/en/players/b8a642fc/Samuel-Chukwueze"
2025,"Milan","Serie A","Emerson","BRA","DF","25-277",1999,5,9,7,5,2,2,6,10,60,4,5,2,3,5,14,12,0,"https://fbref.com/en/players/df8b52a5/Emerson"
2025,"Milan","Serie A","Youssouf Fofana","FRA","MF","25-281",1999,4.8,6,3,2,3,1,3,8,37.5,5,4,1,3,3,9,5,1,"https://fbref.com/en/players/822d51d7/Youssouf-Fofana"
2025,"Milan","Serie A","Matteo Gabbia","ITA","DF","24-362",1999,4,2,0,0,1,1,0,1,0,1,4,2,2,2,4,11,1,"https://fbref.com/en/players/c235e803/Matteo-Gabbia"
2025,"Milan","Serie A","Theo Hernández","FRA","DF","27-011",1997,5.4,7,5,7,0,0,2,4,50,2,4,1,3,8,15,13,0,"https://fbref.com/en/players/d4c9725f/Theo-Hernandez"
2025,"Milan","Serie A","Luka Jović","SRB","FW","26-299",1997,0.9,0,0,0,0,0,0,0,NA,0,0,0,0,1,1,0,0,"https://fbref.com/en/players/4d8cd038/Luka-Jovic"
2025,"Milan","Serie A","Rafael Leão","POR","FW","25-129",1999,5.7,3,3,0,2,1,1,2,50,1,5,0,5,4,7,0,0,"https://fbref.com/en/players/20730eae/Rafael-Leao"
2025,"Milan","Serie A","Ruben Loftus-Cheek","ENG","MF","28-268",1996,4.5,7,3,2,2,3,1,3,33.3,2,1,0,1,1,8,4,0,"https://fbref.com/en/players/e97fd090/Ruben-Loftus-Cheek"
2025,"Milan","Serie A","Mike Maignan","FRA","GK","29-106",1995,7,0,0,0,0,0,0,0,NA,0,0,0,0,0,0,4,1,"https://fbref.com/en/players/fcb38f57/Mike-Maignan"
2025,"Milan","Serie A","Álvaro Morata","ESP","MF,FW","31-360",1992,3.1,2,1,0,2,0,0,1,0,1,4,1,3,2,4,1,0,"https://fbref.com/en/players/129af0db/Alvaro-Morata"
2025,"Milan","Serie A","Yunus Musah","USA","MF","21-323",2002,1.7,6,5,2,2,2,1,1,100,0,2,0,2,1,7,1,0,"https://fbref.com/en/players/b51b1b9c/Yunus-Musah"
2025,"Milan","Serie A","Noah Okafor","SUI","FW","24-146",2000,2.5,1,0,0,0,1,0,0,NA,0,0,0,0,0,1,1,0,"https://fbref.com/en/players/ca607d59/Noah-Okafor"
2025,"Milan","Serie A","Strahinja Pavlović","SRB","DF","23-146",2001,3,11,7,7,4,0,6,11,54.5,5,3,2,1,3,14,16,0,"https://fbref.com/en/players/25146df0/Strahinja-Pavlovic"
2025,"Milan","Serie A","Christian Pulisic","USA","FW,MF","26-029",1998,6.1,12,7,4,5,3,3,7,42.9,4,2,0,2,0,12,2,0,"https://fbref.com/en/players/1bf33a9a/Christian-Pulisic"
2025,"Milan","Serie A","Tijjani Reijnders","NED","MF","26-080",1998,5.8,1,1,0,1,0,1,8,12.5,7,0,0,0,7,8,4,0,"https://fbref.com/en/players/afb61630/Tijjani-Reijnders"
2025,"Milan","Serie A","Alexis Saelemaekers","BEL","DF,FW","25-112",1999,1,1,1,0,0,1,1,1,100,0,0,0,0,1,2,0,0,"https://fbref.com/en/players/ee251371/Alexis-Saelemaekers"
2025,"Milan","Serie A","Filippo Terracciano","ITA","DF","21-252",2003,1,2,2,1,0,1,1,3,33.3,2,0,0,0,2,4,1,0,"https://fbref.com/en/players/5cbb5ad6/Filippo-Terracciano"
2025,"Milan","Serie A","Malick Thiaw","GER","DF","23-070",2001,1,1,1,0,1,0,0,0,NA,0,0,0,0,1,2,1,0,"https://fbref.com/en/players/ff5ea0bf/Malick-Thiaw"
2025,"Milan","Serie A","Fikayo Tomori","ENG","DF","26-303",1997,6,8,7,5,2,1,3,6,50,3,6,5,1,7,15,17,0,"https://fbref.com/en/players/7edfbb8a/Fikayo-Tomori"
2025,"Milan","Serie A","Kevin Zeroli","ITA","MF","19-280",2005,0.1,1,1,0,1,0,0,0,NA,0,0,0,0,0,1,0,0,"https://fbref.com/en/players/7d6d4395/Kevin-Zeroli"
2025,"Monaco","Ligue 1","Maghnes Akliouche","FRA","FW,MF","22-235",2002,4.2,8,6,5,2,1,2,7,28.6,5,2,0,2,0,8,2,0,"https://fbref.com/en/players/b625b241/Maghnes-Akliouche"
2025,"Monaco","Ligue 1","Folarin Balogun","USA","FW","23-106",2001,4.5,0,0,0,0,0,0,2,0,2,0,0,0,0,0,0,0,"https://fbref.com/en/players/31822f8c/Folarin-Balogun"
2025,"Monaco","Ligue 1","Eliesse Ben Seghir","MAR","MF,FW","19-244",2005,5.1,15,12,4,7,4,9,12,75,3,7,0,7,0,15,1,0,"https://fbref.com/en/players/3bd65247/Eliesse-Ben-Seghir"
2025,"Monaco","Ligue 1","Lamine Camara","SEN","MF","20-290",2004,4.7,20,14,8,9,3,8,14,57.1,6,6,3,3,9,29,4,0,"https://fbref.com/en/players/19c2ffa4/Lamine-Camara"
2025,"Monaco","Ligue 1","Krépin Diatta","SEN","DF","25-235",1999,0.4,3,0,3,0,0,2,2,100,0,0,0,0,1,4,3,0,"https://fbref.com/en/players/8104e41e/Krepin-Diatta"
2025,"Monaco","Ligue 1","Breel Embolo","SUI","FW","27-246",1997,3.7,0,0,0,0,0,0,2,0,2,1,0,1,1,1,2,0,"https://fbref.com/en/players/0b4f388a/Breel-Embolo"
2025,"Monaco","Ligue 1","Aleksandr Golovin","RUS","MF","28-140",1996,3,6,4,0,4,2,2,9,22.2,7,4,2,2,3,9,4,0,"https://fbref.com/en/players/3708e9fa/Aleksandr-Golovin"
2025,"Monaco","Ligue 1","George Ilenikhena","FRA","FW,MF","18-062",2006,2.5,0,0,0,0,0,0,0,NA,0,0,0,0,1,1,0,0,"https://fbref.com/en/players/78c3ad07/George-Ilenikhena"
2025,"Monaco","Ligue 1","Ismail Jakobs","SEN","DF","25-061",1999,2,5,5,3,0,2,3,5,60,2,0,0,0,2,7,6,0,"https://fbref.com/en/players/a0415710/Ismail-Jakobs"
2025,"Monaco","Ligue 1","Thilo Kehrer","GER","DF","28-026",1996,5,14,12,9,5,0,6,9,66.7,3,1,1,0,4,18,27,1,"https://fbref.com/en/players/51dbeea9/Thilo-Kehrer"
2025,"Monaco","Ligue 1","Philipp Köhn","SUI","GK","26-198",1998,7,0,0,0,0,0,0,1,0,1,0,0,0,0,0,4,0,"https://fbref.com/en/players/ff74841d/Philipp-Kohn"
2025,"Monaco","Ligue 1","Soungoutou Magassa","FRA","MF","21-009",2003,1.9,12,8,3,8,1,7,9,77.8,2,1,0,1,4,16,1,1,"https://fbref.com/en/players/dfc5d4fa/Soungoutou-Magassa"
2025,"Monaco","Ligue 1","Eliot Matazo","BEL","MF","22-245",2002,0,0,0,0,0,0,0,0,NA,0,0,0,0,0,0,0,0,"https://fbref.com/en/players/15944afd/Eliot-Matazo"
2025,"Monaco","Ligue 1","Christian Mawissa","FRA","DF","19-182",2005,1.8,9,5,3,5,1,9,11,81.8,2,4,1,3,7,16,2,0,"https://fbref.com/en/players/2c70d915/Christian-Mawissa"
2025,"Monaco","Ligue 1","Takumi Minamino","JPN","MF","29-275",1995,4.9,3,3,2,1,0,1,6,16.7,5,5,0,5,3,6,4,0,"https://fbref.com/en/players/f833a830/Takumi-Minamino"
2025,"Monaco","Ligue 1","Kassoum Ouattara","FRA","DF,FW","20-003",2004,1.8,5,3,2,3,0,3,5,60,2,2,0,2,2,7,0,0,"https://fbref.com/en/players/6620c21a/Kassoum-Ouattara"
2025,"Monaco","Ligue 1","Mohammed Salisu","GHA","DF","25-183",1999,4.1,14,7,9,5,0,7,7,100,0,5,4,1,2,16,15,1,"https://fbref.com/en/players/0b33f6ad/Mohammed-Salisu"
2025,"Monaco","Ligue 1","Caio Henrique Oliveira Silva","BRA","DF","27-078",1997,3.1,6,4,2,4,0,3,4,75,1,5,0,5,2,8,6,0,"https://fbref.com/en/players/30af8b93/Caio-Henrique-Oliveira-Silva"
2025,"Monaco","Ligue 1","Wilfried Singo","CIV","DF","23-297",2000,4.1,7,4,4,3,0,2,4,50,2,2,1,1,12,19,15,0,"https://fbref.com/en/players/8b609c34/Wilfried-Singo"
2025,"Monaco","Ligue 1","Jordan Teze","NED","DF","25-017",1999,1.8,7,3,4,2,1,1,2,50,1,5,1,4,1,8,1,0,"https://fbref.com/en/players/82e9b1bb/Jordan-Teze"
2025,"Monaco","Ligue 1","Vanderson","BRA","DF","23-118",2001,5,18,13,9,6,3,10,14,71.4,4,7,3,4,10,28,11,1,"https://fbref.com/en/players/ee45fd85/Vanderson"
2025,"Monaco","Ligue 1","Denis Zakaria","SUI","MF","27-332",1996,6.3,10,7,4,5,1,5,7,71.4,2,6,4,2,7,17,17,0,"https://fbref.com/en/players/384d58d9/Denis-Zakaria"
2025,"Montpellier","Ligue 1","Akor Adams","NGA","FW","24-262",2000,6.1,1,1,0,1,0,0,1,0,1,2,1,1,0,1,3,0,"https://fbref.com/en/players/2ccd39ed/Akor-Adams"
2025,"Montpellier","Ligue 1","Gabriel Bares","SUI","MF","24-049",2000,0.3,1,1,1,0,0,1,2,50,1,0,0,0,1,2,1,0,"https://fbref.com/en/players/5475a510/Gabriel-Bares"
2025,"Montpellier","Ligue 1","Dimitry Bertaud","COD","GK","26-133",1998,3,0,0,0,0,0,0,0,NA,0,0,0,0,0,0,2,0,"https://fbref.com/en/players/380a15e2/Dimitry-Bertaud"
2025,"Montpellier","Ligue 1","Théo Chennahi","FRA","DF","19-254",2005,0,0,0,0,0,0,0,0,NA,0,1,0,1,0,0,0,0,"https://fbref.com/en/players/5a5b785e/Theo-Chennahi"
2025,"Montpellier","Ligue 1","Joris Chotard","FRA","MF","23-023",2001,3.4,7,4,2,5,0,4,7,57.1,3,3,0,3,2,9,4,0,"https://fbref.com/en/players/7909ffa4/Joris-Chotard"
2025,"Montpellier","Ligue 1","Tanguy Coulibaly","FRA","FW","23-242",2001,3.2,5,4,2,3,0,2,7,28.6,5,3,0,3,2,7,0,0,"https://fbref.com/en/players/05ba9d7c/Tanguy-Coulibaly"
2025,"Montpellier","Ligue 1","Stefan Džodić","SRB","DF","19-216",2005,1.8,5,2,3,2,0,3,5,60,2,2,1,1,4,9,7,0,"https://fbref.com/en/players/38ef169e/Stefan-Dzodic"
2025,"Montpellier","Ligue 1","Khalil Fayad","FRA","MF,FW","20-130",2004,2.8,14,7,5,9,0,5,8,62.5,3,4,0,4,1,15,4,0,"https://fbref.com/en/players/faf00ab8/Khalil-Fayad"
2025,"Montpellier","Ligue 1","Jordan Ferri","FRA","MF","32-219",1992,3,6,6,2,4,0,5,6,83.3,1,2,0,2,1,7,2,0,"https://fbref.com/en/players/375622c5/Jordan-Ferri"
2025,"Montpellier","Ligue 1","Axel Gueguin","FRA","FW","19-207",2005,0.3,1,1,0,1,0,1,1,100,0,0,0,0,0,1,0,0,"https://fbref.com/en/players/f6857b4f/Axel-Gueguin"
2025,"Montpellier","Ligue 1","Yanis Issoufou","FRA","FW,MF","17-355",2006,0.8,5,3,4,1,0,3,5,60,2,1,0,1,0,5,1,0,"https://fbref.com/en/players/5d004b30/Yanis-Issoufou"
2025,"Montpellier","Ligue 1","Wahbi Khazri","TUN","FW","33-252",1991,2.1,3,2,0,2,1,1,2,50,1,1,1,0,2,5,1,0,"https://fbref.com/en/players/2677a1de/Wahbi-Khazri"
2025,"Montpellier","Ligue 1","Boubakar Kouyaté","MLI","DF","27-185",1997,1.2,4,1,3,1,0,3,5,60,2,0,0,0,3,7,5,0,"https://fbref.com/en/players/562a4799/Boubakar-Kouyate"
2025,"Montpellier","Ligue 1","Benjamin Lecomte","FRA","GK","33-174",1991,4,0,0,0,0,0,0,0,NA,0,0,0,0,0,0,3,0,"https://fbref.com/en/players/2fa2a875/Benjamin-Lecomte"
2025,"Montpellier","Ligue 1","Othmane Maamma","FRA","FW","19-011",2005,0.1,0,0,0,0,0,0,0,NA,0,0,0,0,0,0,0,0,"https://fbref.com/en/players/5bdb4a7b/Othmane-Maamma"
2025,"Montpellier","Ligue 1","Lucas Mincarelli","FRA","DF","20-286",2004,2.4,3,3,0,2,1,1,4,25,3,1,1,0,1,4,6,0,"https://fbref.com/en/players/02b3733e/Lucas-Mincarelli"
2025,"Montpellier","Ligue 1","Arnaud Nordin","FRA","FW","26-122",1998,5.5,9,5,2,7,0,5,8,62.5,3,5,0,5,2,11,2,0,"https://fbref.com/en/players/7b9a9e25/Arnaud-Nordin"
2025,"Montpellier","Ligue 1","Rabby Nzingoula","CGO","MF","18-327",2005,3.3,13,8,6,5,2,4,10,40,6,4,0,4,6,19,4,0,"https://fbref.com/en/players/627c7a3d/Rabby-Nzingoula"
2025,"Montpellier","Ligue 1","Becir Omeragic","SUI","DF","22-271",2002,4.8,11,4,9,2,0,6,10,60,4,5,3,2,5,16,14,0,"https://fbref.com/en/players/c284d6fb/Becir-Omeragic"
2025,"Montpellier","Ligue 1","Falaye Sacko","MLI","DF","29-169",1995,6.5,10,5,8,1,1,6,13,46.2,7,8,3,5,8,18,6,0,"https://fbref.com/en/players/6388e356/Falaye-Sacko"
2025,"Montpellier","Ligue 1","Modibo Sagnan","MLI","DF","25-186",1999,7,17,8,8,7,2,10,16,62.5,6,7,4,3,13,30,26,1,"https://fbref.com/en/players/76d679c7/Modibo-Sagnan"
2025,"Montpellier","Ligue 1","Téji Savanier","FRA","MF","32-300",1991,6.9,7,7,3,2,2,6,16,37.5,10,2,0,2,3,10,5,0,"https://fbref.com/en/players/6bde367b/Teji-Savanier"
2025,"Montpellier","Ligue 1","Issiaga Sylla","GUI","DF,FW","30-290",1994,0.2,1,0,1,0,0,1,1,100,0,0,0,0,0,1,0,0,"https://fbref.com/en/players/b99bec05/Issiaga-Sylla"
2025,"Montpellier","Ligue 1","Musa Al-Taamari","JOR","FW","27-129",1997,1.9,3,1,1,0,2,1,1,100,0,0,0,0,1,4,0,0,"https://fbref.com/en/players/f15f8b2b/Musa-Al-Taamari"
2025,"Montpellier","Ligue 1","Enzo Tchato","CMR","DF","21-329",2002,5.1,9,5,4,4,1,5,12,41.7,7,7,2,5,4,13,16,0,"https://fbref.com/en/players/7f783431/Enzo-Tchato"
2025,"Montpellier","Ligue 1","Birama Touré","MLI","MF","32-133",1992,1.2,3,2,1,2,0,2,3,66.7,1,2,1,1,2,5,1,0,"https://fbref.com/en/players/a4b798a9/Birama-Toure"
2025,"Monza","Serie A","Alessandro Bianco","ITA","MF","22-016",2002,2.8,7,6,4,3,0,3,3,100,0,2,0,2,1,8,4,1,"https://fbref.com/en/players/d65cf468/Alessandro-Bianco"
2025,"Monza","Serie A","Samuele Birindelli","ITA","DF","25-090",1999,1.9,4,4,2,2,0,1,1,100,0,2,1,1,0,4,2,0,"https://fbref.com/en/players/204ac005/Samuele-Birindelli"
2025,"Monza","Serie A","Warren Bondo","FRA","MF","21-032",2003,6.1,11,6,9,1,1,4,7,57.1,3,6,2,4,2,13,2,1,"https://fbref.com/en/players/0def2376/Warren-Bondo"
2025,"Monza","Serie A","Luca Caldirola","ITA","DF","33-259",1991,2.1,0,0,0,0,0,0,1,0,1,1,1,0,0,0,7,0,"https://fbref.com/en/players/226008f1/Luca-Caldirola"
2025,"Monza","Serie A","Gianluca Caprari","ITA","MF","31-079",1993,2.3,2,1,0,2,0,0,0,NA,0,2,0,2,1,3,0,0,"https://fbref.com/en/players/54e53b7e/Gianluca-Caprari"
2025,"Monza","Serie A","Andrea Carboni","ITA","DF","23-256",2001,4.9,12,7,8,4,0,7,14,50,7,6,1,5,6,18,21,0,"https://fbref.com/en/players/f7e2af2c/Andrea-Carboni"
2025,"Monza","Serie A","Danilo D'Ambrosio","ITA","DF","36-038",1988,0.5,2,0,1,0,1,0,0,NA,0,1,0,1,0,2,0,0,"https://fbref.com/en/players/44eb9093/Danilo-DAmbrosio"
2025,"Monza","Serie A","Omari Forson","ENG","MF,FW","20-089",2004,0.2,0,0,0,0,0,0,0,NA,0,1,0,1,0,0,0,0,"https://fbref.com/en/players/1b9728b0/Omari-Forson"
2025,"Monza","Serie A","Roberto Gagliardini","ITA","MF,DF","30-193",1994,1,1,0,0,1,0,0,2,0,2,0,0,0,1,2,4,0,"https://fbref.com/en/players/ce30bfc8/Roberto-Gagliardini"
2025,"Monza","Serie A","Armando Izzo","ITA","DF","32-229",1992,6.6,10,5,8,2,0,3,6,50,3,13,10,3,14,24,21,0,"https://fbref.com/en/players/89976232/Armando-Izzo"
2025,"Monza","Serie A","Giorgos Kyriakopoulos","GRE","DF","28-255",1996,7,17,12,8,8,1,10,17,58.8,7,10,2,8,7,24,17,0,"https://fbref.com/en/players/0a483542/Giorgos-Kyriakopoulos"
2025,"Monza","Serie A","Daniel Maldini","ITA","MF","23-006",2001,5.6,9,4,1,8,0,3,5,60,2,3,2,1,2,11,3,1,"https://fbref.com/en/players/801831fe/Daniel-Maldini"
2025,"Monza","Serie A","Pablo Marí","ESP","DF","31-047",1993,7,7,5,5,2,0,3,7,42.9,4,8,8,0,17,24,41,0,"https://fbref.com/en/players/aa54ec6f/Pablo-Mari"
2025,"Monza","Serie A","Mirko Marić","CRO","FW","29-154",1995,0.1,0,0,0,0,0,0,0,NA,0,1,1,0,0,0,0,0,"https://fbref.com/en/players/78338347/Mirko-Maric"
2025,"Monza","Serie A","Kevin Martins","ITA","DF","19-260",2005,0,0,0,0,0,0,0,0,NA,0,0,0,0,0,0,0,0,"https://fbref.com/en/players/c1451401/Kevin-Martins"
2025,"Monza","Serie A","Dany Mota","POR","MF","26-168",1998,2.6,2,0,1,0,1,0,0,NA,0,3,0,3,2,4,2,0,"https://fbref.com/en/players/efc9e31f/Dany-Mota"
2025,"Monza","Serie A","Pedro Pereira","POR","DF","26-269",1998,4.6,6,2,3,3,0,2,4,50,2,7,3,4,5,11,9,0,"https://fbref.com/en/players/c77be0cf/Pedro-Pereira"
2025,"Monza","Serie A","Matteo Pessina","ITA","MF","27-179",1997,6.5,13,4,2,10,1,8,11,72.7,3,5,0,5,9,22,7,0,"https://fbref.com/en/players/780e3631/Matteo-Pessina"
2025,"Monza","Serie A","Andrea Petagna","ITA","FW","29-109",1995,2,0,0,0,0,0,0,0,NA,0,0,0,0,1,1,1,0,"https://fbref.com/en/players/03f946ed/Andrea-Petagna"
2025,"Monza","Serie A","Semuel Pizzignacco","ITA","GK","23-046",2001,3,0,0,0,0,0,0,0,NA,0,0,0,0,0,0,1,0,"https://fbref.com/en/players/4f537cf7/Semuel-Pizzignacco"
2025,"Monza","Serie A","Stefano Turati","ITA","GK","23-042",2001,4,0,0,0,0,0,0,0,NA,0,0,0,0,0,0,2,1,"https://fbref.com/en/players/bf168004/Stefano-Turati"
2025,"Monza","Serie A","Samuele Vignato","ITA","MF","20-236",2004,1.2,3,1,0,2,1,2,3,66.7,1,0,0,0,0,3,1,0,"https://fbref.com/en/players/a14d0ab0/Samuele-Vignato"
2025,"Monza","Serie A","Milan Đurić","BIH","FW","34-148",1990,4.9,0,0,0,0,0,0,0,NA,0,2,0,2,1,1,5,0,"https://fbref.com/en/players/405f6586/Milan-Djuric"
2025,"Nantes","Ligue 1","Matthis Abline","FRA","FW","21-203",2003,6.2,0,0,0,0,0,0,1,0,1,1,0,1,0,0,12,0,"https://fbref.com/en/players/0e46fa2f/Matthis-Abline"
2025,"Nantes","Ligue 1","Kelvin Amian","FRA","DF","26-252",1998,5.2,21,12,19,2,0,11,13,84.6,2,6,2,4,1,22,11,0,"https://fbref.com/en/players/bcc81786/Kelvin-Amian"
2025,"Nantes","Ligue 1","Dehmaine Assoumani","FRA","MF,FW","19-183",2005,0.4,4,1,0,2,2,2,2,100,0,0,0,0,0,4,1,0,"https://fbref.com/en/players/fb32896c/Dehmaine-Assoumani"
2025,"Nantes","Ligue 1","Jean-Charles Castelletto","CMR","DF","29-265",1995,5,2,1,2,0,0,1,3,33.3,2,5,4,1,0,2,36,0,"https://fbref.com/en/players/e0f3a1f6/Jean-Charles-Castelletto"
2025,"Nantes","Ligue 1","Pedro Chirivella","ESP","MF","27-147",1997,6.7,9,9,5,3,1,6,9,66.7,3,2,0,2,1,10,14,0,"https://fbref.com/en/players/68a26d51/Pedro-Chirivella"
2025,"Nantes","Ligue 1","Marcus Coco","FRA","DF","28-115",1996,3.1,11,11,5,4,2,6,11,54.5,5,5,2,3,2,13,8,0,"https://fbref.com/en/players/3010aefb/Marcus-Coco"
2025,"Nantes","Ligue 1","Nicolas Cozza","FRA","DF","25-283",1999,2.3,8,7,3,3,2,5,7,71.4,2,0,0,0,1,9,9,0,"https://fbref.com/en/players/8f325097/Nicolas-Cozza"
2025,"Nantes","Ligue 1","Douglas","BRA","MF","27-278",1997,5.6,15,9,5,6,4,4,9,44.4,5,7,1,6,3,18,11,0,"https://fbref.com/en/players/301c287b/Douglas"
2025,"Nantes","Ligue 1","Jean-Kevin Duverne","HAI","DF","27-097",1997,3.6,12,9,6,3,3,10,20,50,10,6,0,6,4,16,15,0,"https://fbref.com/en/players/0cbc8baa/Jean-Kevin-Duverne"
2025,"Nantes","Ligue 1","Ignatius Ganago","CMR","FW","25-244",1999,0.5,1,1,0,1,0,1,1,100,0,0,0,0,0,1,0,0,"https://fbref.com/en/players/23c63b7f/Ignatius-Ganago"
2025,"Nantes","Ligue 1","Jean-Philippe Gbamin","CIV","MF","29-022",1995,0.9,0,0,0,0,0,0,1,0,1,2,1,1,2,2,2,0,"https://fbref.com/en/players/6bd603db/Jean-Philippe-Gbamin"
2025,"Nantes","Ligue 1","Bahereba Guirassy","FRA","FW","18-049",2006,0.1,0,0,0,0,0,0,0,NA,0,1,0,1,0,0,1,0,"https://fbref.com/en/players/a08bb82c/Bahereba-Guirassy"
2025,"Nantes","Ligue 1","Tino Kadewere","ZIM","MF,FW","28-286",1996,3.5,11,5,4,3,4,6,9,66.7,3,1,0,1,3,14,7,0,"https://fbref.com/en/players/7d08063d/Tino-Kadewere"
2025,"Nantes","Ligue 1","Alban Lafont","FRA","GK","25-268",1999,7,1,1,1,0,0,1,1,100,0,0,0,0,0,1,5,1,"https://fbref.com/en/players/4e7db402/Alban-Lafont"
2025,"Nantes","Ligue 1","Johann Lepenant","FRA","MF","21-361",2002,4.9,11,5,5,4,2,3,10,30,7,5,2,3,6,17,3,0,"https://fbref.com/en/players/1e52971c/Johann-Lepenant"
2025,"Nantes","Ligue 1","Louis Leroux","FRA","MF,FW","18-268",2006,0.2,1,1,1,0,0,1,1,100,0,0,0,0,0,1,0,0,"https://fbref.com/en/players/88972aa9/Louis-Leroux"
2025,"Nantes","Ligue 1","Mostafa Mohamed","EGY","FW,MF","26-324",1997,1.3,1,1,1,0,0,0,1,0,1,1,0,1,1,2,4,0,"https://fbref.com/en/players/595e6f3e/Mostafa-Mohamed"
2025,"Nantes","Ligue 1","Florent Mollet","FRA","MF,FW","32-333",1991,0.3,0,0,0,0,0,0,0,NA,0,0,0,0,0,0,0,0,"https://fbref.com/en/players/7e82a78f/Florent-Mollet"
2025,"Nantes","Ligue 1","Nicolas Pallois","FRA","DF","37-028",1987,4,11,3,9,2,0,8,11,72.7,3,3,2,1,6,17,29,0,"https://fbref.com/en/players/779847d6/Nicolas-Pallois"
2025,"Nantes","Ligue 1","Moses Simon","NGA","FW","29-097",1995,6.4,5,5,2,2,1,4,7,57.1,3,2,0,2,4,9,2,0,"https://fbref.com/en/players/5f3eaaf5/Moses-Simon"
2025,"Nantes","Ligue 1","Sorba Thomas","WAL","FW","25-056",1999,4.8,6,4,3,3,0,3,6,50,3,6,0,6,2,8,5,0,"https://fbref.com/en/players/8725a42e/Sorba-Thomas"
2025,"Nantes","Ligue 1","Nathan Zeze","FRA","DF","19-121",2005,5,7,4,1,6,0,5,7,71.4,2,8,3,5,11,18,41,0,"https://fbref.com/en/players/fb4c5b6e/Nathan-Zeze"
2025,"Napoli","Serie A","Alessandro Buongiorno","ITA","DF","25-133",1999,6,10,7,8,2,0,6,7,85.7,1,13,9,4,2,12,17,0,"https://fbref.com/en/players/4ae67f27/Alessandro-Buongiorno"
2025,"Napoli","Serie A","Elia Caprile","ITA","GK","23-053",2001,2.6,0,0,0,0,0,0,0,NA,0,0,0,0,0,0,1,0,"https://fbref.com/en/players/97d7afbd/Elia-Caprile"
2025,"Napoli","Serie A","Walid Cheddira","MAR","FW","26-269",1998,0.1,0,0,0,0,0,0,0,NA,0,0,0,0,0,0,0,0,"https://fbref.com/en/players/0545a08e/Walid-Cheddira"
2025,"Napoli","Serie A","Giovanni Di Lorenzo","ITA","DF","31-074",1993,7,18,11,9,8,1,12,15,80,3,2,1,1,5,23,19,0,"https://fbref.com/en/players/230a2fac/Giovanni-Di-Lorenzo"
2025,"Napoli","Serie A","Michael Folorunsho","ITA","FW","26-253",1998,0.2,1,0,0,1,0,1,3,33.3,2,0,0,0,0,1,0,1,"https://fbref.com/en/players/c391a179/Michael-Folorunsho"
2025,"Napoli","Serie A","Billy Gilmour","SCO","MF","23-128",2001,0.3,3,1,1,0,2,1,2,50,1,0,0,0,0,3,0,0,"https://fbref.com/en/players/df10e27c/Billy-Gilmour"
2025,"Napoli","Serie A","Juan Jesus","BRA","DF","33-129",1991,0.9,0,0,0,0,0,0,0,NA,0,0,0,0,0,0,3,0,"https://fbref.com/en/players/79083382/Juan-Jesus"
2025,"Napoli","Serie A","Khvicha Kvaratskhelia","GEO","MF,FW","23-248",2001,5.8,10,8,3,6,1,4,8,50,4,6,0,6,1,11,4,0,"https://fbref.com/en/players/dea88efd/Khvicha-Kvaratskhelia"
2025,"Napoli","Serie A","Stanislav Lobotka","SVK","MF","29-327",1994,6.7,15,9,2,8,5,5,7,71.4,2,6,2,4,4,19,8,0,"https://fbref.com/en/players/e1cbb531/Stanislav-Lobotka"
2025,"Napoli","Serie A","Romelu Lukaku","BEL","FW","31-157",1993,3.8,0,0,0,0,0,0,2,0,2,0,0,0,0,0,4,0,"https://fbref.com/en/players/5eae500a/Romelu-Lukaku"
2025,"Napoli","Serie A","Pasquale Mazzocchi","ITA","DF","29-082",1995,4,4,2,2,1,1,1,4,25,3,1,1,0,3,7,10,0,"https://fbref.com/en/players/eb0ec070/Pasquale-Mazzocchi"
2025,"Napoli","Serie A","Scott McTominay","SCO","MF","27-314",1996,3.2,5,5,0,4,1,2,4,50,2,5,0,5,4,9,2,0,"https://fbref.com/en/players/d93c2511/Scott-McTominay"
2025,"Napoli","Serie A","Alex Meret","ITA","GK","27-209",1997,4.4,0,0,0,0,0,0,0,NA,0,0,0,0,0,0,0,0,"https://fbref.com/en/players/9413b19f/Alex-Meret"
2025,"Napoli","Serie A","David Neres","BRA","MF,FW","27-228",1997,0.8,1,1,0,1,0,0,0,NA,0,0,0,0,0,1,0,0,"https://fbref.com/en/players/4f1e6a0b/David-Neres"
2025,"Napoli","Serie A","Cyril Ngonge","BEL","DF","24-144",2000,0.1,1,1,0,1,0,0,0,NA,0,0,0,0,0,1,0,0,"https://fbref.com/en/players/2b8360f1/Cyril-Ngonge"
2025,"Napoli","Serie A","Mathías Olivera","URU","DF","26-352",1997,5.2,12,5,6,3,3,5,10,50,5,7,1,6,3,15,12,0,"https://fbref.com/en/players/41c12f75/Mathias-Olivera"
2025,"Napoli","Serie A","Matteo Politano","ITA","MF,FW","31-075",1993,6.2,4,2,2,2,0,4,5,80,1,2,0,2,2,6,10,0,"https://fbref.com/en/players/5e861944/Matteo-Politano"
2025,"Napoli","Serie A","Giacomo Raspadori","ITA","FW,MF","24-242",2000,2.2,2,0,1,1,0,1,2,50,1,3,1,2,2,4,0,0,"https://fbref.com/en/players/6e058f06/Giacomo-Raspadori"
2025,"Napoli","Serie A","Amir Rrahmani","KVX","DF","30-236",1994,7,5,3,4,1,0,2,6,33.3,4,4,1,3,3,8,26,0,"https://fbref.com/en/players/4b3e1a38/Amir-Rrahmani"
2025,"Napoli","Serie A","Giovanni Simeone","ARG","FW","29-104",1995,1.5,0,0,0,0,0,0,2,0,2,1,0,1,1,1,1,0,"https://fbref.com/en/players/343c0d52/Giovanni-Simeone"
2025,"Napoli","Serie A","Leonardo Spinazzola","ITA","DF","31-206",1993,2,1,1,0,1,0,0,1,0,1,3,1,2,0,1,3,1,"https://fbref.com/en/players/3626daea/Leonardo-Spinazzola"
2025,"Napoli","Serie A","Andre-Frank Zambo Anguissa","CMR","MF","28-336",1995,7,13,8,2,9,2,6,10,60,4,4,1,3,16,29,2,0,"https://fbref.com/en/players/6bb2c084/Andre-Frank-Zambo-Anguissa"
2025,"Newcastle Utd","Premier League","Miguel Almirón","PAR","FW","30-250",1994,0.4,1,1,1,0,0,1,1,100,0,0,0,0,0,1,0,0,"https://fbref.com/en/players/862a1c15/Miguel-Almiron"
2025,"Newcastle Utd","Premier League","Harvey Barnes","ENG","FW","26-313",1997,4.3,5,3,2,2,1,2,2,100,0,1,0,1,3,8,4,0,"https://fbref.com/en/players/3ea50f67/Harvey-Barnes"
2025,"Newcastle Utd","Premier League","Dan Burn","ENG","DF","32-161",1992,7,8,4,6,2,0,5,9,55.6,4,7,5,2,5,13,35,1,"https://fbref.com/en/players/b2d31e83/Dan-Burn"
2025,"Newcastle Utd","Premier League","Anthony Gordon","ENG","FW","23-236",2001,6.6,7,4,4,3,0,5,8,62.5,3,9,0,9,2,9,0,1,"https://fbref.com/en/players/2bd83368/Anthony-Gordon"
2025,"Newcastle Utd","Premier League","Bruno Guimarães","BRA","MF","26-336",1997,7,19,10,12,5,2,9,16,56.3,7,8,3,5,11,30,8,1,"https://fbref.com/en/players/82518f62/Bruno-Guimaraes"
2025,"Newcastle Utd","Premier League","Lewis Hall","ENG","DF","20-039",2004,4.8,5,3,3,0,2,4,15,26.7,11,13,7,6,5,10,15,0,"https://fbref.com/en/players/da011f18/Lewis-Hall"
2025,"Newcastle Utd","Premier League","Alexander Isak","SWE","FW","25-026",1999,4.5,2,2,0,1,1,1,3,33.3,2,6,1,5,1,3,5,0,"https://fbref.com/en/players/8e92be30/Alexander-Isak"
2025,"Newcastle Utd","Premier League","Joelinton","BRA","MF","28-064",1996,6.3,19,11,8,6,5,9,18,50,9,12,3,9,2,21,14,1,"https://fbref.com/en/players/c17bfb65/Joelinton"
2025,"Newcastle Utd","Premier League","Lloyd Kelly","ENG","DF","26-011",1998,2.3,2,2,2,0,0,0,0,NA,0,4,2,2,1,3,14,0,"https://fbref.com/en/players/f31def1e/Lloyd-Kelly"
2025,"Newcastle Utd","Premier League","Emil Krafth","SWE","DF","30-076",1994,2.7,2,1,0,1,1,1,2,50,1,5,4,1,2,4,10,0,"https://fbref.com/en/players/77cf6852/Emil-Krafth"
2025,"Newcastle Utd","Premier League","Valentino Livramento","ENG","DF","21-340",2002,3.9,10,5,6,4,0,6,8,75,2,11,3,8,3,13,16,0,"https://fbref.com/en/players/afed6722/Valentino-Livramento"
2025,"Newcastle Utd","Premier League","Sean Longstaff","ENG","MF","26-353",1997,3.4,11,9,3,6,2,8,13,61.5,5,8,1,7,4,15,3,0,"https://fbref.com/en/players/a2b105e0/Sean-Longstaff"
2025,"Newcastle Utd","Premier League","Jacob Murphy","ENG","FW","29-236",1995,4.5,8,6,4,3,1,5,8,62.5,3,6,0,6,1,9,2,0,"https://fbref.com/en/players/de112b84/Jacob-Murphy"
2025,"Newcastle Utd","Premier League","William Osula","DEN","FW","21-074",2003,0.1,0,0,0,0,0,0,0,NA,0,0,0,0,0,0,0,0,"https://fbref.com/en/players/7b355808/William-Osula"
2025,"Newcastle Utd","Premier League","Nick Pope","ENG","GK","32-181",1992,7,0,0,0,0,0,0,0,NA,0,0,0,0,0,0,7,2,"https://fbref.com/en/players/4b40d9ca/Nick-Pope"
2025,"Newcastle Utd","Premier League","Fabian Schär","SUI","DF","32-302",1991,4.3,3,0,2,1,0,0,1,0,1,1,1,0,5,8,15,0,"https://fbref.com/en/players/c8aa95da/Fabian-Schar"
2025,"Newcastle Utd","Premier League","Sandro Tonali","ITA","MF","24-162",2000,2.6,3,2,0,3,0,0,4,0,4,3,1,2,6,9,3,1,"https://fbref.com/en/players/0db169ae/Sandro-Tonali"
2025,"Newcastle Utd","Premier League","Kieran Trippier","ENG","DF","34-028",1990,3.1,9,4,4,4,1,5,13,38.5,8,2,1,1,2,11,6,0,"https://fbref.com/en/players/21512407/Kieran-Trippier"
2025,"Newcastle Utd","Premier League","Joe Willock","ENG","MF,FW","25-058",1999,1.6,3,1,1,2,0,2,5,40,3,2,0,2,2,5,1,0,"https://fbref.com/en/players/a3b03921/Joe-Willock"
2025,"Nice","Ligue 1","Mohamed Abdelmoneim","EGY","DF","25-259",1999,1.8,9,6,6,2,1,6,11,54.5,5,1,1,0,0,9,4,1,"https://fbref.com/en/players/bff15d74/Mohamed-Abdelmoneim"
2025,"Nice","Ligue 1","Ali Abdi","TUN","DF,MF","30-302",1993,2.5,11,7,5,2,4,10,15,66.7,5,7,3,4,1,12,7,0,"https://fbref.com/en/players/ad7cdb35/Ali-Abdi"
2025,"Nice","Ligue 1","Mohamed Ali Cho","FRA","FW","20-272",2004,4.8,3,2,0,1,2,0,3,0,3,3,0,3,1,4,2,0,"https://fbref.com/en/players/f8405304/Mohamed-Ali-Cho"
2025,"Nice","Ligue 1","Melvin Bard","FRA","MF,DF","23-346",2000,3.7,8,4,4,4,0,3,6,50,3,7,2,5,2,10,4,1,"https://fbref.com/en/players/1ddbc7ca/Melvin-Bard"
2025,"Nice","Ligue 1","Jeremie Boga","CIV","MF,FW","27-288",1997,2.7,1,1,0,1,0,0,1,0,1,2,0,2,0,1,0,0,"https://fbref.com/en/players/fe012aca/Jeremie-Boga"
2025,"Nice","Ligue 1","Moïse Bombito","CAN","DF","24-201",2000,4.7,7,6,4,3,0,4,6,66.7,2,5,5,0,5,12,26,1,"https://fbref.com/en/players/c2f23fc8/Moise-Bombito"
2025,"Nice","Ligue 1","Badredine Bouanani","ALG","FW,MF","19-314",2004,2.9,0,0,0,0,0,0,2,0,2,3,0,3,3,3,0,0,"https://fbref.com/en/players/0400dd2f/Badredine-Bouanani"
2025,"Nice","Ligue 1","Hicham Boudaoui","ALG","MF","25-024",1999,5,18,9,12,3,3,9,16,56.3,7,7,2,5,4,22,4,0,"https://fbref.com/en/players/f9d5908e/Hicham-Boudaoui"
2025,"Nice","Ligue 1","Bilal Brahimi","ALG","MF","24-217",2000,0.8,0,0,0,0,0,0,0,NA,0,1,0,1,0,0,2,0,"https://fbref.com/en/players/02bcaf8e/Bilal-Brahimi"
2025,"Nice","Ligue 1","Marcin Bułka","POL","GK","25-013",1999,7,0,0,0,0,0,0,0,NA,0,0,0,0,0,0,2,2,"https://fbref.com/en/players/db87a2c4/Marcin-Bulka"
2025,"Nice","Ligue 1","Issiaga Camara","GUI","MF","19-258",2005,0,0,0,0,0,0,0,0,NA,0,0,0,0,1,1,0,0,"https://fbref.com/en/players/9a34200f/Issiaga-Camara"
2025,"Nice","Ligue 1","Jonathan Clauss","FRA","MF,DF","32-022",1992,6,20,14,10,9,1,10,17,58.8,7,7,2,5,9,29,18,0,"https://fbref.com/en/players/5219ab4a/Jonathan-Clauss"
2025,"Nice","Ligue 1","Dante","BRA","DF","40-365",1983,6.3,13,6,5,6,2,9,12,75,3,5,1,4,8,21,16,0,"https://fbref.com/en/players/fd2bc67d/Dante"
2025,"Nice","Ligue 1","Sofiane Diop","FRA","MF,FW","24-130",2000,0.5,1,1,0,0,1,0,0,NA,0,0,0,0,0,1,1,0,"https://fbref.com/en/players/19053e31/Sofiane-Diop"
2025,"Nice","Ligue 1","Evann Guessand","CIV","FW,MF","23-108",2001,6.4,6,4,1,4,1,0,0,NA,0,3,0,3,5,11,3,0,"https://fbref.com/en/players/b73f17f8/Evann-Guessand"
2025,"Nice","Ligue 1","Gaëtan Laborde","FRA","FW","30-167",1994,0.9,0,0,0,0,0,0,2,0,2,0,0,0,1,1,1,0,"https://fbref.com/en/players/7cdda3bf/Gaetan-Laborde"
2025,"Nice","Ligue 1","Jordan Lotomba","SUI","MF,DF","26-018",1998,0.4,0,0,0,0,0,0,0,NA,0,0,0,0,0,0,1,0,"https://fbref.com/en/players/fc4cf6a7/Jordan-Lotomba"
2025,"Nice","Ligue 1","Tom Louchet","FRA","MF","21-166",2003,0.4,0,0,0,0,0,0,0,NA,0,0,0,0,0,0,0,0,"https://fbref.com/en/players/f999e9be/Tom-Louchet"
2025,"Nice","Ligue 1","Antoine Mendy","FRA","DF,MF","20-143",2004,3.2,10,6,6,4,0,6,10,60,4,3,1,2,2,12,9,0,"https://fbref.com/en/players/3322e296/Antoine-Mendy"
2025,"Nice","Ligue 1","Youssoufa Moukoko","GER","FW,MF","19-332",2004,1.2,1,0,1,0,0,0,1,0,1,0,0,0,0,1,0,0,"https://fbref.com/en/players/6ce43701/Youssoufa-Moukoko"
2025,"Nice","Ligue 1","Youssouf Ndayishimiye","BDI","DF","25-356",1998,4.6,12,5,9,3,0,4,6,66.7,2,5,3,2,6,18,25,1,"https://fbref.com/en/players/65c55288/Youssouf-Ndayishimiye"
2025,"Nice","Ligue 1","Tanguy Ndombele","FRA","MF","27-294",1996,5.7,20,13,5,14,1,7,10,70,3,6,0,6,6,26,2,0,"https://fbref.com/en/players/5cdddffa/Tanguy-Ndombele"
2025,"Nice","Ligue 1","Victor Orakpo","NGA","FW","18-125",2006,0.3,0,0,0,0,0,0,0,NA,0,0,0,0,0,0,0,0,"https://fbref.com/en/players/cbfb7cd7/Victor-Orakpo"
2025,"Nice","Ligue 1","Pablo Rosario","NED","MF,DF","27-284",1997,4.9,3,2,0,3,0,2,4,50,2,6,4,2,6,9,12,1,"https://fbref.com/en/players/1a6b7ea4/Pablo-Rosario"
2025,"Nott'ham Forest","Premier League","Ola Aina","NGA","DF","28-009",1996,6.6,11,6,7,4,0,8,14,57.1,6,8,4,4,10,21,22,1,"https://fbref.com/en/players/246d153b/Ola-Aina"
2025,"Nott'ham Forest","Premier League","Elliot Anderson","ENG","MF,FW","21-346",2002,4.7,15,12,9,4,2,10,15,66.7,5,14,3,11,4,19,13,0,"https://fbref.com/en/players/de31038e/Elliot-Anderson"
2025,"Nott'ham Forest","Premier League","Taiwo Awoniyi","NGA","FW","27-066",1997,0.9,1,0,0,1,0,1,1,100,0,1,0,1,0,1,2,0,"https://fbref.com/en/players/e5478b87/Taiwo-Awoniyi"
2025,"Nott'ham Forest","Premier League","Willy Boly","CIV","DF","33-257",1991,1,4,0,3,1,0,3,3,100,0,3,1,2,1,5,8,0,"https://fbref.com/en/players/a4ac4b8f/Willy-Boly"
2025,"Nott'ham Forest","Premier League","Danilo","BRA","MF","23-171",2001,0.2,0,0,0,0,0,0,0,NA,0,0,0,0,0,0,0,0,"https://fbref.com/en/players/a816dbfb/Danilo"
2025,"Nott'ham Forest","Premier League","Nicolás Domínguez","ARG","MF,FW","26-111",1998,2,8,4,1,4,3,4,8,50,4,4,1,3,2,10,4,0,"https://fbref.com/en/players/20b3a502/Nicolas-Dominguez"
2025,"Nott'ham Forest","Premier League","Anthony Elanga","SWE","FW","22-173",2002,4,2,1,0,1,1,1,4,25,3,2,0,2,3,5,5,0,"https://fbref.com/en/players/2fba6108/Anthony-Elanga"
2025,"Nott'ham Forest","Premier League","Morgan Gibbs-White","ENG","MF","24-264",2000,5.6,9,2,1,6,2,0,2,0,2,1,1,0,3,12,5,0,"https://fbref.com/en/players/32f60ed8/Morgan-Gibbs-White"
2025,"Nott'ham Forest","Premier League","Callum Hudson-Odoi","ENG","FW","23-345",2000,5.3,5,4,0,4,1,2,3,66.7,1,3,0,3,3,8,4,0,"https://fbref.com/en/players/15f3ec41/Callum-Hudson-Odoi"
2025,"Nott'ham Forest","Premier League","Nikola Milenković","SRB","DF","27-005",1997,6,4,4,2,2,0,1,1,100,0,7,6,1,6,10,24,0,"https://fbref.com/en/players/bee704fc/Nikola-Milenkovic"
2025,"Nott'ham Forest","Premier League","Morato","BRA","DF","23-109",2001,0.4,1,1,1,0,0,0,0,NA,0,1,1,0,0,1,10,0,"https://fbref.com/en/players/0f41e2ee/Morato"
2025,"Nott'ham Forest","Premier League","Álex Moreno","ESP","DF","31-131",1993,3.2,10,8,10,0,0,7,16,43.8,9,3,1,2,6,16,9,0,"https://fbref.com/en/players/16e9d0ea/Alex-Moreno"
2025,"Nott'ham Forest","Premier League","Murillo","BRA","DF","22-105",2002,7,7,4,4,3,0,5,13,38.5,8,12,9,3,3,10,40,1,"https://fbref.com/en/players/1704b0b8/Murillo"
2025,"Nott'ham Forest","Premier League","Ibrahim Sangaré","CIV","MF","26-320",1997,2.4,15,9,5,10,0,4,8,50,4,4,0,4,2,17,2,0,"https://fbref.com/en/players/bced0375/Ibrahim-Sangare"
2025,"Nott'ham Forest","Premier League","Matz Sels","BEL","GK","32-234",1992,7,1,1,1,0,0,1,1,100,0,0,0,0,0,1,4,0,"https://fbref.com/en/players/834b5c4c/Matz-Sels"
2025,"Nott'ham Forest","Premier League","Jota Silva","POR","MF,FW","25-077",1999,1.3,4,1,4,0,0,0,3,0,3,1,0,1,5,9,3,0,"https://fbref.com/en/players/4d77e622/Jota-Silva"
2025,"Nott'ham Forest","Premier League","Ramón Sosa","PAR","MF,FW","25-047",1999,0.7,2,1,1,0,1,0,0,NA,0,1,0,1,0,2,2,0,"https://fbref.com/en/players/2d3417a1/Ramon-Sosa"
2025,"Nott'ham Forest","Premier League","Harry Toffolo","ENG","DF","29-059",1995,0.4,2,0,1,0,1,0,0,NA,0,0,0,0,0,2,3,0,"https://fbref.com/en/players/a105d46a/Harry-Toffolo"
2025,"Nott'ham Forest","Premier League","James Ward-Prowse","ENG","MF","29-351",1994,3.2,3,1,1,2,0,1,1,100,0,3,2,1,5,8,3,0,"https://fbref.com/en/players/3515d404/James-Ward-Prowse"
2025,"Nott'ham Forest","Premier League","Neco Williams","WAL","DF","23-187",2001,3.8,11,7,9,2,0,5,11,45.5,6,8,1,7,4,15,17,0,"https://fbref.com/en/players/dd323728/Neco-Williams"
2025,"Nott'ham Forest","Premier League","Chris Wood","NZL","FW","32-315",1991,6.2,1,1,0,0,1,1,3,33.3,2,0,0,0,2,3,5,0,"https://fbref.com/en/players/4e9a0555/Chris-Wood"
2025,"Nott'ham Forest","Premier League","Ryan Yates","ENG","MF","26-331",1997,5,9,4,8,1,0,3,6,50,3,7,1,6,3,12,14,1,"https://fbref.com/en/players/c1fe2a48/Ryan-Yates"
2025,"Osasuna","La Liga","Abel","ESP","DF","24-057",2000,6.8,19,13,10,6,3,12,19,63.2,7,12,2,10,6,25,23,0,"https://fbref.com/en/players/40b6bd38/Abel"
2025,"Osasuna","La Liga","Jesús Areso","ESP","DF","25-107",1999,7.8,9,7,6,2,1,8,13,61.5,5,9,2,7,3,12,19,0,"https://fbref.com/en/players/94e01ec6/Jesus-Areso"
2025,"Osasuna","La Liga","José Arnaiz","ESP","FW","29-185",1995,0.2,1,1,1,0,0,0,0,NA,0,0,0,0,0,1,0,0,"https://fbref.com/en/players/46e07328/Jose-Arnaiz"
2025,"Osasuna","La Liga","Iker Benito","ESP","FW,MF","22-068",2002,0.4,0,0,0,0,0,0,1,0,1,0,0,0,1,1,2,0,"https://fbref.com/en/players/50cbc806/Iker-Benito"
2025,"Osasuna","La Liga","Enzo Boyomo","CMR","DF","23-010",2001,6,14,11,10,3,1,6,7,85.7,1,10,6,4,5,19,31,0,"https://fbref.com/en/players/3a99bc13/Enzo-Boyomo"
2025,"Osasuna","La Liga","Ante Budimir","CRO","FW","33-087",1991,6.6,6,2,1,5,0,1,3,33.3,2,6,1,5,1,7,5,0,"https://fbref.com/en/players/8f3565b3/Ante-Budimir"
2025,"Osasuna","La Liga","Catena","ESP","DF","29-355",1994,8,10,4,4,6,0,6,12,50,6,7,3,4,6,16,57,0,"https://fbref.com/en/players/274ab13c/Catena"
2025,"Osasuna","La Liga","Juan Cruz Armada","ESP","DF","32-081",1992,2.3,2,0,1,1,0,0,1,0,1,1,0,1,0,2,7,0,"https://fbref.com/en/players/a56da3ba/Juan-Cruz-Armada"
2025,"Osasuna","La Liga","Rubén García","ESP","FW,MF","31-095",1993,6,11,9,5,4,2,8,14,57.1,6,11,1,10,5,16,9,0,"https://fbref.com/en/players/5c96b017/Ruben-Garcia"
2025,"Osasuna","La Liga","Moi Gómez","ESP","MF,FW","30-116",1994,3.4,7,3,3,3,1,1,3,33.3,2,1,0,1,5,12,3,1,"https://fbref.com/en/players/5a626448/Moi-Gomez"
2025,"Osasuna","La Liga","Jorge Herrando","ESP","DF","23-232",2001,4.1,2,1,1,1,0,1,2,50,1,6,5,1,1,3,16,0,"https://fbref.com/en/players/e19c989c/Jorge-Herrando"
2025,"Osasuna","La Liga","Sergio Herrera","ESP","GK","31-134",1993,9,1,0,1,0,0,1,1,100,0,0,0,0,0,1,10,1,"https://fbref.com/en/players/a4995f48/Sergio-Herrera"
2025,"Osasuna","La Liga","Pablo Ibáñez","ESP","MF","26-027",1998,3.3,7,3,4,2,1,3,10,30,7,6,3,3,8,15,7,0,"https://fbref.com/en/players/3701906c/Pablo-Ibanez"
2025,"Osasuna","La Liga","Javi Martínez","ESP","MF","24-300",1999,0.1,0,0,0,0,0,0,0,NA,0,0,0,0,0,0,0,0,"https://fbref.com/en/players/3672b352/Javi-Martinez"
2025,"Osasuna","La Liga","Jon Moncayola","ESP","MF,FW","26-157",1998,5.8,22,10,3,16,3,5,12,41.7,7,10,1,9,5,27,6,0,"https://fbref.com/en/players/9939e168/Jon-Moncayola"
2025,"Osasuna","La Liga","Iker Muñoz","ESP","MF","21-347",2002,0.5,0,0,0,0,0,0,0,NA,0,0,0,0,0,0,1,0,"https://fbref.com/en/players/175ece4c/Iker-Munoz"
2025,"Osasuna","La Liga","Aimar Oroz","ESP","MF,FW","22-325",2001,7.7,13,8,5,5,3,6,13,46.2,7,8,1,7,6,19,1,0,"https://fbref.com/en/players/7c363088/Aimar-Oroz"
2025,"Osasuna","La Liga","Rubén Peña","ESP","FW,MF","33-091",1991,2.3,4,0,1,1,2,1,4,25,3,6,0,6,1,5,3,0,"https://fbref.com/en/players/1f079188/Ruben-Pena"
2025,"Osasuna","La Liga","Raúl","ESP","FW","23-349",2000,2.8,2,2,0,1,1,0,1,0,1,1,0,1,0,2,2,0,"https://fbref.com/en/players/18f0a9f0/Raul"
2025,"Osasuna","La Liga","Lucas Torró","ESP","MF","30-090",1994,8.6,20,12,7,13,0,11,18,61.1,7,9,2,7,14,34,17,1,"https://fbref.com/en/players/0e4fef6e/Lucas-Torro"
2025,"Osasuna","La Liga","Nacho Vidal","ESP","DF","29-267",1995,1.2,2,0,0,1,1,1,3,33.3,2,1,0,1,0,2,3,0,"https://fbref.com/en/players/3a9c4b7b/Nacho-Vidal"
2025,"Osasuna","La Liga","Bryan Zaragoza","ESP","FW,MF","23-175",2001,6.3,9,6,6,2,1,4,12,33.3,8,4,0,4,0,9,4,0,"https://fbref.com/en/players/a96103b2/Bryan-Zaragoza"
2025,"Paris S-G","Ligue 1","Marco Asensio","ESP","FW,MF","28-270",1996,3.1,1,1,0,1,0,0,3,0,3,1,0,1,0,1,0,0,"https://fbref.com/en/players/45af8a54/Marco-Asensio"
2025,"Paris S-G","Ligue 1","Bradley Barcola","FRA","FW","22-045",2002,5.2,8,4,5,2,1,1,6,16.7,5,6,0,6,2,10,1,0,"https://fbref.com/en/players/a0d55a09/Bradley-Barcola"
2025,"Paris S-G","Ligue 1","Lucas Beraldo","BRA","DF","20-328",2003,4.9,10,9,9,1,0,7,13,53.8,6,4,0,4,3,13,8,0,"https://fbref.com/en/players/b8aedf06/Lucas-Beraldo"
2025,"Paris S-G","Ligue 1","Ousmane Dembélé","FRA","FW","27-155",1997,4.8,4,2,0,2,2,2,2,100,0,1,0,1,3,7,0,0,"https://fbref.com/en/players/b19db005/Ousmane-Dembele"
2025,"Paris S-G","Ligue 1","Gianluigi Donnarumma","ITA","GK","25-235",1999,5,0,0,0,0,0,0,0,NA,0,0,0,0,0,0,0,0,"https://fbref.com/en/players/08f5afaa/Gianluigi-Donnarumma"
2025,"Paris S-G","Ligue 1","Désiré Doué","FRA","FW","19-136",2005,1.6,2,1,1,1,0,0,4,0,4,1,0,1,0,2,1,0,"https://fbref.com/en/players/9e7483ff/Desire-Doue"
2025,"Paris S-G","Ligue 1","Achraf Hakimi","MAR","DF","25-348",1998,5.9,13,10,6,5,2,6,8,75,2,5,0,5,8,21,5,1,"https://fbref.com/en/players/e42d61c7/Achraf-Hakimi"
2025,"Paris S-G","Ligue 1","Lee Kang-in","KOR","FW,MF","23-241",2001,4.7,9,6,3,2,4,8,12,66.7,4,1,0,1,1,10,2,0,"https://fbref.com/en/players/8455ad90/Lee-Kang-in"
2025,"Paris S-G","Ligue 1","Randal Kolo Muani","FRA","FW","25-317",1998,3.3,4,4,1,1,2,0,0,NA,0,0,0,0,0,4,3,0,"https://fbref.com/en/players/c0b3669f/Randal-Kolo-Muani"
2025,"Paris S-G","Ligue 1","Marquinhos","BRA","DF","30-156",1994,5,7,5,2,4,1,4,4,100,0,8,3,5,2,9,10,0,"https://fbref.com/en/players/d5f2f82b/Marquinhos"
2025,"Paris S-G","Ligue 1","Senny Mayulu","FRA","MF,DF","18-153",2006,0.5,3,2,1,2,0,0,1,0,1,4,2,2,1,4,0,0,"https://fbref.com/en/players/bac89b96/Senny-Mayulu"
2025,"Paris S-G","Ligue 1","Ibrahim Mbaye","FRA","FW,MF","16-267",2008,0.9,0,0,0,0,0,0,2,0,2,0,0,0,0,0,0,0,"https://fbref.com/en/players/201b4ee4/Ibrahim-Mbaye"
2025,"Paris S-G","Ligue 1","Nuno Mendes","POR","DF","22-120",2002,2.8,4,3,1,3,0,3,6,50,3,3,1,2,0,4,2,0,"https://fbref.com/en/players/f20e4cc9/Nuno-Mendes"
2025,"Paris S-G","Ligue 1","João Neves","POR","MF","20-020",2004,5.8,18,9,4,11,3,4,11,36.4,7,6,2,4,5,23,3,0,"https://fbref.com/en/players/c2a15a27/Joao-Neves"
2025,"Paris S-G","Ligue 1","Willian Pacho","ECU","DF","23-001",2001,6.3,11,6,8,3,0,4,6,66.7,2,11,6,5,13,24,25,0,"https://fbref.com/en/players/ecbe2839/Willian-Pacho"
2025,"Paris S-G","Ligue 1","Gonçalo Ramos","POR","FW","23-119",2001,0.2,0,0,0,0,0,0,0,NA,0,0,0,0,0,0,0,0,"https://fbref.com/en/players/f63cda26/Goncalo-Ramos"
2025,"Paris S-G","Ligue 1","Fabián Ruiz Peña","ESP","MF","28-197",1996,3.4,13,7,7,3,3,5,11,45.5,6,4,0,4,3,16,1,0,"https://fbref.com/en/players/c0c7ff58/Fabian-Ruiz-Pena"
2025,"Paris S-G","Ligue 1","Matvei Safonov","RUS","GK","25-235",1999,2,0,0,0,0,0,0,0,NA,0,0,0,0,0,0,0,0,"https://fbref.com/en/players/d97b252e/Matvei-Safonov"
2025,"Paris S-G","Ligue 1","Milan Škriniar","SVK","DF","29-249",1995,1.2,3,2,2,1,0,1,1,100,0,3,2,1,1,4,2,0,"https://fbref.com/en/players/30f5ffa9/Milan-Skriniar"
2025,"Paris S-G","Ligue 1","Vitinha","POR","MF","24-247",2000,4,7,2,2,4,1,4,6,66.7,2,3,1,2,1,8,3,1,"https://fbref.com/en/players/3b029691/Vitinha"
2025,"Paris S-G","Ligue 1","Yoram Zague","FRA","DF","18-155",2006,0.8,3,2,1,1,1,2,2,100,0,1,0,1,0,3,1,0,"https://fbref.com/en/players/5ce497e2/Yoram-Zague"
2025,"Paris S-G","Ligue 1","Warren Zaïre-Emery","FRA","MF,DF","18-223",2006,5.6,11,3,2,6,3,6,9,66.7,3,7,0,7,3,14,8,0,"https://fbref.com/en/players/6b9960cf/Warren-Zaire-Emery"
2025,"Parma","Serie A","Pontus Almqvist","SWE","FW","25-099",1999,1.9,5,3,3,1,1,3,5,60,2,1,0,1,5,10,1,0,"https://fbref.com/en/players/0917188a/Pontus-Almqvist"
2025,"Parma","Serie A","Botond Balogh","HUN","DF","22-133",2002,6.4,13,4,9,4,0,10,11,90.9,1,14,10,4,8,21,46,1,"https://fbref.com/en/players/348bafd4/Botond-Balogh"
2025,"Parma","Serie A","Adrian Bernabe","ESP","MF","23-144",2001,6.9,14,10,11,3,0,9,18,50,9,16,9,7,5,19,11,0,"https://fbref.com/en/players/548672b4/Adrian-Bernabe"
2025,"Parma","Serie A","Ange-Yoan Bonny","FRA","FW","20-358",2003,5.9,6,4,1,5,0,1,4,25,3,1,0,1,0,6,2,0,"https://fbref.com/en/players/64629ba4/Ange-Yoan-Bonny"
2025,"Parma","Serie A","Drissa Camara","CIV","FW","22-242",2002,0.3,0,0,0,0,0,0,2,0,2,0,0,0,0,0,1,0,"https://fbref.com/en/players/543d9d2b/Drissa-Camara"
2025,"Parma","Serie A","Matteo Cancellieri","ITA","FW,MF","22-248",2002,2.3,4,3,4,0,0,1,4,25,3,1,0,1,1,5,4,0,"https://fbref.com/en/players/b6a1cdf9/Matteo-Cancellieri"
2025,"Parma","Serie A","Gabriel Charpentier","CGO","FW","25-153",1999,0.6,1,1,1,0,0,1,1,100,0,1,0,1,0,1,5,0,"https://fbref.com/en/players/c52bea9e/Gabriel-Charpentier"
2025,"Parma","Serie A","Leandro Chichizola","ARG","GK","34-204",1990,1,0,0,0,0,0,0,0,NA,0,0,0,0,0,0,2,0,"https://fbref.com/en/players/8d957256/Leandro-Chichizola"
2025,"Parma","Serie A","Alessandro Circati","AUS","DF","21-007",2003,4,4,2,3,1,0,1,1,100,0,5,4,1,2,6,29,1,"https://fbref.com/en/players/1223765c/Alessandro-Circati"
2025,"Parma","Serie A","Woyo Coulibaly","FRA","DF","25-150",1999,6.1,8,5,5,1,2,4,8,50,4,13,1,12,3,11,11,0,"https://fbref.com/en/players/beb6e3a6/Woyo-Coulibaly"
2025,"Parma","Serie A","Wylan Cyprien","FRA","MF","29-263",1995,0.3,0,0,0,0,0,0,1,0,1,1,0,1,1,1,0,0,"https://fbref.com/en/players/3e092724/Wylan-Cyprien"
2025,"Parma","Serie A","Enrico Del Prato","ITA","DF","24-342",1999,5.2,2,1,1,1,0,2,4,50,2,11,4,7,4,6,21,0,"https://fbref.com/en/players/4c6f9258/Enrico-Del-Prato"
2025,"Parma","Serie A","Nahuel Estévez","ARG","MF","28-338",1995,1.8,3,1,3,0,0,1,6,16.7,5,2,2,0,2,5,6,0,"https://fbref.com/en/players/cec60a2f/Nahuel-Estevez"
2025,"Parma","Serie A","Antoine Hainaut","FRA","DF,MF","22-242",2002,1.9,4,2,3,1,0,2,2,100,0,3,1,2,2,6,5,0,"https://fbref.com/en/players/6503f220/Antoine-Hainaut"
2025,"Parma","Serie A","Mohamed Haj","TUN","MF","19-205",2005,0.4,0,0,0,0,0,0,0,NA,0,0,0,0,1,1,0,0,"https://fbref.com/en/players/eb7dc619/Mohamed-Haj"
2025,"Parma","Serie A","Hernani","BRA","MF","30-204",1994,2.8,7,4,0,5,2,2,7,28.6,5,4,1,3,1,8,2,1,"https://fbref.com/en/players/6f5ead86/Hernani"
2025,"Parma","Serie A","Mandela Keita","BEL","MF","22-160",2002,0.2,0,0,0,0,0,0,0,NA,0,0,0,0,0,0,1,0,"https://fbref.com/en/players/f5692b25/Mandela-Keita"
2025,"Parma","Serie A","Mateusz Kowalski","POL","MF","19-088",2005,0.6,0,0,0,0,0,0,0,NA,0,1,0,1,0,0,1,0,"https://fbref.com/en/players/d2bb908c/Mateusz-Kowalski"
2025,"Parma","Serie A","Dennis Man","ROU","FW","26-052",1998,6.3,2,2,1,0,1,2,4,50,2,1,1,0,2,4,2,0,"https://fbref.com/en/players/2079b3cc/Dennis-Man"
2025,"Parma","Serie A","Valentin Mihaila","ROU","FW,MF","24-258",2000,4.7,12,3,3,6,3,2,6,33.3,4,5,0,5,0,12,1,0,"https://fbref.com/en/players/81a4c239/Valentin-Mihaila"
2025,"Parma","Serie A","Yordan Osorio","VEN","DF","30-160",1994,1.9,5,3,4,1,0,2,2,100,0,3,1,2,4,9,6,1,"https://fbref.com/en/players/4d17df3e/Yordan-Osorio"
2025,"Parma","Serie A","Simon Sohm","SUI","MF","23-189",2001,5,4,2,2,1,1,2,5,40,3,2,1,1,5,9,10,0,"https://fbref.com/en/players/a5f458d9/Simon-Sohm"
2025,"Parma","Serie A","Zion Suzuki","JPN","GK","22-057",2002,5.8,1,0,1,0,0,1,1,100,0,0,0,0,0,1,4,1,"https://fbref.com/en/players/51e1f4f5/Zion-Suzuki"
2025,"Parma","Serie A","Emanuele Valeri","ITA","DF","25-315",1998,3.6,6,4,3,1,2,6,8,75,2,4,1,3,6,12,10,0,"https://fbref.com/en/players/ec52b661/Emanuele-Valeri"
2025,"RB Leipzig","Bundesliga","Christoph Baumgartner","AUT","MF,DF","25-077",1999,1.3,2,2,1,1,0,2,7,28.6,5,3,1,2,0,2,2,0,"https://fbref.com/en/players/437f2b00/Christoph-Baumgartner"
2025,"RB Leipzig","Bundesliga","El Chadaille Bitshiabu","FRA","DF","19-154",2005,1.1,5,3,1,4,0,3,4,75,1,1,1,0,3,8,5,1,"https://fbref.com/en/players/2180c761/El-Chadaille-Bitshiabu"
2025,"RB Leipzig","Bundesliga","Lutsharel Geertruida","NED","DF","24-091",2000,3.2,6,4,1,5,0,2,8,25,6,2,0,2,3,9,9,0,"https://fbref.com/en/players/242e1043/Lutsharel-Geertruida"
2025,"RB Leipzig","Bundesliga","Péter Gulácsi","HUN","GK","34-164",1990,6,0,0,0,0,0,0,0,NA,0,0,0,0,0,0,3,1,"https://fbref.com/en/players/bcb2ccd8/Peter-Gulacsi"
2025,"RB Leipzig","Bundesliga","Amadou Haidara","MLI","MF","26-260",1998,4.1,8,6,4,4,0,4,7,57.1,3,11,4,7,5,13,16,0,"https://fbref.com/en/players/92432bc6/Amadou-Haidara"
2025,"RB Leipzig","Bundesliga","Benjamin Henrichs","GER","DF","27-237",1997,2.7,15,4,7,6,2,8,10,80,2,3,0,3,8,23,6,0,"https://fbref.com/en/players/0a89e877/Benjamin-Henrichs"
2025,"RB Leipzig","Bundesliga","Kevin Kampl","SVN","MF","34-008",1990,2.9,6,4,2,2,2,3,4,75,1,6,1,5,3,9,3,0,"https://fbref.com/en/players/b825a650/Kevin-Kampl"
2025,"RB Leipzig","Bundesliga","Lukas Klostermann","GER","DF","28-136",1996,4.2,7,4,5,1,1,4,6,66.7,2,7,3,4,4,11,18,1,"https://fbref.com/en/players/ca8033cb/Lukas-Klostermann"
2025,"RB Leipzig","Bundesliga","Castello Lukeba","FRA","DF","21-305",2002,4.9,8,3,2,5,1,2,5,40,3,8,4,4,3,11,14,0,"https://fbref.com/en/players/5b9512c5/Castello-Lukeba"
2025,"RB Leipzig","Bundesliga","Antonio Nusa","NOR","MF","19-183",2005,3,6,3,4,1,1,3,5,60,2,6,0,6,2,8,5,0,"https://fbref.com/en/players/4ab12002/Antonio-Nusa"
2025,"RB Leipzig","Bundesliga","Loïs Openda","BEL","FW","24-244",2000,5.2,0,0,0,0,0,0,1,0,1,4,0,4,0,0,0,0,"https://fbref.com/en/players/8652a85c/Lois-Openda"
2025,"RB Leipzig","Bundesliga","Willi Orban","HUN","DF","31-349",1992,3.9,8,5,4,4,0,6,7,85.7,1,6,4,2,4,12,17,0,"https://fbref.com/en/players/20030c06/Willi-Orban"
2025,"RB Leipzig","Bundesliga","Yussuf Poulsen","DEN","FW","30-124",1994,1.2,2,1,1,1,0,2,4,50,2,2,2,0,0,2,1,0,"https://fbref.com/en/players/d2416c2e/Yussuf-Poulsen"
2025,"RB Leipzig","Bundesliga","David Raum","GER","DF","26-178",1998,5.4,11,8,5,4,2,2,6,33.3,4,5,1,4,2,13,10,0,"https://fbref.com/en/players/7d450ed3/David-Raum"
2025,"RB Leipzig","Bundesliga","Nicolas Seiwald","AUT","MF","23-166",2001,3.7,12,8,3,9,0,6,11,54.5,5,4,1,3,9,21,9,0,"https://fbref.com/en/players/28c6e925/Nicolas-Seiwald"
2025,"RB Leipzig","Bundesliga","Benjamin Šeško","SVN","FW,MF","21-139",2003,4.8,4,2,0,2,2,1,2,50,1,4,2,2,2,6,4,0,"https://fbref.com/en/players/3260690c/Benjamin-Sesko"
2025,"RB Leipzig","Bundesliga","André Silva","POR","FW","28-346",1995,0.2,0,0,0,0,0,0,0,NA,0,0,0,0,0,0,0,0,"https://fbref.com/en/players/3effaa34/Andre-Silva"
2025,"RB Leipzig","Bundesliga","Mohamed Simakan","FRA","DF","24-167",2000,0.6,0,0,0,0,0,0,0,NA,0,0,0,0,2,2,0,0,"https://fbref.com/en/players/fcb27134/Mohamed-Simakan"
2025,"RB Leipzig","Bundesliga","Xavi Simons","NED","MF","21-179",2003,5.8,6,5,1,5,0,3,3,100,0,3,1,2,1,7,3,0,"https://fbref.com/en/players/da4d670f/Xavi-Simons"
2025,"RB Leipzig","Bundesliga","Arthur Vermeeren","BEL","MF","19-253",2005,1.6,4,3,2,2,0,2,6,33.3,4,3,2,1,3,7,3,0,"https://fbref.com/en/players/722494dc/Arthur-Vermeeren"
2025,"Rayo Vallecano","La Liga","Iván Balliu","ALB","DF","32-290",1992,5.5,9,7,2,4,3,3,8,37.5,5,2,1,1,5,14,15,0,"https://fbref.com/en/players/cee88597/Ivan-Balliu"
2025,"Rayo Vallecano","La Liga","Augusto Batalla","ARG","GK","28-170",1996,5,0,0,0,0,0,0,1,0,1,0,0,0,0,0,2,1,"https://fbref.com/en/players/fc627681/Augusto-Batalla"
2025,"Rayo Vallecano","La Liga","Sergio Camello","ESP","FW","23-250",2001,5.5,3,0,1,2,0,0,0,NA,0,4,1,3,3,6,9,0,"https://fbref.com/en/players/873619c6/Sergio-Camello"
2025,"Rayo Vallecano","La Liga","Cárdenas","ESP","GK","27-203",1997,4,0,0,0,0,0,0,0,NA,0,0,0,0,0,0,3,0,"https://fbref.com/en/players/e1846dde/Cardenas"
2025,"Rayo Vallecano","La Liga","Pep Chavarría","ESP","DF,MF","26-190",1998,3.4,5,5,3,2,0,2,7,28.6,5,5,1,4,5,10,10,0,"https://fbref.com/en/players/63c5e56b/Pep-Chavarria"
2025,"Rayo Vallecano","La Liga","Pathé Ciss","SEN","MF","30-215",1994,3.3,6,3,4,2,0,1,6,16.7,5,6,3,3,5,11,16,0,"https://fbref.com/en/players/9a0408b6/Pathe-Ciss"
2025,"Rayo Vallecano","La Liga","Pedro Díaz","ESP","MF,FW","26-134",1998,0.6,1,1,0,1,0,1,1,100,0,2,0,2,1,2,0,0,"https://fbref.com/en/players/eea5130e/Pedro-Diaz"
2025,"Rayo Vallecano","La Liga","Adri Embarba","ESP","FW,MF","32-163",1992,6,12,5,6,5,1,7,12,58.3,5,3,0,3,4,16,4,0,"https://fbref.com/en/players/db8f0eba/Adri-Embarba"
2025,"Rayo Vallecano","La Liga","Alfonso Espino","URU","DF","32-286",1992,3.4,16,9,10,5,1,9,20,45,11,6,2,4,7,23,7,0,"https://fbref.com/en/players/db001fa9/Alfonso-Espino"
2025,"Rayo Vallecano","La Liga","Jorge de Frutos","ESP","MF,FW","27-240",1997,6.7,13,8,6,3,4,7,20,35,13,4,0,4,5,18,8,0,"https://fbref.com/en/players/38ce1150/Jorge-de-Frutos"
2025,"Rayo Vallecano","La Liga","Álvaro García","ESP","FW,MF","31-356",1992,4.1,10,7,6,3,1,4,9,44.4,5,2,0,2,6,16,10,0,"https://fbref.com/en/players/90bbd822/Alvaro-Garcia"
2025,"Rayo Vallecano","La Liga","Sergi Guardiola","ESP","FW","33-141",1991,0.3,2,1,0,2,0,0,0,NA,0,0,0,0,0,2,1,0,"https://fbref.com/en/players/32974271/Sergi-Guardiola"
2025,"Rayo Vallecano","La Liga","Gerard Gumbau","ESP","MF","29-304",1994,2.3,8,6,5,3,0,2,4,50,2,2,1,1,0,8,2,0,"https://fbref.com/en/players/ac454a4f/Gerard-Gumbau"
2025,"Rayo Vallecano","La Liga","Florian Lejeune","FRA","DF","33-150",1991,9,12,8,7,3,2,5,9,55.6,4,10,9,1,3,15,40,0,"https://fbref.com/en/players/6eaed4eb/Florian-Lejeune"
2025,"Rayo Vallecano","La Liga","Unai López","ESP","MF","28-353",1995,5.5,5,3,2,1,2,3,9,33.3,6,5,1,4,10,15,6,0,"https://fbref.com/en/players/88050721/Unai-Lopez"
2025,"Rayo Vallecano","La Liga","Abdul Mumin","GHA","DF","26-133",1998,9,8,7,5,3,0,1,6,16.7,5,15,10,5,12,20,50,0,"https://fbref.com/en/players/5487adcd/Abdul-Mumin"
2025,"Rayo Vallecano","La Liga","Randy Nteka","ANG","FW","26-316",1997,3.2,4,2,0,4,0,2,3,66.7,1,3,1,2,1,5,3,0,"https://fbref.com/en/players/a6103274/Randy-Nteka"
2025,"Rayo Vallecano","La Liga","Isaac Palazón Camacho","ESP","FW,MF","29-295",1994,5.6,5,4,3,2,0,3,10,30,7,4,1,3,3,8,3,0,"https://fbref.com/en/players/49dbab27/Isaac-Palazon-Camacho"
2025,"Rayo Vallecano","La Liga","Andrei Ratiu","ROU","DF","26-119",1998,6.9,12,9,8,1,3,8,9,88.9,1,5,1,4,5,17,16,0,"https://fbref.com/en/players/b1b99435/Andrei-Ratiu"
2025,"Rayo Vallecano","La Liga","James Rodríguez","COL","MF,FW","33-097",1991,1.1,3,2,1,2,0,0,2,0,2,2,0,2,1,4,0,0,"https://fbref.com/en/players/715bf047/James-Rodriguez"
2025,"Rayo Vallecano","La Liga","Óscar Trejo","ARG","MF,FW","36-174",1988,1.4,2,2,0,2,0,2,2,100,0,1,0,1,1,3,1,0,"https://fbref.com/en/players/fc647b34/Oscar-Trejo"
2025,"Rayo Vallecano","La Liga","Óscar Valentín","ESP","MF","30-058",1994,7,15,12,6,8,1,10,16,62.5,6,6,1,5,10,25,16,0,"https://fbref.com/en/players/592f3158/Oscar-Valentin"
2025,"Real Madrid","La Liga","Jude Bellingham","ENG","MF","21-110",2003,4.9,14,9,7,4,3,7,9,77.8,2,9,0,9,6,20,3,0,"https://fbref.com/en/players/57d88cf9/Jude-Bellingham"
2025,"Real Madrid","La Liga","Eduardo Camavinga","FRA","MF","21-342",2002,0.8,4,3,1,3,0,3,3,100,0,0,0,0,1,5,1,0,"https://fbref.com/en/players/7b9c2d84/Eduardo-Camavinga"
2025,"Real Madrid","La Liga","Dani Carvajal","ESP","DF","32-280",1992,6.8,12,8,7,3,2,9,12,75,3,8,3,5,10,22,19,1,"https://fbref.com/en/players/4958bfb2/Dani-Carvajal"
2025,"Real Madrid","La Liga","Dani Ceballos","ESP","MF","28-071",1996,0.8,4,3,1,3,0,1,3,33.3,2,1,0,1,0,4,0,0,"https://fbref.com/en/players/c0617e2b/Dani-Ceballos"
2025,"Real Madrid","La Liga","Thibaut Courtois","BEL","GK","32-159",1992,8,0,0,0,0,0,0,0,NA,0,0,0,0,1,1,2,0,"https://fbref.com/en/players/1840e36d/Thibaut-Courtois"
2025,"Real Madrid","La Liga","Brahim Díaz","MAR","FW,MF","25-075",1999,1.3,2,2,2,0,0,0,3,0,3,0,0,0,1,3,0,0,"https://fbref.com/en/players/407feb71/Brahim-Diaz"
2025,"Real Madrid","La Liga","Endrick","BRA","FW","18-088",2006,0.5,0,0,0,0,0,0,1,0,1,0,0,0,1,1,0,0,"https://fbref.com/en/players/a2728fbf/Endrick"
2025,"Real Madrid","La Liga","Fran Garcia","ESP","DF","25-064",1999,2.8,5,4,2,1,2,2,4,50,2,2,1,1,2,7,2,0,"https://fbref.com/en/players/7226539b/Fran-Garcia"
2025,"Real Madrid","La Liga","Arda Güler","TUR","MF,FW","19-235",2005,2.8,8,3,3,2,3,4,6,66.7,2,6,0,6,1,9,3,0,"https://fbref.com/en/players/3741ca58/Arda-Guler"
2025,"Real Madrid","La Liga","Vinicius Júnior","BRA","FW","24-097",2000,8.1,8,4,1,2,5,1,4,25,3,1,0,1,0,8,1,1,"https://fbref.com/en/players/7111d552/Vinicius-Junior"
2025,"Real Madrid","La Liga","Andriy Lunin","UKR","GK","25-249",1999,1,0,0,0,0,0,0,0,NA,0,0,0,0,0,0,0,0,"https://fbref.com/en/players/3061e1ec/Andriy-Lunin"
2025,"Real Madrid","La Liga","Kylian Mbappé","FRA","FW","25-302",1998,7.5,1,1,0,1,0,0,0,NA,0,0,0,0,0,1,0,0,"https://fbref.com/en/players/42fd9c7f/Kylian-Mbappe"
2025,"Real Madrid","La Liga","Ferland Mendy","FRA","DF","29-131",1995,6.2,14,11,5,5,4,7,8,87.5,1,7,2,5,6,20,5,1,"https://fbref.com/en/players/3cefcaef/Ferland-Mendy"
2025,"Real Madrid","La Liga","Éder Militão","BRA","DF","26-273",1998,8.1,13,12,10,3,0,7,12,58.3,5,11,8,3,9,22,29,0,"https://fbref.com/en/players/2784f898/Eder-Militao"
2025,"Real Madrid","La Liga","Luka Modrić","CRO","MF","39-038",1985,5.5,4,1,3,0,1,3,8,37.5,5,3,0,3,5,9,6,0,"https://fbref.com/en/players/6025fab1/Luka-Modric"
2025,"Real Madrid","La Liga","Rodrygo","BRA","FW","23-282",2001,6.9,6,4,4,2,0,3,8,37.5,5,7,1,6,0,6,2,0,"https://fbref.com/en/players/8f5e92a6/Rodrygo"
2025,"Real Madrid","La Liga","Antonio Rüdiger","GER","DF","31-228",1993,8.1,6,4,4,2,0,3,5,60,2,12,9,3,3,9,28,0,"https://fbref.com/en/players/18b896d6/Antonio-Rudiger"
2025,"Real Madrid","La Liga","Aurélien Tchouaméni","FRA","MF,DF","24-264",2000,7.7,15,6,5,9,1,6,14,42.9,8,7,6,1,19,34,11,0,"https://fbref.com/en/players/4f255115/Aurelien-Tchouameni"
2025,"Real Madrid","La Liga","Jesús Vallejo","ESP","DF","27-286",1997,0.1,0,0,0,0,0,0,0,NA,0,0,0,0,0,0,2,0,"https://fbref.com/en/players/c2111b45/Jesus-Vallejo"
2025,"Real Madrid","La Liga","Federico Valverde","URU","MF","26-087",1998,8.8,16,10,7,9,0,11,15,73.3,4,14,3,11,19,35,11,0,"https://fbref.com/en/players/0959c2a2/Federico-Valverde"
2025,"Real Madrid","La Liga","Lucas Vázquez","ESP","DF","33-108",1991,2.5,4,4,2,2,0,3,7,42.9,4,3,0,3,1,5,0,0,"https://fbref.com/en/players/fd51b456/Lucas-Vazquez"
2025,"Real Sociedad","La Liga","Nayef Aguerd","MAR","DF","28-201",1996,4.7,8,6,4,4,0,3,5,60,2,6,2,4,6,14,14,0,"https://fbref.com/en/players/288e1e13/Nayef-Aguerd"
2025,"Real Sociedad","La Liga","Jon Aramburu","VEN","DF","22-086",2002,4.8,24,18,14,6,4,15,19,78.9,4,9,2,7,1,25,19,0,"https://fbref.com/en/players/dc7a172e/Jon-Aramburu"
2025,"Real Sociedad","La Liga","Ander Barrenetxea","ESP","MF,FW","22-295",2001,3.1,5,4,0,4,1,0,4,0,4,4,0,4,4,9,7,0,"https://fbref.com/en/players/200e89e1/Ander-Barrenetxea"
2025,"Real Sociedad","La Liga","Sheraldo Becker","SUR","FW,MF","29-251",1995,5.5,1,1,0,1,0,0,2,0,2,3,0,3,1,2,7,0,"https://fbref.com/en/players/8eb55dbb/Sheraldo-Becker"
2025,"Real Sociedad","La Liga","Aritz Elustondo","ESP","DF","30-203",1994,2.7,4,2,2,1,1,1,1,100,0,6,5,1,1,5,8,0,"https://fbref.com/en/players/f7dc2ae5/Aritz-Elustondo"
2025,"Real Sociedad","La Liga","Sergio Gómez","ESP","MF,DF","24-043",2000,7.6,18,11,8,8,2,9,17,52.9,8,6,1,5,5,23,7,0,"https://fbref.com/en/players/01e5f06e/Sergio-Gomez"
2025,"Real Sociedad","La Liga","Urko González","ESP","MF","23-211",2001,0.5,0,0,0,0,0,0,0,NA,0,1,1,0,0,0,0,0,"https://fbref.com/en/players/c4f5eb61/Urko-Gonzalez"
2025,"Real Sociedad","La Liga","Takefusa Kubo","JPN","MF,FW","23-135",2001,7,7,3,3,2,2,5,9,55.6,4,14,1,13,3,10,3,0,"https://fbref.com/en/players/16aa3654/Takefusa-Kubo"
2025,"Real Sociedad","La Liga","Javi López","ESP","DF","22-206",2002,5.7,12,6,7,4,1,6,10,60,4,4,1,3,1,13,16,1,"https://fbref.com/en/players/e9ada8cf/Javi-Lopez"
2025,"Real Sociedad","La Liga","Jon Magunacelaya","ESP","MF","24-096",2000,0.1,1,1,1,0,0,0,0,NA,0,0,0,0,0,1,0,0,"https://fbref.com/en/players/d4808594/Jon-Magunacelaya"
2025,"Real Sociedad","La Liga","Pablo Marín","ESP","MF","21-106",2003,0.5,1,1,0,1,0,1,1,100,0,0,0,0,0,1,0,0,"https://fbref.com/en/players/a83c19cf/Pablo-Marin"
2025,"Real Sociedad","La Liga","Jon Martin","ESP","DF","18-290",2006,1,0,0,0,0,0,0,0,NA,0,1,1,0,1,1,6,0,"https://fbref.com/en/players/df33ecb5/Jon-Martin"
2025,"Real Sociedad","La Liga","Brais Méndez","ESP","MF","27-284",1997,3.6,4,2,1,1,2,2,7,28.6,5,2,0,2,2,6,1,0,"https://fbref.com/en/players/c9e39d91/Brais-Mendez"
2025,"Real Sociedad","La Liga","Aihen Muñoz","ESP","DF","27-062",1997,1.4,1,1,1,0,0,1,2,50,1,0,0,0,1,2,7,0,"https://fbref.com/en/players/228b0d9d/Aihen-Munoz"
2025,"Real Sociedad","La Liga","Álvaro Odriozola","ESP","DF","28-308",1995,0.3,0,0,0,0,0,0,0,NA,0,0,0,0,0,0,1,0,"https://fbref.com/en/players/1d1691ad/Alvaro-Odriozola"
2025,"Real Sociedad","La Liga","Olasagasti","ESP","MF","24-062",2000,0.7,2,1,1,1,0,0,2,0,2,0,0,0,1,3,1,0,"https://fbref.com/en/players/3d99999d/Olasagasti"
2025,"Real Sociedad","La Liga","Mikel Oyarzabal","ESP","FW","27-179",1997,4.6,2,0,2,0,0,1,3,33.3,2,2,0,2,0,2,2,0,"https://fbref.com/en/players/8c3c640c/Mikel-Oyarzabal"
2025,"Real Sociedad","La Liga","Jon Pacheco","ESP","DF","23-283",2001,3.8,3,2,2,1,0,2,3,66.7,1,5,4,1,3,6,20,1,"https://fbref.com/en/players/44150beb/Jon-Pacheco"
2025,"Real Sociedad","La Liga","Álex Remiro","ESP","GK","29-207",1995,9,0,0,0,0,0,0,0,NA,0,0,0,0,0,0,3,3,"https://fbref.com/en/players/374ee424/Alex-Remiro"
2025,"Real Sociedad","La Liga","Umar Sadiq","NGA","FW","27-258",1997,2.1,2,1,1,1,0,1,2,50,1,2,1,1,1,3,2,0,"https://fbref.com/en/players/686cbe7d/Umar-Sadiq"
2025,"Real Sociedad","La Liga","Orri Steinn Óskarsson","ISL","FW","20-049",2004,1.9,2,2,0,1,1,0,2,0,2,4,0,4,0,2,1,0,"https://fbref.com/en/players/d0b8e745/Orri-Steinn-Oskarsson"
2025,"Real Sociedad","La Liga","Luka Sučić","CRO","MF","22-039",2002,4.4,7,3,1,4,2,2,7,28.6,5,5,2,3,3,10,1,0,"https://fbref.com/en/players/1e1378e1/Luka-Sucic"
2025,"Real Sociedad","La Liga","Hamari Traoré","MLI","DF","32-264",1992,3.5,11,7,7,3,1,9,12,75,3,1,1,0,3,14,11,0,"https://fbref.com/en/players/a4b1028a/Hamari-Traore"
2025,"Real Sociedad","La Liga","Beñat Turrientes","ESP","MF","22-260",2002,4.8,10,3,4,5,1,3,5,60,2,8,2,6,1,11,5,0,"https://fbref.com/en/players/068f4dec/Benat-Turrientes"
2025,"Real Sociedad","La Liga","Igor Zubeldia","ESP","DF","27-201",1997,6.4,5,4,3,1,1,3,5,60,2,9,6,3,5,10,23,1,"https://fbref.com/en/players/5c7845f6/Igor-Zubeldia"
2025,"Real Sociedad","La Liga","Martín Zubimendi","ESP","MF","25-258",1999,8.5,21,11,8,10,3,5,7,71.4,2,11,3,8,11,32,19,0,"https://fbref.com/en/players/3ee0dd59/Martin-Zubimendi"
2025,"Reims","Ligue 1","Martin Adeline","FRA","MF","20-320",2003,0.3,1,1,0,1,0,1,2,50,1,0,0,0,0,1,2,0,"https://fbref.com/en/players/7587446d/Martin-Adeline"
2025,"Reims","Ligue 1","Emmanuel Agbadou","CIV","DF","27-122",1997,7,20,13,15,3,2,15,19,78.9,4,16,11,5,8,28,35,1,"https://fbref.com/en/players/75f1ed80/Emmanuel-Agbadou"
2025,"Reims","Ligue 1","Sergio Akieme","ESP","DF","26-306",1997,4,5,4,4,1,0,3,6,50,3,4,2,2,1,6,12,0,"https://fbref.com/en/players/06efa9dc/Sergio-Akieme"
2025,"Reims","Ligue 1","Valentin Atangana Edoa","FRA","MF","19-053",2005,6.6,14,9,7,6,1,5,8,62.5,3,6,3,3,9,23,10,0,"https://fbref.com/en/players/6b5edd5d/Valentin-Atangana-Edoa"
2025,"Reims","Ligue 1","Aurélio Buta","POR","DF","27-250",1997,4.7,12,7,10,1,1,9,14,64.3,5,1,0,1,5,17,14,0,"https://fbref.com/en/players/b4705807/Aurelio-Buta"
2025,"Reims","Ligue 1","Mohammed Daramy","DEN","FW","22-284",2002,0.2,0,0,0,0,0,0,0,NA,0,0,0,0,0,0,1,0,"https://fbref.com/en/players/06a1d642/Mohammed-Daramy"
2025,"Reims","Ligue 1","Thibault De Smet","BEL","DF","26-134",1998,0.1,0,0,0,0,0,0,0,NA,0,1,1,0,1,1,2,0,"https://fbref.com/en/players/5fdcb075/Thibault-De-Smet"
2025,"Reims","Ligue 1","Mamadou Diakhon","FRA","FW,MF","19-025",2005,0.6,3,3,2,0,1,3,4,75,1,0,0,0,0,3,1,0,"https://fbref.com/en/players/331c5a98/Mamadou-Diakhon"
2025,"Reims","Ligue 1","Oumar Diakité","CIV","FW","20-302",2003,5.5,7,5,4,3,0,4,9,44.4,5,4,0,4,2,9,3,0,"https://fbref.com/en/players/44435c8f/Oumar-Diakite"
2025,"Reims","Ligue 1","Yehvann Diouf","FRA","GK","24-336",1999,7,0,0,0,0,0,0,0,NA,0,0,0,0,0,0,3,1,"https://fbref.com/en/players/eedea60b/Yehvann-Diouf"
2025,"Reims","Ligue 1","Junya Ito","JPN","FW","31-222",1993,6.7,10,9,3,6,1,3,14,21.4,11,10,0,10,1,11,1,1,"https://fbref.com/en/players/dbd3a428/Junya-Ito"
2025,"Reims","Ligue 1","Yaya Kader Fofana","MLI","MF,FW","20-127",2004,4.8,13,8,7,5,1,3,9,33.3,6,5,0,5,2,15,2,0,"https://fbref.com/en/players/cedc53d2/Yaya-Kader-Fofana"
2025,"Reims","Ligue 1","Reda Khadra","GER","MF,FW","23-105",2001,0.9,1,1,1,0,0,0,1,0,1,0,0,0,0,1,1,0,"https://fbref.com/en/players/88acf83f/Reda-Khadra"
2025,"Reims","Ligue 1","Cédric Kipré","CIV","DF","27-313",1996,4.1,8,6,7,1,0,8,10,80,2,8,3,5,2,10,25,0,"https://fbref.com/en/players/9f30e7ed/Cedric-Kipre"
2025,"Reims","Ligue 1","Abdoul Koné","FRA","DF","19-178",2005,0.7,4,2,3,1,0,2,4,50,2,1,1,0,1,5,1,0,"https://fbref.com/en/players/c1ebf5d2/Abdoul-Kone"
2025,"Reims","Ligue 1","Amadou Koné","MLI","MF","19-156",2005,0.2,2,1,1,1,0,2,2,100,0,0,0,0,1,3,0,0,"https://fbref.com/en/players/2eb1ec07/Amadou-Kone"
2025,"Reims","Ligue 1","Marshall Munetsi","ZIM","MF","28-117",1996,6.9,12,8,8,2,2,7,12,58.3,5,10,3,7,5,17,9,0,"https://fbref.com/en/players/2acf0cd7/Marshall-Munetsi"
2025,"Reims","Ligue 1","Keito Nakamura","JPN","FW","24-081",2000,5.4,7,7,1,3,3,3,6,50,3,5,0,5,5,12,2,0,"https://fbref.com/en/players/d97af612/Keito-Nakamura"
2025,"Reims","Ligue 1","Joseph Okumu","KEN","DF","27-144",1997,3,4,2,2,2,0,2,4,50,2,10,9,1,5,9,11,1,"https://fbref.com/en/players/039f1983/Joseph-Okumu"
2025,"Reims","Ligue 1","Amine Salama","FRA","FW,MF","24-091",2000,1.1,2,2,0,1,1,0,2,0,2,2,1,1,0,2,0,0,"https://fbref.com/en/players/bc7cc472/Amine-Salama"
2025,"Reims","Ligue 1","Nhoa Sangui","FRA","DF","18-233",2006,4.8,3,2,0,2,1,2,5,40,3,4,2,2,2,5,9,0,"https://fbref.com/en/players/3f465a66/Nhoa-Sangui"
2025,"Reims","Ligue 1","Teddy Teuma","MLT","MF","31-017",1993,1.5,4,3,1,2,1,2,6,33.3,4,3,1,2,1,5,2,0,"https://fbref.com/en/players/5c26ca51/Teddy-Teuma"
2025,"Rennes","Ligue 1","Lorenz Assignon","TOG","DF,MF","24-117",2000,4.5,6,4,2,4,0,4,7,57.1,3,6,3,3,7,13,21,0,"https://fbref.com/en/players/b026bbf6/Lorenz-Assignon"
2025,"Rennes","Ligue 1","Ludovic Blas","FRA","FW,MF","26-291",1997,6.6,7,6,2,3,2,6,12,50,6,7,2,5,3,10,2,0,"https://fbref.com/en/players/6191093d/Ludovic-Blas"
2025,"Rennes","Ligue 1","Benjamin Bourigeaud","FRA","MF","30-277",1994,0.9,1,0,0,1,0,0,2,0,2,2,1,1,2,3,1,0,"https://fbref.com/en/players/20e73fac/Benjamin-Bourigeaud"
2025,"Rennes","Ligue 1","Carlos Gómez","COL","MF","22-035",2002,0.5,1,1,0,1,0,0,2,0,2,1,0,1,0,1,0,0,"https://fbref.com/en/players/76a82373/Carlos-Gomez"
2025,"Rennes","Ligue 1","Amine Gouiri","ALG","FW,MF","24-244",2000,4.8,5,2,2,2,1,1,5,20,4,4,0,4,0,5,1,0,"https://fbref.com/en/players/aad56ca3/Amine-Gouiri"
2025,"Rennes","Ligue 1","Albert Grønbaek","DEN","MF,FW","23-147",2001,4.9,11,5,4,6,1,6,14,42.9,8,4,0,4,3,14,2,0,"https://fbref.com/en/players/0da5076f/Albert-Gronbaek"
2025,"Rennes","Ligue 1","Hans Hateboer","NED","DF,MF","30-282",1994,4.7,9,4,4,3,2,5,7,71.4,2,3,1,2,5,14,9,0,"https://fbref.com/en/players/3b333ac3/Hans-Hateboer"
2025,"Rennes","Ligue 1","Jordan James","WAL","MF","20-107",2004,0.3,2,0,1,0,1,1,3,33.3,2,0,0,0,0,2,1,0,"https://fbref.com/en/players/f719ad7f/Jordan-James"
2025,"Rennes","Ligue 1","Jota","POR","FW","25-201",1999,0.4,0,0,0,0,0,0,0,NA,0,0,0,0,0,0,1,0,"https://fbref.com/en/players/8c5f1522/Jota"
2025,"Rennes","Ligue 1","Arnaud Kalimuendo","FRA","FW","22-271",2002,4.4,3,2,0,1,2,1,1,100,0,1,0,1,0,3,0,0,"https://fbref.com/en/players/bf4c41f9/Arnaud-Kalimuendo"
2025,"Rennes","Ligue 1","Glen Kamara","FIN","MF","28-355",1995,4,13,6,4,7,2,7,10,70,3,6,0,6,4,17,4,0,"https://fbref.com/en/players/4da9191b/Glen-Kamara"
2025,"Rennes","Ligue 1","Steve Mandanda","FRA","GK","39-203",1985,7,0,0,0,0,0,0,1,0,1,0,0,0,0,0,0,0,"https://fbref.com/en/players/1d2d5cc8/Steve-Mandanda"
2025,"Rennes","Ligue 1","Azor Matusiwa","NED","MF","26-172",1998,6.8,24,13,11,12,1,14,17,82.4,3,11,3,8,11,35,13,0,"https://fbref.com/en/players/a17a94d6/Azor-Matusiwa"
2025,"Rennes","Ligue 1","Henrik Meister","DEN","FW","20-335",2003,0.7,2,0,0,2,0,0,0,NA,0,4,0,4,1,3,0,0,"https://fbref.com/en/players/e1a873eb/Henrik-Meister"
2025,"Rennes","Ligue 1","Mahamadou Nagida","CMR","MF,DF","19-111",2005,0.4,1,1,0,0,1,1,1,100,0,1,0,1,2,3,0,0,"https://fbref.com/en/players/8bfbf257/Mahamadou-Nagida"
2025,"Rennes","Ligue 1","Mikayil Ngor Faye","SEN","DF","20-095",2004,1.1,2,2,2,0,0,2,2,100,0,1,0,1,1,3,4,0,"https://fbref.com/en/players/b37ae816/Mikayil-Ngor-Faye"
2025,"Rennes","Ligue 1","Baptiste Santamaria","FRA","MF","29-222",1995,3,6,2,4,1,1,3,5,60,2,4,1,3,4,10,6,0,"https://fbref.com/en/players/5e22e2a4/Baptiste-Santamaria"
2025,"Rennes","Ligue 1","Alidu Seidu","GHA","DF","24-135",2000,5.9,14,10,9,4,1,9,10,90,1,10,5,5,8,22,12,0,"https://fbref.com/en/players/cea59f02/Alidu-Seidu"
2025,"Rennes","Ligue 1","Leo Skiri Østigård","NOR","DF","24-324",1999,4.7,15,13,12,3,0,12,17,70.6,5,5,5,0,5,20,26,0,"https://fbref.com/en/players/b35a7399/Leo-Skiri-Ostigard"
2025,"Rennes","Ligue 1","Adrien Truffert","FRA","DF,MF","22-332",2001,5.4,15,7,6,5,4,11,15,73.3,4,4,0,4,3,18,9,0,"https://fbref.com/en/players/5d0e0a1f/Adrien-Truffert"
2025,"Rennes","Ligue 1","Christopher Wooh","CMR","DF","23-029",2001,6,15,7,7,7,1,4,5,80,1,10,6,4,6,21,25,0,"https://fbref.com/en/players/b003239d/Christopher-Wooh"
2025,"Roma","Serie A","Tammy Abraham","ENG","FW","27-015",1997,0,0,0,0,0,0,0,1,0,1,0,0,0,0,0,0,0,"https://fbref.com/en/players/f586779e/Tammy-Abraham"
2025,"Roma","Serie A","Angeliño","ESP","DF","27-287",1997,6.8,13,3,3,8,2,3,4,75,1,4,3,1,6,19,23,0,"https://fbref.com/en/players/30941e96/Angelino"
2025,"Roma","Serie A","Tommaso Baldanzi","ITA","MF,DF","21-208",2003,1.7,5,1,3,1,1,0,1,0,1,2,0,2,1,6,2,0,"https://fbref.com/en/players/102e2599/Tommaso-Baldanzi"
2025,"Roma","Serie A","Zeki Çelik","TUR","DF","27-243",1997,5.8,15,11,5,6,4,7,12,58.3,5,4,2,2,2,17,14,0,"https://fbref.com/en/players/31a62dc7/Zeki-Celik"
2025,"Roma","Serie A","Bryan Cristante","ITA","MF","29-228",1995,6.6,11,8,5,6,0,2,5,40,3,6,5,1,9,20,17,0,"https://fbref.com/en/players/16657b95/Bryan-Cristante"
2025,"Roma","Serie A","Artem Dovbyk","UKR","FW","27-118",1997,6.8,1,1,0,0,1,0,0,NA,0,3,0,3,0,1,3,0,"https://fbref.com/en/players/5b847bb0/Artem-Dovbyk"
2025,"Roma","Serie A","Paulo Dybala","ARG","FW,MF","30-337",1993,3.2,3,1,0,1,2,0,1,0,1,2,0,2,1,4,0,0,"https://fbref.com/en/players/e0921a4f/Paulo-Dybala"
2025,"Roma","Serie A","Mario Hermoso","ESP","DF","29-121",1995,0.8,1,0,1,0,0,0,0,NA,0,1,1,0,2,3,7,0,"https://fbref.com/en/players/555f3a0b/Mario-Hermoso"
2025,"Roma","Serie A","Manu Koné","FRA","MF","23-153",2001,2.9,3,2,1,2,0,2,5,40,3,2,0,2,3,6,2,0,"https://fbref.com/en/players/86574238/Manu-Kone"
2025,"Roma","Serie A","Enzo Le Fée","FRA","MF","24-257",2000,1,2,2,0,2,0,0,2,0,2,3,1,2,1,3,0,0,"https://fbref.com/en/players/6f806d99/Enzo-Le-Fee"
2025,"Roma","Serie A","Gianluca Mancini","ITA","DF","28-183",1996,6.6,8,4,3,3,2,4,5,80,1,8,6,2,6,14,9,0,"https://fbref.com/en/players/5aa53281/Gianluca-Mancini"
2025,"Roma","Serie A","Obite N'Dicka","CIV","DF","25-058",1999,7,8,7,4,4,0,4,4,100,0,8,6,2,7,15,27,1,"https://fbref.com/en/players/441197b8/Obite-NDicka"
2025,"Roma","Serie A","Leandro Paredes","ARG","MF","30-110",1994,1.2,1,1,0,1,0,0,1,0,1,2,1,1,2,3,1,1,"https://fbref.com/en/players/dff153a4/Leandro-Paredes"
2025,"Roma","Serie A","Lorenzo Pellegrini","ITA","MF","28-120",1996,5.8,7,4,1,4,2,1,3,33.3,2,1,0,1,0,7,7,0,"https://fbref.com/en/players/4a5a45c7/Lorenzo-Pellegrini"
2025,"Roma","Serie A","Niccolò Pisilli","ITA","MF","20-024",2004,2.7,5,3,2,3,0,2,2,100,0,4,0,4,1,6,3,0,"https://fbref.com/en/players/c84dcc88/Niccolo-Pisilli"
2025,"Roma","Serie A","Alexis Saelemaekers","BEL","FW,DF","25-112",1999,1.2,4,2,3,1,0,2,2,100,0,1,0,1,0,4,1,0,"https://fbref.com/en/players/ee251371/Alexis-Saelemaekers"
2025,"Roma","Serie A","Stephan El Shaarawy","ITA","DF","31-356",1992,2.8,3,2,1,0,2,0,1,0,1,1,0,1,3,6,3,0,"https://fbref.com/en/players/d3aaad90/Stephan-El-Shaarawy"
2025,"Roma","Serie A","Eldor Shomurodov","UZB","FW,DF","29-110",1995,0.4,0,0,0,0,0,0,1,0,1,0,0,0,0,0,0,0,"https://fbref.com/en/players/57469b2d/Eldor-Shomurodov"
2025,"Roma","Serie A","Matìas Soulé","ARG","MF,FW","21-185",2003,4.3,3,2,0,1,2,1,4,25,3,8,1,7,2,5,4,0,"https://fbref.com/en/players/c13ddd3e/Matias-Soule"
2025,"Roma","Serie A","Mile Svilar","SRB","GK","25-051",1999,7,0,0,0,0,0,0,0,NA,0,0,0,0,0,0,2,1,"https://fbref.com/en/players/bcf5058a/Mile-Svilar"
2025,"Roma","Serie A","Nicola Zalewski","POL","DF,FW","22-268",2002,2.4,4,3,1,1,2,1,3,33.3,2,2,0,2,0,4,2,0,"https://fbref.com/en/players/45191c29/Nicola-Zalewski"
2025,"Saint-Étienne","Ligue 1","Yunis Abdelhamid","MAR","DF","37-019",1987,5,5,2,5,0,0,4,7,57.1,3,9,8,1,3,8,24,0,"https://fbref.com/en/players/32c2d95f/Yunis-Abdelhamid"
2025,"Saint-Étienne","Ligue 1","Ayman Aiki","FRA","FW,MF","19-114",2005,1,3,3,1,2,0,1,1,100,0,1,0,1,1,4,0,0,"https://fbref.com/en/players/8399c416/Ayman-Aiki"
2025,"Saint-Étienne","Ligue 1","Mathis Amougou","FRA","MF","18-273",2006,6,8,5,6,2,0,4,7,57.1,3,4,0,4,10,18,2,0,"https://fbref.com/en/players/f93cca97/Mathis-Amougou"
2025,"Saint-Étienne","Ligue 1","Dennis Appiah","FRA","DF","32-130",1992,4.9,14,12,9,5,0,10,22,45.5,12,7,4,3,4,18,18,0,"https://fbref.com/en/players/feb5d3ab/Dennis-Appiah"
2025,"Saint-Étienne","Ligue 1","Dylan Batubinsika","COD","DF","28-245",1996,7,11,6,9,2,0,5,7,71.4,2,7,3,4,15,26,38,0,"https://fbref.com/en/players/37d39918/Dylan-Batubinsika"
2025,"Saint-Étienne","Ligue 1","Augustine Boakye","GHA","MF,FW","23-349",2000,0.6,3,1,1,2,0,2,4,50,2,0,0,0,0,3,0,0,"https://fbref.com/en/players/59e9edb5/Augustine-Boakye"
2025,"Saint-Étienne","Ligue 1","Benjamin Bouchouari","MAR","MF","22-339",2001,0.5,2,1,1,1,0,1,5,20,4,0,0,0,0,2,1,0,"https://fbref.com/en/players/599f9013/Benjamin-Bouchouari"
2025,"Saint-Étienne","Ligue 1","Mathieu Cafaro","FRA","MF,FW","27-206",1997,4.6,4,3,2,1,1,1,7,14.3,6,3,1,2,5,9,2,0,"https://fbref.com/en/players/2a657da0/Mathieu-Cafaro"
2025,"Saint-Étienne","Ligue 1","Pierre Cornud","FRA","DF","27-310",1996,2.3,3,3,2,0,1,3,4,75,1,3,1,2,3,6,10,1,"https://fbref.com/en/players/edeb21ff/Pierre-Cornud"
2025,"Saint-Étienne","Ligue 1","Zuriko Davitashvili","GEO","MF,FW","23-245",2001,6.7,8,4,2,5,1,6,16,37.5,10,3,0,3,5,13,3,0,"https://fbref.com/en/players/88b4d2e3/Zuriko-Davitashvili"
2025,"Saint-Étienne","Ligue 1","Pierre Ekwah Elimby","FRA","MF","22-276",2002,4,8,6,4,4,0,5,6,83.3,1,7,4,3,5,13,12,0,"https://fbref.com/en/players/830371be/Pierre-Ekwah-Elimby"
2025,"Saint-Étienne","Ligue 1","Lamine Fomba","FRA","MF","26-265",1998,0.8,2,1,1,1,0,1,2,50,1,4,1,3,2,4,3,1,"https://fbref.com/en/players/2145368f/Lamine-Fomba"
2025,"Saint-Étienne","Ligue 1","Gautier Larsonneur","FRA","GK","27-237",1997,7,0,0,0,0,0,0,0,NA,0,0,0,0,0,0,5,0,"https://fbref.com/en/players/b49729cb/Gautier-Larsonneur"
2025,"Saint-Étienne","Ligue 1","Yvann Macon","FRA","DF","26-016",1998,1.6,2,1,0,2,0,1,1,100,0,1,1,0,0,2,4,1,"https://fbref.com/en/players/0bb6e193/Yvann-Macon"
2025,"Saint-Étienne","Ligue 1","Aimen Moueffek","FRA","MF","23-191",2001,3.4,5,1,0,4,1,1,5,20,4,5,3,2,2,7,12,0,"https://fbref.com/en/players/2591b066/Aimen-Moueffek"
2025,"Saint-Étienne","Ligue 1","Louis Mouton","FRA","MF,DF","22-136",2002,0.6,5,2,2,1,2,1,3,33.3,2,0,0,0,0,5,2,0,"https://fbref.com/en/players/c37823fe/Louis-Mouton"
2025,"Saint-Étienne","Ligue 1","Mickael Nade","FRA","DF","25-227",1999,2.6,9,6,5,4,0,3,3,100,0,9,3,6,3,12,8,1,"https://fbref.com/en/players/a6b6fa6e/Mickael-Nade"
2025,"Saint-Étienne","Ligue 1","Marwann Nzuzi","FRA","DF","20-154",2004,1.4,2,2,1,0,1,1,2,50,1,0,0,0,2,4,6,0,"https://fbref.com/en/players/165787d9/Marwann-Nzuzi"
2025,"Saint-Étienne","Ligue 1","Ben Old","NZL","MF,FW","22-065",2002,4.2,4,4,3,1,0,2,8,25,6,5,1,4,1,5,1,0,"https://fbref.com/en/players/e14e818c/Ben-Old"
2025,"Saint-Étienne","Ligue 1","Jibril Othman","TUN","FW","20-174",2004,0.1,0,0,0,0,0,0,0,NA,0,0,0,0,0,0,0,0,"https://fbref.com/en/players/967bb460/Jibril-Othman"
2025,"Saint-Étienne","Ligue 1","Beres Owusu","FRA","DF","21-028",2003,1,2,2,1,1,0,2,2,100,0,2,2,0,0,2,5,0,"https://fbref.com/en/players/32c61db3/Beres-Owusu"
2025,"Saint-Étienne","Ligue 1","Kévin Pedro","FRA","DF","18-239",2006,0.1,3,0,2,1,0,3,3,100,0,1,0,1,2,5,1,0,"https://fbref.com/en/players/ff1f24ca/Kevin-Pedro"
2025,"Saint-Étienne","Ligue 1","Léo Pétrot","FRA","DF","27-185",1997,2.7,5,2,3,2,0,4,4,100,0,6,2,4,4,9,16,0,"https://fbref.com/en/players/00638016/Leo-Petrot"
2025,"Saint-Étienne","Ligue 1","Ibrahim Sissoko","MLI","FW","28-325",1995,5.1,7,6,2,3,2,2,5,40,3,5,0,5,1,8,8,0,"https://fbref.com/en/players/a170541f/Ibrahim-Sissoko"
2025,"Saint-Étienne","Ligue 1","Lucas Stassin","BEL","FW","19-324",2004,1.7,2,1,0,1,1,2,3,66.7,1,2,0,2,0,2,2,0,"https://fbref.com/en/players/a47d6f3a/Lucas-Stassin"
2025,"Saint-Étienne","Ligue 1","Florian Tardieu","FRA","MF","32-178",1992,1.8,1,1,1,0,0,0,2,0,2,3,1,2,3,4,2,0,"https://fbref.com/en/players/ed39121c/Florian-Tardieu"
2025,"Saint-Étienne","Ligue 1","Ibrahima Wadji","SEN","FW","29-165",1995,0.5,1,1,0,1,0,1,2,50,1,0,0,0,0,1,0,0,"https://fbref.com/en/players/c844f6f9/Ibrahima-Wadji"
2025,"Sevilla","La Liga","Lucien Agoume","FRA","MF","22-251",2002,6,12,4,7,3,2,6,9,66.7,3,12,5,7,7,19,8,0,"https://fbref.com/en/players/8bc8829a/Lucien-Agoume"
2025,"Sevilla","La Liga","Loïc Bade","FRA","DF","24-189",2000,6.2,12,8,10,2,0,5,6,83.3,1,2,1,1,5,17,33,1,"https://fbref.com/en/players/114bbdee/Loic-Bade"
2025,"Sevilla","La Liga","Valentín Barco","ARG","DF","20-086",2004,2.8,14,8,7,3,4,11,14,78.6,3,0,0,0,2,16,5,0,"https://fbref.com/en/players/b9f282ec/Valentin-Barco"
2025,"Sevilla","La Liga","Carmona","ESP","DF","22-262",2002,8.8,27,19,17,8,2,12,18,66.7,6,7,3,4,17,44,16,0,"https://fbref.com/en/players/2dce876a/Carmona"
2025,"Sevilla","La Liga","Chidera Ejuke","NGA","FW,MF","26-289",1998,5.5,5,3,0,3,2,3,8,37.5,5,6,0,6,1,6,2,0,"https://fbref.com/en/players/e7f3e8a7/Chidera-Ejuke"
2025,"Sevilla","La Liga","Nemanja Gudelj","SRB","MF,DF","32-336",1991,6,11,6,4,5,2,2,2,100,0,5,3,2,8,19,18,0,"https://fbref.com/en/players/0076ab7f/Nemanja-Gudelj"
2025,"Sevilla","La Liga","Stanis Idumbo","BEL","FW","19-110",2005,0.1,1,1,0,1,0,0,0,NA,0,0,0,0,1,2,0,0,"https://fbref.com/en/players/53551b98/Stanis-Idumbo"
2025,"Sevilla","La Liga","Kelechi Iheanacho","NGA","FW","28-014",1996,3,1,0,0,1,0,1,2,50,1,0,0,0,0,1,1,0,"https://fbref.com/en/players/c92e1a31/Kelechi-Iheanacho"
2025,"Sevilla","La Liga","Dodi Lukebakio","BEL","FW","27-023",1997,7.3,5,4,2,2,1,1,4,25,3,5,0,5,1,6,3,0,"https://fbref.com/en/players/0c61c77c/Dodi-Lukebakio"
2025,"Sevilla","La Liga","Marcão","BRA","DF","28-134",1996,3.3,7,5,4,3,0,1,1,100,0,4,3,1,3,10,14,1,"https://fbref.com/en/players/133faa84/Marcao"
2025,"Sevilla","La Liga","Mateo Mejía","ESP","FW","21-200",2003,0.1,0,0,0,0,0,0,0,NA,0,0,0,0,0,0,0,0,"https://fbref.com/en/players/a96e9b5c/Mateo-Mejia"
2025,"Sevilla","La Liga","Gonzalo Montiel","ARG","MF","27-290",1997,0,0,0,0,0,0,0,0,NA,0,0,0,0,0,0,0,0,"https://fbref.com/en/players/374d5158/Gonzalo-Montiel"
2025,"Sevilla","La Liga","Jesús Navas","ESP","FW,MF","38-331",1985,2.4,3,1,2,0,1,0,1,0,1,0,0,0,2,5,3,0,"https://fbref.com/en/players/3f10bd22/Jesus-Navas"
2025,"Sevilla","La Liga","Tanguy Nianzou","FRA","DF","22-132",2002,4.8,7,5,6,0,1,5,5,100,0,1,0,1,8,15,24,0,"https://fbref.com/en/players/5853ac44/Tanguy-Nianzou"
2025,"Sevilla","La Liga","Saúl Ñíguez","ESP","MF","29-331",1994,3.6,9,6,3,3,3,1,4,25,3,6,1,5,2,11,4,0,"https://fbref.com/en/players/c14bc029/Saul-Niguez"
2025,"Sevilla","La Liga","Ørjan Nyland","NOR","GK","34-037",1990,9,1,1,1,0,0,1,1,100,0,0,0,0,0,1,6,1,"https://fbref.com/en/players/bdedffac/Orjan-Nyland"
2025,"Sevilla","La Liga","Lucas Ocampos","ARG","FW","30-098",1994,1.9,3,2,2,0,1,1,2,50,1,2,0,2,0,3,2,0,"https://fbref.com/en/players/a08b974a/Lucas-Ocampos"
2025,"Sevilla","La Liga","Adrià Pedrosa","ESP","DF,MF","26-157",1998,5.7,9,3,6,1,2,8,11,72.7,3,12,2,10,4,13,15,0,"https://fbref.com/en/players/112521d1/Adria-Pedrosa"
2025,"Sevilla","La Liga","Peque","ESP","MF,FW","22-013",2002,4.9,5,2,1,4,0,2,7,28.6,5,7,0,7,3,8,1,0,"https://fbref.com/en/players/cb971b4f/Peque"
2025,"Sevilla","La Liga","Isaac Romero","ESP","FW","24-152",2000,5,2,0,0,1,1,0,3,0,3,6,1,5,0,2,5,0,"https://fbref.com/en/players/be719093/Isaac-Romero"
2025,"Sevilla","La Liga","Kike Salas","ESP","DF","22-177",2002,2.2,4,4,1,1,2,2,4,50,2,3,2,1,2,6,8,0,"https://fbref.com/en/players/0a69de7b/Kike-Salas"
2025,"Sevilla","La Liga","Albert Sambi Lokonga","BEL","MF","24-361",1999,1.9,3,3,3,0,0,1,1,100,0,3,1,2,0,3,2,0,"https://fbref.com/en/players/1b4f1169/Albert-Sambi-Lokonga"
2025,"Sevilla","La Liga","Juanlu Sánchez","ESP","MF,DF","21-063",2003,3.4,6,5,3,2,1,4,5,80,1,0,0,0,6,12,3,0,"https://fbref.com/en/players/cc6de655/Juanlu-Sanchez"
2025,"Sevilla","La Liga","Djibril Sow","SUI","MF","27-254",1997,4.1,5,3,2,3,0,0,3,0,3,1,0,1,3,8,4,0,"https://fbref.com/en/players/4c6facae/Djibril-Sow"
2025,"Sevilla","La Liga","Suso","ESP","FW,MF","30-333",1993,0.8,1,0,1,0,0,1,2,50,1,0,0,0,0,1,0,0,"https://fbref.com/en/players/4e219ad2/Suso"
2025,"Southampton","Premier League","Carlos Alcaraz","ARG","MF","21-322",2002,0.1,0,0,0,0,0,0,0,NA,0,0,0,0,1,1,0,0,"https://fbref.com/en/players/4abac767/Carlos-Alcaraz"
2025,"Southampton","Premier League","Samuel Amo-Ameyaw","ENG","DF","18-091",2006,0.1,0,0,0,0,0,0,0,NA,0,0,0,0,0,0,0,0,"https://fbref.com/en/players/9eedf0e0/Samuel-Amo-Ameyaw"
2025,"Southampton","Premier League","Cameron Archer","ENG","FW","23-088",2001,3.2,4,2,1,1,2,1,2,50,1,1,0,1,1,5,0,0,"https://fbref.com/en/players/05e8ca6d/Cameron-Archer"
2025,"Southampton","Premier League","Joe Aribo","NGA","MF","28-088",1996,4,6,4,1,3,2,2,3,66.7,1,3,3,0,4,10,4,0,"https://fbref.com/en/players/328f7d51/Joe-Aribo"
2025,"Southampton","Premier League","Adam Armstrong","ENG","FW","27-250",1997,2.6,3,1,1,1,1,1,4,25,3,1,0,1,2,5,1,0,"https://fbref.com/en/players/68c720b5/Adam-Armstrong"
2025,"Southampton","Premier League","Jan Bednarek","POL","DF","28-188",1996,6.9,7,3,5,2,0,3,7,42.9,4,13,11,2,11,18,39,1,"https://fbref.com/en/players/4115ce4e/Jan-Bednarek"
2025,"Southampton","Premier League","Ben Brereton","CHI","FW","25-182",1999,4.3,2,2,0,1,1,1,8,12.5,7,2,1,1,0,2,3,0,"https://fbref.com/en/players/57827369/Ben-Brereton"
2025,"Southampton","Premier League","Maxwel Cornet","CIV","FW","28-020",1996,0.8,5,5,1,4,0,0,4,0,4,0,0,0,0,5,2,0,"https://fbref.com/en/players/beb391dd/Maxwel-Cornet"
2025,"Southampton","Premier League","Tyler Dibling","ENG","FW,MF","18-219",2006,4.1,6,5,3,2,1,4,7,57.1,3,4,1,3,1,7,2,0,"https://fbref.com/en/players/bdcc89ae/Tyler-Dibling"
2025,"Southampton","Premier League","Flynn Downes","ENG","MF","25-271",1999,7,14,7,6,6,2,4,13,30.8,9,13,2,11,12,26,8,1,"https://fbref.com/en/players/69fdb896/Flynn-Downes"
2025,"Southampton","Premier League","Samuel Edozie","ENG","DF,FW","21-263",2003,0.7,3,1,0,1,2,2,2,100,0,0,0,0,0,3,0,0,"https://fbref.com/en/players/007414dd/Samuel-Edozie"
2025,"Southampton","Premier League","Mateus Fernandes","POR","MF","20-099",2004,4.1,13,8,3,7,3,3,6,50,3,3,0,3,2,15,7,0,"https://fbref.com/en/players/ef491564/Mateus-Fernandes"
2025,"Southampton","Premier League","Ryan Fraser","SCO","FW","30-236",1994,1.4,5,2,1,4,0,4,5,80,1,0,0,0,0,5,3,0,"https://fbref.com/en/players/d56543a0/Ryan-Fraser"
2025,"Southampton","Premier League","Taylor Harwood-Bellis","ENG","DF","22-261",2002,5.6,1,1,1,0,0,0,1,0,1,12,7,5,7,8,18,1,"https://fbref.com/en/players/47327321/Taylor-Harwood-Bellis"
2025,"Southampton","Premier League","Adam Lallana","ENG","MF","36-160",1988,1.3,3,3,2,1,0,2,4,50,2,0,0,0,3,6,2,0,"https://fbref.com/en/players/99813635/Adam-Lallana"
2025,"Southampton","Premier League","Ryan Manning","IRL","DF","28-125",1996,0.8,3,2,1,2,0,1,1,100,0,2,2,0,0,3,3,0,"https://fbref.com/en/players/847b53eb/Ryan-Manning"
2025,"Southampton","Premier League","Alex McCarthy","ENG","GK","34-319",1989,2,0,0,0,0,0,0,0,NA,0,0,0,0,0,0,0,1,"https://fbref.com/en/players/36c2ca73/Alex-McCarthy"
2025,"Southampton","Premier League","Paul Onuachu","NGA","FW","30-142",1994,0.2,0,0,0,0,0,0,0,NA,0,0,0,0,1,1,0,0,"https://fbref.com/en/players/c06d1086/Paul-Onuachu"
2025,"Southampton","Premier League","Aaron Ramsdale","ENG","GK","26-156",1998,5,0,0,0,0,0,0,0,NA,0,0,0,0,1,1,5,1,"https://fbref.com/en/players/466fb2c5/Aaron-Ramsdale"
2025,"Southampton","Premier League","William Smallbone","IRL","MF","24-239",2000,2.4,7,3,3,3,1,3,4,75,1,3,0,3,0,7,1,1,"https://fbref.com/en/players/5e105217/William-Smallbone"
2025,"Southampton","Premier League","Jack Stephens","ENG","DF","30-264",1994,3.9,8,5,6,2,0,3,7,42.9,4,4,2,2,0,8,5,2,"https://fbref.com/en/players/6adbc307/Jack-Stephens"
2025,"Southampton","Premier League","Ross Stewart","SCO","FW,MF","28-098",1996,1.5,0,0,0,0,0,0,3,0,3,3,0,3,0,0,4,0,"https://fbref.com/en/players/18986367/Ross-Stewart"
2025,"Southampton","Premier League","Yukinari Sugawara","JPN","DF","24-111",2000,6.3,14,9,8,5,1,6,9,66.7,3,7,3,4,4,18,19,1,"https://fbref.com/en/players/580bcd18/Yukinari-Sugawara"
2025,"Southampton","Premier League","Charlie Taylor","ENG","DF","31-029",1993,2.2,4,2,1,3,0,2,2,100,0,5,3,2,3,7,17,1,"https://fbref.com/en/players/cc2d7ad5/Charlie-Taylor"
2025,"Southampton","Premier League","Lesley Ugochukwu","FRA","MF","20-205",2004,1.6,3,1,0,3,0,0,4,0,4,4,1,3,1,4,1,0,"https://fbref.com/en/players/1df4a109/Lesley-Ugochukwu"
2025,"Southampton","Premier League","Kyle Walker-Peters","ENG","DF","27-187",1997,4.9,7,5,4,2,1,4,8,50,4,6,2,4,3,10,9,0,"https://fbref.com/en/players/984a5a64/Kyle-Walker-Peters"
2025,"St. Pauli","Bundesliga","Oladapo Afolayan","ENG","FW,MF","26-248",1998,3.8,6,3,1,2,3,2,4,50,2,2,0,2,2,8,3,0,"https://fbref.com/en/players/5054c359/Oladapo-Afolayan"
2025,"St. Pauli","Bundesliga","Andreas Albers","DEN","FW","34-208",1990,0.3,0,0,0,0,0,0,1,0,1,0,0,0,0,0,1,0,"https://fbref.com/en/players/94471fb7/Andreas-Albers"
2025,"St. Pauli","Bundesliga","Scott Banks","SCO","FW,MF","23-021",2001,0.3,0,0,0,0,0,0,0,NA,0,0,0,0,1,1,1,0,"https://fbref.com/en/players/d01f8942/Scott-Banks"
2025,"St. Pauli","Bundesliga","Carlo Boukhalfa","MAR","MF","25-167",1999,2.6,6,1,0,5,1,0,2,0,2,3,0,3,3,9,2,0,"https://fbref.com/en/players/1a86f4a9/Carlo-Boukhalfa"
2025,"St. Pauli","Bundesliga","Adam Dźwigała","POL","DF,MF","29-022",1995,1,4,1,3,1,0,2,3,66.7,1,0,0,0,0,4,3,0,"https://fbref.com/en/players/75edc8ce/Adam-Dzwigala"
2025,"St. Pauli","Bundesliga","Johannes Eggestein","GER","FW","26-162",1998,5.3,0,0,0,0,0,0,0,NA,0,1,0,1,0,0,2,0,"https://fbref.com/en/players/d571df78/Johannes-Eggestein"
2025,"St. Pauli","Bundesliga","Morgan Guilavogui","GUI","FW,MF","26-221",1998,2.4,2,0,1,1,0,0,0,NA,0,2,0,2,1,3,1,0,"https://fbref.com/en/players/79b51257/Morgan-Guilavogui"
2025,"St. Pauli","Bundesliga","Jackson Irvine","AUS","MF","31-224",1993,6,14,6,7,5,2,5,12,41.7,7,6,0,6,10,24,16,0,"https://fbref.com/en/players/4637747c/Jackson-Irvine"
2025,"St. Pauli","Bundesliga","Connor Metcalfe","AUS","MF","24-347",1999,2.5,1,0,0,1,0,0,3,0,3,3,0,3,2,3,4,0,"https://fbref.com/en/players/73ce4d7d/Connor-Metcalfe"
2025,"St. Pauli","Bundesliga","Karol Mets","EST","DF","31-154",1993,6,6,3,3,3,0,1,3,33.3,2,4,1,3,5,11,36,0,"https://fbref.com/en/players/ef2ad14e/Karol-Mets"
2025,"St. Pauli","Bundesliga","Lars Ritzka","GER","DF,FW","26-163",1998,2.3,11,8,3,5,3,5,10,50,5,6,0,6,0,11,6,0,"https://fbref.com/en/players/35d23b15/Lars-Ritzka"
2025,"St. Pauli","Bundesliga","Elias Saad","TUN","FW,MF","24-295",1999,3.8,12,7,4,5,3,6,11,54.5,5,6,0,6,1,13,1,0,"https://fbref.com/en/players/78a2284f/Elias-Saad"
2025,"St. Pauli","Bundesliga","Manolis Saliakas","GRE","MF,DF","28-035",1996,3.3,6,3,3,1,2,3,6,50,3,3,0,3,1,7,9,0,"https://fbref.com/en/players/18fe6d90/Manolis-Saliakas"
2025,"St. Pauli","Bundesliga","Danel Sinani","LUX","MF,FW","27-195",1997,0.3,0,0,0,0,0,0,1,0,1,0,0,0,1,1,0,0,"https://fbref.com/en/players/96ddfa79/Danel-Sinani"
2025,"St. Pauli","Bundesliga","Eric Smith","SWE","DF","27-283",1997,5.4,7,5,6,1,0,5,5,100,0,6,3,3,7,14,18,2,"https://fbref.com/en/players/8817312f/Eric-Smith"
2025,"St. Pauli","Bundesliga","Philipp Treu","GER","MF,DF","23-319",2000,5.9,10,6,6,3,1,6,12,50,6,13,1,12,3,13,9,0,"https://fbref.com/en/players/047822ad/Philipp-Treu"
2025,"St. Pauli","Bundesliga","Nikola Vasilj","BIH","GK","28-320",1995,6,0,0,0,0,0,0,0,NA,0,0,0,0,0,0,1,1,"https://fbref.com/en/players/f038585f/Nikola-Vasilj"
2025,"St. Pauli","Bundesliga","Robert Wagner","GER","MF","21-095",2003,2.7,6,2,1,5,0,2,7,28.6,5,6,0,6,0,6,3,0,"https://fbref.com/en/players/e3d3fbeb/Robert-Wagner"
2025,"St. Pauli","Bundesliga","Hauke Wahl","GER","DF","30-185",1994,6,6,3,1,5,0,3,4,75,1,4,1,3,5,11,21,0,"https://fbref.com/en/players/f3db5b34/Hauke-Wahl"
2025,"Strasbourg","Ligue 1","Dilane Bakwa","FRA","FW,MF","22-052",2002,6.8,8,5,5,1,2,4,7,57.1,3,5,0,5,3,11,8,0,"https://fbref.com/en/players/2b5a35e5/Dilane-Bakwa"
2025,"Strasbourg","Ligue 1","Pape Daouda Diongue","SEN","MF","",NA,0.5,1,0,0,1,0,0,0,NA,0,0,0,0,1,2,0,0,"https://fbref.com/en/players/d4925a40/Pape-Daouda-Diongue"
2025,"Strasbourg","Ligue 1","Habib Diarra","SEN","MF,FW","20-288",2004,6.3,4,2,0,3,1,2,5,40,3,5,0,5,1,5,9,0,"https://fbref.com/en/players/6d0fe035/Habib-Diarra"
2025,"Strasbourg","Ligue 1","Guela Doué","CIV","DF","22-000",2002,7,13,10,7,2,4,8,11,72.7,3,8,0,8,12,25,37,0,"https://fbref.com/en/players/b4ef3fb5/Guela-Doue"
2025,"Strasbourg","Ligue 1","Ismaël Doukouré","FRA","MF","21-085",2003,6.5,14,6,5,9,0,8,8,100,0,7,2,5,6,20,16,2,"https://fbref.com/en/players/0512a60a/Ismael-Doukoure"
2025,"Strasbourg","Ligue 1","Emanuel Emegha","NED","FW","21-257",2003,6.6,4,4,0,2,2,1,1,100,0,6,4,2,0,4,8,0,"https://fbref.com/en/players/a0c590b9/Emanuel-Emegha"
2025,"Strasbourg","Ligue 1","Karol Fila","POL","MF","26-126",1998,0.1,0,0,0,0,0,0,0,NA,0,0,0,0,0,0,0,0,"https://fbref.com/en/players/50ac8941/Karol-Fila"
2025,"Strasbourg","Ligue 1","Karl-Johan Johnsson","SWE","GK","34-263",1990,3,0,0,0,0,0,0,1,0,1,0,0,0,0,0,3,0,"https://fbref.com/en/players/a56bd2ee/Karl-Johan-Johnsson"
2025,"Strasbourg","Ligue 1","Nordine Kandil","FRA","MF","22-352",2001,0.1,0,0,0,0,0,0,0,NA,0,0,0,0,0,0,1,0,"https://fbref.com/en/players/c5908bc4/Nordine-Kandil"
2025,"Strasbourg","Ligue 1","Félix Lemaréchal","FRA","FW,MF","21-071",2003,0.9,0,0,0,0,0,0,0,NA,0,3,0,3,0,0,2,0,"https://fbref.com/en/players/8ca9415f/Felix-Lemarechal"
2025,"Strasbourg","Ligue 1","Sekou Mara","FRA","FW,MF","22-079",2002,1.3,1,1,0,0,1,0,2,0,2,1,0,1,2,3,1,0,"https://fbref.com/en/players/3544641e/Sekou-Mara"
2025,"Strasbourg","Ligue 1","Diego Moreira","POR","DF,FW","20-072",2004,5.2,9,5,1,4,4,5,8,62.5,3,3,0,3,7,16,12,0,"https://fbref.com/en/players/12de1b0d/Diego-Moreira"
2025,"Strasbourg","Ligue 1","Junior Mwanga","FRA","MF","21-159",2003,1.7,8,3,7,1,0,4,6,66.7,2,0,0,0,0,8,1,0,"https://fbref.com/en/players/ee158be5/Junior-Mwanga"
2025,"Strasbourg","Ligue 1","Sebastian Nanasi","SWE","FW,MF","22-154",2002,4.5,3,2,0,3,0,1,4,25,3,4,1,3,0,3,3,0,"https://fbref.com/en/players/ce747d2a/Sebastian-Nanasi"
2025,"Strasbourg","Ligue 1","Đorđe Petrović","SRB","GK","25-009",1999,4,0,0,0,0,0,0,0,NA,0,0,0,0,0,0,1,0,"https://fbref.com/en/players/0cf321c8/Djordje-Petrovic"
2025,"Strasbourg","Ligue 1","Andrey Santos","BRA","MF","20-167",2004,5.8,23,15,13,8,2,11,24,45.8,13,8,1,7,2,25,9,0,"https://fbref.com/en/players/dd745366/Andrey-Santos"
2025,"Strasbourg","Ligue 1","Mamadou Sarr","FRA","DF","19-049",2005,1.8,4,2,1,3,0,3,5,60,2,3,2,1,3,7,4,0,"https://fbref.com/en/players/61f80c89/Mamadou-Sarr"
2025,"Strasbourg","Ligue 1","Jérémy Sebas","MTQ","FW,MF","21-186",2003,0.2,2,1,1,1,0,2,3,66.7,1,0,0,0,0,2,0,0,"https://fbref.com/en/players/0b6911e4/Jeremy-Sebas"
2025,"Strasbourg","Ligue 1","Marvin Senaya","TOG","DF","23-263",2001,1.2,3,2,2,1,0,2,4,50,2,5,2,3,6,9,7,0,"https://fbref.com/en/players/1d383c10/Marvin-Senaya"
2025,"Strasbourg","Ligue 1","Saidou Sow","GUI","DF","22-105",2002,6.8,7,4,4,3,0,4,7,57.1,3,9,5,4,14,21,26,0,"https://fbref.com/en/players/f6b94e8d/Saidou-Sow"
2025,"Strasbourg","Ligue 1","Abakar Sylla","CIV","DF","21-297",2002,4.4,12,7,8,2,2,6,7,85.7,1,9,6,3,4,16,20,0,"https://fbref.com/en/players/29c91632/Abakar-Sylla"
2025,"Strasbourg","Ligue 1","Caleb Wiley","USA","DF,MF","19-300",2004,2.4,0,0,0,0,0,0,0,NA,0,3,1,2,1,1,3,0,"https://fbref.com/en/players/64796fe0/Caleb-Wiley"
2025,"Stuttgart","Bundesliga","El Bilal Touré","MLI","FW","23-014",2001,1.4,2,1,0,1,1,2,2,100,0,1,0,1,0,2,0,0,"https://fbref.com/en/players/47c609d5/El-Bilal-Toure"
2025,"Stuttgart","Bundesliga","Julian Chabot","GER","DF","26-248",1998,5.8,12,7,9,2,1,6,9,66.7,3,3,1,2,11,23,30,0,"https://fbref.com/en/players/ae7058f9/Julian-Chabot"
2025,"Stuttgart","Bundesliga","Anrie Chase","JPN","DF","20-207",2004,3.5,5,2,2,3,0,2,3,66.7,1,5,3,2,6,11,12,0,"https://fbref.com/en/players/ee2cf168/Anrie-Chase"
2025,"Stuttgart","Bundesliga","Ermedin Demirović","BIH","FW","26-206",1998,3.9,1,1,0,1,0,0,1,0,1,3,0,3,0,1,0,0,"https://fbref.com/en/players/ed79b7d3/Ermedin-Demirovic"
2025,"Stuttgart","Bundesliga","Justin Diehl","GER","DF","19-325",2004,0.3,0,0,0,0,0,0,0,NA,0,2,0,2,0,0,0,0,"https://fbref.com/en/players/d82a310a/Justin-Diehl"
2025,"Stuttgart","Bundesliga","Chris Führich","GER","FW,MF","26-282",1998,2.4,3,2,1,1,1,3,4,75,1,0,0,0,0,3,4,0,"https://fbref.com/en/players/0cf778df/Chris-Fuhrich"
2025,"Stuttgart","Bundesliga","Ramon Hendriks","NED","DF","23-091",2001,0,0,0,0,0,0,0,0,NA,0,0,0,0,2,2,0,0,"https://fbref.com/en/players/5a28ad23/Ramon-Hendriks"
2025,"Stuttgart","Bundesliga","Atakan Karazor","","MF","28-004",1996,4.9,14,4,1,8,5,7,8,87.5,1,2,0,2,4,18,6,0,"https://fbref.com/en/players/5762be5c/Atakan-Karazor"
2025,"Stuttgart","Bundesliga","Frans Krätzig","GER","DF","21-277",2003,0.6,2,1,1,0,1,1,3,33.3,2,2,1,1,0,2,1,0,"https://fbref.com/en/players/1fc08838/Frans-Kratzig"
2025,"Stuttgart","Bundesliga","Jamie Leweling","GER","FW,MF","23-234",2001,5.5,4,2,2,0,2,2,5,40,3,9,0,9,2,6,5,0,"https://fbref.com/en/players/13fe7b69/Jamie-Leweling"
2025,"Stuttgart","Bundesliga","Enzo Millot","FRA","MF","22-092",2002,4.7,5,5,0,3,2,2,9,22.2,7,8,0,8,3,8,2,0,"https://fbref.com/en/players/f76022e7/Enzo-Millot"
2025,"Stuttgart","Bundesliga","Maximilian Mittelstädt","GER","DF","27-213",1997,5.1,16,10,10,6,0,10,15,66.7,5,12,5,7,7,23,14,1,"https://fbref.com/en/players/88d4144a/Maximilian-Mittelstadt"
2025,"Stuttgart","Bundesliga","Alexander Nübel","GER","GK","28-017",1996,6,0,0,0,0,0,0,0,NA,0,0,0,0,0,0,1,0,"https://fbref.com/en/players/afb0c500/Alexander-Nubel"
2025,"Stuttgart","Bundesliga","Fabian Rieder","SUI","MF,FW","22-244",2002,2.8,5,4,1,2,2,2,6,33.3,4,3,0,3,3,8,0,0,"https://fbref.com/en/players/c2bd8585/Fabian-Rieder"
2025,"Stuttgart","Bundesliga","Anthony Rouault","FRA","DF","23-141",2001,2.8,2,1,1,1,0,2,2,100,0,4,1,3,3,5,9,0,"https://fbref.com/en/players/9b545925/Anthony-Rouault"
2025,"Stuttgart","Bundesliga","Pascal Stenzel","GER","DF","28-211",1996,1.3,1,0,1,0,0,0,1,0,1,3,1,2,0,1,4,0,"https://fbref.com/en/players/99f7e9aa/Pascal-Stenzel"
2025,"Stuttgart","Bundesliga","Angelo Stiller","GER","MF,DF","23-196",2001,5.9,8,3,5,2,1,2,6,33.3,4,7,3,4,4,12,13,1,"https://fbref.com/en/players/3b1ed320/Angelo-Stiller"
2025,"Stuttgart","Bundesliga","Deniz Undav","GER","FW,MF","28-090",1996,4.6,3,3,0,1,2,0,1,0,1,2,0,2,0,3,1,0,"https://fbref.com/en/players/dd549382/Deniz-Undav"
2025,"Stuttgart","Bundesliga","Josha Vagnoman","GER","DF","23-311",2000,3.5,3,1,2,1,0,0,1,0,1,3,1,2,3,6,7,0,"https://fbref.com/en/players/fb377d11/Josha-Vagnoman"
2025,"Stuttgart","Bundesliga","Nick Woltemade","GER","MF","22-246",2002,0.4,0,0,0,0,0,0,0,NA,0,0,0,0,0,0,0,0,"https://fbref.com/en/players/7ca196eb/Nick-Woltemade"
2025,"Stuttgart","Bundesliga","Dan-Axel Zagadou","FRA","DF,MF","25-136",1999,0.3,0,0,0,0,0,0,0,NA,0,0,0,0,1,1,1,0,"https://fbref.com/en/players/a4effc55/Dan-Axel-Zagadou"
2025,"Torino","Serie A","Che Adams","SCO","FW,MF","28-096",1996,4.3,3,2,1,1,1,0,1,0,1,2,2,0,0,3,1,0,"https://fbref.com/en/players/f2bf1b0f/Che-Adams"
2025,"Torino","Serie A","Raoul Bellanova","ITA","DF","24-153",2000,1,0,0,0,0,0,0,1,0,1,0,0,0,0,0,4,0,"https://fbref.com/en/players/e3756e72/Raoul-Bellanova"
2025,"Torino","Serie A","Aaron Ciammaglichella","ITA","MF","19-265",2005,0,0,0,0,0,0,0,0,NA,0,0,0,0,0,0,0,0,"https://fbref.com/en/players/20525799/Aaron-Ciammaglichella"
2025,"Torino","Serie A","Saúl Coco","EQG","DF","25-251",1999,6,8,5,5,3,0,1,4,25,3,10,5,5,11,19,33,2,"https://fbref.com/en/players/d0ee1652/Saul-Coco"
2025,"Torino","Serie A","Ali Dembélé","FRA","DF","20-286",2004,0.6,2,1,1,1,0,2,2,100,0,0,0,0,0,2,2,0,"https://fbref.com/en/players/eb3df7d9/Ali-Dembele"
2025,"Torino","Serie A","Gvidas Gineitis","LTU","MF","20-185",2004,1.1,4,1,2,1,1,1,2,50,1,1,1,0,1,5,7,0,"https://fbref.com/en/players/548bd0de/Gvidas-Gineitis"
2025,"Torino","Serie A","Ivan Ilić","SRB","MF","23-214",2001,5.6,2,1,0,1,1,0,4,0,4,0,0,0,4,6,3,0,"https://fbref.com/en/players/bb376bed/Ivan-Ilic"
2025,"Torino","Serie A","Yann Karamoh","FRA","FW","26-101",1998,0.5,0,0,0,0,0,0,1,0,1,1,1,0,0,0,0,0,"https://fbref.com/en/players/8b66d9cc/Yann-Karamoh"
2025,"Torino","Serie A","Valentino Lazaro","AUT","DF","28-207",1996,6.3,9,2,4,4,1,7,11,63.6,4,6,2,4,0,9,13,1,"https://fbref.com/en/players/016ff750/Valentino-Lazaro"
2025,"Torino","Serie A","Karol Linetty","POL","MF","29-258",1995,4.9,14,8,6,8,0,6,11,54.5,5,6,2,4,4,18,11,0,"https://fbref.com/en/players/d023d70f/Karol-Linetty"
2025,"Torino","Serie A","Guillermo Maripán","CHI","DF","30-164",1994,1.4,2,0,1,1,0,1,1,100,0,2,0,2,1,3,6,0,"https://fbref.com/en/players/d9764034/Guillermo-Maripan"
2025,"Torino","Serie A","Adam Masina","MAR","DF","30-289",1994,6.7,9,7,8,1,0,6,12,50,6,9,7,2,4,13,28,1,"https://fbref.com/en/players/de0f152c/Adam-Masina"
2025,"Torino","Serie A","Vanja Milinković-Savić","SRB","GK","27-240",1997,6,0,0,0,0,0,0,2,0,2,0,0,0,0,0,2,0,"https://fbref.com/en/players/9fa26bc2/Vanja-Milinkovic-Savic"
2025,"Torino","Serie A","Eybi Nije","SWE","DF","19-156",2005,0.3,2,0,2,0,0,0,1,0,1,0,0,0,0,2,0,0,"https://fbref.com/en/players/15918c9c/Eybi-Nije"
2025,"Torino","Serie A","Alberto Paleari","ITA","GK","32-049",1992,1,0,0,0,0,0,0,0,NA,0,0,0,0,0,0,2,0,"https://fbref.com/en/players/94a3606c/Alberto-Paleari"
2025,"Torino","Serie A","Marcus Pedersen","NOR","DF","24-093",2000,2.3,4,2,2,1,1,3,5,60,2,2,0,2,0,4,6,0,"https://fbref.com/en/players/596cc50e/Marcus-Pedersen"
2025,"Torino","Serie A","Samuele Ricci","ITA","MF","23-057",2001,6.6,5,3,2,2,1,4,5,80,1,6,3,3,3,8,13,1,"https://fbref.com/en/players/9823be92/Samuele-Ricci"
2025,"Torino","Serie A","Antonio Sanabria","PAR","FW,MF","28-227",1996,2.4,1,1,0,0,1,1,3,33.3,2,1,0,1,0,1,1,0,"https://fbref.com/en/players/0a447501/Antonio-Sanabria"
2025,"Torino","Serie A","Saba Sazonov","GEO","DF","22-259",2002,0,0,0,0,0,0,0,0,NA,0,1,1,0,0,0,0,0,"https://fbref.com/en/players/645dffbf/Saba-Sazonov"
2025,"Torino","Serie A","Borna Sosa","CRO","DF","26-270",1998,2.8,4,3,2,2,0,3,6,50,3,1,0,1,4,8,7,0,"https://fbref.com/en/players/af0d79a9/Borna-Sosa"
2025,"Torino","Serie A","Adrien Tameze","CMR","MF,DF","30-256",1994,2.7,2,1,0,2,0,0,5,0,5,2,2,0,8,10,3,1,"https://fbref.com/en/players/8da74c05/Adrien-Tameze"
2025,"Torino","Serie A","Nikola Vlašić","CRO","FW,MF","27-013",1997,0.4,0,0,0,0,0,0,1,0,1,0,0,0,1,1,0,0,"https://fbref.com/en/players/aa8e289e/Nikola-Vlasic"
2025,"Torino","Serie A","Mërgim Vojvoda","KVX","DF","29-259",1995,4.1,7,3,2,3,2,3,9,33.3,6,7,2,5,2,9,9,0,"https://fbref.com/en/players/be2706c0/Mergim-Vojvoda"
2025,"Torino","Serie A","Sebastian Walukiewicz","POL","DF","24-195",2000,2.7,4,1,3,0,1,2,3,66.7,1,3,0,3,6,10,15,0,"https://fbref.com/en/players/217875a4/Sebastian-Walukiewicz"
2025,"Torino","Serie A","Duván Zapata","COL","FW","33-199",1991,6.5,7,5,2,0,5,0,3,0,3,2,1,1,2,9,7,0,"https://fbref.com/en/players/d3de9af0/Duvan-Zapata"
2025,"Tottenham","Premier League","Rodrigo Bentancur","URU","MF","27-114",1997,4.3,8,6,4,4,0,5,7,71.4,2,4,0,4,11,19,4,0,"https://fbref.com/en/players/3b8674e6/Rodrigo-Bentancur"
2025,"Tottenham","Premier League","Lucas Bergvall","SWE","MF,FW","18-258",2006,0.6,5,2,0,3,2,5,7,71.4,2,0,0,0,0,5,0,0,"https://fbref.com/en/players/a109e5c8/Lucas-Bergvall"
2025,"Tottenham","Premier League","Yves Bissouma","MLI","MF","28-048",1996,2.1,5,4,2,3,0,4,7,57.1,3,2,0,2,2,7,3,0,"https://fbref.com/en/players/6c203af0/Yves-Bissouma"
2025,"Tottenham","Premier League","Radu Drăgușin","ROU","DF","22-257",2002,1.1,1,0,1,0,0,1,1,100,0,2,1,1,1,2,3,0,"https://fbref.com/en/players/620922ed/Radu-Dragusin"
2025,"Tottenham","Premier League","Archie Gray","ENG","MF,DF","18-219",2006,0.4,2,1,0,0,2,1,3,33.3,2,1,0,1,0,2,1,0,"https://fbref.com/en/players/f58515f5/Archie-Gray"
2025,"Tottenham","Premier League","Son Heung-min","KOR","FW","32-101",1992,5,2,2,0,1,1,0,4,0,4,3,0,3,2,4,4,0,"https://fbref.com/en/players/92e7e919/Son-Heung-min"
2025,"Tottenham","Premier League","Brennan Johnson","WAL","FW","23-147",2001,5.7,14,9,2,8,4,7,10,70,3,6,1,5,1,15,7,0,"https://fbref.com/en/players/0cd31129/Brennan-Johnson"
2025,"Tottenham","Premier League","Dejan Kulusevski","SWE","MF,FW","24-175",2000,5.9,5,2,1,0,4,0,7,0,7,10,2,8,5,10,7,0,"https://fbref.com/en/players/df3cda47/Dejan-Kulusevski"
2025,"Tottenham","Premier League","James Maddison","ENG","MF","27-329",1996,6.3,9,5,1,6,2,4,11,36.4,7,3,2,1,5,14,7,0,"https://fbref.com/en/players/ee38d9c5/James-Maddison"
2025,"Tottenham","Premier League","Pape Matar Sarr","SEN","MF","22-033",2002,2.4,10,6,3,6,1,0,1,0,1,5,0,5,1,11,0,0,"https://fbref.com/en/players/feb5d972/Pape-Matar-Sarr"
2025,"Tottenham","Premier League","Mikey Moore","ENG","FW","17-067",2007,0.3,0,0,0,0,0,0,0,NA,0,0,0,0,0,0,0,0,"https://fbref.com/en/players/00953a9d/Mikey-Moore"
2025,"Tottenham","Premier League","Wilson Odobert","FRA","FW","19-324",2004,1.8,5,2,2,2,1,4,6,66.7,2,1,0,1,0,5,1,1,"https://fbref.com/en/players/35516eac/Wilson-Odobert"
2025,"Tottenham","Premier League","Pedro Porro","ESP","DF","25-034",1999,7,18,12,9,5,4,12,18,66.7,6,12,5,7,10,28,16,0,"https://fbref.com/en/players/27d0a506/Pedro-Porro"
2025,"Tottenham","Premier League","Richarlison","BRA","FW,MF","27-160",1997,0.3,0,0,0,0,0,0,0,NA,0,0,0,0,0,0,2,0,"https://fbref.com/en/players/fa031b34/Richarlison"
2025,"Tottenham","Premier League","Cristian Romero","ARG","DF","26-173",1998,7,14,14,11,3,0,9,12,75,3,12,3,9,7,21,21,0,"https://fbref.com/en/players/a3d94a58/Cristian-Romero"
2025,"Tottenham","Premier League","Dominic Solanke","ENG","FW","27-033",1997,5,4,3,1,3,0,0,0,NA,0,2,0,2,0,4,4,0,"https://fbref.com/en/players/e77dc3b2/Dominic-Solanke"
2025,"Tottenham","Premier League","Djed Spence","ENG","DF","24-069",2000,0.7,2,2,2,0,0,2,2,100,0,0,0,0,2,4,1,0,"https://fbref.com/en/players/9bc9a519/Djed-Spence"
2025,"Tottenham","Premier League","Destiny Udogie","ITA","DF","21-324",2002,6.3,22,14,11,6,5,12,16,75,4,9,1,8,7,29,9,1,"https://fbref.com/en/players/7cd520e8/Destiny-Udogie"
2025,"Tottenham","Premier League","Micky van de Ven","NED","DF","23-181",2001,5.9,4,1,1,2,1,3,5,60,2,4,2,2,6,10,17,0,"https://fbref.com/en/players/8fe2a392/Micky-van-de-Ven"
2025,"Tottenham","Premier League","Guglielmo Vicario","ITA","GK","28-010",1996,7,0,0,0,0,0,0,0,NA,0,0,0,0,0,0,5,1,"https://fbref.com/en/players/77d6fd4d/Guglielmo-Vicario"
2025,"Tottenham","Premier League","Timo Werner","GER","FW","28-225",1996,2.2,2,2,1,1,0,1,2,50,1,7,1,6,1,3,2,0,"https://fbref.com/en/players/49fe9070/Timo-Werner"
2025,"Toulouse","Ligue 1","Zakaria Aboukhlal","MAR","MF,FW","24-242",2000,5.3,3,1,0,1,2,2,4,50,2,3,0,3,2,5,1,0,"https://fbref.com/en/players/c2a6033c/Zakaria-Aboukhlal"
2025,"Toulouse","Ligue 1","Ümit Akdag","ROU","DF","21-011",2003,0.9,3,2,1,2,0,3,5,60,2,1,1,0,5,8,0,0,"https://fbref.com/en/players/d746900e/Umit-Akdag"
2025,"Toulouse","Ligue 1","Shavy Babicka","GAB","MF","24-138",2000,3,7,6,3,3,1,4,5,80,1,1,0,1,0,7,0,1,"https://fbref.com/en/players/c6f0d5d4/Shavy-Babicka"
2025,"Toulouse","Ligue 1","Jaydee Canvot","FRA","DF","18-080",2006,0.1,1,1,1,0,0,1,1,100,0,0,0,0,0,1,0,0,"https://fbref.com/en/players/3684108d/Jaydee-Canvot"
2025,"Toulouse","Ligue 1","Cristian Cásseres Jr.","VEN","MF","24-271",2000,5.7,26,17,14,10,2,9,17,52.9,8,9,2,7,8,34,7,0,"https://fbref.com/en/players/f86fe8c1/Cristian-Casseres-Jr"
2025,"Toulouse","Ligue 1","Logan Costa","CPV","DF","23-199",2001,1,2,1,0,2,0,1,1,100,0,2,2,0,2,4,4,0,"https://fbref.com/en/players/bfb2056e/Logan-Costa"
2025,"Toulouse","Ligue 1","Charlie Cresswell","ENG","DF","22-061",2002,3.8,8,2,2,6,0,7,12,58.3,5,3,2,1,5,13,16,1,"https://fbref.com/en/players/4654e5f5/Charlie-Cresswell"
2025,"Toulouse","Ligue 1","Aron Dønnum","NOR","DF,MF","26-180",1998,5.1,7,4,2,5,0,2,9,22.2,7,2,0,2,2,9,8,0,"https://fbref.com/en/players/10cff752/Aron-Donnum"
2025,"Toulouse","Ligue 1","Yann Gboho","FRA","MF,FW","23-277",2001,6.8,8,3,0,6,2,3,8,37.5,5,4,0,4,0,8,0,0,"https://fbref.com/en/players/6be41a31/Yann-Gboho"
2025,"Toulouse","Ligue 1","Denis Genreau","AUS","MF","25-149",1999,0,0,0,0,0,0,0,0,NA,0,0,0,0,0,0,0,0,"https://fbref.com/en/players/badcdcae/Denis-Genreau"
2025,"Toulouse","Ligue 1","Waren Kamanzi","NOR","DF,MF","23-341",2000,4.3,16,8,7,7,2,7,15,46.7,8,1,0,1,1,17,9,0,"https://fbref.com/en/players/a426a912/Waren-Kamanzi"
2025,"Toulouse","Ligue 1","Joshua King","NOR","FW,MF","32-276",1992,2.1,1,1,0,0,1,0,0,NA,0,0,0,0,0,1,5,0,"https://fbref.com/en/players/43458538/Joshua-King"
2025,"Toulouse","Ligue 1","Frank Magri","CMR","FW,MF","25-043",1999,3.1,1,0,0,0,1,1,4,25,3,7,0,7,1,2,3,0,"https://fbref.com/en/players/42fdb11d/Frank-Magri"
2025,"Toulouse","Ligue 1","Mark McKenzie","USA","DF","25-235",1999,4.7,9,6,3,6,0,6,9,66.7,3,8,5,3,3,12,18,0,"https://fbref.com/en/players/a5f5d094/Mark-McKenzie"
2025,"Toulouse","Ligue 1","Rasmus Nicolaisen","DEN","DF","27-215",1997,6.9,6,3,4,2,0,3,5,60,2,10,5,5,10,16,25,0,"https://fbref.com/en/players/3f319bb9/Rasmus-Nicolaisen"
2025,"Toulouse","Ligue 1","Guillaume Restes","FRA","GK","19-220",2005,7,0,0,0,0,0,0,0,NA,0,0,0,0,0,0,3,0,"https://fbref.com/en/players/6b91b999/Guillaume-Restes"
2025,"Toulouse","Ligue 1","Niklas Schmidt","GER","MF","26-230",1998,1.6,3,2,1,2,0,1,2,50,1,0,0,0,0,3,2,0,"https://fbref.com/en/players/b9ae8560/Niklas-Schmidt"
2025,"Toulouse","Ligue 1","Djibril Sidibé","FRA","DF","32-080",1992,4.1,15,7,7,6,2,5,7,71.4,2,2,1,1,6,21,10,0,"https://fbref.com/en/players/4c5b714f/Djibril-Sidibe"
2025,"Toulouse","Ligue 1","Vincent Sierro","SUI","MF","29-009",1995,6.2,13,6,3,9,1,7,12,58.3,5,7,0,7,5,18,13,0,"https://fbref.com/en/players/92ffb8f9/Vincent-Sierro"
2025,"Toulouse","Ligue 1","Naatan Skyttä","FIN","FW","22-163",2002,0.1,1,0,0,0,1,0,0,NA,0,0,0,0,0,1,0,0,"https://fbref.com/en/players/d7547531/Naatan-Skytta"
2025,"Toulouse","Ligue 1","Gabriel Suazo","CHI","DF","27-069",1997,4,12,6,4,5,3,8,14,57.1,6,4,0,4,4,16,2,0,"https://fbref.com/en/players/39b326ed/Gabriel-Suazo"
2025,"Toulouse","Ligue 1","Miha Zajc","SVN","MF","30-108",1994,0.5,1,1,0,0,1,1,1,100,0,0,0,0,1,2,0,0,"https://fbref.com/en/players/83e4643e/Miha-Zajc"
2025,"Udinese","Serie A","James Abankwah","IRL","DF","20-275",2004,0,0,0,0,0,0,0,0,NA,0,0,0,0,0,0,0,0,"https://fbref.com/en/players/4b7a9fcc/James-Abankwah"
2025,"Udinese","Serie A","Arthur Atta","FRA","MF","21-277",2003,0.3,2,2,0,1,1,0,0,NA,0,0,0,0,0,2,0,0,"https://fbref.com/en/players/d3ddf88b/Arthur-Atta"
2025,"Udinese","Serie A","Jaka Bijol","SVN","DF","25-255",1999,7,16,9,12,4,0,10,14,71.4,4,12,7,5,10,26,33,1,"https://fbref.com/en/players/6fdac234/Jaka-Bijol"
2025,"Udinese","Serie A","Iker Bravo","ESP","MF,FW","19-278",2005,0.6,1,1,0,1,0,0,1,0,1,0,0,0,0,1,1,0,"https://fbref.com/en/players/db8c8860/Iker-Bravo"
2025,"Udinese","Serie A","Brenner","BRA","MF,FW","24-275",2000,4.1,5,3,1,3,1,2,7,28.6,5,4,0,4,1,6,5,0,"https://fbref.com/en/players/279508bf/Brenner"
2025,"Udinese","Serie A","Keinan Davis","ENG","FW","26-247",1998,2.3,1,1,0,1,0,0,1,0,1,0,0,0,1,2,0,0,"https://fbref.com/en/players/9deaf2c8/Keinan-Davis"
2025,"Udinese","Serie A","Kingsley Ehizibue","NED","DF","29-145",1995,6.7,11,7,7,4,0,6,15,40,9,9,4,5,7,18,20,1,"https://fbref.com/en/players/76b2817e/Kingsley-Ehizibue"
2025,"Udinese","Serie A","Jurgen Ekkelenkamp","NED","MF","24-195",2000,3.2,6,4,1,5,0,4,5,80,1,5,0,5,3,9,4,0,"https://fbref.com/en/players/73d6a176/Jurgen-Ekkelenkamp"
2025,"Udinese","Serie A","Lautaro Gianetti","ARG","DF","30-339",1993,3.3,6,4,5,0,1,1,6,16.7,5,7,3,4,8,14,12,0,"https://fbref.com/en/players/e08ac719/Lautaro-Gianetti"
2025,"Udinese","Serie A","Christian Kabasele","BEL","DF","33-236",1991,4.4,7,5,4,3,0,3,3,100,0,3,0,3,6,13,16,1,"https://fbref.com/en/players/914ab9a1/Christian-Kabasele"
2025,"Udinese","Serie A","Hassane Kamara","CIV","DF","30-226",1994,3.6,9,5,4,4,1,1,2,50,1,4,1,3,6,15,10,0,"https://fbref.com/en/players/19a12bed/Hassane-Kamara"
2025,"Udinese","Serie A","Jesper Karlström","SWE","MF","29-118",1995,6.2,11,5,6,4,1,1,6,16.7,5,6,3,3,10,21,16,0,"https://fbref.com/en/players/e0a1f4eb/Jesper-Karlstrom"
2025,"Udinese","Serie A","Thomas Kristensen","DEN","DF","22-274",2002,2.1,2,1,1,1,0,1,2,50,1,1,1,0,0,2,7,0,"https://fbref.com/en/players/fadf9a05/Thomas-Kristensen"
2025,"Udinese","Serie A","Sandi Lovrić","SVN","MF","26-203",1998,3.5,7,5,4,2,1,4,8,50,4,4,0,4,5,12,1,0,"https://fbref.com/en/players/966eea58/Sandi-Lovric"
2025,"Udinese","Serie A","Lorenzo Lucca","ITA","FW","24-037",2000,5.1,7,4,1,2,4,3,5,60,2,2,0,2,1,8,2,0,"https://fbref.com/en/players/83c06f3a/Lorenzo-Lucca"
2025,"Udinese","Serie A","Maduka Okoye","NGA","GK","25-050",1999,7,0,0,0,0,0,0,0,NA,0,0,0,0,0,0,3,1,"https://fbref.com/en/players/ab5c36dd/Maduka-Okoye"
2025,"Udinese","Serie A","Martín Payero","ARG","MF","26-036",1998,2.4,4,2,1,2,1,1,2,50,1,1,1,0,3,7,4,0,"https://fbref.com/en/players/bdbff2b5/Martin-Payero"
2025,"Udinese","Serie A","Nehuén Pérez","ARG","DF","24-115",2000,2,1,1,0,0,1,0,1,0,1,2,2,0,1,2,7,0,"https://fbref.com/en/players/f7c491f1/Nehuen-Perez"
2025,"Udinese","Serie A","Florian Thauvin","FRA","MF,FW","31-265",1993,5,5,5,4,0,1,4,7,57.1,3,2,0,2,2,7,2,0,"https://fbref.com/en/players/2b9fdeea/Florian-Thauvin"
2025,"Udinese","Serie A","Souleymane Touré","FRA","DF","21-203",2003,2.2,2,2,2,0,0,1,1,100,0,4,2,2,3,5,4,0,"https://fbref.com/en/players/01fd01e8/Souleymane-Toure"
2025,"Udinese","Serie A","Oier Zarraga","ESP","MF","25-287",1999,2.2,3,1,1,2,0,2,5,40,3,1,1,0,1,4,0,0,"https://fbref.com/en/players/968a1c2f/Oier-Zarraga"
2025,"Udinese","Serie A","Jordan Zemura","ZIM","DF","24-338",1999,3.4,5,2,3,0,2,3,6,50,3,8,1,7,4,9,3,0,"https://fbref.com/en/players/e8271ad9/Jordan-Zemura"
2025,"Union Berlin","Bundesliga","László Bénes","SVK","MF,FW","27-038",1997,1.5,0,0,0,0,0,0,1,0,1,1,1,0,0,0,1,0,"https://fbref.com/en/players/fe888e39/Laszlo-Benes"
2025,"Union Berlin","Bundesliga","Danilho Doekhi","NED","DF","26-109",1998,6,6,4,3,1,2,3,5,60,2,9,2,7,3,9,19,0,"https://fbref.com/en/players/f67c9d29/Danilho-Doekhi"
2025,"Union Berlin","Bundesliga","Robin Gosens","GER","DF","30-104",1994,1,0,0,0,0,0,0,3,0,3,1,0,1,1,1,2,0,"https://fbref.com/en/players/2d970560/Robin-Gosens"
2025,"Union Berlin","Bundesliga","Janik Haberer","GER","DF,MF","30-198",1994,4,7,5,3,3,1,7,12,58.3,5,1,0,1,1,8,7,0,"https://fbref.com/en/players/70dcf94d/Janik-Haberer"
2025,"Union Berlin","Bundesliga","Benedict Hollerbach","GER","MF,FW","23-153",2001,4.7,10,4,3,5,2,5,5,100,0,7,0,7,1,11,0,0,"https://fbref.com/en/players/2a158218/Benedict-Hollerbach"
2025,"Union Berlin","Bundesliga","Aljoscha Kemlein","GER","MF","20-076",2004,0.8,2,1,1,1,0,0,1,0,1,0,0,0,1,3,1,0,"https://fbref.com/en/players/4658e309/Aljoscha-Kemlein"
2025,"Union Berlin","Bundesliga","Rani Khedira","GER","MF","30-264",1994,6,10,6,3,6,1,4,6,66.7,2,4,2,2,9,19,9,0,"https://fbref.com/en/players/59e4b92e/Rani-Khedira"
2025,"Union Berlin","Bundesliga","Diogo Leite","POR","DF","25-268",1999,6,20,11,14,5,1,9,16,56.3,7,14,6,8,12,32,21,0,"https://fbref.com/en/players/c4987edc/Diogo-Leite"
2025,"Union Berlin","Bundesliga","Jordan Pefok","USA","FW","28-174",1996,4,3,2,2,0,1,0,2,0,2,2,0,2,3,6,5,0,"https://fbref.com/en/players/b684a484/Jordan-Pefok"
2025,"Union Berlin","Bundesliga","Leopold Querfeld","AUT","DF","20-302",2003,1.2,2,0,2,0,0,2,3,66.7,1,2,1,1,1,3,13,0,"https://fbref.com/en/players/9fd158d6/Leopold-Querfeld"
2025,"Union Berlin","Bundesliga","Tom Rothe","GER","DF,MF","19-354",2004,4.2,17,8,12,5,0,9,14,64.3,5,9,3,6,5,22,10,1,"https://fbref.com/en/players/90c1f9a4/Tom-Rothe"
2025,"Union Berlin","Bundesliga","Frederik Rønnow","DEN","GK","32-074",1992,6,0,0,0,0,0,0,0,NA,0,0,0,0,0,0,5,0,"https://fbref.com/en/players/a70b8345/Frederik-Ronnow"
2025,"Union Berlin","Bundesliga","András Schäfer","HUN","MF","25-187",1999,4.2,13,7,6,6,1,10,15,66.7,5,8,1,7,4,17,8,0,"https://fbref.com/en/players/049751d7/Andras-Schafer"
2025,"Union Berlin","Bundesliga","Tim Skarke","GER","FW,MF","28-040",1996,1.9,2,2,1,1,0,2,5,40,3,2,0,2,0,2,4,0,"https://fbref.com/en/players/65857fdf/Tim-Skarke"
2025,"Union Berlin","Bundesliga","Lucas Tousart","FRA","MF","27-171",1997,1.4,1,1,0,1,0,0,2,0,2,3,1,2,1,2,2,0,"https://fbref.com/en/players/71ec39ef/Lucas-Tousart"
2025,"Union Berlin","Bundesliga","Christopher Trimmel","AUT","DF,MF","37-236",1987,2.2,7,6,5,2,0,5,8,62.5,3,2,0,2,1,8,6,0,"https://fbref.com/en/players/056d2d95/Christopher-Trimmel"
2025,"Union Berlin","Bundesliga","Yorbe Vertessen","BEL","MF,FW","23-283",2001,2.8,3,1,2,1,0,0,1,0,1,3,0,3,0,3,1,0,"https://fbref.com/en/players/e8ef59da/Yorbe-Vertessen"
2025,"Union Berlin","Bundesliga","Kevin Vogt","GER","DF","33-024",1991,5.6,2,2,1,1,0,1,4,25,3,4,1,3,2,4,25,0,"https://fbref.com/en/players/1d8e9add/Kevin-Vogt"
2025,"Union Berlin","Bundesliga","Jeong Woo-yeong","KOR","MF,FW","25-027",1999,2.4,1,1,0,1,0,0,1,0,1,0,0,0,2,3,0,0,"https://fbref.com/en/players/6190474d/Jeong-Woo-yeong"
2025,"Valencia","La Liga","Domingos André Ribeiro Almeida","POR","FW,MF","24-140",2000,4.6,11,7,5,4,2,4,6,66.7,2,5,1,4,2,13,2,0,"https://fbref.com/en/players/e6697917/Domingos-Andre-Ribeiro-Almeida"
2025,"Valencia","La Liga","Enzo Barrenechea","ARG","MF","23-148",2001,2.3,5,1,3,2,0,3,6,50,3,3,0,3,2,7,7,0,"https://fbref.com/en/players/6caffe81/Enzo-Barrenechea"
2025,"Valencia","La Liga","Sergi Canós","ESP","MF,FW","27-258",1997,1.4,5,4,0,3,2,2,5,40,3,2,0,2,2,7,1,0,"https://fbref.com/en/players/1137759d/Sergi-Canos"
2025,"Valencia","La Liga","Thierry Correia","POR","DF","25-222",1999,7.1,21,14,17,2,2,11,17,64.7,6,9,1,8,4,25,14,0,"https://fbref.com/en/players/c78b352d/Thierry-Correia"
2025,"Valencia","La Liga","Hugo Duro","ESP","FW","24-342",1999,5.8,4,4,2,2,0,0,0,NA,0,3,0,3,4,8,5,0,"https://fbref.com/en/players/37e103f8/Hugo-Duro"
2025,"Valencia","La Liga","Dimitri Foulquier","FRA","DF","31-208",1993,4.8,13,8,4,6,3,7,11,63.6,4,4,0,4,0,13,7,1,"https://fbref.com/en/players/45e17712/Dimitri-Foulquier"
2025,"Valencia","La Liga","Yarek Gasiorowski","ESP","DF","19-279",2005,3,7,5,6,1,0,4,7,57.1,3,6,3,3,3,10,13,0,"https://fbref.com/en/players/20a65cdf/Yarek-Gasiorowski"
2025,"Valencia","La Liga","Dani Gómez","ESP","FW","26-079",1998,3.6,2,1,0,0,2,0,0,NA,0,1,0,1,2,4,3,0,"https://fbref.com/en/players/0e5ddc7c/Dani-Gomez"
2025,"Valencia","La Liga","Javier Guerra","ESP","MF,FW","21-290",2003,4.6,9,5,4,3,2,6,10,60,4,1,0,1,0,9,7,1,"https://fbref.com/en/players/3828f130/Javier-Guerra"
2025,"Valencia","La Liga","Hugo Guillamón","ESP","MF","24-260",2000,3.4,6,4,0,5,1,4,5,80,1,2,1,1,5,11,6,0,"https://fbref.com/en/players/f7c12fbf/Hugo-Guillamon"
2025,"Valencia","La Liga","Diego López","ESP","MF,FW","22-157",2002,7.3,5,4,1,2,2,4,14,28.6,10,5,0,5,2,7,1,0,"https://fbref.com/en/players/c487901c/Diego-Lopez"
2025,"Valencia","La Liga","Giorgi Mamardashvili","GEO","GK","24-018",2000,9,0,0,0,0,0,0,0,NA,0,0,0,0,0,0,2,0,"https://fbref.com/en/players/d4b73232/Giorgi-Mamardashvili"
2025,"Valencia","La Liga","Alberto Marí","ESP","FW","23-098",2001,0.1,0,0,0,0,0,0,0,NA,0,0,0,0,0,0,0,0,"https://fbref.com/en/players/44330c36/Alberto-Mari"
2025,"Valencia","La Liga","Rafa Mir","ESP","MF,FW","27-121",1997,2.7,6,3,4,2,0,1,3,33.3,2,1,0,1,0,6,5,0,"https://fbref.com/en/players/bbf5c11b/Rafa-Mir"
2025,"Valencia","La Liga","Cristhian Mosquera","ESP","DF","20-112",2004,9,6,3,5,1,0,1,3,33.3,2,11,7,4,10,16,26,0,"https://fbref.com/en/players/dc1ce4f5/Cristhian-Mosquera"
2025,"Valencia","La Liga","David Otorbi","ESP","MF","17-001",2007,0.2,0,0,0,0,0,0,0,NA,0,1,0,1,0,0,0,0,"https://fbref.com/en/players/c83e3553/David-Otorbi"
2025,"Valencia","La Liga","Francisco Perez","ESP","MF","22-038",2002,0.3,1,1,0,1,0,0,1,0,1,1,0,1,0,1,1,0,"https://fbref.com/en/players/3d79a68c/Francisco-Perez"
2025,"Valencia","La Liga","Luis Rioja","ESP","MF,FW","31-001",1993,6.9,6,4,0,3,3,2,10,20,8,8,0,8,11,17,7,0,"https://fbref.com/en/players/eb3dd471/Luis-Rioja"
2025,"Valencia","La Liga","César Tárrega","ESP","DF","22-234",2002,7,8,7,4,3,1,3,5,60,2,6,5,1,4,12,33,1,"https://fbref.com/en/players/59c29820/Cesar-Tarrega"
2025,"Valencia","La Liga","Martín Tejón","ESP","MF,DF","20-188",2004,0.5,2,0,0,2,0,1,2,50,1,0,0,0,0,2,0,0,"https://fbref.com/en/players/f99cc198/Martin-Tejon"
2025,"Valencia","La Liga","Germán Valera","ESP","MF,FW","22-215",2002,0.3,0,0,0,0,0,0,0,NA,0,0,0,0,3,3,1,0,"https://fbref.com/en/players/84f55b4a/German-Valera"
2025,"Valencia","La Liga","José Luis García Vayá","ESP","MF","26-067",1998,8.7,15,9,7,6,2,3,11,27.3,8,9,2,7,2,17,13,0,"https://fbref.com/en/players/27dc1378/Jose-Luis-Garcia-Vaya"
2025,"Valencia","La Liga","Jesus Vazquez","ESP","DF","21-289",2003,6.2,16,13,8,6,2,5,12,41.7,7,11,5,6,5,21,19,0,"https://fbref.com/en/players/106c142c/Jesus-Vazquez"
2025,"Valladolid","La Liga","Selim Amallah","MAR","MF","27-337",1996,5.1,10,6,4,5,1,0,5,0,5,12,0,12,5,15,1,0,"https://fbref.com/en/players/00eba9c9/Selim-Amallah"
2025,"Valladolid","La Liga","Amath","SEN","FW,DF","28-093",1996,3.3,1,0,1,0,0,1,5,20,4,5,1,4,2,3,2,0,"https://fbref.com/en/players/f3b1d9a2/Amath"
2025,"Valladolid","La Liga","Marcos André","BRA","FW","27-363",1996,2.8,0,0,0,0,0,0,2,0,2,3,1,2,1,1,2,0,"https://fbref.com/en/players/ae86d473/Marcos-Andre"
2025,"Valladolid","La Liga","Anuar","MAR","FW","29-276",1995,0.3,0,0,0,0,0,0,0,NA,0,0,0,0,1,1,0,0,"https://fbref.com/en/players/c93231dc/Anuar"
2025,"Valladolid","La Liga","Enzo Boyomo","CMR","DF","23-010",2001,3,6,2,4,2,0,3,3,100,0,4,3,1,1,7,7,0,"https://fbref.com/en/players/3a99bc13/Enzo-Boyomo"
2025,"Valladolid","La Liga","Raúl Chasco","ESP","DF","21-034",2003,0.4,1,1,1,0,0,0,1,0,1,1,0,1,1,2,2,0,"https://fbref.com/en/players/61d964b8/Raul-Chasco"
2025,"Valladolid","La Liga","Eray Cömert","SUI","DF,MF","26-256",1998,6.2,8,3,4,4,0,5,9,55.6,4,10,7,3,6,14,21,1,"https://fbref.com/en/players/15937e17/Eray-Comert"
2025,"Valladolid","La Liga","Karl Jakob Hein","EST","GK","22-187",2002,9,0,0,0,0,0,0,1,0,1,0,0,0,0,0,4,0,"https://fbref.com/en/players/aa81d8f8/Karl-Jakob-Hein"
2025,"Valladolid","La Liga","Abdulai Juma Bah","SLE","DF","18-189",2006,2.9,4,3,2,2,0,0,2,0,2,4,2,2,4,8,14,0,"https://fbref.com/en/players/7b505397/Abdulai-Juma-Bah"
2025,"Valladolid","La Liga","Stanko Jurić","CRO","MF","28-062",1996,6.1,19,10,12,6,1,11,23,47.8,12,10,4,6,8,27,19,0,"https://fbref.com/en/players/21a87181/Stanko-Juric"
2025,"Valladolid","La Liga","Kenedy","BRA","MF","28-252",1996,0.1,0,0,0,0,0,0,0,NA,0,1,0,1,0,0,0,0,"https://fbref.com/en/players/5eebbfdf/Kenedy"
2025,"Valladolid","La Liga","Juanmi Latasa","ESP","FW","23-208",2001,4.6,1,0,0,1,0,0,2,0,2,1,0,1,0,1,4,0,"https://fbref.com/en/players/2bea832e/Juanmi-Latasa"
2025,"Valladolid","La Liga","Darwin Machís","VEN","FW,MF","31-253",1993,3,0,0,0,0,0,0,4,0,4,2,0,2,1,1,3,0,"https://fbref.com/en/players/ed6ea4d9/Darwin-Machis"
2025,"Valladolid","La Liga","Mario Maroto","ESP","MF","20-324",2003,0.2,0,0,0,0,0,0,1,0,1,0,0,0,2,2,1,0,"https://fbref.com/en/players/b518c5ab/Mario-Maroto"
2025,"Valladolid","La Liga","Mario Martín","ESP","MF","20-226",2004,4.1,15,8,7,7,1,8,16,50,8,2,1,1,2,17,5,1,"https://fbref.com/en/players/a9aff11a/Mario-Martin"
2025,"Valladolid","La Liga","Víctor Meseguer","ESP","MF","25-130",1999,2.9,7,5,4,2,1,1,6,16.7,5,3,0,3,0,7,3,1,"https://fbref.com/en/players/428a06a7/Victor-Meseguer"
2025,"Valladolid","La Liga","Raúl Moro","ESP","FW,MF","21-317",2002,6.5,8,6,5,2,1,4,11,36.4,7,3,0,3,6,14,2,0,"https://fbref.com/en/players/919dd4b1/Raul-Moro"
2025,"Valladolid","La Liga","Lucas Oliveira Rosa","BRA","DF","24-197",2000,9,21,15,16,4,1,13,19,68.4,6,10,6,4,12,33,24,1,"https://fbref.com/en/players/5132b92c/Lucas-Oliveira-Rosa"
2025,"Valladolid","La Liga","Cenk Özkacar","TUR","DF","24-011",2000,1.2,2,2,2,0,0,2,5,40,3,2,1,1,3,5,7,0,"https://fbref.com/en/players/9a93efc9/Cenk-Ozkacar"
2025,"Valladolid","La Liga","Kike Pérez","ESP","MF","27-246",1997,5.8,18,12,6,12,0,6,14,42.9,8,7,3,4,4,22,3,0,"https://fbref.com/en/players/237a3851/Kike-Perez"
2025,"Valladolid","La Liga","Luis Pérez","ESP","DF","29-256",1995,8.6,16,10,8,4,4,9,13,69.2,4,13,2,11,9,25,21,0,"https://fbref.com/en/players/b7c04927/Luis-Perez"
2025,"Valladolid","La Liga","Chuky san jose","ESP","MF,FW","20-171",2004,1,1,0,0,0,1,1,1,100,0,2,0,2,0,1,0,0,"https://fbref.com/en/players/0525a80f/Chuky-san-jose"
2025,"Valladolid","La Liga","Iván Sánchez","ESP","MF,FW","32-024",1992,4.1,10,7,7,2,1,3,10,30,7,4,1,3,6,16,2,0,"https://fbref.com/en/players/70107d4d/Ivan-Sanchez"
2025,"Valladolid","La Liga","Javi Sánchez","ESP","DF","27-217",1997,2.7,2,2,1,1,0,2,3,66.7,1,5,3,2,2,4,13,0,"https://fbref.com/en/players/60359288/Javi-Sanchez"
2025,"Valladolid","La Liga","Mamadou Sylla","SEN","FW","30-211",1994,2.4,0,0,0,0,0,0,0,NA,0,1,0,1,0,0,1,1,"https://fbref.com/en/players/e5ec95f8/Mamadou-Sylla"
2025,"Valladolid","La Liga","David Torres","ESP","DF","21-226",2003,3.7,2,2,2,0,0,1,1,100,0,9,8,1,1,3,17,0,"https://fbref.com/en/players/381dbcfc/David-Torres"
2025,"Venezia","Serie A","Giorgio Altare","ITA","DF","26-069",1998,2.2,5,4,4,1,0,1,4,25,3,3,2,1,4,9,9,0,"https://fbref.com/en/players/aa5322d5/Giorgio-Altare"
2025,"Venezia","Serie A","Gianluca Busio","USA","MF","22-142",2002,3.8,5,3,4,1,0,4,6,66.7,2,5,2,3,1,6,9,0,"https://fbref.com/en/players/4a0b7f07/Gianluca-Busio"
2025,"Venezia","Serie A","Antonio Candela","ITA","DF","24-173",2000,5.9,10,7,6,3,1,6,8,75,2,4,3,1,2,12,8,0,"https://fbref.com/en/players/d4307c52/Antonio-Candela"
2025,"Venezia","Serie A","Franco Carboni","ITA","DF","21-196",2003,0,0,0,0,0,0,0,0,NA,0,0,0,0,0,0,1,0,"https://fbref.com/en/players/b033f803/Franco-Carboni"
2025,"Venezia","Serie A","Domen Črnigoj","SVN","MF","28-334",1995,0.4,3,1,0,0,3,1,1,100,0,2,1,1,1,4,3,0,"https://fbref.com/en/players/22cd43d2/Domen-Crnigoj"
2025,"Venezia","Serie A","Issa Doumbia","CIV","MF","21-001",2003,1.6,3,1,1,2,0,3,4,75,1,3,1,2,1,4,2,0,"https://fbref.com/en/players/b74fc282/Issa-Doumbia"
2025,"Venezia","Serie A","Alfred Duncan","GHA","MF","31-221",1993,3.7,9,3,3,6,0,2,7,28.6,5,1,0,1,5,14,2,0,"https://fbref.com/en/players/528492ea/Alfred-Duncan"
2025,"Venezia","Serie A","Mikael Ellertsson","ISL","MF","22-220",2002,4.8,5,1,0,3,2,1,3,33.3,2,7,2,5,0,5,12,0,"https://fbref.com/en/players/c55967eb/Mikael-Ellertsson"
2025,"Venezia","Serie A","Christian Gytkjær","DEN","FW","34-164",1990,1.9,1,1,1,0,0,1,2,50,1,1,1,0,0,1,3,0,"https://fbref.com/en/players/9250bcff/Christian-Gytkjaer"
2025,"Venezia","Serie A","Saad El Haddad","MAR","MF","19-085",2005,0.2,0,0,0,0,0,0,0,NA,0,0,0,0,0,0,0,0,"https://fbref.com/en/players/7b12dccc/Saad-El-Haddad"
2025,"Venezia","Serie A","Ridgeciano Haps","SUR","DF","31-127",1993,3,7,5,6,0,1,4,5,80,1,0,0,0,0,7,10,0,"https://fbref.com/en/players/c8d7131c/Ridgeciano-Haps"
2025,"Venezia","Serie A","Jay Idzes","IDN","DF","24-137",2000,5.7,5,3,3,2,0,1,2,50,1,7,4,3,2,7,18,0,"https://fbref.com/en/players/a54ef587/Jay-Idzes"
2025,"Venezia","Serie A","Jesse Joronen","FIN","GK","31-210",1993,7,0,0,0,0,0,0,0,NA,0,0,0,0,0,0,3,0,"https://fbref.com/en/players/7f66ea09/Jesse-Joronen"
2025,"Venezia","Serie A","Magnus Kofod Andersen","DEN","MF","25-160",1999,3,5,0,1,4,0,0,2,0,2,1,0,1,3,8,2,0,"https://fbref.com/en/players/a4731ebc/Magnus-Kofod-Andersen"
2025,"Venezia","Serie A","Nunzio Lella","ITA","MF","24-081",2000,0.1,0,0,0,0,0,0,0,NA,0,0,0,0,0,0,0,0,"https://fbref.com/en/players/c149e8a6/Nunzio-Lella"
2025,"Venezia","Serie A","Hans Nicolussi Caviglia","ITA","MF","24-121",2000,3.6,7,2,0,3,4,4,6,66.7,2,3,2,1,3,10,4,0,"https://fbref.com/en/players/b136c945/Hans-Nicolussi-Caviglia"
2025,"Venezia","Serie A","Gaetano Oristanio","ITA","MF,FW","22-019",2002,5,6,4,3,2,1,3,4,75,1,6,0,6,2,8,3,0,"https://fbref.com/en/players/5cfc74fc/Gaetano-Oristanio"
2025,"Venezia","Serie A","Nicholas Pierini","ITA","MF","26-072",1998,0.9,0,0,0,0,0,0,1,0,1,2,0,2,0,0,0,0,"https://fbref.com/en/players/7cc89a5f/Nicholas-Pierini"
2025,"Venezia","Serie A","Joel Pohjanpalo","FIN","FW","30-034",1994,4.4,1,1,1,0,0,0,0,NA,0,1,1,0,2,3,3,0,"https://fbref.com/en/players/ea003d07/Joel-Pohjanpalo"
2025,"Venezia","Serie A","Antonio Raimondo","ITA","FW,DF","20-213",2004,0.9,2,1,1,1,0,0,0,NA,0,0,0,0,0,2,0,1,"https://fbref.com/en/players/ce1a6c7e/Antonio-Raimondo"
2025,"Venezia","Serie A","Richie Sagrado","BEL","DF","20-261",2004,0.6,1,1,0,1,0,0,0,NA,0,0,0,0,0,1,1,0,"https://fbref.com/en/players/3e3190f1/Richie-Sagrado"
2025,"Venezia","Serie A","Joël Schingtienne","BEL","DF","22-066",2002,1,4,4,3,1,0,1,1,100,0,1,0,1,1,5,1,0,"https://fbref.com/en/players/35a4790e/Joel-Schingtienne"
2025,"Venezia","Serie A","Marin Šverko","CRO","DF","26-256",1998,3.9,4,3,3,1,0,2,2,100,0,4,1,3,7,11,13,1,"https://fbref.com/en/players/06dba850/Marin-Sverko"
2025,"Venezia","Serie A","Michael Svoboda","AUT","DF","26-002",1998,6.3,14,7,10,3,1,4,10,40,6,14,9,5,7,21,24,2,"https://fbref.com/en/players/8abd174d/Michael-Svoboda"
2025,"Venezia","Serie A","John Yeboah","ECU","FW,MF","24-116",2000,0.8,2,2,0,1,1,0,1,0,1,1,0,1,0,2,0,0,"https://fbref.com/en/players/8dfdc6c3/John-Yeboah"
2025,"Venezia","Serie A","Francesco Zampano","ITA","DF","31-017",1993,6.3,12,9,7,4,1,4,11,36.4,7,5,0,5,4,16,13,2,"https://fbref.com/en/players/8e45910b/Francesco-Zampano"
2025,"Villarreal","La Liga","Ilias Akhomach","MAR","MF","20-184",2004,4.3,12,7,4,4,4,6,11,54.5,5,6,0,6,3,15,9,0,"https://fbref.com/en/players/b8bd60fe/Ilias-Akhomach"
2025,"Villarreal","La Liga","Raúl Albiol","ESP","DF","39-043",1985,5.2,2,2,2,0,0,1,2,50,1,6,6,0,2,4,39,0,"https://fbref.com/en/players/4bd414c1/Raul-Albiol"
2025,"Villarreal","La Liga","Alex Baena","ESP","MF,FW","23-089",2001,6.4,2,1,0,1,1,1,5,20,4,10,1,9,7,9,2,0,"https://fbref.com/en/players/518f2234/Alex-Baena"
2025,"Villarreal","La Liga","Eric Bailly","CIV","DF","30-188",1994,5.4,9,2,5,4,0,2,3,66.7,1,8,3,5,5,14,19,0,"https://fbref.com/en/players/a1232f4e/Eric-Bailly"
2025,"Villarreal","La Liga","Thierno Barry","FRA","FW","21-362",2002,6,1,0,0,1,0,1,3,33.3,2,3,0,3,0,1,4,0,"https://fbref.com/en/players/52c3244b/Thierno-Barry"
2025,"Villarreal","La Liga","Juan Bernat","ESP","DF,MF","31-230",1993,0.3,2,1,1,0,1,1,2,50,1,1,0,1,0,2,0,0,"https://fbref.com/en/players/433dc9a2/Juan-Bernat"
2025,"Villarreal","La Liga","Pau Cabanes","ESP","MF","19-243",2005,0.2,0,0,0,0,0,0,0,NA,0,0,0,0,0,0,1,0,"https://fbref.com/en/players/53440b64/Pau-Cabanes"
2025,"Villarreal","La Liga","Sergi Cardona","ESP","DF","25-101",1999,8.8,20,13,13,6,1,12,23,52.2,11,19,2,17,8,28,32,0,"https://fbref.com/en/players/74e90475/Sergi-Cardona"
2025,"Villarreal","La Liga","Santi Comesaña","ESP","MF","28-012",1996,7.5,16,11,9,7,0,4,13,30.8,9,13,5,8,8,24,8,0,"https://fbref.com/en/players/5ae499d0/Santi-Comesana"
2025,"Villarreal","La Liga","Diego Conde","ESP","GK","25-355",1998,9,2,2,2,0,0,2,4,50,2,0,0,0,1,3,4,1,"https://fbref.com/en/players/4eae5bc4/Diego-Conde"
2025,"Villarreal","La Liga","Logan Costa","CPV","DF","23-199",2001,6.2,4,3,3,1,0,3,3,100,0,4,4,0,4,8,26,0,"https://fbref.com/en/players/bfb2056e/Logan-Costa"
2025,"Villarreal","La Liga","Arnaut Danjuma","NED","FW","27-260",1997,2.2,2,1,0,1,1,0,1,0,1,1,0,1,0,2,0,0,"https://fbref.com/en/players/f08490a6/Arnaut-Danjuma"
2025,"Villarreal","La Liga","Kiko Femenía","ESP","DF","33-258",1991,9,18,11,13,4,1,12,23,52.2,11,13,6,7,14,32,16,0,"https://fbref.com/en/players/e5d01ecf/Kiko-Femenia"
2025,"Villarreal","La Liga","Pape Gueye","SEN","MF","25-267",1999,5.3,12,6,6,4,2,7,8,87.5,1,3,0,3,7,19,11,0,"https://fbref.com/en/players/7155e3e1/Pape-Gueye"
2025,"Villarreal","La Liga","Willy Kambwala","FRA","DF","20-053",2004,1,4,2,3,0,1,2,2,100,0,1,1,0,0,4,6,0,"https://fbref.com/en/players/6a7353d7/Willy-Kambwala"
2025,"Villarreal","La Liga","Gerard Moreno","ESP","FW","32-193",1992,1.3,2,2,0,0,2,1,1,100,0,0,0,0,0,2,1,0,"https://fbref.com/en/players/81f0781e/Gerard-Moreno"
2025,"Villarreal","La Liga","Pau Navarro","ESP","DF","19-175",2005,0.2,0,0,0,0,0,0,0,NA,0,0,0,0,0,0,4,0,"https://fbref.com/en/players/3171351c/Pau-Navarro"
2025,"Villarreal","La Liga","Daniel Parejo","ESP","MF","35-184",1989,6.4,9,7,5,3,1,3,13,23.1,10,4,1,3,4,13,10,1,"https://fbref.com/en/players/7460ca0d/Daniel-Parejo"
2025,"Villarreal","La Liga","Nicolas Pépé","CIV","FW,MF","29-141",1995,4.2,3,0,1,1,1,0,3,0,3,2,1,1,3,6,2,0,"https://fbref.com/en/players/57e3f0c7/Nicolas-Pepe"
2025,"Villarreal","La Liga","Ayoze Pérez","ESP","FW","31-080",1993,4.6,4,2,1,3,0,1,6,16.7,5,4,0,4,2,6,5,0,"https://fbref.com/en/players/819aa8e7/Ayoze-Perez"
2025,"Villarreal","La Liga","Yeremi Pino","ESP","MF","21-363",2002,3.6,9,6,2,5,2,5,11,45.5,6,5,1,4,1,10,3,0,"https://fbref.com/en/players/540ec57b/Yeremi-Pino"
2025,"Villarreal","La Liga","Denis Suárez","ESP","MF","30-285",1994,0.9,1,1,1,0,0,1,2,50,1,1,1,0,0,1,1,0,"https://fbref.com/en/players/12c50af5/Denis-Suarez"
2025,"Villarreal","La Liga","Ramón Terrats","ESP","MF","23-365",2000,0.8,3,3,1,2,0,2,3,66.7,1,2,1,1,1,4,3,0,"https://fbref.com/en/players/f36016a5/Ramon-Terrats"
2025,"Werder Bremen","Bundesliga","Felix Agu","GER","DF","25-020",1999,5.6,8,4,5,2,1,4,7,57.1,3,4,1,3,5,13,16,0,"https://fbref.com/en/players/cb6d81b3/Felix-Agu"
2025,"Werder Bremen","Bundesliga","Skelly Alvero","FRA","MF","22-166",2002,1.1,3,3,3,0,0,1,1,100,0,4,0,4,2,5,5,0,"https://fbref.com/en/players/add37c13/Skelly-Alvero"
2025,"Werder Bremen","Bundesliga","Leonardo Bittencourt","GER","MF","30-303",1993,0.4,0,0,0,0,0,0,0,NA,0,1,0,1,0,0,0,0,"https://fbref.com/en/players/dc62fbee/Leonardo-Bittencourt"
2025,"Werder Bremen","Bundesliga","Oliver Burke","SCO","DF","27-193",1997,0.1,0,0,0,0,0,0,0,NA,0,0,0,0,0,0,0,0,"https://fbref.com/en/players/f631c17f/Oliver-Burke"
2025,"Werder Bremen","Bundesliga","Olivier Deman","BEL","DF","24-194",2000,0.3,3,1,0,3,0,1,5,20,4,0,0,0,0,3,2,0,"https://fbref.com/en/players/13210854/Olivier-Deman"
2025,"Werder Bremen","Bundesliga","Marvin Ducksch","GER","FW","30-224",1994,5.1,3,2,0,2,1,0,5,0,5,2,0,2,0,3,8,0,"https://fbref.com/en/players/638a4d71/Marvin-Ducksch"
2025,"Werder Bremen","Bundesliga","Marco Friedl","AUT","DF","26-215",1998,3.7,7,6,3,4,0,2,6,33.3,4,7,5,2,5,12,20,0,"https://fbref.com/en/players/f86ad3f5/Marco-Friedl"
2025,"Werder Bremen","Bundesliga","Marco Grüll","AUT","FW,MF","26-103",1998,1.6,2,2,0,1,1,0,2,0,2,4,1,3,1,3,1,0,"https://fbref.com/en/players/8babb812/Marco-Grull"
2025,"Werder Bremen","Bundesliga","Anthony Jung","GER","DF","32-349",1991,5.4,7,5,5,2,0,3,5,60,2,3,1,2,6,13,25,0,"https://fbref.com/en/players/de838f86/Anthony-Jung"
2025,"Werder Bremen","Bundesliga","Derrick Köhn","GER","DF","25-256",1999,2.5,2,1,1,0,1,0,0,NA,0,2,2,0,2,4,5,0,"https://fbref.com/en/players/b735b590/Derrick-Kohn"
2025,"Werder Bremen","Bundesliga","Senne Lynen","BEL","MF","25-241",1999,4.8,11,5,5,3,3,6,7,85.7,1,8,1,7,4,15,10,0,"https://fbref.com/en/players/0ed60738/Senne-Lynen"
2025,"Werder Bremen","Bundesliga","Julián Malatini","ARG","DF","23-139",2001,2.4,6,6,3,2,1,3,5,60,2,2,2,0,3,9,9,0,"https://fbref.com/en/players/8b84b707/Julian-Malatini"
2025,"Werder Bremen","Bundesliga","Keke Maximilian Topp","GER","FW,MF","20-206",2004,1.3,1,0,0,0,1,0,0,NA,0,0,0,0,1,2,0,0,"https://fbref.com/en/players/ebb32f3a/Keke-Maximilian-Topp"
2025,"Werder Bremen","Bundesliga","Justin Njinmah","GER","MF,FW","23-337",2000,1.5,1,1,1,0,0,1,1,100,0,0,0,0,2,3,0,0,"https://fbref.com/en/players/a45241d5/Justin-Njinmah"
2025,"Werder Bremen","Bundesliga","Amos Pieper","GER","DF","26-274",1998,1.2,2,1,1,0,1,0,3,0,3,2,2,0,5,7,4,0,"https://fbref.com/en/players/526ea7cc/Amos-Pieper"
2025,"Werder Bremen","Bundesliga","Romano Schmid","AUT","MF","24-264",2000,5.8,8,1,3,4,1,5,12,41.7,7,5,0,5,0,8,4,0,"https://fbref.com/en/players/220ace7e/Romano-Schmid"
2025,"Werder Bremen","Bundesliga","Jens Stage","DEN","MF","27-344",1996,5.7,6,5,4,2,0,3,10,30,7,12,3,9,7,13,7,0,"https://fbref.com/en/players/1fffae99/Jens-Stage"
2025,"Werder Bremen","Bundesliga","Niklas Stark","GER","DF","29-186",1995,4.1,9,6,4,4,1,4,5,80,1,10,8,2,4,13,24,0,"https://fbref.com/en/players/aad48be9/Niklas-Stark"
2025,"Werder Bremen","Bundesliga","Miloš Veljković","SRB","DF","29-021",1995,1,0,0,0,0,0,0,1,0,1,1,1,0,0,0,2,0,"https://fbref.com/en/players/a5ae8f8e/Milos-Veljkovic"
2025,"Werder Bremen","Bundesliga","Mitchell Weiser","GER","DF,MF","30-179",1994,6,10,6,3,6,1,4,9,44.4,5,2,0,2,3,13,12,0,"https://fbref.com/en/players/30c220c3/Mitchell-Weiser"
2025,"Werder Bremen","Bundesliga","Michael Zetterer","GER","GK","29-097",1995,6,0,0,0,0,0,0,0,NA,0,0,0,0,0,0,1,1,"https://fbref.com/en/players/9b688ae1/Michael-Zetterer"
2025,"West Ham","Premier League","Edson Álvarez","MEX","MF,DF","26-359",1997,2.7,10,6,6,3,1,5,6,83.3,1,4,1,3,4,14,4,0,"https://fbref.com/en/players/8b3ab7ad/Edson-Alvarez"
2025,"West Ham","Premier League","Michail Antonio","JAM","FW","34-203",1990,4.8,0,0,0,0,0,0,1,0,1,2,0,2,0,0,1,0,"https://fbref.com/en/players/ac05f970/Michail-Antonio"
2025,"West Ham","Premier League","Alphonse Areola","FRA","GK","31-233",1993,6.5,1,1,1,0,0,1,2,50,1,0,0,0,0,1,3,0,"https://fbref.com/en/players/2f965a72/Alphonse-Areola"
2025,"West Ham","Premier League","Jarrod Bowen","ENG","MF,FW","27-302",1996,6.7,8,4,2,3,3,1,8,12.5,7,6,1,5,2,10,9,0,"https://fbref.com/en/players/79c84d1c/Jarrod-Bowen"
2025,"West Ham","Premier League","Vladimír Coufal","CZE","DF","32-056",1992,2.2,0,0,0,0,0,0,3,0,3,2,2,0,2,2,4,0,"https://fbref.com/en/players/fdf3cb77/Vladimir-Coufal"
2025,"West Ham","Premier League","Aaron Cresswell","ENG","DF","34-307",1989,0.3,1,0,0,1,0,1,1,100,0,1,0,1,0,1,1,0,"https://fbref.com/en/players/4f974391/Aaron-Cresswell"
2025,"West Ham","Premier League","Łukasz Fabiański","POL","GK","39-182",1985,0.5,0,0,0,0,0,0,0,NA,0,0,0,0,0,0,0,0,"https://fbref.com/en/players/9328b835/Lukasz-Fabianski"
2025,"West Ham","Premier League","Niclas Füllkrug","GER","FW","31-251",1993,0.7,0,0,0,0,0,0,0,NA,0,0,0,0,0,0,2,0,"https://fbref.com/en/players/4f16405e/Niclas-Fullkrug"
2025,"West Ham","Premier League","Luis Guilherme","BRA","MF","18-251",2006,0.1,0,0,0,0,0,0,0,NA,0,0,0,0,0,0,0,0,"https://fbref.com/en/players/b7672d43/Luis-Guilherme"
2025,"West Ham","Premier League","Danny Ings","ENG","FW,MF","32-086",1992,0.3,0,0,0,0,0,0,0,NA,0,0,0,0,0,0,0,0,"https://fbref.com/en/players/07802f7f/Danny-Ings"
2025,"West Ham","Premier League","Andy Irving","SCO","MF","24-157",2000,0.2,2,1,0,1,1,0,3,0,3,0,0,0,0,2,0,0,"https://fbref.com/en/players/b1be9fc0/Andy-Irving"
2025,"West Ham","Premier League","Max Kilman","ENG","DF","27-147",1997,7,4,2,2,2,0,2,4,50,2,9,5,4,10,14,33,0,"https://fbref.com/en/players/d0f72bf1/Max-Kilman"
2025,"West Ham","Premier League","Mohammed Kudus","GHA","MF,FW","24-076",2000,6.4,7,5,1,3,3,3,10,30,7,9,1,8,1,8,1,0,"https://fbref.com/en/players/b62878a5/Mohammed-Kudus"
2025,"West Ham","Premier League","Konstantinos Mavropanos","GRE","DF","26-311",1997,5.5,10,7,8,2,0,5,8,62.5,3,10,8,2,12,22,34,0,"https://fbref.com/en/players/00963611/Konstantinos-Mavropanos"
2025,"West Ham","Premier League","Emerson Palmieri","ITA","DF,MF","30-075",1994,5.6,14,7,8,6,0,4,10,40,6,7,1,6,6,20,11,0,"https://fbref.com/en/players/e0bc6fdc/Emerson-Palmieri"
2025,"West Ham","Premier League","Lucas Paquetá","BRA","MF","27-051",1997,5.8,10,5,5,4,1,5,9,55.6,4,7,1,6,4,14,5,2,"https://fbref.com/en/players/9b6f7fd5/Lucas-Paqueta"
2025,"West Ham","Premier League","Guido Rodríguez","ARG","MF","30-188",1994,5.9,16,6,11,5,0,6,15,40,9,8,2,6,8,24,11,0,"https://fbref.com/en/players/34e393f2/Guido-Rodriguez"
2025,"West Ham","Premier League","Carlos Soler","ESP","MF","27-289",1997,1.4,2,2,1,1,0,1,5,20,4,4,1,3,1,3,2,0,"https://fbref.com/en/players/fed17f5a/Carlos-Soler"
2025,"West Ham","Premier League","Tomáš Souček","CZE","MF","29-233",1995,5.1,10,6,4,5,1,6,10,60,4,7,2,5,5,15,14,0,"https://fbref.com/en/players/6613c819/Tomas-Soucek"
2025,"West Ham","Premier League","Crysencio Summerville","NED","FW,MF","22-353",2001,1.6,2,0,0,1,1,1,2,50,1,4,1,3,0,2,1,0,"https://fbref.com/en/players/df04eb4b/Crysencio-Summerville"
2025,"West Ham","Premier League","Jean-Clair Todibo","FRA","DF","24-292",1999,2.1,6,4,6,0,0,4,4,100,0,4,2,2,2,8,12,0,"https://fbref.com/en/players/88f130ed/Jean-Clair-Todibo"
2025,"West Ham","Premier League","Aaron Wan-Bissaka","ENG","DF,MF","26-326",1997,5.3,11,6,4,5,2,4,4,100,0,4,2,2,6,17,9,0,"https://fbref.com/en/players/9e525177/Aaron-Wan-Bissaka"
2025,"West Ham","Premier League","James Ward-Prowse","ENG","MF","29-351",1994,0.2,1,0,1,0,0,1,1,100,0,1,0,1,0,1,0,0,"https://fbref.com/en/players/3515d404/James-Ward-Prowse"
2025,"Wolfsburg","Bundesliga","Mohamed Amoura","ALG","FW","24-161",2000,3.4,3,1,1,0,2,0,0,NA,0,4,0,4,0,3,1,0,"https://fbref.com/en/players/6597f8b6/Mohamed-Amoura"
2025,"Wolfsburg","Bundesliga","Maximilian Arnold","GER","MF","30-143",1994,5.9,11,8,3,6,2,4,9,44.4,5,5,4,1,2,13,17,0,"https://fbref.com/en/players/86e119e0/Maximilian-Arnold"
2025,"Wolfsburg","Bundesliga","Ridle Baku","GER","FW,MF","26-192",1998,4.4,7,5,1,4,2,3,9,33.3,6,10,0,10,5,12,5,0,"https://fbref.com/en/players/442b56fa/Ridle-Baku"
2025,"Wolfsburg","Bundesliga","Kevin Behrens","GER","FW","33-257",1991,0.5,1,1,0,1,0,0,1,0,1,0,0,0,0,1,0,0,"https://fbref.com/en/players/30ae134d/Kevin-Behrens"
2025,"Wolfsburg","Bundesliga","Sebastiaan Bornauw","BEL","DF","25-209",1999,6,5,3,2,2,1,1,4,25,3,11,11,0,8,13,25,0,"https://fbref.com/en/players/01834aa0/Sebastiaan-Bornauw"
2025,"Wolfsburg","Bundesliga","Bence Dárdai","GER","FW","18-267",2006,0.1,0,0,0,0,0,0,0,NA,0,0,0,0,1,1,0,0,"https://fbref.com/en/players/dcb6f03c/Bence-Dardai"
2025,"Wolfsburg","Bundesliga","Kilian Fischer","GER","DF","24-005",2000,5.2,17,13,12,3,2,13,27,48.1,14,10,0,10,5,22,18,1,"https://fbref.com/en/players/79f7302a/Kilian-Fischer"
2025,"Wolfsburg","Bundesliga","Yannick Gerhardt","GER","DF,FW","30-218",1994,0.6,1,1,1,0,0,1,1,100,0,2,0,2,3,4,2,0,"https://fbref.com/en/players/62ab9184/Yannick-Gerhardt"
2025,"Wolfsburg","Bundesliga","Kamil Grabara","POL","GK","25-283",1999,6,0,0,0,0,0,0,1,0,1,1,0,1,0,0,3,0,"https://fbref.com/en/players/62182b1d/Kamil-Grabara"
2025,"Wolfsburg","Bundesliga","Jakub Kamiński","POL","DF,MF","22-134",2002,5.9,10,4,4,2,4,5,16,31.3,11,11,6,5,6,16,7,0,"https://fbref.com/en/players/202b3b68/Jakub-Kaminski"
2025,"Wolfsburg","Bundesliga","Konstantinos Koulierakis","GRE","DF","20-324",2003,2.6,5,2,4,1,0,2,5,40,3,7,3,4,1,6,17,0,"https://fbref.com/en/players/cba21b0d/Konstantinos-Koulierakis"
2025,"Wolfsburg","Bundesliga","Lovro Majer","CRO","MF","26-274",1998,1.3,0,0,0,0,0,0,1,0,1,1,0,1,0,0,1,0,"https://fbref.com/en/players/fc46aab1/Lovro-Majer"
2025,"Wolfsburg","Bundesliga","Joakim Mæhle","DEN","MF","27-150",1997,0,0,0,0,0,0,0,0,NA,0,0,0,0,0,0,0,0,"https://fbref.com/en/players/c459a650/Joakim-Maehle"
2025,"Wolfsburg","Bundesliga","Salih Özcan","TUR","MF","26-280",1998,1.4,1,1,0,0,1,0,4,0,4,5,1,4,2,3,1,0,"https://fbref.com/en/players/15413fa5/Salih-Ozcan"
2025,"Wolfsburg","Bundesliga","Mattias Svanberg","SWE","MF","25-286",1999,4.2,6,3,0,5,1,1,3,33.3,2,1,0,1,4,10,4,0,"https://fbref.com/en/players/92d83c27/Mattias-Svanberg"
2025,"Wolfsburg","Bundesliga","Tiago Tomás","POR","FW,MF","22-123",2002,4.9,7,4,5,1,1,4,13,30.8,9,4,1,3,4,11,6,0,"https://fbref.com/en/players/b492126a/Tiago-Tomas"
2025,"Wolfsburg","Bundesliga","Denis Vavro","SVK","DF","28-190",1996,1,0,0,0,0,0,0,0,NA,0,1,0,1,2,2,8,0,"https://fbref.com/en/players/08990838/Denis-Vavro"
2025,"Wolfsburg","Bundesliga","Aster Vranckx","BEL","MF","22-013",2002,1.4,3,2,1,2,0,1,1,100,0,2,1,1,3,6,4,0,"https://fbref.com/en/players/f86cd5df/Aster-Vranckx"
2025,"Wolfsburg","Bundesliga","Patrick Wimmer","AUT","FW,MF","23-140",2001,3.5,4,4,1,3,0,2,6,33.3,4,4,0,4,4,8,2,0,"https://fbref.com/en/players/cb11b429/Patrick-Wimmer"
2025,"Wolfsburg","Bundesliga","Jonas Wind","DEN","MF,FW","25-253",1999,2.5,0,0,0,0,0,0,0,NA,0,1,0,1,0,0,3,0,"https://fbref.com/en/players/2077ae86/Jonas-Wind"
2025,"Wolfsburg","Bundesliga","Cedric Zesiger","SUI","DF","26-115",1998,5,10,6,3,5,2,4,9,44.4,5,5,5,0,3,13,24,0,"https://fbref.com/en/players/2bab583c/Cedric-Zesiger"
2025,"Wolves","Premier League","Rayan Aït-Nouri","ALG","DF,MF","23-133",2001,6.3,11,6,9,2,0,4,7,57.1,3,6,0,6,6,17,15,1,"https://fbref.com/en/players/9b398aea/Rayan-Ait-Nouri"
2025,"Wolves","Premier League","André","BRA","MF","23-093",2001,3.5,8,4,4,2,2,5,6,83.3,1,5,2,3,2,10,2,0,"https://fbref.com/en/players/ec604e2c/Andre"
2025,"Wolves","Premier League","Jean-Ricner Bellegarde","FRA","MF,FW","26-112",1998,4.5,6,4,2,2,2,2,3,66.7,1,5,0,5,4,10,1,0,"https://fbref.com/en/players/10f0fdd3/Jean-Ricner-Bellegarde"
2025,"Wolves","Premier League","Santiago Bueno","URU","DF","25-343",1998,0.9,3,2,2,1,0,2,2,100,0,2,0,2,1,4,6,0,"https://fbref.com/en/players/edc98fac/Santiago-Bueno"
2025,"Wolves","Premier League","Chiquinho","POR","MF","24-255",2000,0.1,0,0,0,0,0,0,0,NA,0,0,0,0,0,0,0,0,"https://fbref.com/en/players/dc6c2f02/Chiquinho"
2025,"Wolves","Premier League","Matheus Cunha","BRA","MF,FW","25-143",1999,6.1,8,7,3,3,2,0,6,0,6,4,0,4,4,12,10,0,"https://fbref.com/en/players/dc62b55d/Matheus-Cunha"
2025,"Wolves","Premier League","Craig Dawson","ENG","DF","34-164",1990,4.3,5,3,3,1,1,5,6,83.3,1,5,4,1,4,9,18,0,"https://fbref.com/en/players/3e9e06cb/Craig-Dawson"
2025,"Wolves","Premier League","Matt Doherty","IRL","DF","32-275",1992,2.3,8,6,6,2,0,4,5,80,1,4,1,3,2,10,8,0,"https://fbref.com/en/players/d557d734/Matt-Doherty"
2025,"Wolves","Premier League","Tommy Doyle","ENG","MF","23-000",2001,0.8,1,0,0,1,0,1,2,50,1,1,0,1,0,1,1,0,"https://fbref.com/en/players/5526deb1/Tommy-Doyle"
2025,"Wolves","Premier League","Carlos Forbs","POR","MF","20-212",2004,1.2,5,5,2,2,1,3,4,75,1,1,0,1,0,5,1,0,"https://fbref.com/en/players/8a310070/Carlos-Forbs"
2025,"Wolves","Premier League","João Gomes","BRA","MF","23-248",2001,6.3,24,15,12,11,1,5,18,27.8,13,5,1,4,5,29,4,0,"https://fbref.com/en/players/8b57ad2c/Joao-Gomes"
2025,"Wolves","Premier League","Rodrigo Gomes","POR","FW,MF","21-102",2003,1.3,4,1,2,2,0,1,3,33.3,2,2,0,2,0,4,1,0,"https://fbref.com/en/players/8dcf77c0/Rodrigo-Gomes"
2025,"Wolves","Premier League","Toti Gomes","POR","DF","25-275",1999,5,7,6,5,2,0,4,4,100,0,3,2,1,1,8,18,0,"https://fbref.com/en/players/f0caab96/Toti-Gomes"
2025,"Wolves","Premier League","Gonçalo Guedes","POR","MF,FW","27-323",1996,0.8,1,1,0,0,1,0,3,0,3,3,0,3,2,3,1,0,"https://fbref.com/en/players/e6bc67d7/Goncalo-Guedes"
2025,"Wolves","Premier League","Hwang Hee-chan","KOR","FW,MF","28-265",1996,2.8,1,0,0,0,1,0,1,0,1,5,0,5,1,2,3,0,"https://fbref.com/en/players/169fd162/Hwang-Hee-chan"
2025,"Wolves","Premier League","Sam Johnstone","ENG","GK","31-206",1993,5,0,0,0,0,0,0,0,NA,0,0,0,0,0,0,5,0,"https://fbref.com/en/players/9e5708be/Sam-Johnstone"
2025,"Wolves","Premier League","Mario Lemina","GAB","MF,FW","31-046",1993,7,22,12,12,8,2,11,14,78.6,3,6,4,2,15,37,14,1,"https://fbref.com/en/players/2b471f99/Mario-Lemina"
2025,"Wolves","Premier League","Yerson Mosquera","COL","DF","23-168",2001,4.9,11,7,9,2,0,9,14,64.3,5,13,10,3,10,21,14,0,"https://fbref.com/en/players/1e159d70/Yerson-Mosquera"
2025,"Wolves","Premier League","Daniel Podence","POR","MF,FW","28-362",1995,0.5,0,0,0,0,0,0,1,0,1,0,0,0,0,0,0,0,"https://fbref.com/en/players/7fcc71d8/Daniel-Podence"
2025,"Wolves","Premier League","José Sá","POR","GK","31-274",1993,2,0,0,0,0,0,0,0,NA,0,0,0,0,0,0,2,0,"https://fbref.com/en/players/903b6e8b/Jose-Sa"
2025,"Wolves","Premier League","Pablo Sarabia","ESP","FW,MF","32-159",1992,0.3,2,0,1,0,1,1,2,50,1,2,0,2,1,3,0,0,"https://fbref.com/en/players/9744ff80/Pablo-Sarabia"
2025,"Wolves","Premier League","Nélson Semedo","POR","DF","30-336",1993,4.7,9,4,5,3,1,4,11,36.4,7,2,1,1,1,10,18,0,"https://fbref.com/en/players/d04b94db/Nelson-Semedo"
2025,"Wolves","Premier League","Jørgen Strand Larsen","NOR","FW","24-254",2000,6.3,2,2,1,0,1,0,5,0,5,4,1,3,1,3,6,0,"https://fbref.com/en/players/f553b2b3/Jorgen-Strand-Larsen"
